#chrom	chromStart	chromEnd	name	length	cpgNum	gcNum	perCpg	perGc	obsExp
chr1	2714	3606	CpG: 161	892	161	713	36.1	79.9	1.16
chr1	24168	26285	CpG: 180	2117	180	1302	17.0	61.5	0.90
chr1	36361	37578	CpG: 106	1217	106	890	17.4	73.1	0.66
chr1	136811	137089	CpG: 24	278	24	174	17.3	62.6	0.89
chr1	205141	205704	CpG: 60	563	60	384	21.3	68.2	0.92
chr1	256008	257037	CpG: 121	1029	121	726	23.5	70.6	0.98
chr1	282403	282849	CpG: 32	446	32	241	14.3	54.0	0.98
chr1	298792	299222	CpG: 50	430	50	316	23.3	73.5	0.87
chr1	328993	329231	CpG: 18	238	18	142	15.1	59.7	0.87
chr1	334221	335526	CpG: 155	1305	155	937	23.8	71.8	0.93
chr1	338950	340138	CpG: 124	1188	124	878	20.9	73.9	0.78
chr1	349029	349237	CpG: 16	208	16	140	15.4	67.3	0.68
chr1	353233	355885	CpG: 339	2652	339	1994	25.6	75.2	0.91
chr1	368972	371728	CpG: 282	2756	282	2026	20.5	73.5	0.76
chr1	387718	395985	CpG: 645	8267	645	5696	15.6	68.9	0.66
chr1	399626	399868	CpG: 23	242	23	175	19.0	72.3	0.74
chr1	401016	401291	CpG: 20	275	20	182	14.5	66.2	0.68
chr1	404755	409265	CpG: 328	4510	328	3279	14.5	72.7	0.64
chr1	412753	413167	CpG: 35	414	35	268	16.9	64.7	0.81
chr1	414186	414387	CpG: 15	201	15	139	14.9	69.2	0.63
chr1	428105	432185	CpG: 456	4080	456	2974	22.4	72.9	0.84
chr1	437916	438190	CpG: 23	274	23	169	16.8	61.7	0.89
chr1	443420	443678	CpG: 20	258	20	155	15.5	60.1	0.86
chr1	444080	444602	CpG: 35	522	35	345	13.4	66.1	0.62
chr1	445907	446184	CpG: 19	277	19	165	13.7	59.6	0.78
chr1	447348	447559	CpG: 18	211	18	119	17.1	56.4	1.09
chr1	448584	448810	CpG: 21	226	21	164	18.6	72.6	0.71
chr1	449517	451094	CpG: 204	1577	204	1258	25.9	79.8	0.81
chr1	458349	459280	CpG: 68	931	68	662	14.6	71.1	0.61
chr1	462722	464994	CpG: 220	2272	220	1688	19.4	74.3	0.71
chr1	486362	486815	CpG: 39	453	39	296	17.2	65.3	0.97
chr1	489128	489995	CpG: 102	867	102	655	23.5	75.5	0.84
chr1	494342	494575	CpG: 20	233	20	167	17.2	71.7	0.67
chr1	497298	500032	CpG: 243	2734	243	1941	17.8	71.0	0.71
chr1	501930	502347	CpG: 40	417	40	312	19.2	74.8	0.69
chr1	506222	506857	CpG: 44	635	44	453	13.9	71.3	0.65
chr1	509004	509497	CpG: 32	493	32	356	13.0	72.2	0.87
chr1	511332	511623	CpG: 30	291	30	207	20.6	71.1	0.82
chr1	513051	513259	CpG: 15	208	15	144	14.4	69.2	0.60
chr1	516377	516581	CpG: 19	204	19	143	18.6	70.1	0.89
chr1	517309	517848	CpG: 44	539	44	369	16.3	68.5	0.70
chr1	519611	519859	CpG: 20	248	20	176	16.1	71.0	0.64
chr1	520743	520964	CpG: 18	221	18	160	16.3	72.4	0.62
chr1	539278	539574	CpG: 25	296	25	181	16.9	61.1	0.93
chr1	543750	545697	CpG: 208	1947	208	1398	21.4	71.8	0.85
chr1	559977	560406	CpG: 32	429	32	251	14.9	58.5	0.88
chr1	562421	562695	CpG: 21	274	21	170	15.3	62.0	0.81
chr1	565605	566083	CpG: 55	478	55	371	23.0	77.6	0.77
chr1	591260	593801	CpG: 183	2541	183	1652	14.4	65.0	0.69
chr1	602531	603497	CpG: 67	966	67	609	13.9	63.0	0.70
chr1	608791	609223	CpG: 32	432	32	302	14.8	69.9	0.61
chr1	615295	615523	CpG: 17	228	17	139	14.9	61.0	0.82
chr1	625828	626273	CpG: 48	445	48	338	21.6	76.0	0.76
chr1	629361	630157	CpG: 105	796	105	622	26.4	78.1	0.86
chr1	634747	635227	CpG: 55	480	55	343	22.9	71.5	0.90
chr1	638645	638955	CpG: 25	310	25	210	16.1	67.7	0.70
chr1	639785	639991	CpG: 16	206	16	141	15.5	68.4	0.67
chr1	642132	642601	CpG: 38	469	38	342	16.2	72.9	0.62
chr1	645599	646211	CpG: 78	612	78	438	25.5	71.6	1.00
chr1	646861	647496	CpG: 44	635	44	417	13.9	65.7	0.65
chr1	651394	651810	CpG: 37	416	37	235	17.8	56.5	1.25
chr1	652245	652605	CpG: 28	360	28	243	15.6	67.5	0.70
chr1	655019	655358	CpG: 25	339	25	225	14.7	66.4	0.67
chr1	659979	662062	CpG: 300	2083	300	1564	28.8	75.1	1.02
chr1	666992	667340	CpG: 27	348	27	250	15.5	71.8	0.61
chr1	671005	671327	CpG: 26	322	26	228	16.1	70.8	0.66
chr1	675309	676023	CpG: 90	714	90	554	25.2	77.6	0.84
chr1	683014	683863	CpG: 68	849	68	567	16.0	66.8	0.72
chr1	684140	684417	CpG: 25	277	25	182	18.1	65.7	0.84
chr1	685597	685842	CpG: 19	245	19	146	15.5	59.6	0.89
chr1	687980	688377	CpG: 28	397	28	229	14.1	57.7	0.90
chr1	696793	697224	CpG: 31	431	31	274	14.4	63.6	0.72
chr1	702142	703569	CpG: 167	1427	167	1055	23.4	73.9	0.86
chr1	708431	708661	CpG: 16	230	16	138	13.9	60.0	0.79
chr1	709236	709456	CpG: 17	220	17	137	15.5	62.3	0.81
chr1	715220	726329	CpG: 876	11109	876	7665	15.8	69.0	0.68
chr1	738569	741356	CpG: 342	2787	342	2026	24.5	72.7	0.93
chr1	744094	744669	CpG: 41	575	41	393	14.3	68.3	0.63
chr1	750456	750682	CpG: 18	226	18	154	15.9	68.1	0.70
chr1	755848	756840	CpG: 122	992	122	748	24.6	75.4	0.87
chr1	758870	759681	CpG: 68	811	68	563	16.8	69.4	0.70
chr1	761209	761839	CpG: 51	630	51	354	16.2	56.2	1.05
chr1	763290	763491	CpG: 16	201	16	132	15.9	65.7	0.75
chr1	763640	765191	CpG: 116	1551	116	1059	15.0	68.3	0.64
chr1	780179	786290	CpG: 523	6111	523	4327	17.1	70.8	0.69
chr1	804309	806208	CpG: 167	1899	167	1269	17.6	66.8	0.79
chr1	810159	810436	CpG: 19	277	19	163	13.7	58.8	0.80
chr1	819199	819479	CpG: 25	280	25	169	17.9	60.4	0.98
chr1	830621	832152	CpG: 167	1531	167	1050	21.8	68.6	0.93
chr1	838172	839821	CpG: 162	1649	162	1093	19.6	66.3	0.92
chr1	848707	848939	CpG: 20	232	20	142	17.2	61.2	0.94
chr1	851709	852622	CpG: 118	913	118	726	25.8	79.5	0.82
chr1	858109	858336	CpG: 20	227	20	171	17.6	75.3	0.63
chr1	861400	861842	CpG: 69	442	69	355	31.2	80.3	1.02
chr1	865152	865374	CpG: 18	222	18	157	16.2	70.7	0.67
chr1	869747	870429	CpG: 104	682	104	536	30.5	78.6	1.01
chr1	873441	874564	CpG: 133	1123	133	849	23.7	75.6	0.83
chr1	877396	877631	CpG: 17	235	17	144	14.5	61.3	0.78
chr1	884421	884622	CpG: 14	201	14	119	13.9	59.2	0.81
chr1	888548	888882	CpG: 27	334	27	230	16.2	68.9	0.70
chr1	895078	895331	CpG: 19	253	19	163	15.0	64.4	0.73
chr1	903162	903395	CpG: 20	233	20	158	17.2	67.8	0.75
chr1	905835	906812	CpG: 136	977	136	721	27.8	73.8	1.03
chr1	908585	908868	CpG: 22	283	22	171	15.5	60.4	0.87
chr1	913158	913656	CpG: 40	498	40	340	16.1	68.3	0.69
chr1	916409	916877	CpG: 43	468	43	327	18.4	69.9	0.78
chr1	919350	919808	CpG: 34	458	34	314	14.8	68.6	0.63
chr1	943712	943973	CpG: 19	261	19	172	14.6	65.9	0.67
chr1	946002	947329	CpG: 176	1327	176	981	26.5	73.9	0.97
chr1	951825	952323	CpG: 40	498	40	340	16.1	68.3	0.69
chr1	952947	953167	CpG: 15	220	15	150	13.6	68.2	0.78
chr1	954426	955016	CpG: 48	590	48	408	16.3	69.2	0.69
chr1	955953	956198	CpG: 18	245	18	163	14.7	66.5	0.67
chr1	957078	958153	CpG: 77	1075	77	721	14.3	67.1	0.64
chr1	963632	963930	CpG: 23	298	23	203	15.4	68.1	0.67
chr1	965054	965328	CpG: 23	274	23	170	16.8	62.0	0.88
chr1	969728	970714	CpG: 83	986	83	703	16.8	71.3	0.66
chr1	972231	972466	CpG: 21	235	21	141	17.9	60.0	1.00
chr1	974086	975970	CpG: 204	1884	204	1422	21.7	75.5	0.76
chr1	978031	978363	CpG: 27	332	27	240	16.3	72.3	0.72
chr1	988656	988918	CpG: 25	262	25	180	19.1	68.7	0.81
chr1	995875	996110	CpG: 19	235	19	139	16.2	59.1	0.96
chr1	1008608	1010458	CpG: 204	1850	204	1195	22.1	64.6	1.06
chr1	1022413	1022642	CpG: 17	229	17	139	14.8	60.7	0.83
chr1	1033457	1035262	CpG: 239	1805	239	1357	26.5	75.2	0.94
chr1	1049578	1051140	CpG: 199	1562	199	1168	25.5	74.8	0.91
chr1	1057712	1058484	CpG: 73	772	73	552	18.9	71.5	0.74
chr1	1059905	1060180	CpG: 27	275	27	198	19.6	72.0	0.77
chr1	1061174	1069131	CpG: 632	7957	632	5705	15.9	71.7	0.62
chr1	1070157	1070595	CpG: 31	438	31	297	14.2	67.8	0.62
chr1	1079502	1080013	CpG: 43	511	43	305	16.8	59.7	1.00
chr1	1093074	1093943	CpG: 93	869	93	565	21.4	65.0	1.01
chr1	1103982	1104232	CpG: 21	250	21	164	16.8	65.6	0.78
chr1	1105392	1105687	CpG: 21	295	21	187	14.2	63.4	0.72
chr1	1110899	1111244	CpG: 27	345	27	213	15.7	61.7	0.82
chr1	1112002	1112274	CpG: 21	272	21	150	15.4	55.1	1.04
chr1	1126523	1128713	CpG: 206	2190	206	1417	18.8	64.7	0.90
chr1	1134029	1136219	CpG: 191	2190	191	1564	17.4	71.4	0.68
chr1	1137245	1137683	CpG: 30	438	30	296	13.7	67.6	0.60
chr1	1138496	1138705	CpG: 16	209	16	142	15.3	67.9	0.67
chr1	1141537	1142003	CpG: 33	466	33	315	14.2	67.6	0.62
chr1	1146574	1147085	CpG: 43	511	43	305	16.8	59.7	1.00
chr1	1158324	1159160	CpG: 82	836	82	536	19.6	64.1	0.96
chr1	1173691	1174036	CpG: 28	345	28	213	16.2	61.7	0.85
chr1	1179730	1181569	CpG: 182	1839	182	1217	19.8	66.2	0.91
chr1	1188355	1188931	CpG: 46	576	46	385	16.0	66.8	0.72
chr1	1194729	1195025	CpG: 22	296	22	204	14.9	68.9	0.64
chr1	1212333	1213521	CpG: 160	1188	160	914	26.9	76.9	0.91
chr1	1216578	1217080	CpG: 45	502	45	350	17.9	69.7	0.74
chr1	1233331	1233600	CpG: 21	269	21	165	15.6	61.3	0.83
chr1	1264682	1264928	CpG: 18	246	18	151	14.6	61.4	0.80
chr1	1314715	1314937	CpG: 21	222	21	138	18.9	62.2	1.00
chr1	1324354	1326224	CpG: 272	1870	272	1455	29.1	77.8	0.96
chr1	1342942	1344330	CpG: 149	1388	149	987	21.5	71.1	0.86
chr1	1353081	1354365	CpG: 126	1284	126	940	19.6	73.2	0.74
chr1	1362324	1362601	CpG: 22	277	22	183	15.9	66.1	0.73
chr1	1378190	1378490	CpG: 25	300	25	215	16.7	71.7	0.65
chr1	1379113	1379352	CpG: 20	239	20	163	16.7	68.2	0.72
chr1	1389943	1390505	CpG: 48	562	48	367	17.1	65.3	0.80
chr1	1400049	1400263	CpG: 18	214	18	149	16.8	69.6	0.69
chr1	1401216	1401421	CpG: 17	205	17	145	16.6	70.7	0.74
chr1	1413903	1417505	CpG: 299	3602	299	2367	16.6	65.7	0.78
chr1	1439019	1439305	CpG: 36	286	36	220	25.2	76.9	0.86
chr1	1454274	1455592	CpG: 158	1318	158	1043	24.0	79.1	0.80
chr1	1461159	1461499	CpG: 35	340	35	229	20.6	67.4	0.91
chr1	1463526	1463980	CpG: 44	454	44	307	19.4	67.6	0.87
chr1	1465055	1465261	CpG: 15	206	15	127	14.6	61.7	0.77
chr1	1465527	1465963	CpG: 37	436	37	289	17.0	66.3	0.77
chr1	1478764	1479020	CpG: 22	256	22	180	17.2	70.3	0.70
chr1	1480131	1480791	CpG: 74	660	74	483	22.4	73.2	0.84
chr1	1485331	1487292	CpG: 226	1961	226	1426	23.0	72.7	0.88
chr1	1490195	1490713	CpG: 37	518	37	296	14.3	57.1	0.88
chr1	1494859	1495251	CpG: 29	392	29	240	14.8	61.2	0.80
chr1	1509259	1509645	CpG: 40	386	40	263	20.7	68.1	0.90
chr1	1527022	1527374	CpG: 24	352	24	215	13.6	61.1	0.73
chr1	1529285	1530305	CpG: 83	1020	83	701	16.3	68.7	0.69
chr1	1544909	1545214	CpG: 23	305	23	203	15.1	66.6	0.70
chr1	1550247	1550683	CpG: 32	436	32	277	14.7	63.5	0.73
chr1	1556799	1558684	CpG: 129	1885	129	1150	13.7	61.0	1.22
chr1	1567143	1567413	CpG: 20	270	20	171	14.8	63.3	0.77
chr1	1567989	1568540	CpG: 54	551	54	398	19.6	72.2	0.86
chr1	1569728	1570027	CpG: 22	299	22	209	14.7	69.9	0.60
chr1	1604379	1604793	CpG: 34	414	34	295	16.4	71.3	0.76
chr1	1607806	1608016	CpG: 24	210	24	136	22.9	64.8	1.29
chr1	1610975	1611371	CpG: 27	396	27	235	13.6	59.3	0.82
chr1	1615308	1615638	CpG: 42	330	42	203	25.5	61.5	1.35
chr1	1619968	1620337	CpG: 34	369	34	238	18.4	64.5	0.89
chr1	1623695	1623976	CpG: 25	281	25	176	17.8	62.6	0.92
chr1	1624554	1625355	CpG: 59	801	59	545	14.7	68.0	0.64
chr1	1629425	1630179	CpG: 82	754	82	576	21.8	76.4	0.75
chr1	1639455	1640888	CpG: 143	1433	143	1070	20.0	74.7	0.77
chr1	1648169	1648467	CpG: 24	298	24	211	16.1	70.8	0.64
chr1	1662182	1665143	CpG: 440	2961	440	2313	29.7	78.1	0.98
chr1	1715997	1718362	CpG: 229	2365	229	1478	19.4	62.5	1.11
chr1	1735087	1735342	CpG: 20	255	20	179	15.7	70.2	0.65
chr1	1736836	1737143	CpG: 23	307	23	203	15.0	66.1	0.69
chr1	1739834	1740383	CpG: 42	549	42	375	15.3	68.3	0.66
chr1	1740968	1743595	CpG: 206	2627	206	1721	15.7	65.5	0.73
chr1	1750206	1751578	CpG: 144	1372	144	1039	21.0	75.7	0.73
chr1	1753808	1754127	CpG: 26	319	26	228	16.3	71.5	0.64
chr1	1758216	1759251	CpG: 75	1035	75	706	14.5	68.2	0.62
chr1	1765938	1766264	CpG: 23	326	23	224	14.1	68.7	0.60
chr1	1766905	1767167	CpG: 24	262	24	185	18.3	70.6	0.74
chr1	1771025	1771311	CpG: 40	286	40	218	28.0	76.2	1.22
chr1	1773848	1774273	CpG: 30	425	30	257	14.1	60.5	0.78
chr1	1784194	1784493	CpG: 24	299	24	193	16.1	64.5	0.79
chr1	1787715	1788128	CpG: 51	413	51	285	24.7	69.0	1.10
chr1	1810195	1810465	CpG: 18	270	18	161	13.3	59.6	0.76
chr1	1811989	1812206	CpG: 16	217	16	141	14.7	65.0	0.70
chr1	1824183	1824579	CpG: 37	396	37	281	18.7	71.0	0.75
chr1	1830311	1831594	CpG: 159	1283	159	967	24.8	75.4	0.88
chr1	1841700	1842323	CpG: 43	623	43	391	13.8	62.8	0.72
chr1	1848027	1848397	CpG: 27	370	27	250	14.6	67.6	0.64
chr1	1851536	1852868	CpG: 149	1332	149	995	22.4	74.7	0.81
chr1	1854042	1854307	CpG: 19	265	19	163	14.3	61.5	0.76
chr1	1868076	1868327	CpG: 25	251	25	178	19.9	70.9	0.79
chr1	1873588	1873841	CpG: 20	253	20	167	15.8	66.0	0.73
chr1	1879948	1881893	CpG: 140	1945	140	1295	14.4	66.6	0.66
chr1	1884566	1885695	CpG: 134	1129	134	865	23.7	76.6	0.81
chr1	1897540	1897957	CpG: 30	417	30	285	14.4	68.3	0.62
chr1	1908505	1908726	CpG: 27	221	27	175	24.4	79.2	0.78
chr1	1919428	1919720	CpG: 26	292	26	199	17.8	68.2	0.78
chr1	1920796	1921075	CpG: 24	279	24	193	17.2	69.2	0.73
chr1	1924869	1925156	CpG: 27	287	27	219	18.8	76.3	0.69
chr1	1943236	1943715	CpG: 41	479	41	356	17.1	74.3	0.62
chr1	1949447	1949672	CpG: 17	225	17	148	15.1	65.8	0.71
chr1	1949776	1950128	CpG: 30	352	30	214	17.0	60.8	0.92
chr1	1955005	1955298	CpG: 24	293	24	195	16.4	66.6	0.75
chr1	1959572	1959856	CpG: 25	284	25	190	17.6	66.9	0.82
chr1	1960867	1961201	CpG: 29	334	29	230	17.4	68.9	0.74
chr1	1962445	1962657	CpG: 16	212	16	147	15.1	69.3	0.63
chr1	1967446	1968464	CpG: 118	1018	118	720	23.2	70.7	0.94
chr1	1970965	1972215	CpG: 165	1250	165	928	26.4	74.2	0.97
chr1	1977139	1977417	CpG: 23	278	23	194	16.5	69.8	0.69
chr1	1982300	1982791	CpG: 54	491	54	355	22.0	72.3	0.84
chr1	1987768	1988568	CpG: 75	800	75	590	18.8	73.8	0.69
chr1	1990179	1990428	CpG: 17	249	17	147	13.7	59.0	0.79
chr1	2027603	2029098	CpG: 159	1495	159	1079	21.3	72.2	0.82
chr1	2037444	2037708	CpG: 20	264	20	185	15.2	70.1	0.63
chr1	2047869	2048084	CpG: 19	215	19	142	17.7	66.0	0.81
chr1	2058789	2059031	CpG: 22	242	22	151	18.2	62.4	0.95
chr1	2070104	2071267	CpG: 103	1163	103	875	17.7	75.2	0.64
chr1	2072088	2072655	CpG: 37	567	37	306	13.1	54.0	1.02
chr1	2083835	2084669	CpG: 86	834	86	616	20.6	73.9	0.76
chr1	2289060	2290147	CpG: 126	1087	126	794	23.2	73.0	0.87
chr1	2299946	2300438	CpG: 41	492	41	353	16.7	71.7	0.65
chr1	2356001	2356540	CpG: 44	539	44	326	16.3	60.5	0.89
chr1	2361784	2361988	CpG: 15	204	15	136	14.7	66.7	0.66
chr1	2412491	2413000	CpG: 40	509	40	315	15.7	61.9	0.82
chr1	2431747	2431979	CpG: 19	232	19	165	16.4	71.1	0.65
chr1	2435356	2435564	CpG: 16	208	16	122	15.4	58.7	0.90
chr1	2461308	2461571	CpG: 21	263	21	184	16.0	70.0	0.65
chr1	2469825	2470047	CpG: 18	222	18	126	16.2	56.8	1.01
chr1	2471352	2471686	CpG: 23	334	23	200	13.8	59.9	0.77
chr1	2496024	2496297	CpG: 20	273	20	164	14.7	60.1	0.82
chr1	2502838	2503226	CpG: 34	388	34	242	17.5	62.4	0.98
chr1	2513629	2513850	CpG: 22	221	22	163	19.9	73.8	0.74
chr1	2523689	2524099	CpG: 28	410	28	267	13.7	65.1	0.64
chr1	2564753	2566236	CpG: 137	1483	137	1008	18.5	68.0	0.80
chr1	2569403	2573439	CpG: 483	4036	483	2946	23.9	73.0	0.90
chr1	2575507	2576195	CpG: 82	688	82	509	23.8	74.0	0.87
chr1	2585211	2585462	CpG: 19	251	19	171	15.1	68.1	0.65
chr1	2613705	2614083	CpG: 30	378	30	238	15.9	63.0	0.80
chr1	2616192	2616604	CpG: 49	412	49	246	23.8	59.7	1.51
chr1	2623605	2623881	CpG: 20	276	20	184	14.5	66.7	0.67
chr1	2636960	2637172	CpG: 19	212	19	159	17.9	75.0	0.64
chr1	2642087	2642318	CpG: 21	231	21	138	18.2	59.7	1.02
chr1	2657436	2657776	CpG: 27	340	27	205	15.9	60.3	0.88
chr1	2664236	2664466	CpG: 18	230	18	143	15.7	62.2	0.87
chr1	2667213	2667414	CpG: 19	201	19	126	18.9	62.7	1.04
chr1	2670690	2671009	CpG: 25	319	25	242	15.7	75.9	0.76
chr1	2683722	2684386	CpG: 56	664	56	345	16.9	52.0	1.43
chr1	2688998	2689612	CpG: 43	614	43	396	14.0	64.5	0.68
chr1	2691414	2691794	CpG: 31	380	31	236	16.3	62.1	0.85
chr1	2697605	2698388	CpG: 60	783	60	502	15.3	64.1	0.77
chr1	2703453	2703676	CpG: 17	223	17	135	15.2	60.5	0.85
chr1	2710134	2710342	CpG: 15	208	15	121	14.4	58.2	0.90
chr1	2714646	2715976	CpG: 95	1330	95	887	14.3	66.7	0.65
chr1	2734597	2734896	CpG: 25	299	25	188	16.7	62.9	0.85
chr1	2741975	2742269	CpG: 24	294	24	203	16.3	69.0	0.69
chr1	2744319	2745110	CpG: 61	791	61	541	15.4	68.4	0.66
chr1	2750778	2751452	CpG: 65	674	65	457	19.3	67.8	0.84
chr1	2770490	2770885	CpG: 33	395	33	260	16.7	65.8	0.78
chr1	2772215	2772493	CpG: 26	278	26	182	18.7	65.5	0.87
chr1	2783060	2783736	CpG: 47	676	47	455	13.9	67.3	0.61
chr1	2791448	2792136	CpG: 61	688	61	468	17.7	68.0	0.77
chr1	2827599	2827945	CpG: 24	346	24	235	13.9	67.9	0.60
chr1	2863283	2863538	CpG: 18	255	18	161	14.1	63.1	0.73
chr1	2895340	2895556	CpG: 20	216	20	142	18.5	65.7	0.86
chr1	2898372	2899307	CpG: 89	935	89	666	19.0	71.2	0.76
chr1	2909508	2910549	CpG: 75	1041	75	691	14.4	66.4	0.66
chr1	2913485	2913918	CpG: 37	433	37	277	17.1	64.0	1.13
chr1	2916230	2917663	CpG: 107	1433	107	967	14.9	67.5	0.67
chr1	2919279	2919518	CpG: 19	239	19	164	15.9	68.6	0.68
chr1	2920225	2920466	CpG: 19	241	19	151	15.8	62.7	0.80
chr1	2930251	2931045	CpG: 52	794	52	502	13.1	63.2	0.66
chr1	2935740	2935969	CpG: 18	229	18	157	15.7	68.6	0.69
chr1	2939604	2939871	CpG: 23	267	23	183	17.2	68.5	0.74
chr1	2940463	2940837	CpG: 25	374	25	243	13.4	65.0	0.63
chr1	2959107	2959885	CpG: 98	778	98	613	25.2	78.8	0.81
chr1	2985159	2985649	CpG: 34	490	34	327	13.9	66.7	0.62
chr1	2991109	2991416	CpG: 23	307	23	202	15.0	65.8	0.70
chr1	3007456	3007669	CpG: 21	213	21	141	19.7	66.2	0.97
chr1	3017327	3017548	CpG: 21	221	21	152	19.0	68.8	0.80
chr1	3018112	3018321	CpG: 21	209	21	149	20.1	71.3	0.80
chr1	3019106	3019434	CpG: 26	328	26	214	15.9	65.2	0.80
chr1	3027737	3027999	CpG: 20	262	20	176	15.3	67.2	0.68
chr1	3039198	3040151	CpG: 103	953	103	696	21.6	73.0	0.82
chr1	3051621	3052016	CpG: 28	395	28	271	14.2	68.6	0.60
chr1	3091798	3093782	CpG: 145	1984	145	1290	14.6	65.0	0.85
chr1	3105271	3105680	CpG: 29	409	29	264	14.2	64.5	0.68
chr1	3121176	3122239	CpG: 106	1063	106	787	19.9	74.0	0.77
chr1	3134298	3135772	CpG: 172	1474	172	1077	23.3	73.1	0.87
chr1	3150472	3150673	CpG: 15	201	15	144	14.9	71.6	0.60
chr1	3153423	3154286	CpG: 92	863	92	627	21.3	72.7	0.81
chr1	3155175	3155441	CpG: 42	266	42	208	31.6	78.2	1.17
chr1	3159661	3162945	CpG: 321	3284	321	2217	19.5	67.5	0.86
chr1	3200380	3200837	CpG: 40	457	40	294	17.5	64.3	0.86
chr1	3208674	3208893	CpG: 20	219	20	152	18.3	69.4	0.84
chr1	3212570	3212853	CpG: 19	283	19	180	13.4	63.6	0.67
chr1	3219120	3219487	CpG: 28	367	28	256	15.3	69.8	0.64
chr1	3244329	3244709	CpG: 36	380	36	266	18.9	70.0	0.78
chr1	3258000	3259122	CpG: 108	1122	108	779	19.3	69.4	0.81
chr1	3283585	3284716	CpG: 108	1131	108	849	19.1	75.1	0.70
chr1	3298494	3298938	CpG: 31	444	31	282	14.0	63.5	0.73
chr1	3307431	3308267	CpG: 92	836	92	615	22.0	73.6	0.81
chr1	3326491	3327049	CpG: 37	558	37	339	13.3	60.8	0.72
chr1	3353705	3353973	CpG: 22	268	22	163	16.4	60.8	0.89
chr1	3367729	3367973	CpG: 17	244	17	144	13.9	59.0	0.82
chr1	3368221	3369499	CpG: 130	1278	130	920	20.3	72.0	0.79
chr1	3370111	3370403	CpG: 21	292	21	179	14.4	61.3	0.78
chr1	3384043	3384313	CpG: 19	270	19	163	14.1	60.4	0.78
chr1	3386209	3386956	CpG: 49	747	49	423	13.1	56.6	0.82
chr1	3403830	3404576	CpG: 48	746	48	501	12.9	67.2	0.60
chr1	3411696	3413424	CpG: 134	1728	134	1170	15.5	67.7	0.68
chr1	3413810	3414086	CpG: 20	276	20	164	14.5	59.4	0.83
chr1	3419559	3419796	CpG: 18	237	18	145	15.2	61.2	0.82
chr1	3606438	3606726	CpG: 25	288	25	180	17.4	62.5	0.90
chr1	3643906	3644516	CpG: 41	610	41	359	13.4	58.9	0.78
chr1	3673801	3674314	CpG: 36	513	36	317	14.0	61.8	0.74
chr1	4069110	4069386	CpG: 23	276	23	171	16.7	62.0	0.88
chr1	4167653	4170219	CpG: 335	2566	335	1930	26.1	75.2	0.92
chr1	4180311	4180602	CpG: 23	291	23	197	15.8	67.7	0.87
chr1	4225355	4226248	CpG: 73	893	73	616	16.3	69.0	0.69
chr1	4286212	4286414	CpG: 17	202	17	126	16.8	62.4	0.87
chr1	5234470	5234927	CpG: 43	457	43	322	18.8	70.5	0.80
chr1	5255974	5256201	CpG: 16	227	16	143	14.1	63.0	0.94
chr1	5401582	5401804	CpG: 21	222	21	152	18.9	68.5	0.82
chr1	5415249	5415454	CpG: 16	205	16	131	15.6	63.9	0.77
chr1	5517267	5519172	CpG: 199	1905	199	1356	20.9	71.2	0.83
chr1	5551866	5552116	CpG: 20	250	20	167	16.0	66.8	0.72
chr1	5577227	5577454	CpG: 20	227	20	157	17.6	69.2	0.74
chr1	5597255	5597605	CpG: 34	350	34	246	19.4	70.3	0.79
chr1	5637282	5637562	CpG: 22	280	22	179	15.7	63.9	0.77
chr1	5653370	5653862	CpG: 41	492	41	341	16.7	69.3	0.72
chr1	5654500	5654747	CpG: 22	247	22	159	17.8	64.4	0.86
chr1	5667743	5667984	CpG: 20	241	20	143	16.6	59.3	0.96
chr1	5674340	5674734	CpG: 42	394	42	277	21.3	70.3	0.88
chr1	5684350	5684646	CpG: 25	296	25	183	16.9	61.8	0.90
chr1	5704821	5706400	CpG: 210	1579	210	1235	26.6	78.2	0.87
chr1	5706617	5706837	CpG: 17	220	17	129	15.5	58.6	0.90
chr1	5724764	5725469	CpG: 66	705	66	481	18.7	68.2	0.81
chr1	5731340	5732362	CpG: 103	1022	103	735	20.2	71.9	0.78
chr1	5734192	5735172	CpG: 109	980	109	683	22.2	69.7	0.92
chr1	5742227	5742522	CpG: 21	295	21	166	14.2	56.3	0.90
chr1	5761112	5762713	CpG: 163	1601	163	1058	20.4	66.1	0.93
chr1	5767279	5768440	CpG: 126	1161	126	824	21.7	71.0	0.87
chr1	5770732	5772047	CpG: 126	1315	126	934	19.2	71.0	0.77
chr1	5774747	5775676	CpG: 135	929	135	731	29.1	78.7	0.96
chr1	5779345	5779723	CpG: 35	378	35	256	18.5	67.7	0.81
chr1	5785721	5787052	CpG: 177	1331	177	1044	26.6	78.4	0.87
chr1	5805532	5805852	CpG: 22	320	22	213	13.8	66.6	0.62
chr1	5806720	5806996	CpG: 21	276	21	181	15.2	65.6	0.71
chr1	5830611	5831726	CpG: 93	1115	93	808	16.7	72.5	0.64
chr1	5907775	5908032	CpG: 20	257	20	156	15.6	60.7	0.86
chr1	5918395	5919767	CpG: 173	1372	173	1017	25.2	74.1	0.93
chr1	5930070	5930564	CpG: 36	494	36	279	14.6	56.5	0.91
chr1	5944485	5946519	CpG: 213	2034	213	1467	20.9	72.1	0.81
chr1	5949789	5950908	CpG: 123	1119	123	803	22.0	71.8	0.85
chr1	5965749	5966712	CpG: 105	963	105	716	21.8	74.4	0.79
chr1	5972789	5974768	CpG: 185	1979	185	1447	18.7	73.1	0.70
chr1	5977271	5977692	CpG: 32	421	32	286	15.2	67.9	0.66
chr1	5979690	5981907	CpG: 248	2217	248	1574	22.4	71.0	0.89
chr1	5986166	5987537	CpG: 109	1371	109	882	15.9	64.3	0.77
chr1	5991578	5992052	CpG: 50	474	50	345	21.1	72.8	0.80
chr1	5996118	5997397	CpG: 121	1279	121	888	18.9	69.4	0.79
chr1	6004951	6005219	CpG: 20	268	20	162	14.9	60.4	0.83
chr1	6010726	6011501	CpG: 80	775	80	606	20.6	78.2	0.70
chr1	6015666	6016698	CpG: 84	1032	84	705	16.3	68.3	0.70
chr1	6022734	6023456	CpG: 89	722	89	571	24.7	79.1	0.79
chr1	6079734	6080433	CpG: 83	699	83	499	23.7	71.4	0.93
chr1	6081596	6081836	CpG: 18	240	18	145	15.0	60.4	0.85
chr1	6105031	6105965	CpG: 80	934	80	624	17.1	66.8	0.77
chr1	6119001	6119278	CpG: 23	277	23	181	16.6	65.3	0.78
chr1	6124729	6125109	CpG: 27	380	27	246	14.2	64.7	0.68
chr1	6127380	6129448	CpG: 238	2068	238	1431	23.0	69.2	0.96
chr1	6137846	6138115	CpG: 21	269	21	163	15.6	60.6	0.86
chr1	6138390	6141345	CpG: 346	2955	346	2184	23.4	73.9	0.88
chr1	6141753	6141990	CpG: 20	237	20	142	16.9	59.9	0.95
chr1	6150675	6151444	CpG: 84	769	84	583	21.8	75.8	0.76
chr1	6226901	6227737	CpG: 96	836	96	602	23.0	72.0	0.89
chr1	6258141	6258390	CpG: 18	249	18	150	14.5	60.2	0.80
chr1	6261028	6261267	CpG: 21	239	21	147	17.6	61.5	0.94
chr1	6286166	6286368	CpG: 17	202	17	120	16.8	59.4	0.97
chr1	6312093	6314146	CpG: 256	2053	256	1540	24.9	75.0	0.89
chr1	6490578	6490885	CpG: 23	307	23	200	15.0	65.1	0.71
chr1	6591524	6591731	CpG: 16	207	16	141	15.5	68.1	0.77
chr1	7132073	7132861	CpG: 59	788	59	543	15.0	68.9	0.63
chr1	7166358	7166601	CpG: 19	243	19	147	15.6	60.5	0.86
chr1	7194355	7196154	CpG: 113	1799	113	1159	12.6	64.4	0.61
chr1	7211121	7212099	CpG: 113	978	113	710	23.1	72.6	0.88
chr1	7234857	7236847	CpG: 300	1990	300	1554	30.2	78.1	1.01
chr1	7289702	7289968	CpG: 21	266	21	162	15.8	60.9	0.88
chr1	7302037	7302832	CpG: 97	795	97	577	24.4	72.6	0.93
chr1	7314446	7316090	CpG: 181	1644	181	1207	22.0	73.4	0.82
chr1	7317027	7317288	CpG: 21	261	21	158	16.1	60.5	0.89
chr1	7358185	7358463	CpG: 25	278	25	193	18.0	69.4	0.79
chr1	7473207	7473498	CpG: 31	291	31	198	21.3	68.0	0.92
chr1	7483065	7485553	CpG: 172	2488	172	1617	13.8	65.0	0.66
chr1	7492205	7493112	CpG: 90	907	90	596	19.8	65.7	0.93
chr1	7556421	7557872	CpG: 179	1451	179	1033	24.7	71.2	0.97
chr1	7742977	7743183	CpG: 15	206	15	122	14.6	59.2	0.83
chr1	7748176	7748802	CpG: 71	626	71	460	22.7	73.5	0.85
chr1	7849405	7850080	CpG: 74	675	74	465	21.9	68.9	0.93
chr1	7856512	7856844	CpG: 24	332	24	216	14.5	65.1	0.71
chr1	7858020	7858293	CpG: 21	273	21	177	15.4	64.8	0.73
chr1	7862327	7862925	CpG: 47	598	47	400	15.7	66.9	0.72
chr1	7867765	7868057	CpG: 24	292	24	188	16.4	64.4	0.80
chr1	7870976	7871201	CpG: 18	225	18	133	16.0	59.1	0.92
chr1	7891104	7891639	CpG: 43	535	43	364	16.1	68.0	0.72
chr1	7921185	7921512	CpG: 24	327	24	199	14.7	60.9	0.80
chr1	7956196	7957146	CpG: 107	950	107	706	22.5	74.3	0.83
chr1	7966444	7966725	CpG: 24	281	24	174	17.1	61.9	0.91
chr1	8045638	8045919	CpG: 23	281	23	174	16.4	61.9	0.87
chr1	8064308	8064589	CpG: 24	281	24	176	17.1	62.6	0.89
chr1	8236420	8236995	CpG: 77	575	77	444	26.8	77.2	0.90
chr1	8350409	8351554	CpG: 115	1145	115	764	20.1	66.7	0.91
chr1	8411200	8412819	CpG: 158	1619	158	1096	19.5	67.7	0.85
chr1	8426327	8426964	CpG: 47	637	47	353	14.8	55.4	0.96
chr1	8440285	8440682	CpG: 34	397	34	232	17.1	58.4	1.02
chr1	8558534	8558743	CpG: 16	209	16	136	15.3	65.1	0.72
chr1	8572872	8574105	CpG: 105	1233	105	863	17.0	70.0	0.70
chr1	8597603	8597878	CpG: 25	275	25	172	18.2	62.5	0.94
chr1	8617904	8618180	CpG: 20	276	20	170	14.5	61.6	0.77
chr1	8662688	8664018	CpG: 149	1330	149	998	22.4	75.0	0.82
chr1	8716736	8718363	CpG: 160	1627	160	1150	19.7	70.7	0.79
chr1	8733120	8733586	CpG: 48	466	48	317	20.6	68.0	0.89
chr1	8768986	8770037	CpG: 133	1051	133	785	25.3	74.7	0.91
chr1	8798761	8798998	CpG: 20	237	20	161	16.9	67.9	0.73
chr1	8799246	8799575	CpG: 23	329	23	218	14.0	66.3	0.65
chr1	8801715	8801966	CpG: 18	251	18	169	14.3	67.3	0.64
chr1	8827205	8828703	CpG: 198	1498	198	1144	26.4	76.4	0.91
chr1	8890925	8891203	CpG: 24	278	24	178	17.3	64.0	0.85
chr1	8902306	8902533	CpG: 22	227	22	159	19.4	70.0	0.80
chr1	8965187	8965499	CpG: 32	312	32	199	20.5	63.8	1.02
chr1	9031656	9031929	CpG: 32	273	32	202	23.4	74.0	0.86
chr1	9053146	9053412	CpG: 23	266	23	166	17.3	62.4	0.90
chr1	9075627	9076721	CpG: 144	1094	144	808	26.3	73.9	0.96
chr1	9077574	9077787	CpG: 16	213	16	129	15.0	60.6	0.84
chr1	9124323	9124586	CpG: 22	263	22	161	16.7	61.2	0.90
chr1	9124872	9125803	CpG: 150	931	150	745	32.2	80.0	1.01
chr1	9164438	9164681	CpG: 20	243	20	148	16.5	60.9	0.93
chr1	9169849	9170319	CpG: 45	470	45	334	19.1	71.1	0.76
chr1	9194446	9195715	CpG: 137	1269	137	904	21.6	71.2	0.86
chr1	9217880	9218117	CpG: 19	237	19	142	16.0	59.9	0.92
chr1	9230156	9230909	CpG: 51	753	51	501	13.5	66.5	0.62
chr1	9232011	9232944	CpG: 108	933	108	710	23.2	76.1	0.80
chr1	9258430	9258719	CpG: 26	289	26	194	18.0	67.1	0.81
chr1	9273017	9273429	CpG: 32	412	32	272	15.5	66.0	0.72
chr1	9273883	9274211	CpG: 26	328	26	206	15.9	62.8	0.80
chr1	9305301	9305542	CpG: 19	241	19	161	15.8	66.8	0.73
chr1	9365871	9367527	CpG: 199	1656	199	1216	24.0	73.4	0.89
chr1	9452711	9453656	CpG: 125	945	125	738	26.5	78.1	0.91
chr1	9486012	9486432	CpG: 39	420	39	287	18.6	68.3	0.80
chr1	9486880	9487146	CpG: 20	266	20	158	15.0	59.4	0.87
chr1	9505108	9505385	CpG: 20	277	20	168	14.4	60.6	0.79
chr1	9540111	9541202	CpG: 133	1091	133	815	24.4	74.7	0.89
chr1	9571585	9572246	CpG: 47	661	47	451	14.2	68.2	0.61
chr1	9574969	9575238	CpG: 25	269	25	170	18.6	63.2	0.94
chr1	9575528	9576400	CpG: 85	872	85	589	19.5	67.5	0.86
chr1	9578857	9579099	CpG: 20	242	20	147	16.5	60.7	0.91
chr1	9753566	9754857	CpG: 168	1291	168	964	26.0	74.7	0.93
chr1	9788202	9788515	CpG: 22	313	22	184	14.1	58.8	0.83
chr1	9869730	9869937	CpG: 18	207	18	122	17.4	58.9	1.00
chr1	9942100	9943549	CpG: 147	1449	147	982	20.3	67.8	0.88
chr1	9973758	9974920	CpG: 122	1162	122	761	21.0	65.5	0.98
chr1	10015728	10016351	CpG: 59	623	59	380	18.9	61.0	1.04
chr1	10018469	10018723	CpG: 22	254	22	176	17.3	69.3	0.75
chr1	10086095	10086341	CpG: 18	246	18	136	14.6	55.3	0.97
chr1	10107124	10107476	CpG: 24	352	24	209	13.6	59.4	0.79
chr1	10181837	10183636	CpG: 217	1799	217	1310	24.1	72.8	0.91
chr1	10185674	10185878	CpG: 19	204	19	151	18.6	74.0	0.78
chr1	10188838	10189080	CpG: 19	242	19	146	15.7	60.3	0.89
chr1	10191348	10191678	CpG: 25	330	25	225	15.2	68.2	0.72
chr1	10197376	10197741	CpG: 30	365	30	236	16.4	64.7	0.81
chr1	10197939	10198246	CpG: 22	307	22	191	14.3	62.2	0.74
chr1	10203405	10204119	CpG: 48	714	48	470	13.4	65.8	0.63
chr1	10208721	10209151	CpG: 35	430	35	297	16.3	69.1	0.69
chr1	10215858	10216093	CpG: 20	235	20	145	17.0	61.7	0.96
chr1	10237307	10239055	CpG: 242	1748	242	1281	27.7	73.3	1.04
chr1	10241426	10241787	CpG: 27	361	27	240	15.0	66.5	0.76
chr1	10247990	10248466	CpG: 44	476	44	330	18.5	69.3	0.77
chr1	10337555	10340624	CpG: 277	3069	277	2087	18.1	68.0	0.79
chr1	10379733	10379995	CpG: 23	262	23	191	17.6	72.9	0.67
chr1	10410799	10411323	CpG: 69	524	69	402	26.3	76.7	0.93
chr1	10432369	10433139	CpG: 89	770	89	604	23.1	78.4	0.75
chr1	10551947	10552184	CpG: 19	237	19	143	16.0	60.3	0.91
chr1	10553522	10554448	CpG: 97	926	97	644	21.0	69.5	0.87
chr1	10577495	10577779	CpG: 24	284	24	177	16.9	62.3	0.88
chr1	10600537	10602141	CpG: 165	1604	165	1152	20.6	71.8	0.81
chr1	10608717	10608929	CpG: 16	212	16	129	15.1	60.8	0.83
chr1	10619845	10620119	CpG: 23	274	23	169	16.8	61.7	0.89
chr1	10640901	10641650	CpG: 77	749	77	506	20.6	67.6	0.92
chr1	10791582	10791853	CpG: 28	271	28	223	20.7	82.3	0.61
chr1	10802807	10803058	CpG: 19	251	19	147	15.1	58.6	0.90
chr1	10803792	10804570	CpG: 60	778	60	501	15.4	64.4	0.75
chr1	10814457	10815083	CpG: 61	626	61	477	19.5	76.2	0.71
chr1	10847258	10848065	CpG: 63	807	63	556	15.6	68.9	0.66
chr1	11021554	11023496	CpG: 196	1942	196	1361	20.2	70.1	0.82
chr1	11034775	11035053	CpG: 25	278	25	175	18.0	62.9	0.92
chr1	11044247	11045037	CpG: 80	790	80	518	20.3	65.6	0.95
chr1	11074097	11074303	CpG: 20	206	20	134	19.4	65.0	0.92
chr1	11080653	11080893	CpG: 23	240	23	156	19.2	65.0	0.94
chr1	11094022	11094256	CpG: 16	234	16	141	13.7	60.3	0.77
chr1	11153085	11153434	CpG: 29	349	29	258	16.6	73.9	0.61
chr1	11179676	11179955	CpG: 23	279	23	172	16.5	61.6	0.87
chr1	11192714	11193271	CpG: 42	557	42	381	15.1	68.4	0.66
chr1	11194453	11194884	CpG: 44	431	44	313	20.4	72.6	0.79
chr1	11198212	11199308	CpG: 130	1096	130	823	23.7	75.1	0.85
chr1	11208111	11209004	CpG: 100	893	100	659	22.4	73.8	0.84
chr1	11209524	11209880	CpG: 25	356	25	198	14.0	55.6	0.93
chr1	11224293	11225716	CpG: 135	1423	135	962	19.0	67.6	0.83
chr1	11234699	11236649	CpG: 196	1950	196	1394	20.1	71.5	0.80
chr1	11263583	11264033	CpG: 34	450	34	296	15.1	65.8	0.70
chr1	11280018	11280301	CpG: 31	283	31	199	21.9	70.3	0.89
chr1	11306168	11306392	CpG: 25	224	25	158	22.3	70.5	0.90
chr1	11349489	11350593	CpG: 93	1104	93	772	16.8	69.9	0.70
chr1	11382417	11382756	CpG: 28	339	28	217	16.5	64.0	0.82
chr1	11403154	11403594	CpG: 43	440	43	306	19.5	69.5	0.81
chr1	11441855	11442130	CpG: 21	275	21	168	15.3	61.1	0.84
chr1	11453295	11453717	CpG: 35	422	35	260	16.6	61.6	0.88
chr1	11469703	11470695	CpG: 118	992	118	749	23.8	75.5	0.84
chr1	11478757	11479032	CpG: 35	275	35	214	25.5	77.8	0.87
chr1	11497277	11497479	CpG: 16	202	16	114	15.8	56.4	1.00
chr1	11524175	11524855	CpG: 73	680	73	489	21.5	71.9	0.83
chr1	11535774	11536048	CpG: 23	274	23	171	16.8	62.4	0.87
chr1	11543908	11544157	CpG: 20	249	20	142	16.1	57.0	1.00
chr1	11552472	11553219	CpG: 57	747	57	521	15.3	69.7	0.63
chr1	11562788	11563970	CpG: 96	1182	96	721	16.2	61.0	0.87
chr1	11586947	11587767	CpG: 69	820	69	574	16.8	70.0	0.69
chr1	11607570	11608230	CpG: 63	660	63	461	19.1	69.8	0.79
chr1	11710942	11711778	CpG: 95	836	95	626	22.7	74.9	0.81
chr1	11735407	11736058	CpG: 57	651	57	454	17.5	69.7	0.79
chr1	11770546	11770822	CpG: 21	276	21	169	15.2	61.2	0.82
chr1	11774033	11774664	CpG: 77	631	77	489	24.4	77.5	0.81
chr1	11775034	11775278	CpG: 23	244	23	179	18.9	73.4	0.70
chr1	11905559	11905833	CpG: 23	274	23	171	16.8	62.4	0.87
chr1	12084448	12084657	CpG: 18	209	18	139	17.2	66.5	0.78
chr1	12139336	12140388	CpG: 80	1052	80	749	15.2	71.2	0.64
chr1	12161117	12162774	CpG: 133	1657	133	981	16.1	59.2	0.92
chr1	12234926	12235200	CpG: 24	274	24	169	17.5	61.7	0.93
chr1	12382225	12382450	CpG: 17	225	17	135	15.1	60.0	0.85
chr1	12446477	12447051	CpG: 44	574	44	399	15.3	69.5	0.64
chr1	12739926	12740500	CpG: 45	574	45	399	15.7	69.5	0.65
chr1	12836124	12836854	CpG: 60	730	60	496	16.4	67.9	0.71
chr1	12863581	12863795	CpG: 18	214	18	129	16.8	60.3	0.94
chr1	12875384	12875625	CpG: 20	241	20	179	16.6	74.3	0.62
chr1	12880401	12880937	CpG: 48	536	48	395	17.9	73.7	0.66
chr1	12954924	12956032	CpG: 127	1108	127	788	22.9	71.1	0.92
chr1	12969446	12969721	CpG: 20	275	20	170	14.5	61.8	0.77
chr1	12996941	12997143	CpG: 23	202	23	142	22.8	70.3	0.93
chr1	13025071	13025307	CpG: 22	236	22	163	18.6	69.1	0.79
chr1	13025602	13026477	CpG: 68	875	68	573	15.5	65.5	0.73
chr1	13090978	13091253	CpG: 23	275	23	171	16.7	62.2	0.88
chr1	13115309	13115590	CpG: 24	281	24	172	17.1	61.2	0.93
chr1	13140810	13141020	CpG: 15	210	15	127	14.3	60.5	0.80
chr1	13142068	13142787	CpG: 113	719	113	570	31.4	79.3	1.02
chr1	13190881	13192072	CpG: 160	1191	160	847	26.9	71.1	1.07
chr1	13335035	13335422	CpG: 50	387	50	307	25.8	79.3	0.82
chr1	13374443	13374717	CpG: 23	274	23	170	16.8	62.0	0.88
chr1	13442973	13443251	CpG: 22	278	22	172	15.8	61.9	0.84
chr1	14041929	14043312	CpG: 141	1383	141	992	20.4	71.7	0.80
chr1	14179098	14179377	CpG: 23	279	23	173	16.5	62.0	0.87
chr1	14245104	14245390	CpG: 21	286	21	174	14.7	60.8	0.81
chr1	14367850	14369022	CpG: 178	1172	178	922	30.4	78.7	0.99
chr1	14401381	14401602	CpG: 21	221	21	139	19.0	62.9	0.97
chr1	14445854	14446145	CpG: 19	291	19	171	13.1	58.8	0.77
chr1	14492585	14492935	CpG: 31	350	31	220	17.7	62.9	0.96
chr1	14509705	14510043	CpG: 33	338	33	214	19.5	63.3	0.98
chr1	14596792	14599042	CpG: 208	2250	208	1541	18.5	68.5	0.79
chr1	14658769	14659035	CpG: 20	266	20	164	15.0	61.7	0.81
chr1	14691481	14691814	CpG: 46	333	46	256	27.6	76.9	0.94
chr1	14854120	14855481	CpG: 152	1361	152	985	22.3	72.4	0.86
chr1	14863116	14863356	CpG: 20	240	20	148	16.7	61.7	0.89
chr1	14968696	14970014	CpG: 140	1318	140	949	21.2	72.0	0.93
chr1	14971311	14971866	CpG: 53	555	53	368	19.1	66.3	0.87
chr1	15029305	15029825	CpG: 62	520	62	385	23.8	74.0	0.87
chr1	15048039	15048505	CpG: 44	466	44	303	18.9	65.0	0.89
chr1	15062039	15062574	CpG: 73	535	73	403	27.3	75.3	0.96
chr1	15128815	15129742	CpG: 121	927	121	723	26.1	78.0	0.86
chr1	15171858	15172217	CpG: 25	359	25	239	13.9	66.6	0.63
chr1	15176540	15176748	CpG: 17	208	17	147	16.3	70.7	0.67
chr1	15188870	15189095	CpG: 18	225	18	164	16.0	72.9	0.61
chr1	15191560	15191767	CpG: 16	207	16	143	15.5	69.1	0.66
chr1	15202982	15204107	CpG: 118	1125	118	832	21.0	74.0	0.77
chr1	15204684	15204928	CpG: 20	244	20	147	16.4	60.2	0.92
chr1	15266896	15267178	CpG: 21	282	21	171	14.9	60.6	0.82
chr1	15276034	15278899	CpG: 243	2865	243	1765	17.0	61.6	0.90
chr1	15288660	15290166	CpG: 210	1506	210	1111	27.9	73.8	1.02
chr1	15290599	15290887	CpG: 27	288	27	175	18.8	60.8	1.05
chr1	15375646	15375931	CpG: 22	285	22	176	15.4	61.8	0.82
chr1	15384685	15385044	CpG: 28	359	28	242	15.6	67.4	0.69
chr1	15385376	15386367	CpG: 82	991	82	677	16.5	68.3	0.72
chr1	15416714	15417484	CpG: 85	770	85	545	22.1	70.8	0.91
chr1	15454157	15454438	CpG: 28	281	28	202	19.9	71.9	0.77
chr1	15514533	15515132	CpG: 85	599	85	482	28.4	80.5	0.88
chr1	15579261	15579506	CpG: 20	245	20	162	16.3	66.1	0.75
chr1	15590012	15590225	CpG: 20	213	20	133	18.8	62.4	0.97
chr1	15596385	15597683	CpG: 118	1298	118	892	18.2	68.7	0.77
chr1	15608940	15609384	CpG: 48	444	48	331	21.6	74.5	0.80
chr1	15647756	15649415	CpG: 146	1659	146	1120	17.6	67.5	0.80
chr1	15658515	15659139	CpG: 44	624	44	421	14.1	67.5	0.65
chr1	15668166	15669410	CpG: 107	1244	107	787	17.2	63.3	0.86
chr1	15678383	15678638	CpG: 38	255	38	190	29.8	74.5	1.08
chr1	15793598	15794216	CpG: 75	618	75	454	24.3	73.5	0.90
chr1	15808660	15809310	CpG: 56	650	56	443	17.2	68.2	0.75
chr1	15831064	15831270	CpG: 16	206	16	122	15.5	59.2	0.90
chr1	15882184	15882989	CpG: 71	805	71	518	17.6	64.3	0.86
chr1	15925784	15926118	CpG: 33	334	33	245	19.8	73.4	0.73
chr1	15940312	15941551	CpG: 142	1239	142	885	22.9	71.4	0.90
chr1	15941726	15942167	CpG: 29	441	29	244	13.2	55.3	0.87
chr1	15956002	15956230	CpG: 18	228	18	141	15.8	61.8	0.89
chr1	15962325	15963095	CpG: 51	770	51	475	13.2	61.7	0.70
chr1	15976076	15977499	CpG: 113	1423	113	894	15.9	62.8	0.81
chr1	15986897	15987164	CpG: 22	267	22	165	16.5	61.8	0.87
chr1	15989599	15990011	CpG: 39	412	39	283	18.9	68.7	0.82
chr1	16075012	16076010	CpG: 102	998	102	694	20.4	69.5	0.86
chr1	16104587	16105224	CpG: 62	637	62	436	19.5	68.4	0.88
chr1	16107224	16108626	CpG: 119	1402	119	934	17.0	66.6	0.77
chr1	16118487	16118766	CpG: 31	279	31	214	22.2	76.7	0.76
chr1	16127197	16127436	CpG: 17	239	17	147	14.2	61.5	0.80
chr1	16133881	16134102	CpG: 18	221	18	132	16.3	59.7	0.95
chr1	16139711	16139978	CpG: 21	267	21	163	15.7	61.0	0.86
chr1	16142418	16142830	CpG: 41	412	41	286	19.9	69.4	0.84
chr1	16240430	16241428	CpG: 102	998	102	695	20.4	69.6	0.86
chr1	16271836	16272473	CpG: 64	637	64	438	20.1	68.8	0.89
chr1	16274466	16276026	CpG: 134	1560	134	1041	17.2	66.7	0.78
chr1	16285794	16286028	CpG: 28	234	28	180	23.9	76.9	0.81
chr1	16294469	16294696	CpG: 16	227	16	138	14.1	60.8	0.81
chr1	16301180	16301475	CpG: 23	295	23	156	15.6	52.9	1.12
chr1	16303145	16305599	CpG: 172	2454	172	1512	14.0	61.6	0.74
chr1	16308458	16308679	CpG: 18	221	18	131	16.3	59.3	0.96
chr1	16362553	16364118	CpG: 130	1565	130	1042	16.6	66.6	0.75
chr1	16373849	16374128	CpG: 30	279	30	214	21.5	76.7	0.73
chr1	16382545	16382784	CpG: 19	239	19	150	15.9	62.8	0.86
chr1	16389235	16389456	CpG: 18	221	18	132	16.3	59.7	0.95
chr1	16390027	16390308	CpG: 24	281	24	177	17.1	63.0	0.88
chr1	16395846	16396255	CpG: 39	409	39	284	19.1	69.4	0.81
chr1	16407791	16410055	CpG: 240	2264	240	1592	21.2	70.3	0.86
chr1	16412082	16412380	CpG: 25	298	25	209	16.8	70.1	0.69
chr1	16415022	16417079	CpG: 207	2057	207	1506	20.1	73.2	0.75
chr1	16422902	16423862	CpG: 107	960	107	713	22.3	74.3	0.81
chr1	16440623	16441023	CpG: 38	400	38	274	19.0	68.5	0.83
chr1	16449207	16449428	CpG: 18	221	18	132	16.3	59.7	0.95
chr1	16452287	16454743	CpG: 168	2456	168	1501	13.7	61.1	0.73
chr1	16456428	16456723	CpG: 23	295	23	156	15.6	52.9	1.13
chr1	16463206	16463433	CpG: 16	227	16	138	14.1	60.8	0.81
chr1	16470111	16470373	CpG: 28	262	28	200	21.4	76.3	0.73
chr1	16480141	16481614	CpG: 125	1473	125	985	17.0	66.9	0.76
chr1	16535592	16535813	CpG: 17	221	17	130	15.4	58.8	0.93
chr1	16538672	16541126	CpG: 173	2454	173	1509	14.1	61.5	0.75
chr1	16542796	16543091	CpG: 23	295	23	158	15.6	53.6	1.10
chr1	16549575	16549802	CpG: 16	227	16	138	14.1	60.8	0.81
chr1	16558260	16558494	CpG: 28	234	28	180	23.9	76.9	0.81
chr1	16568263	16569823	CpG: 133	1560	133	1041	17.1	66.7	0.77
chr1	16571816	16572453	CpG: 64	637	64	438	20.1	68.8	0.89
chr1	16602856	16603854	CpG: 103	998	103	696	20.6	69.7	0.86
chr1	16670043	16670455	CpG: 41	412	41	286	19.9	69.4	0.84
chr1	16681495	16681783	CpG: 23	288	23	192	16.0	66.7	0.72
chr1	16682560	16683982	CpG: 109	1422	109	892	15.3	62.7	0.78
chr1	16699354	16700179	CpG: 61	825	61	514	14.8	62.3	0.76
chr1	16706172	16706399	CpG: 16	227	16	138	14.1	60.8	0.81
chr1	16714485	16714751	CpG: 21	266	21	161	15.8	60.5	0.88
chr1	16724008	16725169	CpG: 131	1161	131	839	22.6	72.3	0.87
chr1	16749375	16749708	CpG: 35	333	35	253	21.0	76.0	0.73
chr1	16765766	16766004	CpG: 22	238	22	168	18.5	70.6	0.80
chr1	16771237	16771631	CpG: 49	394	49	307	24.9	77.9	0.83
chr1	16776845	16777056	CpG: 19	211	19	155	18.0	73.5	0.72
chr1	16790483	16791293	CpG: 80	810	80	580	19.8	71.6	0.81
chr1	16815811	16816019	CpG: 17	208	17	136	16.3	65.4	0.77
chr1	16821755	16822579	CpG: 99	824	99	626	24.0	76.0	0.83
chr1	16827195	16827417	CpG: 16	222	16	134	14.4	60.4	0.80
chr1	16864398	16864664	CpG: 31	266	31	183	23.3	68.8	0.99
chr1	16929610	16930047	CpG: 52	437	52	318	23.8	72.8	0.90
chr1	16959633	16960141	CpG: 46	508	46	341	18.1	67.1	0.80
chr1	17193084	17193362	CpG: 24	278	24	176	17.3	63.3	0.87
chr1	17221886	17222096	CpG: 18	210	18	130	17.1	61.9	0.90
chr1	17233652	17233999	CpG: 30	347	30	214	17.3	61.7	0.91
chr1	17251526	17254009	CpG: 282	2483	282	1723	22.7	69.4	0.95
chr1	17353362	17354129	CpG: 119	767	119	620	31.0	80.8	0.98
chr1	17436943	17437161	CpG: 17	218	17	146	15.6	67.0	0.70
chr1	17512278	17512589	CpG: 33	311	33	216	21.2	69.5	0.88
chr1	17641270	17641734	CpG: 31	464	31	291	13.4	62.7	0.68
chr1	17882685	17882955	CpG: 22	270	22	166	16.3	61.5	0.87
chr1	17927732	17931311	CpG: 264	3579	264	2341	14.8	65.4	0.71
chr1	18107122	18107352	CpG: 20	230	20	140	17.4	60.9	0.95
chr1	18185441	18185648	CpG: 18	207	18	138	17.4	66.7	0.81
chr1	18196862	18197063	CpG: 21	201	21	133	20.9	66.2	0.95
chr1	18302478	18303272	CpG: 81	794	81	545	20.4	68.6	0.87
chr1	18450463	18453397	CpG: 213	2934	213	1713	14.5	58.4	0.85
chr1	18456312	18457051	CpG: 66	739	66	475	17.9	64.3	0.87
chr1	18457750	18457971	CpG: 20	221	20	162	18.1	73.3	0.69
chr1	18460821	18461689	CpG: 62	868	62	536	14.3	61.8	0.80
chr1	18463117	18464308	CpG: 98	1191	98	778	16.5	65.3	0.79
chr1	18465203	18465666	CpG: 40	463	40	301	17.3	65.0	0.83
chr1	18466445	18467302	CpG: 74	857	74	578	17.3	67.4	0.77
chr1	18536902	18537465	CpG: 69	563	69	416	24.5	73.9	0.90
chr1	18604291	18604503	CpG: 19	212	19	116	17.9	54.7	1.21
chr1	18674242	18674766	CpG: 44	524	44	335	16.8	63.9	0.83
chr1	18697180	18697424	CpG: 30	244	30	164	24.6	67.2	1.09
chr1	18702939	18703227	CpG: 21	288	21	187	14.6	64.9	0.69
chr1	18722142	18722948	CpG: 75	806	75	526	18.6	65.3	0.87
chr1	18733660	18733933	CpG: 21	273	21	170	15.4	62.3	0.80
chr1	18775348	18777283	CpG: 232	1935	232	1434	24.0	74.1	0.88
chr1	19033169	19034064	CpG: 97	895	97	602	21.7	67.3	0.96
chr1	19074914	19076022	CpG: 99	1108	99	717	17.9	64.7	0.85
chr1	19097281	19097974	CpG: 72	693	72	484	20.8	69.8	0.85
chr1	19112032	19112694	CpG: 73	662	73	464	22.1	70.1	0.90
chr1	19135248	19136315	CpG: 128	1067	128	794	24.0	74.4	0.87
chr1	19162051	19162317	CpG: 25	266	25	179	18.8	67.3	0.84
chr1	19308662	19309603	CpG: 120	941	120	744	25.5	79.1	0.82
chr1	19310745	19310987	CpG: 20	242	20	145	16.5	59.9	0.96
chr1	19392738	19392976	CpG: 20	238	20	148	16.8	62.2	0.90
chr1	19420291	19420952	CpG: 61	661	61	456	18.5	69.0	0.79
chr1	19467138	19468806	CpG: 212	1668	212	1254	25.4	75.2	0.90
chr1	19488030	19489672	CpG: 176	1642	176	1218	21.4	74.2	0.80
chr1	19502393	19502748	CpG: 33	355	33	254	18.6	71.5	0.75
chr1	19622910	19623661	CpG: 82	751	82	561	21.8	74.7	0.78
chr1	19705699	19706354	CpG: 89	655	89	482	27.2	73.6	1.01
chr1	19740802	19741072	CpG: 19	270	19	161	14.1	59.6	0.80
chr1	19742858	19743125	CpG: 22	267	22	163	16.5	61.0	0.89
chr1	19975210	19975456	CpG: 20	246	20	150	16.3	61.0	0.89
chr1	19995428	19995704	CpG: 23	276	23	170	16.7	61.6	0.89
chr1	20009511	20009948	CpG: 40	437	40	321	18.3	73.5	0.68
chr1	20066619	20066981	CpG: 34	362	34	251	18.8	69.3	0.81
chr1	20166662	20167114	CpG: 46	452	46	329	20.4	72.8	0.78
chr1	20189675	20190627	CpG: 110	952	110	664	23.1	69.7	0.98
chr1	20308923	20311972	CpG: 303	3049	303	2168	19.9	71.1	0.79
chr1	20332871	20333338	CpG: 43	467	43	317	18.4	67.9	0.80
chr1	20377355	20379053	CpG: 202	1698	202	1255	23.8	73.9	0.87
chr1	20405885	20406132	CpG: 21	247	21	149	17.0	60.3	0.94
chr1	20449076	20449672	CpG: 44	596	44	347	14.8	58.2	0.88
chr1	20459562	20460249	CpG: 88	687	88	525	25.6	76.4	0.90
chr1	20487210	20487932	CpG: 60	722	60	478	16.6	66.2	0.76
chr1	20522633	20522883	CpG: 19	250	19	178	15.2	71.2	0.61
chr1	20530705	20531066	CpG: 34	361	34	235	18.8	65.1	0.89
chr1	20543813	20544850	CpG: 126	1037	126	777	24.3	74.9	0.87
chr1	20558080	20559440	CpG: 142	1360	142	981	20.9	72.1	0.80
chr1	20611060	20611331	CpG: 19	271	19	165	14.0	60.9	0.77
chr1	20612773	20614186	CpG: 197	1413	197	1041	27.9	73.7	1.03
chr1	20850056	20850997	CpG: 69	941	69	652	14.7	69.3	0.61
chr1	20879368	20880576	CpG: 96	1208	96	875	15.9	72.4	0.61
chr1	20962562	20962843	CpG: 23	281	23	172	16.4	61.2	0.89
chr1	21002676	21004043	CpG: 154	1367	154	979	22.5	71.6	0.88
chr1	21018639	21018877	CpG: 18	238	18	143	15.1	60.1	0.85
chr1	21052147	21052504	CpG: 32	357	32	227	17.9	63.6	0.89
chr1	21063252	21063671	CpG: 28	419	28	246	13.4	58.7	0.78
chr1	21080541	21080808	CpG: 20	267	20	164	15.0	61.4	0.81
chr1	21116940	21117661	CpG: 89	721	89	556	24.7	77.1	0.83
chr1	21128268	21128541	CpG: 19	273	19	169	13.9	61.9	0.73
chr1	21136856	21137100	CpG: 21	244	21	147	17.2	60.2	0.96
chr1	21171922	21173066	CpG: 132	1144	132	837	23.1	73.2	0.86
chr1	21185513	21185754	CpG: 20	241	20	148	16.6	61.4	0.91
chr1	21251578	21251859	CpG: 24	281	24	174	17.1	61.9	0.91
chr1	21255118	21256625	CpG: 179	1507	179	1068	23.8	70.9	0.95
chr1	21260811	21261157	CpG: 34	346	34	255	19.7	73.7	0.73
chr1	21264011	21264963	CpG: 96	952	96	658	20.2	69.1	0.87
chr1	21326567	21327370	CpG: 64	803	64	553	15.9	68.9	0.67
chr1	21332987	21333783	CpG: 89	796	89	593	22.4	74.5	0.81
chr1	21375692	21375966	CpG: 22	274	22	168	16.1	61.3	0.86
chr1	21427604	21427805	CpG: 20	201	20	139	19.9	69.2	0.84
chr1	21446082	21446671	CpG: 83	589	83	482	28.2	81.8	0.84
chr1	21475507	21476362	CpG: 110	855	110	637	25.7	74.5	0.96
chr1	21483018	21483504	CpG: 57	486	57	343	23.5	70.6	0.97
chr1	21492524	21493870	CpG: 109	1346	109	958	16.2	71.2	0.64
chr1	21606578	21607710	CpG: 119	1132	119	756	21.0	66.8	0.96
chr1	21608650	21608920	CpG: 22	270	22	169	16.3	62.6	0.84
chr1	21638246	21638857	CpG: 64	611	64	439	20.9	71.8	0.81
chr1	21644053	21644326	CpG: 20	273	20	170	14.7	62.3	0.76
chr1	21646998	21647302	CpG: 25	304	25	196	16.4	64.5	0.82
chr1	21652615	21652880	CpG: 22	265	22	182	16.6	68.7	0.70
chr1	21688680	21688923	CpG: 23	243	23	173	18.9	71.2	0.76
chr1	21708309	21708635	CpG: 26	326	26	226	16.0	69.3	0.66
chr1	21711218	21711435	CpG: 16	217	16	144	14.7	66.4	0.69
chr1	21760666	21761596	CpG: 129	930	129	748	27.7	80.4	0.91
chr1	21805565	21805782	CpG: 15	217	15	127	13.8	58.5	0.82
chr1	21809469	21809683	CpG: 16	214	16	126	15.0	58.9	0.87
chr1	21849227	21849504	CpG: 23	277	23	173	16.6	62.5	0.88
chr1	21874909	21875146	CpG: 19	237	19	140	16.0	59.1	0.94
chr1	21876324	21877345	CpG: 124	1021	124	772	24.3	75.6	0.85
chr1	21894849	21895090	CpG: 18	241	18	144	14.9	59.8	0.85
chr1	21918085	21918359	CpG: 25	274	25	171	18.2	62.4	0.95
chr1	21943788	21944211	CpG: 35	423	35	278	16.5	65.7	0.77
chr1	21953293	21953495	CpG: 17	202	17	136	16.8	67.3	0.76
chr1	21966023	21967526	CpG: 205	1503	205	1205	27.3	80.2	0.85
chr1	22109438	22109642	CpG: 19	204	19	147	18.6	72.1	0.72
chr1	22165838	22166074	CpG: 17	236	17	153	14.4	64.8	0.69
chr1	22215723	22215986	CpG: 20	263	20	161	15.2	61.2	0.82
chr1	22252770	22253043	CpG: 20	273	20	167	14.7	61.2	0.80
chr1	22275448	22276075	CpG: 66	627	66	431	21.1	68.7	0.90
chr1	22386809	22387655	CpG: 129	846	129	666	30.5	78.7	1.00
chr1	22400104	22400715	CpG: 47	611	47	393	15.4	64.3	0.75
chr1	22418343	22418777	CpG: 32	434	32	296	14.7	68.2	0.63
chr1	22425664	22426061	CpG: 30	397	30	272	15.1	68.5	0.64
chr1	22472590	22472843	CpG: 19	253	19	157	15.0	62.1	0.78
chr1	22501836	22502251	CpG: 33	415	33	290	15.9	69.9	0.65
chr1	22535214	22536753	CpG: 203	1539	203	1203	26.4	78.2	0.87
chr1	22583515	22583747	CpG: 20	232	20	141	17.2	60.8	0.95
chr1	22609945	22610608	CpG: 46	663	46	397	13.9	59.9	0.77
chr1	22778839	22779855	CpG: 129	1016	129	748	25.4	73.6	0.94
chr1	22842913	22843143	CpG: 21	230	21	143	18.3	62.2	0.96
chr1	22844983	22845846	CpG: 108	863	108	620	25.0	71.8	0.98
chr1	22868143	22868417	CpG: 24	274	24	170	17.5	62.0	0.92
chr1	22993413	22994984	CpG: 150	1571	150	1060	19.1	67.5	0.87
chr1	23003224	23003798	CpG: 60	574	60	400	20.9	69.7	0.86
chr1	23042545	23043405	CpG: 112	860	112	679	26.0	79.0	0.86
chr1	23057296	23057567	CpG: 20	271	20	169	14.8	62.4	0.76
chr1	23066071	23066312	CpG: 21	241	21	146	17.4	60.6	0.97
chr1	23066971	23067206	CpG: 18	235	18	133	15.3	56.6	0.97
chr1	23083014	23083560	CpG: 46	546	46	403	16.8	73.8	0.62
chr1	23087992	23088258	CpG: 20	266	20	162	15.0	60.9	0.83
chr1	23158003	23158239	CpG: 17	236	17	144	14.4	61.0	0.79
chr1	23168998	23169272	CpG: 23	274	23	170	16.8	62.0	0.88
chr1	23176922	23178039	CpG: 132	1117	132	810	23.6	72.5	0.90
chr1	23179007	23179242	CpG: 17	235	17	134	14.5	57.0	0.91
chr1	23180100	23180406	CpG: 21	306	21	173	13.7	56.5	0.87
chr1	23201375	23202735	CpG: 106	1360	106	868	15.6	63.8	0.77
chr1	23258349	23259664	CpG: 121	1315	121	934	18.4	71.0	0.74
chr1	23271150	23271967	CpG: 56	817	56	553	13.7	67.7	0.60
chr1	23296603	23296808	CpG: 16	205	16	121	15.6	59.0	0.91
chr1	23317961	23319339	CpG: 128	1378	128	974	18.6	70.7	0.77
chr1	23337925	23338819	CpG: 78	894	78	615	17.4	68.8	0.74
chr1	23365107	23366165	CpG: 107	1058	107	726	20.2	68.6	0.86
chr1	23389094	23389832	CpG: 78	738	78	552	21.1	74.8	0.80
chr1	23392920	23393165	CpG: 23	245	23	169	18.8	69.0	0.79
chr1	23393520	23394290	CpG: 64	770	64	487	16.6	63.2	0.83
chr1	23402600	23403161	CpG: 66	561	66	422	23.5	75.2	0.87
chr1	23454028	23454376	CpG: 44	348	44	266	25.3	76.4	0.87
chr1	23462637	23462938	CpG: 25	301	25	178	16.6	59.1	0.96
chr1	23489257	23489534	CpG: 25	277	25	173	18.1	62.5	0.93
chr1	23523201	23524093	CpG: 80	892	80	646	17.9	72.4	0.68
chr1	23525277	23525534	CpG: 22	257	22	146	17.1	56.8	1.09
chr1	23526765	23526977	CpG: 17	212	17	135	16.0	63.7	0.79
chr1	23532135	23532363	CpG: 16	228	16	133	14.0	58.3	0.84
chr1	23575253	23575475	CpG: 16	222	16	128	14.4	57.7	0.87
chr1	23578172	23579092	CpG: 131	920	131	704	28.5	76.5	0.98
chr1	23602318	23602553	CpG: 17	235	17	137	14.5	58.3	0.88
chr1	23612490	23612725	CpG: 19	235	19	137	16.2	58.3	0.96
chr1	23612977	23613742	CpG: 89	765	89	515	23.3	67.3	1.03
chr1	23625968	23626310	CpG: 35	342	35	237	20.5	69.3	0.89
chr1	23635125	23636034	CpG: 100	909	100	663	22.0	72.9	0.83
chr1	23660301	23660534	CpG: 27	233	27	168	23.2	72.1	0.93
chr1	23687687	23688594	CpG: 69	907	69	628	15.2	69.2	0.64
chr1	23696176	23696406	CpG: 19	230	19	139	16.5	60.4	0.92
chr1	23702851	23703750	CpG: 94	899	94	604	20.9	67.2	0.93
chr1	23740028	23740599	CpG: 80	571	80	437	28.0	76.5	0.96
chr1	23756999	23757270	CpG: 19	271	19	164	14.0	60.5	0.78
chr1	23765464	23765715	CpG: 19	251	19	156	15.1	62.2	0.79
chr1	23772558	23773309	CpG: 60	751	60	512	16.0	68.2	0.69
chr1	23785773	23785984	CpG: 17	211	17	130	16.1	61.6	0.87
chr1	23796469	23797633	CpG: 111	1164	111	771	19.1	66.2	0.88
chr1	23817298	23817952	CpG: 81	654	81	463	24.8	70.8	0.99
chr1	23828894	23829123	CpG: 17	229	17	138	14.8	60.3	0.85
chr1	23839536	23839822	CpG: 24	286	24	177	16.8	61.9	0.89
chr1	23869749	23870512	CpG: 58	763	58	521	15.2	68.3	0.65
chr1	23914244	23914519	CpG: 23	275	23	169	16.7	61.5	0.89
chr1	24024736	24025678	CpG: 86	942	86	632	18.3	67.1	0.81
chr1	24159818	24160790	CpG: 91	972	91	661	18.7	68.0	0.81
chr1	24251738	24252143	CpG: 37	405	37	279	18.3	68.9	0.78
chr1	24254554	24254922	CpG: 24	368	24	202	13.0	54.9	0.91
chr1	24340761	24341775	CpG: 123	1014	123	737	24.3	72.7	0.92
chr1	24373600	24373818	CpG: 19	218	19	141	17.4	64.7	0.84
chr1	24394333	24394682	CpG: 45	349	45	282	25.8	80.8	0.82
chr1	24440733	24440943	CpG: 21	210	21	132	20.0	62.9	1.03
chr1	24470309	24470592	CpG: 24	283	24	175	17.0	61.8	0.90
chr1	24480713	24482116	CpG: 146	1403	146	920	20.8	65.6	0.97
chr1	24513661	24513897	CpG: 20	236	20	145	16.9	61.4	0.91
chr1	24559995	24560348	CpG: 32	353	32	264	18.1	74.8	0.65
chr1	24583218	24584904	CpG: 173	1686	173	1152	20.5	68.3	0.88
chr1	24594868	24595100	CpG: 17	232	17	140	14.7	60.3	0.82
chr1	24675041	24675269	CpG: 18	228	18	139	15.8	61.0	0.87
chr1	24683530	24684549	CpG: 99	1019	99	715	19.4	70.2	0.79
chr1	24737726	24738362	CpG: 47	636	47	439	14.8	69.0	0.64
chr1	24743658	24744037	CpG: 44	379	44	210	23.2	55.4	1.60
chr1	24764757	24768235	CpG: 367	3478	367	2396	21.1	68.9	0.89
chr1	25050694	25050961	CpG: 22	267	22	166	16.5	62.2	0.86
chr1	25068329	25068944	CpG: 45	615	45	380	14.6	61.8	0.79
chr1	25075971	25076477	CpG: 39	506	39	330	15.4	65.2	0.73
chr1	25082737	25084292	CpG: 166	1555	166	1022	21.4	65.7	0.99
chr1	25103057	25104267	CpG: 92	1210	92	751	15.2	62.1	0.80
chr1	25173408	25175200	CpG: 146	1792	146	1154	16.3	64.4	0.79
chr1	25177572	25177791	CpG: 20	219	20	135	18.3	61.6	0.97
chr1	25266272	25267967	CpG: 193	1695	193	1181	22.8	69.7	0.94
chr1	25330170	25330403	CpG: 17	233	17	139	14.6	59.7	0.84
chr1	25342980	25343339	CpG: 26	359	26	210	14.5	58.5	0.85
chr1	25380740	25381889	CpG: 122	1149	122	836	21.2	72.8	0.81
chr1	25453511	25455622	CpG: 270	2111	270	1621	25.6	76.8	0.87
chr1	25608894	25609097	CpG: 16	203	16	135	15.8	66.5	0.71
chr1	25637438	25638104	CpG: 90	666	90	537	27.0	80.6	0.83
chr1	25657072	25658325	CpG: 125	1253	125	865	20.0	69.0	0.85
chr1	25696414	25697298	CpG: 81	884	81	558	18.3	63.1	0.98
chr1	25712662	25713456	CpG: 89	794	89	594	22.4	74.8	0.81
chr1	25742889	25744563	CpG: 157	1674	157	1195	18.8	71.4	0.75
chr1	25760132	25760540	CpG: 47	408	47	294	23.0	72.1	0.89
chr1	25814468	25814719	CpG: 23	251	23	159	18.3	63.3	0.93
chr1	25833789	25834031	CpG: 18	242	18	147	14.9	60.7	0.85
chr1	25835460	25835845	CpG: 33	385	33	220	17.1	57.1	1.07
chr1	25872504	25873619	CpG: 88	1115	88	741	15.8	66.5	0.72
chr1	25883191	25884223	CpG: 111	1032	111	734	21.5	71.1	0.85
chr1	25948261	25949859	CpG: 181	1598	181	1170	22.7	73.2	0.85
chr1	25998746	26001988	CpG: 246	3242	246	2004	15.2	61.8	0.79
chr1	26007119	26007764	CpG: 74	645	74	464	22.9	71.9	0.89
chr1	26062465	26063142	CpG: 51	677	51	448	15.1	66.2	0.69
chr1	26071399	26072295	CpG: 90	896	90	582	20.1	65.0	0.96
chr1	26073070	26073311	CpG: 19	241	19	143	15.8	59.3	0.91
chr1	26117355	26117906	CpG: 67	551	67	399	24.3	72.4	0.93
chr1	26143795	26144275	CpG: 41	480	41	312	17.1	65.0	0.81
chr1	26173493	26174421	CpG: 80	928	80	638	17.2	68.8	0.73
chr1	26183400	26183605	CpG: 15	205	15	142	14.6	69.3	0.61
chr1	26197472	26198237	CpG: 66	765	66	532	17.3	69.5	0.72
chr1	26248790	26249692	CpG: 72	902	72	595	16.0	66.0	0.74
chr1	26269472	26269690	CpG: 17	218	17	128	15.6	58.7	0.92
chr1	26270016	26270380	CpG: 36	364	36	252	19.8	69.2	0.84
chr1	26309894	26311372	CpG: 167	1478	167	1038	22.6	70.2	0.92
chr1	26338130	26339434	CpG: 125	1304	125	921	19.2	70.6	0.77
chr1	26346850	26347135	CpG: 24	285	24	177	16.8	62.1	0.89
chr1	26364694	26364928	CpG: 21	234	21	144	17.9	61.5	0.97
chr1	26367532	26368145	CpG: 95	613	95	493	31.0	80.4	0.98
chr1	26458303	26459535	CpG: 119	1232	119	837	19.3	67.9	0.84
chr1	26460094	26460330	CpG: 18	236	18	140	15.3	59.3	0.88
chr1	26460965	26461225	CpG: 21	260	21	163	16.2	62.7	0.84
chr1	26486714	26486957	CpG: 19	243	19	152	15.6	62.6	0.81
chr1	26529293	26529504	CpG: 16	211	16	124	15.2	58.8	0.89
chr1	26533287	26535555	CpG: 272	2268	272	1728	24.0	76.2	0.83
chr1	26625554	26626156	CpG: 60	602	60	420	19.9	69.8	0.83
chr1	26630297	26630578	CpG: 24	281	24	178	17.1	63.3	0.86
chr1	26655204	26657159	CpG: 188	1955	188	1531	19.2	78.3	0.63
chr1	26664477	26665250	CpG: 108	773	108	599	27.9	77.5	0.93
chr1	26685005	26685222	CpG: 15	217	15	126	13.8	58.1	0.83
chr1	26701496	26701712	CpG: 17	216	17	142	15.7	65.7	0.76
chr1	26702646	26703557	CpG: 80	911	80	611	17.6	67.1	0.79
chr1	26704762	26705035	CpG: 25	273	25	169	18.3	61.9	0.96
chr1	26711892	26712129	CpG: 19	237	19	143	16.0	60.3	0.91
chr1	26727716	26728617	CpG: 94	901	94	587	20.9	65.1	0.98
chr1	26738064	26738581	CpG: 45	517	45	319	17.4	61.7	0.92
chr1	26759615	26760186	CpG: 71	571	71	404	24.9	70.8	1.00
chr1	26763319	26763556	CpG: 20	237	20	148	16.9	62.4	0.89
chr1	26797629	26798665	CpG: 96	1036	96	748	18.5	72.2	0.73
chr1	26820128	26820346	CpG: 16	218	16	131	14.7	60.1	0.83
chr1	26830621	26831248	CpG: 42	627	42	369	13.4	58.9	0.78
chr1	26831553	26832720	CpG: 147	1167	147	883	25.2	75.7	0.89
chr1	26844168	26844557	CpG: 36	389	36	262	18.5	67.4	0.82
chr1	26850452	26851014	CpG: 65	562	65	407	23.1	72.4	0.88
chr1	26851439	26851711	CpG: 21	272	21	167	15.4	61.4	0.83
chr1	26891790	26892030	CpG: 17	240	17	146	14.2	60.8	0.77
chr1	26902275	26903787	CpG: 125	1512	125	1111	16.5	73.5	0.61
chr1	26971333	26971546	CpG: 16	213	16	124	15.0	58.2	0.89
chr1	26996012	26996409	CpG: 45	397	45	292	22.7	73.6	0.84
chr1	26997671	26997933	CpG: 25	262	25	164	19.1	62.6	0.99
chr1	27001893	27002202	CpG: 21	309	21	176	13.6	57.0	0.84
chr1	27028082	27028367	CpG: 25	285	25	179	17.5	62.8	0.90
chr1	27042619	27042820	CpG: 21	201	21	136	20.9	67.7	0.92
chr1	27073687	27074173	CpG: 34	486	34	274	14.0	56.4	0.89
chr1	27075434	27076436	CpG: 106	1002	106	745	21.2	74.4	0.79
chr1	27130167	27131093	CpG: 72	926	72	652	15.6	70.4	0.63
chr1	27163196	27163749	CpG: 63	553	63	392	22.8	70.9	0.92
chr1	27190664	27192761	CpG: 177	2097	177	1436	16.9	68.5	0.72
chr1	27198024	27198337	CpG: 23	313	23	216	14.7	69.0	0.63
chr1	27201771	27202490	CpG: 72	719	72	504	20.0	70.1	0.84
chr1	27207159	27207990	CpG: 96	831	96	610	23.1	73.4	0.87
chr1	27224420	27224807	CpG: 39	387	39	289	20.2	74.7	0.76
chr1	27233712	27234169	CpG: 66	457	66	346	28.9	75.7	1.01
chr1	27302784	27303068	CpG: 20	284	20	166	14.1	58.5	0.85
chr1	27312367	27312634	CpG: 21	267	21	164	15.7	61.4	0.84
chr1	27318918	27319158	CpG: 22	240	22	149	18.3	62.1	0.97
chr1	27328424	27328653	CpG: 19	229	19	135	16.6	59.0	0.99
chr1	27331139	27331650	CpG: 55	511	55	359	21.5	70.3	0.90
chr1	27369106	27369758	CpG: 66	652	66	493	20.2	75.6	0.71
chr1	27389209	27389430	CpG: 16	221	16	143	14.5	64.7	0.71
chr1	27409721	27410318	CpG: 63	597	63	431	21.1	72.2	0.81
chr1	27416454	27417499	CpG: 115	1045	115	783	22.0	74.9	0.78
chr1	27444377	27445661	CpG: 141	1284	141	946	22.0	73.7	0.83
chr1	27456657	27457116	CpG: 39	459	39	308	17.0	67.1	0.78
chr1	27475357	27475813	CpG: 59	456	59	344	25.9	75.4	0.91
chr1	27476349	27476600	CpG: 24	251	24	181	19.1	72.1	0.74
chr1	27483815	27484057	CpG: 20	242	20	146	16.5	60.3	0.93
chr1	27501105	27501608	CpG: 68	503	68	370	27.0	73.6	1.02
chr1	27509535	27509839	CpG: 33	304	33	220	21.7	72.4	0.84
chr1	27516167	27516440	CpG: 20	273	20	168	14.7	61.5	0.78
chr1	27566927	27567784	CpG: 100	857	100	625	23.3	72.9	0.88
chr1	27614408	27614814	CpG: 40	406	40	286	19.7	70.4	0.80
chr1	27672003	27672570	CpG: 52	567	52	368	18.3	64.9	0.87
chr1	27713136	27713737	CpG: 61	601	61	431	20.3	71.7	0.80
chr1	27756176	27757127	CpG: 81	951	81	581	17.0	61.1	0.95
chr1	27800346	27802164	CpG: 142	1818	142	1164	15.6	64.0	0.77
chr1	27930420	27930634	CpG: 23	214	23	139	21.5	65.0	1.03
chr1	27930904	27931344	CpG: 30	440	30	254	13.6	57.7	0.83
chr1	27963108	27963602	CpG: 40	494	40	314	16.2	63.6	0.80
chr1	27965857	27966123	CpG: 20	266	20	163	15.0	61.3	0.81
chr1	28074469	28074921	CpG: 36	452	36	290	15.9	64.2	0.83
chr1	28077834	28078300	CpG: 46	466	46	301	19.7	64.6	0.95
chr1	28088775	28089346	CpG: 42	571	42	323	14.7	56.6	0.92
chr1	28094767	28095052	CpG: 23	285	23	177	16.1	62.1	0.85
chr1	28101155	28102573	CpG: 138	1418	138	1000	19.5	70.5	0.79
chr1	28111907	28112143	CpG: 18	236	18	141	15.3	59.7	0.87
chr1	28170690	28170992	CpG: 27	302	27	176	17.9	58.3	1.06
chr1	28171182	28171420	CpG: 18	238	18	140	15.1	58.8	0.89
chr1	28178396	28178970	CpG: 39	574	39	322	13.6	56.1	0.86
chr1	28199198	28199543	CpG: 24	345	24	204	13.9	59.1	0.80
chr1	28200183	28200441	CpG: 18	258	18	153	14.0	59.3	0.80
chr1	28211363	28212053	CpG: 61	690	61	477	17.7	69.1	0.74
chr1	28221911	28222185	CpG: 23	274	23	169	16.8	61.7	0.89
chr1	28281981	28282256	CpG: 23	275	23	171	16.7	62.2	0.88
chr1	28347397	28347665	CpG: 22	268	22	162	16.4	60.4	0.90
chr1	28348213	28348579	CpG: 26	366	26	214	14.2	58.5	0.83
chr1	28360097	28360737	CpG: 91	640	91	483	28.4	75.5	1.01
chr1	28365048	28365272	CpG: 18	224	18	132	16.1	58.9	0.96
chr1	28372482	28372756	CpG: 29	274	29	208	21.2	75.9	0.74
chr1	28376162	28376436	CpG: 22	274	22	163	16.1	59.5	0.92
chr1	28385982	28386311	CpG: 29	329	29	195	17.6	59.3	1.03
chr1	28394845	28395147	CpG: 37	302	37	215	24.5	71.2	0.97
chr1	28423513	28424243	CpG: 77	730	77	496	21.1	67.9	0.91
chr1	28424746	28424989	CpG: 21	243	21	144	17.3	59.3	1.00
chr1	28434335	28434906	CpG: 77	571	77	436	27.0	76.4	0.95
chr1	28485006	28485351	CpG: 38	345	38	212	22.0	61.4	1.17
chr1	28510625	28511287	CpG: 99	662	99	544	29.9	82.2	0.90
chr1	28516710	28516985	CpG: 23	275	23	170	16.7	61.8	0.88
chr1	28537651	28537930	CpG: 25	279	25	175	17.9	62.7	0.92
chr1	28563390	28563762	CpG: 28	372	28	216	15.1	58.1	0.90
chr1	28564836	28565110	CpG: 22	274	22	167	16.1	60.9	0.88
chr1	28578545	28579794	CpG: 135	1249	135	852	21.6	68.2	0.93
chr1	28617274	28617553	CpG: 26	279	26	194	18.6	69.5	0.77
chr1	28627413	28627653	CpG: 19	240	19	149	15.8	62.1	0.85
chr1	28653981	28654828	CpG: 116	847	116	643	27.4	75.9	0.95
chr1	28700100	28700376	CpG: 22	276	22	170	15.9	61.6	0.85
chr1	28704760	28705405	CpG: 64	645	64	438	19.8	67.9	0.86
chr1	28728833	28729695	CpG: 81	862	81	626	18.8	72.6	0.71
chr1	28730556	28730834	CpG: 24	278	24	172	17.3	61.9	0.92
chr1	28755061	28755324	CpG: 19	263	19	155	14.4	58.9	0.84
chr1	28756148	28757360	CpG: 126	1212	126	827	20.8	68.2	0.90
chr1	28771234	28771606	CpG: 26	372	26	211	14.0	56.7	0.87
chr1	28790191	28790454	CpG: 20	263	20	155	15.2	58.9	0.89
chr1	28811438	28811719	CpG: 19	281	19	152	13.5	54.1	0.93
chr1	28836961	28837235	CpG: 24	274	24	170	17.5	62.0	0.92
chr1	28897970	28898244	CpG: 23	274	23	171	16.8	62.4	0.87
chr1	28940880	28941094	CpG: 14	214	14	127	13.1	59.3	0.75
chr1	28963843	28967991	CpG: 421	4148	421	2999	20.3	72.3	0.78
chr1	28973835	28974153	CpG: 29	318	29	235	18.2	73.9	0.67
chr1	28976954	28977316	CpG: 37	362	37	256	20.4	70.7	0.82
chr1	28979774	28979998	CpG: 18	224	18	134	16.1	59.8	0.93
chr1	29024120	29024952	CpG: 106	832	106	587	25.5	70.6	1.03
chr1	29032751	29033002	CpG: 20	251	20	151	15.9	60.2	0.89
chr1	29073365	29073772	CpG: 41	407	41	287	20.1	70.5	0.81
chr1	29078856	29081452	CpG: 291	2596	291	1812	22.4	69.8	0.94
chr1	29102043	29103558	CpG: 121	1515	121	1035	16.0	68.3	0.69
chr1	29321095	29321372	CpG: 23	277	23	197	16.6	71.1	0.67
chr1	29553680	29553916	CpG: 19	236	19	143	16.1	60.6	0.90
chr1	30018390	30018668	CpG: 20	278	20	170	14.4	61.2	0.78
chr1	30535114	30535635	CpG: 46	521	46	359	17.7	68.9	0.75
chr1	30567644	30569084	CpG: 132	1440	132	999	18.3	69.4	0.81
chr1	30571400	30571711	CpG: 23	311	23	192	14.8	61.7	0.78
chr1	30625582	30625852	CpG: 23	270	23	183	17.0	67.8	0.74
chr1	30659591	30659982	CpG: 39	391	39	284	19.9	72.6	0.77
chr1	30676758	30677025	CpG: 25	267	25	187	18.7	70.0	0.76
chr1	30683857	30684081	CpG: 20	224	20	138	17.9	61.6	0.98
chr1	30760226	30761346	CpG: 161	1120	161	907	28.8	81.0	0.88
chr1	30762295	30762552	CpG: 19	257	19	160	14.8	62.3	0.78
chr1	30917702	30918236	CpG: 61	534	61	377	22.8	70.6	0.92
chr1	30976359	30976595	CpG: 18	236	18	138	15.3	58.5	0.91
chr1	31006943	31007792	CpG: 89	849	89	643	21.0	75.7	0.78
chr1	31028068	31029229	CpG: 93	1161	93	839	16.0	72.3	0.61
chr1	31033613	31034140	CpG: 46	527	46	358	17.5	67.9	0.76
chr1	31091446	31092232	CpG: 111	786	111	615	28.2	78.2	0.92
chr1	31148621	31149353	CpG: 55	732	55	436	15.0	59.6	0.85
chr1	31247011	31247348	CpG: 28	337	28	222	16.6	65.9	0.77
chr1	31265269	31266485	CpG: 131	1216	131	874	21.5	71.9	0.84
chr1	31392151	31392428	CpG: 23	277	23	173	16.6	62.5	0.87
chr1	31415669	31415954	CpG: 24	285	24	177	16.8	62.1	0.89
chr1	31444571	31444871	CpG: 37	300	37	221	24.7	73.7	0.93
chr1	31446440	31446942	CpG: 54	502	54	372	21.5	74.1	0.78
chr1	31475202	31476122	CpG: 86	920	86	677	18.7	73.6	0.69
chr1	31502259	31503010	CpG: 65	751	65	470	17.3	62.6	0.91
chr1	31561569	31561901	CpG: 27	332	27	244	16.3	73.5	0.60
chr1	31572170	31572526	CpG: 30	356	30	245	16.9	68.8	0.72
chr1	31600535	31600753	CpG: 21	218	21	164	19.3	75.2	0.70
chr1	31613936	31614156	CpG: 18	220	18	154	16.4	70.0	0.67
chr1	31618195	31618775	CpG: 55	580	55	418	19.0	72.1	0.73
chr1	31620396	31622301	CpG: 205	1905	205	1374	21.5	72.1	0.85
chr1	31629589	31630714	CpG: 109	1125	109	747	19.4	66.4	0.90
chr1	31646052	31647056	CpG: 66	1004	66	637	13.1	63.4	0.66
chr1	31700034	31700300	CpG: 28	266	28	171	21.1	64.3	1.03
chr1	31781351	31781583	CpG: 21	232	21	142	18.1	61.2	0.99
chr1	31795634	31796734	CpG: 145	1100	145	838	26.4	76.2	0.93
chr1	31802542	31803002	CpG: 41	460	41	304	17.8	66.1	0.83
chr1	31871427	31872908	CpG: 155	1481	155	1003	20.9	67.7	0.92
chr1	31876403	31876641	CpG: 18	238	18	144	15.1	60.5	0.85
chr1	31894136	31894348	CpG: 16	212	16	126	15.1	59.4	0.87
chr1	31930553	31931400	CpG: 80	847	80	583	18.9	68.8	0.83
chr1	31966403	31966660	CpG: 19	257	19	161	14.8	62.6	0.78
chr1	32037450	32038110	CpG: 81	660	81	486	24.5	73.6	0.91
chr1	32058532	32058761	CpG: 20	229	20	152	17.5	66.4	0.82
chr1	32062870	32064186	CpG: 105	1316	105	851	16.0	64.7	0.76
chr1	32079824	32080343	CpG: 40	519	40	339	15.4	65.3	0.73
chr1	32097827	32099444	CpG: 130	1617	130	1064	16.1	65.8	0.74
chr1	32106221	32106489	CpG: 23	268	23	196	17.2	73.1	0.64
chr1	32133019	32133853	CpG: 74	834	74	562	17.7	67.4	0.81
chr1	32149682	32150350	CpG: 64	668	64	464	19.2	69.5	0.82
chr1	32177899	32178125	CpG: 16	226	16	131	14.2	58.0	0.85
chr1	32193176	32194546	CpG: 168	1370	168	1041	24.5	76.0	0.85
chr1	32209029	32209902	CpG: 86	873	86	627	19.7	71.8	0.77
chr1	32219258	32220331	CpG: 126	1073	126	806	23.5	75.1	0.84
chr1	32252085	32252663	CpG: 43	578	43	359	14.9	62.1	0.87
chr1	32263299	32263574	CpG: 23	275	23	169	16.7	61.5	0.90
chr1	32284743	32285150	CpG: 30	407	30	262	14.7	64.4	0.71
chr1	32322815	32323376	CpG: 54	561	54	393	19.3	70.1	0.79
chr1	32358329	32358897	CpG: 94	568	94	459	33.1	80.8	1.04
chr1	32375998	32376232	CpG: 22	234	22	146	18.8	62.4	0.98
chr1	32397320	32398282	CpG: 151	962	151	755	31.4	78.5	1.03
chr1	32510724	32511542	CpG: 96	818	96	569	23.5	69.6	0.97
chr1	32551774	32551981	CpG: 15	207	15	122	14.5	58.9	0.84
chr1	32562238	32563084	CpG: 86	846	86	637	20.3	75.3	0.72
chr1	32572089	32572388	CpG: 32	299	32	196	21.4	65.6	1.00
chr1	32572538	32572778	CpG: 18	240	18	141	15.0	58.8	0.87
chr1	32586837	32587111	CpG: 23	274	23	171	16.8	62.4	0.87
chr1	32594306	32594542	CpG: 18	236	18	142	15.3	60.2	0.88
chr1	32601346	32602086	CpG: 113	740	113	605	30.5	81.8	0.92
chr1	32613609	32614816	CpG: 103	1207	103	809	17.1	67.0	0.76
chr1	32629677	32629901	CpG: 20	224	20	159	17.9	71.0	0.71
chr1	32661764	32662038	CpG: 24	274	24	171	17.5	62.4	0.91
chr1	32663999	32664896	CpG: 74	897	74	620	16.5	69.1	0.69
chr1	32676856	32678087	CpG: 104	1231	104	844	16.9	68.6	0.72
chr1	32697890	32698105	CpG: 17	215	17	124	15.8	57.7	0.97
chr1	32730397	32730950	CpG: 91	553	91	459	32.9	83.0	0.96
chr1	32745880	32746591	CpG: 75	711	75	542	21.1	76.2	0.73
chr1	32752663	32753643	CpG: 89	980	89	692	18.2	70.6	0.76
chr1	32760707	32761797	CpG: 112	1090	112	770	20.6	70.6	0.83
chr1	32784682	32785048	CpG: 29	366	29	264	15.8	72.1	0.61
chr1	32823712	32824797	CpG: 151	1085	151	828	27.8	76.3	0.96
chr1	32832639	32835495	CpG: 203	2856	203	1934	14.2	67.7	0.62
chr1	32859583	32859857	CpG: 24	274	24	171	17.5	62.4	0.91
chr1	32896392	32896910	CpG: 47	518	47	343	18.1	66.2	0.84
chr1	32910787	32912805	CpG: 192	2018	192	1572	19.0	77.9	0.63
chr1	32940816	32941535	CpG: 60	719	60	489	16.7	68.0	0.73
chr1	32987167	32987431	CpG: 25	264	25	160	18.9	60.6	1.05
chr1	33007250	33007595	CpG: 26	345	26	220	15.1	63.8	0.74
chr1	33019533	33019801	CpG: 24	268	24	184	17.9	68.7	0.76
chr1	33040597	33042149	CpG: 144	1552	144	1114	18.6	71.8	0.72
chr1	33117438	33118664	CpG: 183	1226	183	970	29.9	79.1	0.96
chr1	33137771	33138256	CpG: 48	485	48	349	19.8	72.0	0.77
chr1	33141740	33141989	CpG: 20	249	20	170	16.1	68.3	0.73
chr1	33168167	33169125	CpG: 123	958	123	680	25.7	71.0	1.02
chr1	33170977	33171781	CpG: 61	804	61	559	15.2	69.5	0.63
chr1	33210788	33212198	CpG: 182	1410	182	1048	25.8	74.3	0.94
chr1	33292003	33292930	CpG: 125	927	125	704	27.0	75.9	0.94
chr1	33334026	33334329	CpG: 30	303	30	198	19.8	65.3	0.93
chr1	33486601	33486850	CpG: 20	249	20	167	16.1	67.1	0.72
chr1	33494889	33495112	CpG: 18	223	18	147	16.1	65.9	0.74
chr1	33943338	33944276	CpG: 74	938	74	652	15.8	69.5	0.65
chr1	33954346	33954588	CpG: 23	242	23	150	19.0	62.0	0.99
chr1	34024910	34027103	CpG: 190	2193	190	1472	17.3	67.1	0.77
chr1	34038481	34039123	CpG: 62	642	62	459	19.3	71.5	0.76
chr1	34112468	34112802	CpG: 25	334	25	196	15.0	58.7	0.87
chr1	34246090	34246342	CpG: 23	252	23	158	18.3	62.7	0.94
chr1	34256149	34256389	CpG: 17	240	17	145	14.2	60.4	0.79
chr1	34369216	34369493	CpG: 23	277	23	168	16.6	60.6	0.91
chr1	34434398	34434697	CpG: 23	299	23	176	15.4	58.9	0.89
chr1	34624065	34624313	CpG: 22	248	22	159	17.7	64.1	0.88
chr1	34630877	34631151	CpG: 23	274	23	168	16.8	61.3	0.90
chr1	34643904	34644627	CpG: 70	723	70	529	19.4	73.2	0.72
chr1	34647446	34647764	CpG: 26	318	26	200	16.4	62.9	0.83
chr1	34655523	34655819	CpG: 38	296	38	227	25.7	76.7	0.88
chr1	34722212	34722580	CpG: 38	368	38	255	20.7	69.3	0.87
chr1	34728314	34729246	CpG: 99	932	99	662	21.2	71.0	0.85
chr1	34731335	34731537	CpG: 26	202	26	155	25.7	76.7	0.91
chr1	34747911	34748887	CpG: 89	976	89	695	18.2	71.2	0.72
chr1	34755523	34755808	CpG: 22	285	22	176	15.4	61.8	0.82
chr1	34791805	34793264	CpG: 156	1459	156	1131	21.4	77.5	0.72
chr1	34830324	34830782	CpG: 42	458	42	336	18.3	73.4	0.68
chr1	34839306	34840005	CpG: 76	699	76	512	21.7	73.2	0.81
chr1	34847719	34848107	CpG: 46	388	46	285	23.7	73.5	0.91
chr1	34894191	34894657	CpG: 40	466	40	287	17.2	61.6	0.98
chr1	34912056	34912298	CpG: 18	242	18	146	14.9	60.3	0.83
chr1	34941991	34942369	CpG: 36	378	36	237	19.0	62.7	0.99
chr1	34979535	34979797	CpG: 25	262	25	166	19.1	63.4	0.96
chr1	34983400	34983660	CpG: 26	260	26	179	20.0	68.8	0.85
chr1	35054535	35055879	CpG: 152	1344	152	976	22.6	72.6	0.86
chr1	35059856	35060131	CpG: 21	275	21	164	15.3	59.6	0.87
chr1	35081550	35081914	CpG: 28	364	28	210	15.4	57.7	0.95
chr1	35101094	35101380	CpG: 22	286	22	167	15.4	58.4	0.91
chr1	35110659	35110875	CpG: 16	216	16	128	14.8	59.3	0.86
chr1	35113902	35114143	CpG: 23	241	23	147	19.1	61.0	1.05
chr1	35115925	35116203	CpG: 23	278	23	170	16.5	61.2	0.90
chr1	35121543	35121809	CpG: 27	266	27	168	20.3	63.2	1.03
chr1	35131677	35132309	CpG: 69	632	69	456	21.8	72.2	0.85
chr1	35147034	35147315	CpG: 21	281	21	172	14.9	61.2	0.81
chr1	35293066	35293301	CpG: 21	235	21	143	17.9	60.9	0.99
chr1	35420124	35421481	CpG: 108	1357	108	898	15.9	66.2	0.74
chr1	35436297	35437499	CpG: 134	1202	134	883	22.3	73.5	0.84
chr1	35439880	35440858	CpG: 99	978	99	697	20.2	71.3	0.80
chr1	35504075	35504684	CpG: 49	609	49	363	16.1	59.6	0.91
chr1	35562880	35563106	CpG: 17	226	17	133	15.0	58.8	0.88
chr1	35570762	35571334	CpG: 67	572	67	438	23.4	76.6	0.80
chr1	35581603	35582250	CpG: 70	647	70	456	21.6	70.5	0.89
chr1	35632247	35633123	CpG: 82	876	82	614	18.7	70.1	0.76
chr1	35650248	35650497	CpG: 18	249	18	142	14.5	57.0	0.91
chr1	35655910	35656152	CpG: 19	242	19	149	15.7	61.6	0.85
chr1	35668533	35669122	CpG: 40	589	40	333	13.6	56.5	0.87
chr1	35670802	35671749	CpG: 141	947	141	747	29.8	78.9	0.96
chr1	35732543	35732744	CpG: 16	201	16	120	15.9	59.7	0.91
chr1	35733236	35733467	CpG: 18	231	18	137	15.6	59.3	0.91
chr1	35745793	35747023	CpG: 96	1230	96	846	15.6	68.8	0.67
chr1	35793542	35794555	CpG: 131	1013	131	751	25.9	74.1	0.94
chr1	35946829	35947296	CpG: 46	467	46	338	19.7	72.4	0.76
chr1	35951600	35952639	CpG: 103	1039	103	672	19.8	64.7	0.95
chr1	35987609	35988400	CpG: 97	791	97	615	24.5	77.7	0.81
chr1	36012133	36012740	CpG: 61	607	61	406	20.1	66.9	0.95
chr1	36018729	36019900	CpG: 139	1171	139	871	23.7	74.4	0.86
chr1	36039030	36039735	CpG: 75	705	75	507	21.3	71.9	0.82
chr1	36041229	36041995	CpG: 68	766	68	542	17.8	70.8	0.75
chr1	36087046	36087374	CpG: 39	328	39	228	23.8	69.5	0.99
chr1	36169075	36170254	CpG: 110	1179	110	824	18.7	69.9	0.77
chr1	36183772	36186674	CpG: 250	2902	250	2049	17.2	70.6	0.70
chr1	36204634	36204856	CpG: 20	222	20	145	18.0	65.3	0.84
chr1	36248372	36249156	CpG: 82	784	82	566	20.9	72.2	0.81
chr1	36260465	36260977	CpG: 54	512	54	337	21.1	65.8	0.98
chr1	36263051	36263378	CpG: 25	327	25	197	15.3	60.2	0.86
chr1	36266672	36266948	CpG: 20	276	20	167	14.5	60.5	0.79
chr1	36304315	36304554	CpG: 23	239	23	147	19.2	61.5	1.03
chr1	36313049	36313577	CpG: 46	528	46	359	17.4	68.0	0.79
chr1	36326975	36327410	CpG: 46	435	46	285	21.1	65.5	0.99
chr1	36495162	36495443	CpG: 24	281	24	175	17.1	62.3	0.90
chr1	36896530	36898777	CpG: 257	2247	257	1640	22.9	73.0	0.86
chr1	37182042	37182689	CpG: 47	647	47	394	14.5	60.9	0.78
chr1	37338876	37339669	CpG: 99	793	99	579	25.0	73.0	0.94
chr1	37379030	37379908	CpG: 106	878	106	621	24.1	70.7	0.99
chr1	37380951	37381165	CpG: 16	214	16	121	15.0	56.5	0.96
chr1	37382989	37383376	CpG: 32	387	32	278	16.5	71.8	0.64
chr1	37418755	37418972	CpG: 30	217	30	160	27.6	73.7	1.02
chr1	37420670	37420901	CpG: 17	231	17	138	14.7	59.7	0.83
chr1	37421602	37421869	CpG: 21	267	21	173	15.7	64.8	0.75
chr1	37460576	37460888	CpG: 40	312	40	209	25.6	67.0	1.19
chr1	37498751	37499938	CpG: 112	1187	112	839	18.9	70.7	0.76
chr1	37554762	37555334	CpG: 38	572	38	339	13.3	59.3	0.77
chr1	37556350	37557641	CpG: 106	1291	106	866	16.4	67.1	0.73
chr1	37599959	37600240	CpG: 22	281	22	186	15.7	66.2	0.72
chr1	37617082	37618872	CpG: 162	1790	162	1273	18.1	71.1	0.75
chr1	37625938	37626600	CpG: 69	662	69	444	20.8	67.1	0.93
chr1	37628695	37629745	CpG: 77	1050	77	660	14.7	62.9	0.79
chr1	37660316	37661648	CpG: 155	1332	155	992	23.3	74.5	0.84
chr1	37674520	37675618	CpG: 135	1098	135	824	24.6	75.0	0.88
chr1	37726362	37727211	CpG: 64	849	64	560	15.1	66.0	0.70
chr1	37762512	37764054	CpG: 125	1542	125	1126	16.2	73.0	0.61
chr1	37798287	37798950	CpG: 63	663	63	441	19.0	66.5	0.93
chr1	37801813	37802073	CpG: 21	260	21	159	16.2	61.2	0.87
chr1	37808552	37808826	CpG: 23	274	23	170	16.8	62.0	0.88
chr1	37833996	37834231	CpG: 19	235	19	138	16.2	58.7	0.97
chr1	37848120	37848331	CpG: 15	211	15	123	14.2	58.3	0.84
chr1	37856743	37857280	CpG: 37	537	37	322	13.8	60.0	0.77
chr1	37857667	37857911	CpG: 18	244	18	142	14.8	58.2	0.88
chr1	37863095	37863499	CpG: 42	404	42	285	20.8	70.5	0.84
chr1	37872124	37872903	CpG: 97	779	97	600	24.9	77.0	0.85
chr1	37879589	37880234	CpG: 47	645	47	372	14.6	57.7	0.88
chr1	37891597	37891887	CpG: 25	290	25	179	17.2	61.7	0.92
chr1	37911608	37915148	CpG: 423	3540	423	2499	23.9	70.6	0.96
chr1	38196298	38196579	CpG: 23	281	23	174	16.4	61.9	0.87
chr1	38343472	38343957	CpG: 42	485	42	315	17.3	64.9	0.84
chr1	38426722	38427093	CpG: 30	371	30	225	16.2	60.6	0.90
chr1	38445508	38446099	CpG: 65	591	65	399	22.0	67.5	1.01
chr1	38514129	38514952	CpG: 64	823	64	575	15.6	69.9	0.64
chr1	38575894	38576455	CpG: 45	561	45	360	16.0	64.2	0.78
chr1	38586746	38586982	CpG: 20	236	20	143	16.9	60.6	0.94
chr1	38671279	38671801	CpG: 73	522	73	391	28.0	74.9	1.00
chr1	38685154	38686121	CpG: 97	967	97	660	20.1	68.3	0.86
chr1	38726379	38727285	CpG: 101	906	101	670	22.3	74.0	0.83
chr1	38728330	38728609	CpG: 21	279	21	168	15.1	60.2	0.84
chr1	38737755	38738036	CpG: 24	281	24	175	17.1	62.3	0.90
chr1	38740048	38740918	CpG: 82	870	82	599	18.9	68.9	0.80
chr1	38746973	38747268	CpG: 25	295	25	178	16.9	60.3	0.94
chr1	38771981	38772217	CpG: 21	236	21	144	17.8	61.0	0.97
chr1	38827124	38827383	CpG: 20	259	20	158	15.4	61.0	0.84
chr1	38858201	38858817	CpG: 72	616	72	465	23.4	75.5	0.82
chr1	38886341	38886575	CpG: 17	234	17	139	14.5	59.4	0.85
chr1	38893401	38893618	CpG: 25	217	25	136	23.0	62.7	1.19
chr1	38915721	38915998	CpG: 22	277	22	170	15.9	61.4	0.86
chr1	38948365	38949685	CpG: 155	1320	155	1008	23.5	76.4	0.84
chr1	38969298	38969531	CpG: 21	233	21	143	18.0	61.4	0.97
chr1	38972386	38973580	CpG: 150	1194	150	896	25.1	75.0	0.91
chr1	39039078	39039309	CpG: 16	231	16	134	13.9	58.0	0.85
chr1	39114987	39115216	CpG: 20	229	20	137	17.5	59.8	0.98
chr1	39132587	39132869	CpG: 22	282	22	174	15.6	61.7	0.84
chr1	39232399	39232677	CpG: 21	278	21	173	15.1	62.2	0.79
chr1	39276228	39277449	CpG: 149	1221	149	905	24.4	74.1	0.89
chr1	39358662	39360375	CpG: 229	1713	229	1302	26.7	76.0	0.93
chr1	39383061	39384464	CpG: 130	1403	130	943	18.5	67.2	0.82
chr1	39425767	39426001	CpG: 17	234	17	142	14.5	60.7	0.80
chr1	39426147	39426379	CpG: 17	232	17	139	14.7	59.9	0.83
chr1	39428027	39428420	CpG: 28	393	28	221	14.2	56.2	0.92
chr1	39443989	39445373	CpG: 170	1384	170	938	24.6	67.8	1.07
chr1	39468753	39468992	CpG: 17	239	17	134	14.2	56.1	0.91
chr1	39474894	39475124	CpG: 20	230	20	140	17.4	60.9	0.96
chr1	39501326	39501647	CpG: 50	321	50	257	31.2	80.1	0.97
chr1	39507758	39508455	CpG: 86	697	86	529	24.7	75.9	0.87
chr1	39540688	39541787	CpG: 89	1099	89	758	16.2	69.0	0.68
chr1	39553142	39553748	CpG: 65	606	65	433	21.5	71.5	0.84
chr1	39560662	39562087	CpG: 107	1425	107	953	15.0	66.9	0.67
chr1	39608052	39608509	CpG: 42	457	42	296	18.4	64.8	0.91
chr1	39639540	39640963	CpG: 129	1423	129	951	18.1	66.8	0.81
chr1	39657460	39658950	CpG: 206	1490	206	1161	27.7	77.9	0.91
chr1	39677281	39677879	CpG: 46	598	46	420	15.4	70.2	0.63
chr1	39738679	39739485	CpG: 56	806	56	545	13.9	67.6	0.61
chr1	39752709	39753173	CpG: 40	464	40	298	17.2	64.2	0.84
chr1	39770363	39771986	CpG: 187	1623	187	1172	23.0	72.2	0.88
chr1	39782475	39783338	CpG: 69	863	69	595	16.0	68.9	0.67
chr1	39791904	39792191	CpG: 24	287	24	182	16.7	63.4	0.83
chr1	39824261	39825140	CpG: 80	879	80	616	18.2	70.1	0.76
chr1	39842553	39842788	CpG: 23	235	23	148	19.6	63.0	1.01
chr1	39868630	39869520	CpG: 69	890	69	624	15.5	70.1	0.63
chr1	39909059	39910351	CpG: 104	1292	104	858	16.1	66.4	0.73
chr1	39966453	39966915	CpG: 48	462	48	311	20.8	67.3	0.93
chr1	40000995	40001392	CpG: 30	397	30	238	15.1	59.9	0.87
chr1	40002299	40003000	CpG: 53	701	53	435	15.1	62.1	0.79
chr1	40030703	40031402	CpG: 65	699	65	484	18.6	69.2	0.80
chr1	40038795	40039080	CpG: 24	285	24	182	16.8	63.9	0.84
chr1	40127191	40127503	CpG: 22	312	22	199	14.1	63.8	0.69
chr1	40127601	40127815	CpG: 24	214	24	144	22.4	67.3	1.11
chr1	40173020	40173705	CpG: 60	685	60	498	17.5	72.7	0.66
chr1	40184840	40186980	CpG: 174	2140	174	1432	16.3	66.9	0.73
chr1	40243082	40243889	CpG: 69	807	69	574	17.1	71.1	0.69
chr1	40257576	40257797	CpG: 17	221	17	160	15.4	72.4	0.60
chr1	40258396	40258608	CpG: 17	212	17	122	16.0	57.5	1.01
chr1	40319493	40319960	CpG: 53	467	53	340	22.7	72.8	0.88
chr1	40346725	40347328	CpG: 67	603	67	450	22.2	74.6	0.81
chr1	40363885	40364159	CpG: 24	274	24	171	17.5	62.4	0.91
chr1	40377564	40378295	CpG: 69	731	69	487	18.9	66.6	0.86
chr1	40400656	40400935	CpG: 24	279	24	171	17.2	61.3	0.92
chr1	40428087	40428402	CpG: 32	315	32	241	20.3	76.5	0.69
chr1	40523240	40523646	CpG: 32	406	32	284	15.8	70.0	0.71
chr1	40534625	40535002	CpG: 47	377	47	296	24.9	78.5	0.83
chr1	40560684	40561497	CpG: 89	813	89	561	21.9	69.0	0.92
chr1	40607133	40607407	CpG: 21	274	21	168	15.3	61.3	0.82
chr1	40652640	40653712	CpG: 149	1072	149	834	27.8	77.8	0.94
chr1	40671481	40671960	CpG: 51	479	51	351	21.3	73.3	0.79
chr1	40687403	40688154	CpG: 70	751	70	515	18.6	68.6	0.80
chr1	40688410	40688712	CpG: 24	302	24	198	15.9	65.6	0.74
chr1	40706923	40708004	CpG: 76	1081	76	718	14.1	66.4	0.65
chr1	40730517	40731852	CpG: 167	1335	167	997	25.0	74.7	0.90
chr1	40732501	40732777	CpG: 23	276	23	168	16.7	60.9	0.91
chr1	40753276	40753858	CpG: 69	582	69	424	23.7	72.9	0.91
chr1	40827059	40827273	CpG: 18	214	18	128	16.8	59.8	0.97
chr1	40848488	40849946	CpG: 172	1458	172	1048	23.6	71.9	0.91
chr1	40887110	40887385	CpG: 25	275	25	184	18.2	66.9	0.81
chr1	40888263	40888484	CpG: 15	221	15	129	13.6	58.4	0.81
chr1	41110714	41112098	CpG: 173	1384	173	1068	25.0	77.2	0.84
chr1	41124268	41124547	CpG: 23	279	23	170	16.5	60.9	0.90
chr1	41230418	41232028	CpG: 190	1610	190	1209	23.6	75.1	0.84
chr1	41235714	41236280	CpG: 55	566	55	407	19.4	71.9	0.76
chr1	41251023	41253174	CpG: 237	2151	237	1557	22.0	72.4	0.85
chr1	41293270	41293626	CpG: 27	356	27	250	15.2	70.2	0.62
chr1	41354758	41355017	CpG: 19	259	19	180	14.7	69.5	0.61
chr1	41366393	41366859	CpG: 59	466	59	352	25.3	75.5	0.89
chr1	41386470	41386978	CpG: 41	508	41	352	16.1	69.3	0.72
chr1	41532237	41533489	CpG: 164	1252	164	954	26.2	76.2	0.90
chr1	41788537	41788900	CpG: 46	363	46	262	25.3	72.2	0.98
chr1	41905752	41906877	CpG: 123	1125	123	822	21.9	73.1	0.82
chr1	42016451	42016657	CpG: 22	206	22	150	21.4	72.8	0.81
chr1	42086883	42087157	CpG: 24	274	24	171	17.5	62.4	0.91
chr1	42122388	42122627	CpG: 20	239	20	146	16.7	61.1	0.92
chr1	42204998	42206121	CpG: 121	1123	121	820	21.5	73.0	0.81
chr1	42224928	42225165	CpG: 19	237	19	142	16.0	59.9	0.91
chr1	42249701	42249934	CpG: 17	233	17	138	14.6	59.2	0.84
chr1	42250690	42251700	CpG: 135	1010	135	759	26.7	75.1	0.96
chr1	42325694	42325932	CpG: 20	238	20	145	16.8	60.9	0.92
chr1	42326407	42327266	CpG: 81	859	81	549	18.9	63.9	0.92
chr1	42333487	42334190	CpG: 56	703	56	412	15.9	58.6	0.93
chr1	42370703	42370933	CpG: 18	230	18	137	15.7	59.6	0.88
chr1	42413051	42413335	CpG: 24	284	24	175	16.9	61.6	0.91
chr1	42478963	42479201	CpG: 24	238	24	149	20.2	62.6	1.04
chr1	42483773	42484047	CpG: 19	274	19	164	13.9	59.9	0.78
chr1	42528801	42529246	CpG: 38	445	38	285	17.1	64.0	0.84
chr1	42552324	42553840	CpG: 182	1516	182	1064	24.0	70.2	0.98
chr1	42608934	42609142	CpG: 15	208	15	138	14.4	66.3	0.67
chr1	42637033	42638178	CpG: 123	1145	123	814	21.5	71.1	0.85
chr1	42655581	42655901	CpG: 35	320	35	232	21.9	72.5	0.84
chr1	42657811	42658092	CpG: 22	281	22	174	15.7	61.9	0.84
chr1	42669293	42669529	CpG: 21	236	21	147	17.8	62.3	0.94
chr1	42687370	42687957	CpG: 66	587	66	447	22.5	76.1	0.78
chr1	42716814	42717324	CpG: 41	510	41	317	16.1	62.2	0.83
chr1	42758050	42758251	CpG: 15	201	15	140	14.9	69.7	0.63
chr1	42758756	42758979	CpG: 17	223	17	149	15.2	66.8	0.69
chr1	42794632	42795348	CpG: 67	716	67	481	18.7	67.2	0.83
chr1	42828266	42829737	CpG: 166	1471	166	1080	22.6	73.4	0.84
chr1	42877334	42878351	CpG: 77	1017	77	666	15.1	65.5	0.72
chr1	42938702	42939191	CpG: 52	489	52	363	21.3	74.2	0.78
chr1	42990644	42991018	CpG: 30	374	30	223	16.0	59.6	0.91
chr1	43018227	43018661	CpG: 38	434	38	289	17.5	66.6	0.82
chr1	43042328	43042877	CpG: 46	549	46	343	16.8	62.5	0.89
chr1	43056846	43057057	CpG: 16	211	16	125	15.2	59.2	0.88
chr1	43143320	43143665	CpG: 30	345	30	243	17.4	70.4	0.70
chr1	43175348	43175706	CpG: 43	358	43	260	24.0	72.6	0.91
chr1	43219181	43220153	CpG: 87	972	87	664	17.9	68.3	0.77
chr1	43228212	43228442	CpG: 18	230	18	133	15.7	57.8	0.96
chr1	43229011	43229936	CpG: 79	925	79	617	17.1	66.7	0.77
chr1	43237691	43237950	CpG: 27	259	27	189	20.8	73.0	0.81
chr1	43238393	43239014	CpG: 59	621	59	467	19.0	75.2	0.68
chr1	43260254	43260800	CpG: 49	546	49	360	17.9	65.9	0.83
chr1	43323665	43324396	CpG: 87	731	87	530	23.8	72.5	0.91
chr1	43371674	43372666	CpG: 77	992	77	706	15.5	71.2	0.61
chr1	43400955	43402165	CpG: 161	1210	161	941	26.6	77.8	0.89
chr1	43435860	43436436	CpG: 60	576	60	419	20.8	72.7	0.81
chr1	43461316	43461740	CpG: 44	424	44	298	20.8	70.3	0.84
chr1	43468315	43468603	CpG: 30	288	30	205	20.8	71.2	0.85
chr1	43475738	43475988	CpG: 17	250	17	160	13.6	64.0	0.67
chr1	43519801	43520042	CpG: 19	241	19	146	15.8	60.6	0.87
chr1	43520454	43521147	CpG: 49	693	49	433	14.1	62.5	0.77
chr1	43577489	43578584	CpG: 129	1095	129	780	23.6	71.2	0.93
chr1	43613747	43614018	CpG: 24	271	24	171	17.7	63.1	0.90
chr1	43642187	43642451	CpG: 19	264	19	159	14.4	60.2	0.80
chr1	43649457	43649733	CpG: 20	276	20	167	14.5	60.5	0.81
chr1	43804473	43804940	CpG: 35	467	35	328	15.0	70.2	0.62
chr1	43807162	43807828	CpG: 87	666	87	522	26.1	78.4	0.86
chr1	43817482	43818213	CpG: 77	731	77	524	21.1	71.7	0.82
chr1	43840817	43841522	CpG: 48	705	48	442	13.6	62.7	0.70
chr1	43845550	43846664	CpG: 120	1114	120	776	21.5	69.7	0.89
chr1	43850043	43851030	CpG: 132	987	132	780	26.7	79.0	0.86
chr1	43862565	43863188	CpG: 61	623	61	446	19.6	71.6	0.78
chr1	43901054	43902531	CpG: 162	1477	162	1069	21.9	72.4	0.84
chr1	44036622	44036860	CpG: 20	238	20	144	16.8	60.5	0.94
chr1	44051241	44051476	CpG: 18	235	18	142	15.3	60.4	0.85
chr1	44084221	44084683	CpG: 36	462	36	299	15.6	64.7	0.74
chr1	44225904	44226360	CpG: 56	456	56	338	24.6	74.1	0.91
chr1	44276267	44279301	CpG: 261	3034	261	1987	17.2	65.5	0.80
chr1	44288392	44289526	CpG: 110	1134	110	770	19.4	67.9	0.84
chr1	44423520	44423755	CpG: 19	235	19	146	16.2	62.1	0.86
chr1	44480934	44481218	CpG: 20	284	20	175	14.1	61.6	0.75
chr1	44488006	44488552	CpG: 60	546	60	362	22.0	66.3	1.01
chr1	44502535	44503441	CpG: 93	906	93	639	20.5	70.5	0.83
chr1	44525504	44525990	CpG: 35	486	35	307	14.4	63.2	0.73
chr1	44545044	44545858	CpG: 58	814	58	527	14.3	64.7	0.68
chr1	44594976	44595829	CpG: 79	853	79	591	18.5	69.3	0.77
chr1	44609167	44609727	CpG: 48	560	48	383	17.1	68.4	0.73
chr1	44610632	44611056	CpG: 44	424	44	258	20.8	60.8	1.14
chr1	44646269	44647217	CpG: 87	948	87	623	18.4	65.7	0.85
chr1	44655174	44655666	CpG: 60	492	60	372	24.4	75.6	0.87
chr1	44657276	44657606	CpG: 38	330	38	239	23.0	72.4	0.88
chr1	44671016	44672265	CpG: 127	1249	127	874	20.3	70.0	0.83
chr1	44677161	44677800	CpG: 71	639	71	468	22.2	73.2	0.83
chr1	44684227	44685106	CpG: 84	879	84	625	19.1	71.1	0.76
chr1	44685445	44685789	CpG: 27	344	27	195	15.7	56.7	0.98
chr1	44714104	44714720	CpG: 67	616	67	458	21.8	74.4	0.81
chr1	44747157	44748311	CpG: 92	1154	92	841	15.9	72.9	0.60
chr1	44809236	44809507	CpG: 24	271	24	171	17.7	63.1	0.90
chr1	44857952	44858931	CpG: 69	979	69	585	14.1	59.8	0.79
chr1	44882147	44882944	CpG: 78	797	78	565	19.6	70.9	0.78
chr1	44986807	44987564	CpG: 62	757	62	535	16.4	70.7	0.66
chr1	45053695	45053957	CpG: 24	262	24	164	18.3	62.6	0.94
chr1	45062529	45062794	CpG: 25	265	25	168	18.9	63.4	0.98
chr1	45077227	45078415	CpG: 164	1188	164	891	27.6	75.0	0.98
chr1	45119131	45119871	CpG: 57	740	57	502	15.4	67.8	0.67
chr1	45174814	45175792	CpG: 84	978	84	639	17.2	65.3	0.82
chr1	45198303	45199185	CpG: 95	882	95	617	21.5	70.0	0.88
chr1	45211456	45211868	CpG: 55	412	55	287	26.7	69.7	1.10
chr1	45356802	45357071	CpG: 21	269	21	163	15.6	60.6	0.86
chr1	45362257	45362805	CpG: 51	548	51	387	18.6	70.6	0.76
chr1	45372281	45372744	CpG: 33	463	33	258	14.3	55.7	0.92
chr1	45393859	45394499	CpG: 64	640	64	437	20.0	68.3	0.86
chr1	45411099	45411373	CpG: 21	274	21	166	15.3	60.6	0.84
chr1	45423097	45423388	CpG: 27	291	27	193	18.6	66.3	0.85
chr1	45449979	45450253	CpG: 23	274	23	169	16.8	61.7	0.89
chr1	45456284	45457272	CpG: 84	988	84	647	17.0	65.5	0.80
chr1	45494877	45495825	CpG: 85	948	85	640	17.9	67.5	0.80
chr1	45558425	45559754	CpG: 116	1329	116	843	17.5	63.4	0.88
chr1	45626731	45627072	CpG: 28	341	28	217	16.4	63.6	0.82
chr1	45627750	45628031	CpG: 39	281	39	206	27.8	73.3	1.04
chr1	45680625	45681346	CpG: 105	721	105	555	29.1	77.0	1.02
chr1	45777687	45777972	CpG: 26	285	26	180	18.2	63.2	0.93
chr1	45792620	45792860	CpG: 19	240	19	144	15.8	60.0	0.91
chr1	45979256	45979529	CpG: 21	273	21	170	15.4	62.3	0.80
chr1	46009697	46010700	CpG: 84	1003	84	655	16.7	65.3	0.79
chr1	46024664	46024892	CpG: 17	228	17	132	14.9	57.9	0.90
chr1	46043025	46043264	CpG: 18	239	18	142	15.1	59.4	0.87
chr1	46044211	46044454	CpG: 27	243	27	163	22.2	67.1	1.00
chr1	46075481	46075899	CpG: 58	418	58	327	27.8	78.2	0.91
chr1	46080367	46080804	CpG: 41	437	41	301	18.8	68.9	0.79
chr1	46117453	46119595	CpG: 197	2142	197	1671	18.4	78.0	0.60
chr1	46123201	46123474	CpG: 22	273	22	164	16.1	60.1	0.90
chr1	46124461	46124991	CpG: 51	530	51	359	19.2	67.7	0.93
chr1	46178975	46180586	CpG: 157	1611	157	1170	19.5	72.6	0.79
chr1	46181636	46181902	CpG: 18	266	18	166	13.5	62.4	0.70
chr1	46182652	46182967	CpG: 25	315	25	199	15.9	63.2	0.82
chr1	46214243	46214472	CpG: 20	229	20	144	17.5	62.9	0.89
chr1	46217308	46217587	CpG: 22	279	22	175	15.8	62.7	0.80
chr1	46217885	46218382	CpG: 47	497	47	299	18.9	60.2	1.05
chr1	46233634	46233867	CpG: 16	233	16	139	13.7	59.7	0.79
chr1	46271265	46271832	CpG: 71	567	71	418	25.0	73.7	0.93
chr1	46283856	46284119	CpG: 22	263	22	158	16.7	60.1	0.94
chr1	46325330	46325887	CpG: 69	557	69	394	24.8	70.7	0.99
chr1	46343585	46344429	CpG: 98	844	98	584	23.2	69.2	0.97
chr1	46351773	46351974	CpG: 15	201	15	125	14.9	62.2	0.81
chr1	46362727	46363351	CpG: 59	624	59	442	18.9	70.8	0.76
chr1	46366348	46368676	CpG: 192	2328	192	1513	16.5	65.0	0.79
chr1	46410176	46410793	CpG: 93	617	93	485	30.1	78.6	0.98
chr1	46421135	46421692	CpG: 47	557	47	385	16.9	69.1	0.72
chr1	46465760	46466035	CpG: 23	275	23	171	16.7	62.2	0.88
chr1	46481176	46481740	CpG: 52	564	52	384	18.4	68.1	0.80
chr1	46490134	46490521	CpG: 40	387	40	248	20.7	64.1	1.01
chr1	46493570	46494131	CpG: 55	561	55	401	19.6	71.5	0.80
chr1	46545242	46545963	CpG: 91	721	91	540	25.2	74.9	0.92
chr1	46595967	46596648	CpG: 80	681	80	494	23.5	72.5	0.89
chr1	46651170	46651451	CpG: 24	281	24	175	17.1	62.3	0.90
chr1	46900957	46901364	CpG: 40	407	40	280	19.7	68.8	0.83
chr1	47103715	47104462	CpG: 89	747	89	559	23.8	74.8	0.85
chr1	47109239	47110932	CpG: 149	1693	149	1072	17.6	63.3	0.89
chr1	47192477	47192981	CpG: 51	504	51	316	20.2	62.7	1.04
chr1	47193202	47193629	CpG: 33	427	33	249	15.5	58.3	0.93
chr1	47212181	47213196	CpG: 125	1015	125	722	24.6	71.1	0.97
chr1	47258911	47259185	CpG: 24	274	24	169	17.5	61.7	0.93
chr1	47294683	47295852	CpG: 170	1169	170	900	29.1	77.0	0.99
chr1	47311905	47312178	CpG: 20	273	20	166	14.7	60.8	0.80
chr1	47312441	47313165	CpG: 54	724	54	419	14.9	57.9	0.89
chr1	47315627	47318319	CpG: 328	2692	328	1997	24.4	74.2	0.89
chr1	47322500	47323808	CpG: 109	1308	109	765	16.7	58.5	0.98
chr1	47328424	47328737	CpG: 25	313	25	208	16.0	66.5	0.73
chr1	47386495	47387138	CpG: 72	643	72	446	22.4	69.4	0.93
chr1	47411691	47412309	CpG: 54	618	54	406	17.5	65.7	0.88
chr1	47471547	47472061	CpG: 48	514	48	350	18.7	68.1	0.81
chr1	47492884	47493158	CpG: 24	274	24	171	17.5	62.4	0.91
chr1	47587390	47589415	CpG: 165	2025	165	1318	16.3	65.1	0.77
chr1	47603652	47603945	CpG: 41	293	41	214	28.0	73.0	1.05
chr1	47753164	47753452	CpG: 25	288	25	180	17.4	62.5	0.90
chr1	47863076	47863350	CpG: 36	274	36	200	26.3	73.0	0.99
chr1	47873005	47873254	CpG: 19	249	19	153	15.3	61.4	0.81
chr1	47875322	47876792	CpG: 170	1470	170	1125	23.1	76.5	0.80
chr1	48011441	48011700	CpG: 18	259	18	158	13.9	61.0	0.75
chr1	48350302	48351069	CpG: 73	767	73	528	19.0	68.8	0.86
chr1	48357533	48358450	CpG: 71	917	71	635	15.5	69.2	0.65
chr1	48655270	48655889	CpG: 69	619	69	451	22.3	72.9	0.84
chr1	48777624	48777983	CpG: 35	359	35	253	19.5	70.5	0.79
chr1	49136034	49136235	CpG: 15	201	15	122	14.9	60.7	0.81
chr1	49228926	49229200	CpG: 24	274	24	171	17.5	62.4	0.91
chr1	49501018	49501292	CpG: 23	274	23	170	16.8	62.0	0.88
chr1	49707473	49707679	CpG: 16	206	16	120	15.5	58.3	0.93
chr1	49858144	49858425	CpG: 23	281	23	174	16.4	61.9	0.87
chr1	49881341	49881615	CpG: 25	274	25	173	18.2	63.1	0.93
chr1	49890829	49891114	CpG: 23	285	23	175	16.1	61.4	0.87
chr1	49902698	49903127	CpG: 46	429	46	310	21.4	72.3	0.82
chr1	49926925	49927601	CpG: 71	676	71	487	21.0	72.0	0.81
chr1	50211935	50212814	CpG: 91	879	91	631	20.7	71.8	0.81
chr1	50260625	50261573	CpG: 75	948	75	674	15.8	71.1	0.63
chr1	50294851	50297361	CpG: 153	2510	153	1519	12.2	60.5	0.67
chr1	50298174	50305405	CpG: 511	7231	511	4389	14.1	60.7	0.77
chr1	50306371	50307679	CpG: 89	1308	89	785	13.6	60.0	0.76
chr1	50443967	50444197	CpG: 21	230	21	142	18.3	61.7	0.97
chr1	50832133	50832826	CpG: 53	693	53	458	15.3	66.1	0.70
chr1	50839657	50840277	CpG: 90	620	90	458	29.0	73.9	1.06
chr1	50847968	50849714	CpG: 163	1746	163	1159	18.7	66.4	0.85
chr1	50857520	50858245	CpG: 85	725	85	553	23.4	76.3	0.81
chr1	51080305	51080571	CpG: 22	266	22	164	16.5	61.7	0.88
chr1	51116003	51116778	CpG: 89	775	89	564	23.0	72.8	0.87
chr1	51176954	51177225	CpG: 18	271	18	168	13.3	62.0	0.70
chr1	51210121	51210816	CpG: 93	695	93	553	26.8	79.6	0.85
chr1	51224554	51225077	CpG: 58	523	58	389	22.2	74.4	0.81
chr1	51398617	51399456	CpG: 105	839	105	637	25.0	75.9	0.87
chr1	51472052	51472331	CpG: 19	279	19	168	13.6	60.2	0.76
chr1	51486691	51486929	CpG: 19	238	19	144	16.0	60.5	0.90
chr1	51496826	51497300	CpG: 35	474	35	294	14.8	62.0	0.77
chr1	51609677	51610440	CpG: 67	763	67	552	17.6	72.3	0.67
chr1	51727751	51728273	CpG: 41	522	41	377	15.7	72.2	0.60
chr1	51759389	51760150	CpG: 63	761	63	449	16.6	59.0	0.96
chr1	51800147	51800428	CpG: 24	281	24	175	17.1	62.3	0.90
chr1	51864950	51865231	CpG: 24	281	24	177	17.1	63.0	0.87
chr1	51871619	51872295	CpG: 75	676	75	514	22.2	76.0	0.82
chr1	51886278	51886514	CpG: 17	236	17	140	14.4	59.3	0.84
chr1	51900946	51901177	CpG: 21	231	21	135	18.2	58.4	1.10
chr1	51914293	51915346	CpG: 101	1053	101	671	19.2	63.7	0.95
chr1	51936582	51936957	CpG: 33	375	33	227	17.6	60.5	1.01
chr1	51937613	51938129	CpG: 54	516	54	367	20.9	71.1	0.83
chr1	51976942	51977198	CpG: 22	256	22	148	17.2	57.8	1.04
chr1	52023233	52024337	CpG: 139	1104	139	815	25.2	73.8	0.93
chr1	52062726	52063702	CpG: 80	976	80	694	16.4	71.1	0.65
chr1	52244584	52244855	CpG: 20	271	20	167	14.8	61.6	0.79
chr1	52247193	52247974	CpG: 95	781	95	578	24.3	74.0	0.89
chr1	52249932	52250321	CpG: 45	389	45	279	23.1	71.7	0.90
chr1	52285664	52286102	CpG: 40	438	40	269	18.3	61.4	1.00
chr1	52434054	52435395	CpG: 127	1341	127	966	18.9	72.0	0.74
chr1	52483679	52484407	CpG: 95	728	95	537	26.1	73.8	0.96
chr1	52514479	52515153	CpG: 90	674	90	510	26.7	75.7	0.94
chr1	52579135	52580049	CpG: 79	914	79	584	17.3	63.9	0.87
chr1	52602477	52602944	CpG: 36	467	36	277	15.4	59.3	0.89
chr1	52607869	52608266	CpG: 50	397	50	306	25.2	77.1	0.85
chr1	52624077	52624616	CpG: 42	539	42	339	15.6	62.9	0.79
chr1	52697236	52697467	CpG: 16	231	16	137	13.9	59.3	0.80
chr1	52721257	52721493	CpG: 21	236	21	145	17.8	61.4	0.96
chr1	52724123	52725102	CpG: 121	979	121	702	24.7	71.7	0.97
chr1	52725262	52725509	CpG: 18	247	18	148	14.6	59.9	0.82
chr1	52802461	52803367	CpG: 82	906	82	623	18.1	68.8	0.77
chr1	52808719	52809545	CpG: 70	826	70	553	16.9	66.9	0.76
chr1	52852587	52852813	CpG: 18	226	18	133	15.9	58.8	0.94
chr1	52943402	52944804	CpG: 121	1402	121	995	17.3	71.0	0.70
chr1	52959934	52960513	CpG: 43	579	43	382	14.9	66.0	0.69
chr1	52974031	52974366	CpG: 23	335	23	217	13.7	64.8	0.66
chr1	53078079	53078585	CpG: 53	506	53	374	20.9	73.9	0.77
chr1	53101660	53102155	CpG: 51	495	51	357	20.6	72.1	0.81
chr1	53118839	53119079	CpG: 18	240	18	141	15.0	58.8	0.88
chr1	53119750	53120433	CpG: 60	683	60	432	17.6	63.3	0.89
chr1	53158098	53158646	CpG: 83	548	83	411	30.3	75.0	1.08
chr1	53165421	53166352	CpG: 68	931	68	502	14.6	53.9	1.27
chr1	53208225	53210486	CpG: 235	2261	235	1599	20.8	70.7	0.84
chr1	53320705	53321923	CpG: 119	1218	119	836	19.5	68.6	0.84
chr1	53341761	53342798	CpG: 97	1037	97	691	18.7	66.6	0.84
chr1	53620581	53622480	CpG: 229	1899	229	1379	24.1	72.6	0.92
chr1	53688646	53688920	CpG: 24	274	24	170	17.5	62.0	0.92
chr1	53720936	53721440	CpG: 54	504	54	354	21.4	70.2	0.88
chr1	53750312	53750540	CpG: 18	228	18	139	15.8	61.0	0.87
chr1	53772316	53772865	CpG: 50	549	50	361	18.2	65.8	0.84
chr1	53828292	53829578	CpG: 147	1286	147	974	22.9	75.7	0.85
chr1	53887076	53887661	CpG: 45	585	45	413	15.4	70.6	0.62
chr1	53908812	53909093	CpG: 23	281	23	175	16.4	62.3	0.86
chr1	53935831	53936529	CpG: 55	698	55	450	15.8	64.5	0.76
chr1	54004594	54004944	CpG: 25	350	25	235	14.3	67.1	0.64
chr1	54083022	54083520	CpG: 47	498	47	333	18.9	66.9	0.84
chr1	54140851	54141174	CpG: 27	323	27	205	16.7	63.5	0.90
chr1	54199135	54199482	CpG: 28	347	28	208	16.1	59.9	0.90
chr1	54239148	54239491	CpG: 24	343	24	218	14.0	63.6	0.70
chr1	54273592	54273799	CpG: 21	207	21	141	20.3	68.1	0.88
chr1	54288046	54290192	CpG: 257	2146	257	1590	24.0	74.1	0.89
chr1	54323495	54323780	CpG: 23	285	23	177	16.1	62.1	0.85
chr1	54357787	54358194	CpG: 45	407	45	323	22.1	79.4	0.72
chr1	54371336	54372731	CpG: 112	1395	112	910	16.1	65.2	0.76
chr1	54382480	54382848	CpG: 37	368	37	260	20.1	70.7	0.82
chr1	54425364	54426108	CpG: 70	744	70	544	18.8	73.1	0.70
chr1	54595926	54596434	CpG: 45	508	45	339	17.7	66.7	0.80
chr1	54644454	54644921	CpG: 48	467	48	305	20.6	65.3	0.98
chr1	54661292	54662069	CpG: 88	777	88	560	22.7	72.1	0.88
chr1	54680825	54681701	CpG: 86	876	86	605	19.6	69.1	0.82
chr1	54686210	54686517	CpG: 34	307	34	226	22.1	73.6	0.82
chr1	54702216	54702490	CpG: 23	274	23	169	16.8	61.7	0.89
chr1	54766968	54767833	CpG: 107	865	107	621	24.7	71.8	0.96
chr1	54860634	54861407	CpG: 81	773	81	574	21.0	74.3	0.76
chr1	54877250	54877572	CpG: 33	322	33	234	20.5	72.7	0.79
chr1	54920292	54921247	CpG: 90	955	90	652	18.8	68.3	0.82
chr1	54936963	54937368	CpG: 37	405	37	285	18.3	70.4	0.74
chr1	54996113	54996365	CpG: 20	252	20	155	15.9	61.5	0.85
chr1	54998331	54998620	CpG: 25	289	25	181	17.3	62.6	0.90
chr1	55095635	55096878	CpG: 151	1243	151	902	24.3	72.6	0.93
chr1	55122541	55122819	CpG: 26	278	26	175	18.7	62.9	0.95
chr1	55690976	55691207	CpG: 17	231	17	137	14.7	59.3	0.84
chr1	55972792	55973043	CpG: 21	251	21	149	16.7	59.4	0.95
chr1	56049803	56050037	CpG: 20	234	20	146	17.1	62.4	0.89
chr1	56356379	56356821	CpG: 47	442	47	304	21.3	68.8	0.91
chr1	56457307	56458322	CpG: 105	1015	105	684	20.7	67.4	0.91
chr1	56523858	56524783	CpG: 116	925	116	688	25.1	74.4	0.91
chr1	57086396	57086663	CpG: 21	267	21	164	15.7	61.4	0.84
chr1	57301073	57303747	CpG: 233	2674	233	1759	17.4	65.8	0.80
chr1	57358630	57358903	CpG: 24	273	24	168	17.6	61.5	0.94
chr1	57447751	57448028	CpG: 24	277	24	177	17.3	63.9	0.86
chr1	57756433	57756722	CpG: 24	289	24	177	16.6	61.2	0.90
chr1	57943639	57943864	CpG: 20	225	20	136	17.8	60.4	1.01
chr1	57964847	57965121	CpG: 23	274	23	170	16.8	62.0	0.88
chr1	58010955	58011282	CpG: 25	327	25	192	15.3	58.7	0.89
chr1	58128435	58129258	CpG: 87	823	87	575	21.1	69.9	0.87
chr1	58153477	58153836	CpG: 29	359	29	212	16.2	59.1	0.93
chr1	58256697	58257124	CpG: 34	427	34	259	15.9	60.7	0.87
chr1	58274722	58274999	CpG: 20	277	20	167	14.4	60.3	0.80
chr1	58351201	58351429	CpG: 18	228	18	139	15.8	61.0	0.87
chr1	58424225	58424881	CpG: 67	656	67	468	20.4	71.3	0.82
chr1	58454049	58455587	CpG: 171	1538	171	1037	22.2	67.4	0.98
chr1	58471961	58472235	CpG: 24	274	24	171	17.5	62.4	0.91
chr1	58501362	58501796	CpG: 38	434	38	317	17.5	73.0	0.66
chr1	58502539	58502751	CpG: 16	212	16	119	15.1	56.1	0.98
chr1	58577601	58577807	CpG: 15	206	15	115	14.6	55.8	0.94
chr1	58638679	58638957	CpG: 24	278	24	175	17.3	62.9	0.88
chr1	58660234	58663713	CpG: 301	3479	301	2230	17.3	64.1	0.84
chr1	58693013	58693967	CpG: 69	954	69	589	14.5	61.7	0.76
chr1	58694662	58695008	CpG: 40	346	40	236	23.1	68.2	1.00
chr1	58766960	58767196	CpG: 20	236	20	144	16.9	61.0	0.93
chr1	58782079	58782671	CpG: 66	592	66	436	22.3	73.6	0.82
chr1	59025098	59025414	CpG: 39	316	39	230	24.7	72.8	0.97
chr1	59167215	59167496	CpG: 23	281	23	173	16.4	61.6	0.88
chr1	59174802	59175494	CpG: 70	692	70	472	20.2	68.2	0.87
chr1	59202670	59202944	CpG: 24	274	24	171	17.5	62.4	0.91
chr1	59247457	59247749	CpG: 23	292	23	175	15.8	59.9	0.88
chr1	59350365	59350861	CpG: 43	496	43	359	17.3	72.4	0.66
chr1	59351607	59351822	CpG: 18	215	18	122	16.7	56.7	1.07
chr1	59395743	59395973	CpG: 19	230	19	140	16.5	60.9	0.90
chr1	59531847	59532062	CpG: 17	215	17	125	15.8	58.1	0.94
chr1	59692858	59693818	CpG: 96	960	96	688	20.0	71.7	0.78
chr1	59805054	59805365	CpG: 30	311	30	217	19.3	69.8	0.80
chr1	59848102	59848493	CpG: 40	391	40	290	20.5	74.2	0.74
chr1	59952210	59952435	CpG: 23	225	23	158	20.4	70.2	0.83
chr1	60168057	60168345	CpG: 24	288	24	178	16.7	61.8	0.89
chr1	60283806	60284085	CpG: 25	279	25	175	17.9	62.7	0.92
chr1	60369079	60369374	CpG: 21	295	21	180	14.2	61.0	0.77
chr1	60482875	60483149	CpG: 23	274	23	169	16.8	61.7	0.89
chr1	60518977	60519218	CpG: 23	241	23	145	19.1	60.2	1.06
chr1	60921745	60922509	CpG: 86	764	86	538	22.5	70.4	0.91
chr1	60928980	60929936	CpG: 113	956	113	716	23.6	74.9	0.84
chr1	60932457	60933076	CpG: 50	619	50	393	16.2	63.5	0.80
chr1	60935732	60936118	CpG: 40	386	40	225	20.7	58.3	1.22
chr1	60936421	60936691	CpG: 21	270	21	168	15.6	62.2	0.81
chr1	60955649	60956204	CpG: 42	555	42	332	15.1	59.8	0.86
chr1	60960747	60962684	CpG: 220	1937	220	1346	22.7	69.5	0.94
chr1	61034189	61034470	CpG: 21	281	21	173	14.9	61.6	0.81
chr1	61098251	61098511	CpG: 21	260	21	144	16.2	55.4	1.07
chr1	61446521	61446795	CpG: 24	274	24	171	17.5	62.4	0.91
chr1	61533090	61533309	CpG: 25	219	25	154	22.8	70.3	0.92
chr1	61592777	61593058	CpG: 24	281	24	175	17.1	62.3	0.90
chr1	61603844	61604139	CpG: 27	295	27	192	18.3	65.1	0.87
chr1	61621017	61622008	CpG: 110	991	110	751	22.2	75.8	0.78
chr1	61747964	61748194	CpG: 20	230	20	141	17.4	61.3	0.94
chr1	61779470	61779740	CpG: 20	270	20	165	14.8	61.1	0.80
chr1	62068160	62068434	CpG: 20	274	20	169	14.6	61.7	0.78
chr1	62070617	62070895	CpG: 23	278	23	170	16.5	61.2	0.90
chr1	62073487	62073878	CpG: 36	391	36	289	18.4	73.9	0.71
chr1	62074269	62074637	CpG: 28	368	28	221	15.2	60.1	0.86
chr1	62196961	62197958	CpG: 102	997	102	711	20.5	71.3	0.80
chr1	62198494	62198724	CpG: 18	230	18	139	15.7	60.4	0.87
chr1	62229687	62229928	CpG: 19	241	19	145	15.8	60.2	0.89
chr1	62239348	62239584	CpG: 19	236	19	146	16.1	61.9	0.87
chr1	62313729	62313963	CpG: 17	234	17	140	14.5	59.8	0.83
chr1	62314567	62316583	CpG: 201	2016	201	1270	19.9	63.0	1.01
chr1	62460817	62461091	CpG: 24	274	24	169	17.5	61.7	0.93
chr1	62548440	62548827	CpG: 33	387	33	283	17.1	73.1	0.64
chr1	62565914	62566883	CpG: 130	969	130	719	26.8	74.2	0.98
chr1	62639691	62639900	CpG: 17	209	17	150	16.3	71.8	0.63
chr1	62661116	62661697	CpG: 41	581	41	320	14.1	55.1	0.96
chr1	62671097	62671333	CpG: 20	236	20	142	16.9	60.2	0.95
chr1	62752146	62752420	CpG: 23	274	23	166	16.8	60.6	0.93
chr1	62874403	62874684	CpG: 23	281	23	175	16.4	62.3	0.86
chr1	62916714	62916941	CpG: 18	227	18	131	15.9	57.7	0.97
chr1	62923232	62923512	CpG: 23	280	23	174	16.4	62.1	0.87
chr1	62937245	62937526	CpG: 24	281	24	176	17.1	62.6	0.89
chr1	63192388	63200465	CpG: 615	8077	615	4879	15.2	60.4	0.84
chr1	63205357	63206134	CpG: 66	777	66	527	17.0	67.8	0.74
chr1	63243112	63243824	CpG: 73	712	73	501	20.5	70.4	0.83
chr1	63469060	63470036	CpG: 104	976	104	688	21.3	70.5	0.87
chr1	63649618	63651025	CpG: 165	1407	165	1029	23.5	73.1	0.88
chr1	64294159	64294452	CpG: 26	293	26	181	17.7	61.8	0.94
chr1	64309251	64309532	CpG: 24	281	24	174	17.1	61.9	0.91
chr1	64324035	64324304	CpG: 23	269	23	168	17.1	62.5	0.89
chr1	64347668	64349352	CpG: 167	1684	167	1184	19.8	70.3	0.81
chr1	64355438	64355719	CpG: 20	281	20	170	14.2	60.5	0.79
chr1	64370203	64370490	CpG: 24	287	24	175	16.7	61.0	0.92
chr1	64383633	64384026	CpG: 43	393	43	311	21.9	79.1	0.91
chr1	64589022	64589292	CpG: 21	270	21	164	15.6	60.7	0.86
chr1	64622608	64623564	CpG: 123	956	123	737	25.7	77.1	0.87
chr1	64637374	64637688	CpG: 26	314	26	186	16.6	59.2	0.96
chr1	64716864	64717106	CpG: 21	242	21	147	17.4	60.7	0.97
chr1	64835579	64835934	CpG: 25	355	25	207	14.1	58.3	0.84
chr1	64843768	64844927	CpG: 136	1159	136	823	23.5	71.0	0.95
chr1	64880592	64881159	CpG: 65	567	65	382	22.9	67.4	1.01
chr1	64892758	64892995	CpG: 19	237	19	145	16.0	61.2	0.89
chr1	64896745	64896998	CpG: 21	253	21	159	16.6	62.8	0.84
chr1	64944487	64946291	CpG: 200	1804	200	1232	22.2	68.3	0.97
chr1	64949607	64949904	CpG: 23	297	23	169	15.5	56.9	0.97
chr1	64959784	64960023	CpG: 20	239	20	149	16.7	62.3	0.88
chr1	64999555	64999823	CpG: 21	268	21	165	15.7	61.6	0.84
chr1	65006202	65006418	CpG: 16	216	16	128	14.8	59.3	0.85
chr1	65013533	65013799	CpG: 21	266	21	164	15.8	61.7	0.84
chr1	65025337	65027194	CpG: 200	1857	200	1346	21.5	72.5	0.83
chr1	65028955	65029172	CpG: 17	217	17	121	15.7	55.8	1.02
chr1	65119544	65119787	CpG: 20	243	20	146	16.5	60.1	0.93
chr1	65132290	65132908	CpG: 89	618	89	476	28.8	77.0	0.97
chr1	65143724	65144162	CpG: 52	438	52	303	23.7	69.2	0.99
chr1	65180546	65180827	CpG: 24	281	24	175	17.1	62.3	0.90
chr1	65187143	65188040	CpG: 87	897	87	603	19.4	67.2	0.88
chr1	65298150	65298998	CpG: 84	848	84	608	19.8	71.7	0.81
chr1	65403037	65403847	CpG: 93	810	93	602	23.0	74.3	0.84
chr1	65441925	65442149	CpG: 19	224	19	132	17.0	58.9	0.98
chr1	65491203	65491484	CpG: 23	281	23	172	16.4	61.2	0.89
chr1	65670232	65670710	CpG: 63	478	63	356	26.4	74.5	0.95
chr1	65675746	65676031	CpG: 26	285	26	179	18.2	62.8	0.94
chr1	65697006	65697252	CpG: 20	246	20	148	16.3	60.2	0.90
chr1	65798449	65798723	CpG: 22	274	22	169	16.1	61.7	0.85
chr1	65801573	65801851	CpG: 24	278	24	174	17.3	62.6	0.89
chr1	66006841	66007118	CpG: 24	277	24	171	17.3	61.7	0.92
chr1	66216190	66216465	CpG: 24	275	24	170	17.5	61.8	0.92
chr1	66358502	66358853	CpG: 24	351	24	207	13.7	59.0	0.79
chr1	66410630	66410962	CpG: 35	332	35	222	21.1	66.9	0.95
chr1	66478627	66478865	CpG: 19	238	19	140	16.0	58.8	0.96
chr1	66576284	66576558	CpG: 20	274	20	165	14.6	60.2	0.82
chr1	66629930	66630144	CpG: 23	214	23	156	21.5	72.9	0.83
chr1	66702706	66702989	CpG: 24	283	24	175	17.0	61.8	0.90
chr1	66735753	66735985	CpG: 17	232	17	138	14.7	59.5	0.83
chr1	66802313	66802954	CpG: 59	641	59	442	18.4	69.0	0.78
chr1	66807528	66808328	CpG: 82	800	82	573	20.5	71.6	0.81
chr1	66931055	66931970	CpG: 99	915	99	648	21.6	70.8	0.86
chr1	66961987	66962413	CpG: 33	426	33	256	15.5	60.1	0.86
chr1	67012219	67012544	CpG: 27	325	27	195	16.6	60.0	1.06
chr1	67185195	67185644	CpG: 62	449	62	343	27.6	76.4	0.95
chr1	67239844	67240125	CpG: 24	281	24	174	17.1	61.9	0.91
chr1	67307023	67308714	CpG: 139	1691	139	1060	16.4	62.7	0.84
chr1	67404393	67404631	CpG: 18	238	18	143	15.1	60.1	0.85
chr1	67562465	67564106	CpG: 156	1641	156	1140	19.0	69.5	0.79
chr1	67710133	67711213	CpG: 114	1080	114	791	21.1	73.2	0.81
chr1	67756337	67756573	CpG: 19	236	19	143	16.1	60.6	0.90
chr1	67922515	67922788	CpG: 20	273	20	166	14.7	60.8	0.81
chr1	67924421	67924783	CpG: 30	362	30	220	16.6	60.8	0.90
chr1	67928012	67928249	CpG: 21	237	21	147	17.7	62.0	0.93
chr1	67929030	67929250	CpG: 22	220	22	143	20.0	65.0	1.01
chr1	68040747	68040950	CpG: 22	203	22	147	21.7	72.4	0.84
chr1	68108348	68109365	CpG: 87	1017	87	639	17.1	62.8	0.87
chr1	68220696	68220939	CpG: 21	243	21	148	17.3	60.9	0.95
chr1	68373986	68374709	CpG: 71	723	71	475	19.6	65.7	0.91
chr1	68695239	68695627	CpG: 40	388	40	286	20.6	73.7	0.76
chr1	68789366	68789584	CpG: 18	218	18	134	16.5	61.5	0.89
chr1	68801009	68801369	CpG: 26	360	26	211	14.4	58.6	0.84
chr1	68841354	68841641	CpG: 22	287	22	177	15.3	61.7	0.82
chr1	68997675	68997909	CpG: 18	234	18	138	15.4	59.0	0.89
chr1	69089775	69090049	CpG: 23	274	23	166	16.8	60.6	0.93
chr1	69118728	69119014	CpG: 21	286	21	167	14.7	58.4	0.87
chr1	69143338	69143612	CpG: 25	274	25	172	18.2	62.8	0.93
chr1	69339324	69339598	CpG: 25	274	25	172	18.2	62.8	0.94
chr1	69353390	69353626	CpG: 19	236	19	141	16.1	59.7	0.92
chr1	69386302	69386535	CpG: 19	233	19	141	16.3	60.5	0.90
chr1	69393970	69394239	CpG: 21	269	21	166	15.6	61.7	0.82
chr1	69443920	69445458	CpG: 145	1538	145	1043	18.9	67.8	0.82
chr1	69502040	69502315	CpG: 24	275	24	169	17.5	61.5	0.93
chr1	69540708	69540995	CpG: 24	287	24	178	16.7	62.0	0.89
chr1	69765229	69765454	CpG: 16	225	16	129	14.2	57.3	0.87
chr1	69797522	69797749	CpG: 17	227	17	151	15.0	66.5	0.68
chr1	70004011	70004285	CpG: 23	274	23	170	16.8	62.0	0.88
chr1	70084016	70084275	CpG: 28	259	28	174	21.6	67.2	0.96
chr1	70099787	70100395	CpG: 66	608	66	403	21.7	66.3	0.99
chr1	70180968	70181242	CpG: 24	274	24	171	17.5	62.4	0.91
chr1	70187962	70188237	CpG: 20	275	20	160	14.5	58.2	0.89
chr1	70225317	70225558	CpG: 19	241	19	147	15.8	61.0	0.88
chr1	70232559	70233545	CpG: 84	986	84	635	17.0	64.4	0.82
chr1	70289446	70289915	CpG: 40	469	40	289	17.1	61.6	0.91
chr1	70462700	70462925	CpG: 17	225	17	132	15.1	58.7	0.89
chr1	70584330	70584803	CpG: 32	473	32	277	13.5	58.6	0.80
chr1	70587784	70588022	CpG: 17	238	17	138	14.3	58.0	0.86
chr1	70715421	70715650	CpG: 20	229	20	143	17.5	62.4	0.92
chr1	70874692	70874916	CpG: 18	224	18	138	16.1	61.6	0.85
chr1	70924003	70924236	CpG: 21	233	21	143	18.0	61.4	1.00
chr1	70924535	70926115	CpG: 142	1580	142	1057	18.0	66.9	0.81
chr1	70958810	70959107	CpG: 20	297	20	165	13.5	55.6	0.90
chr1	71065808	71066047	CpG: 18	239	18	145	15.1	60.7	0.84
chr1	71249082	71249322	CpG: 18	240	18	144	15.0	60.0	0.86
chr1	71308498	71308775	CpG: 21	277	21	169	15.2	61.0	0.86
chr1	71391603	71391895	CpG: 25	292	25	178	17.1	61.0	0.92
chr1	71480039	71480317	CpG: 25	278	25	175	18.0	62.9	0.92
chr1	71534239	71534459	CpG: 20	220	20	133	18.2	60.5	1.02
chr1	71627927	71628208	CpG: 23	281	23	172	16.4	61.2	0.89
chr1	71766389	71766783	CpG: 29	394	29	235	14.7	59.6	0.83
chr1	71795638	71795906	CpG: 22	268	22	166	16.4	61.9	0.87
chr1	71821449	71821724	CpG: 24	275	24	171	17.5	62.2	0.91
chr1	71904761	71905035	CpG: 23	274	23	169	16.8	61.7	0.89
chr1	72135965	72136231	CpG: 22	266	22	164	16.5	61.7	0.88
chr1	72161717	72162986	CpG: 99	1269	99	726	15.6	57.2	0.99
chr1	72279193	72279459	CpG: 23	266	23	160	17.3	60.2	0.96
chr1	72590271	72590528	CpG: 19	257	19	148	14.8	57.6	0.92
chr1	72732298	72732723	CpG: 33	425	33	252	15.5	59.3	0.89
chr1	73139971	73140261	CpG: 24	290	24	173	16.6	59.7	0.94
chr1	73144633	73144913	CpG: 23	280	23	176	16.4	62.9	0.84
chr1	73538463	73538704	CpG: 18	241	18	138	14.9	57.3	0.93
chr1	73995533	73995795	CpG: 20	262	20	157	15.3	59.9	0.87
chr1	74039694	74039903	CpG: 24	209	24	145	23.0	69.4	0.99
chr1	74096638	74096868	CpG: 20	230	20	141	17.4	61.3	0.94
chr1	74150513	74150778	CpG: 21	265	21	167	15.8	63.0	0.81
chr1	74341767	74342000	CpG: 19	233	19	140	16.3	60.1	0.92
chr1	74455760	74456003	CpG: 19	243	19	146	15.6	60.1	0.89
chr1	74523763	74524041	CpG: 24	278	24	170	17.3	61.2	0.93
chr1	74588993	74589264	CpG: 23	271	23	170	17.0	62.7	0.87
chr1	74966981	74967518	CpG: 40	537	40	345	14.9	64.2	0.72
chr1	74971974	74972323	CpG: 28	349	28	205	16.0	58.7	0.93
chr1	74972884	74973108	CpG: 19	224	19	150	17.0	67.0	0.76
chr1	74976839	74977580	CpG: 55	741	55	447	14.8	60.3	0.83
chr1	74978163	74979043	CpG: 88	880	88	638	20.0	72.5	0.78
chr1	75015252	75015481	CpG: 17	229	17	131	14.8	57.2	0.93
chr1	75149158	75149394	CpG: 20	236	20	143	16.9	60.6	0.95
chr1	75373680	75373946	CpG: 23	266	23	166	17.3	62.4	0.90
chr1	75451436	75451790	CpG: 34	354	34	242	19.2	68.4	0.88
chr1	75452348	75453335	CpG: 93	987	93	708	18.8	71.7	0.74
chr1	75560891	75561705	CpG: 75	814	75	554	18.4	68.1	0.80
chr1	75633513	75633880	CpG: 30	367	30	237	16.3	64.6	0.79
chr1	75797391	75797613	CpG: 19	222	19	136	17.1	61.3	0.93
chr1	75912416	75912922	CpG: 53	506	53	359	20.9	70.9	0.84
chr1	75949955	75951176	CpG: 95	1221	95	875	15.6	71.7	0.60
chr1	75976900	75977130	CpG: 18	230	18	138	15.7	60.0	0.88
chr1	76536642	76536915	CpG: 23	273	23	171	16.8	62.6	0.88
chr1	76705023	76706446	CpG: 113	1423	113	931	15.9	65.4	0.74
chr1	76840954	76841235	CpG: 24	281	24	174	17.1	61.9	0.91
chr1	76910842	76911111	CpG: 22	269	22	163	16.4	60.6	0.90
chr1	76974425	76974711	CpG: 27	286	27	182	18.9	63.6	0.94
chr1	77057475	77057731	CpG: 23	256	23	156	18.0	60.9	0.97
chr1	77108584	77108841	CpG: 19	257	19	155	14.8	60.3	0.83
chr1	77119804	77120714	CpG: 103	910	103	652	22.6	71.6	0.88
chr1	77370628	77371111	CpG: 44	483	44	353	18.2	73.1	0.68
chr1	77521362	77522563	CpG: 119	1201	119	778	19.8	64.8	0.98
chr1	77526709	77526980	CpG: 22	271	22	167	16.2	61.6	0.87
chr1	77597968	77598775	CpG: 78	807	78	558	19.3	69.1	0.82
chr1	77650493	77650734	CpG: 22	241	22	171	18.3	71.0	0.78
chr1	77708282	77709790	CpG: 124	1508	124	1111	16.4	73.7	0.61
chr1	77727402	77727792	CpG: 42	390	42	287	21.5	73.6	0.81
chr1	77817414	77818392	CpG: 79	978	79	554	16.2	56.6	1.01
chr1	77818737	77818974	CpG: 20	237	20	144	16.9	60.8	0.92
chr1	77830950	77831224	CpG: 23	274	23	170	16.8	62.0	0.88
chr1	77883268	77883479	CpG: 16	211	16	127	15.2	60.2	0.86
chr1	77884801	77885385	CpG: 76	584	76	430	26.0	73.6	0.98
chr1	77916691	77916961	CpG: 24	270	24	170	17.8	63.0	0.91
chr1	78329783	78330675	CpG: 70	892	70	560	15.7	62.8	0.80
chr1	78677313	78677594	CpG: 23	281	23	175	16.4	62.3	0.86
chr1	78689958	78690184	CpG: 17	226	17	132	15.0	58.4	0.88
chr1	78845062	78845318	CpG: 33	256	33	182	25.8	71.1	1.04
chr1	78938655	78938879	CpG: 16	224	16	134	14.3	59.8	0.82
chr1	78969361	78969623	CpG: 23	262	23	162	17.6	61.8	0.93
chr1	79092918	79093194	CpG: 24	276	24	171	17.4	62.0	0.92
chr1	79095478	79095751	CpG: 22	273	22	168	16.1	61.5	0.87
chr1	79186100	79186348	CpG: 18	248	18	147	14.5	59.3	0.86
chr1	79510794	79511081	CpG: 21	287	21	173	14.6	60.3	0.81
chr1	79617928	79618153	CpG: 15	225	15	128	13.3	56.9	0.83
chr1	79781480	79781757	CpG: 21	277	21	164	15.2	59.2	0.87
chr1	80026363	80026599	CpG: 18	236	18	140	15.3	59.3	0.89
chr1	80062325	80062599	CpG: 25	274	25	172	18.2	62.8	0.93
chr1	80158246	80158480	CpG: 17	234	17	142	14.5	60.7	0.81
chr1	80168509	80168769	CpG: 27	260	27	133	20.8	51.2	1.69
chr1	80292709	80292942	CpG: 19	233	19	139	16.3	59.7	0.94
chr1	80509843	80510077	CpG: 19	234	19	143	16.2	61.1	0.91
chr1	80566196	80566470	CpG: 24	274	24	171	17.5	62.4	0.91
chr1	80759061	80759342	CpG: 22	281	22	172	15.7	61.2	0.85
chr1	80782440	80782766	CpG: 25	326	25	193	15.3	59.2	0.88
chr1	80896027	80896301	CpG: 24	274	24	171	17.5	62.4	0.91
chr1	80915800	80916075	CpG: 20	275	20	166	14.5	60.4	0.81
chr1	80931519	80931776	CpG: 20	257	20	151	15.6	58.8	0.91
chr1	81014989	81015241	CpG: 21	252	21	153	16.7	60.7	0.92
chr1	81015748	81015995	CpG: 17	247	17	143	13.8	57.9	0.84
chr1	81016640	81016902	CpG: 22	262	22	192	16.8	73.3	0.63
chr1	81138043	81138321	CpG: 25	278	25	174	18.0	62.6	0.93
chr1	81559620	81559891	CpG: 22	271	22	165	16.2	60.9	0.89
chr1	81637915	81640965	CpG: 281	3050	281	2025	18.4	66.4	0.84
chr1	81846641	81846919	CpG: 25	278	25	175	18.0	62.9	0.92
chr1	81974182	81974409	CpG: 23	227	23	140	20.3	61.7	1.07
chr1	82257075	82257355	CpG: 24	280	24	170	17.1	60.7	0.94
chr1	82338388	82338667	CpG: 25	279	25	176	17.9	63.1	0.91
chr1	82388134	82388415	CpG: 23	281	23	175	16.4	62.3	0.86
chr1	82617166	82617556	CpG: 33	390	33	282	16.9	72.3	0.65
chr1	82728481	82728704	CpG: 16	223	16	136	14.3	61.0	0.78
chr1	83022612	83022849	CpG: 19	237	19	140	16.0	59.1	0.92
chr1	83046065	83046339	CpG: 24	274	24	171	17.5	62.4	0.91
chr1	83082868	83083149	CpG: 23	281	23	174	16.4	61.9	0.87
chr1	83086404	83086641	CpG: 18	237	18	144	15.2	60.8	0.86
chr1	83104045	83104356	CpG: 25	311	25	188	16.1	60.5	0.89
chr1	83196391	83196618	CpG: 18	227	18	132	15.9	58.1	0.94
chr1	83630398	83630642	CpG: 18	244	18	147	14.8	60.2	0.83
chr1	83700931	83701502	CpG: 50	571	50	409	17.5	71.6	0.69
chr1	83838937	83839946	CpG: 93	1009	93	692	18.4	68.6	0.78
chr1	83898399	83898946	CpG: 41	547	41	327	15.0	59.8	0.84
chr1	83917918	83919033	CpG: 125	1115	125	796	22.4	71.4	0.88
chr1	84111158	84111428	CpG: 21	270	21	166	15.6	61.5	0.83
chr1	84138889	84139687	CpG: 77	798	77	553	19.3	69.3	0.81
chr1	84319632	84320050	CpG: 41	418	41	255	19.6	61.0	1.09
chr1	84346042	84347189	CpG: 117	1147	117	780	20.4	68.0	0.89
chr1	84376845	84377076	CpG: 17	231	17	139	14.7	60.2	0.83
chr1	84398689	84398965	CpG: 23	276	23	170	16.7	61.6	0.89
chr1	84414516	84415035	CpG: 58	519	58	373	22.4	71.9	0.90
chr1	84461015	84461573	CpG: 54	558	54	400	19.4	71.7	0.76
chr1	84530323	84531292	CpG: 116	969	116	713	23.9	73.6	0.92
chr1	84594726	84595046	CpG: 25	320	25	184	15.6	57.5	0.96
chr1	84733284	84734112	CpG: 93	828	93	584	22.5	70.5	0.90
chr1	84837533	84839120	CpG: 141	1587	141	1028	17.8	64.8	0.85
chr1	84888459	84889505	CpG: 115	1046	115	787	22.0	75.2	0.79
chr1	84950788	84951054	CpG: 21	266	21	162	15.8	60.9	0.86
chr1	85035991	85036231	CpG: 18	240	18	144	15.0	60.0	0.84
chr1	85041250	85043082	CpG: 197	1832	197	1312	21.5	71.6	0.84
chr1	85052213	85052488	CpG: 21	275	21	170	15.3	61.8	0.81
chr1	85100137	85100960	CpG: 74	823	74	564	18.0	68.5	0.77
chr1	85117298	85117968	CpG: 76	670	76	467	22.7	69.7	0.93
chr1	85305070	85306296	CpG: 145	1226	145	869	23.7	70.9	0.94
chr1	85320002	85320279	CpG: 24	277	24	172	17.3	62.1	0.91
chr1	85417365	85418071	CpG: 93	706	93	515	26.3	72.9	1.00
chr1	85421488	85422366	CpG: 100	878	100	613	22.8	69.8	0.97
chr1	85456840	85457208	CpG: 47	368	47	280	25.5	76.1	0.88
chr1	85549203	85549415	CpG: 23	212	23	130	21.7	61.3	1.16
chr1	85589533	85589825	CpG: 23	292	23	178	15.8	61.0	0.85
chr1	85654425	85654700	CpG: 25	275	25	172	18.2	62.5	0.94
chr1	85723050	85723272	CpG: 18	222	18	133	16.2	59.9	0.94
chr1	85767956	85768384	CpG: 30	428	30	256	14.0	59.8	0.79
chr1	85788768	85789042	CpG: 25	274	25	172	18.2	62.8	0.94
chr1	85948086	85948316	CpG: 16	230	16	137	13.9	59.6	0.79
chr1	85951112	85951376	CpG: 26	264	26	195	19.7	73.9	0.73
chr1	85996120	85997713	CpG: 106	1593	106	989	13.3	62.1	0.69
chr1	86113423	86113704	CpG: 24	281	24	173	17.1	61.6	0.91
chr1	86184279	86184553	CpG: 24	274	24	171	17.5	62.4	0.91
chr1	86234891	86235165	CpG: 27	274	27	176	19.7	64.2	0.96
chr1	86235904	86236421	CpG: 47	517	47	337	18.2	65.2	0.86
chr1	86256815	86257089	CpG: 24	274	24	171	17.5	62.4	0.91
chr1	86364094	86364361	CpG: 25	267	25	193	18.7	72.3	0.73
chr1	86390956	86391161	CpG: 16	205	16	121	15.6	59.0	0.92
chr1	86393026	86393612	CpG: 45	586	45	374	15.4	63.8	0.76
chr1	86524697	86525124	CpG: 30	427	30	254	14.1	59.5	0.80
chr1	86544221	86545361	CpG: 126	1140	126	780	22.1	68.4	0.95
chr1	86595373	86595648	CpG: 20	275	20	169	14.5	61.5	0.78
chr1	86674913	86675151	CpG: 16	238	16	138	13.4	58.0	0.82
chr1	86691069	86691349	CpG: 23	280	23	170	16.4	60.7	0.90
chr1	86713470	86713752	CpG: 19	282	19	170	13.5	60.3	0.75
chr1	86740013	86741008	CpG: 76	995	76	699	15.3	70.3	0.62
chr1	86755037	86756089	CpG: 101	1052	101	697	19.2	66.3	0.93
chr1	86804359	86805119	CpG: 62	760	62	533	16.3	70.1	0.66
chr1	86974590	86975562	CpG: 78	972	78	637	16.0	65.5	0.75
chr1	86994175	86994451	CpG: 22	276	22	169	15.9	61.2	0.86
chr1	86994726	86995020	CpG: 23	294	23	190	15.6	64.6	0.75
chr1	87018250	87018488	CpG: 20	238	20	142	16.8	59.7	0.98
chr1	87115614	87115895	CpG: 26	281	26	177	18.5	63.0	0.95
chr1	87170818	87172158	CpG: 145	1340	145	926	21.6	69.1	0.91
chr1	87174098	87174903	CpG: 64	805	64	538	15.9	66.8	0.71
chr1	87177854	87178271	CpG: 56	417	56	311	26.9	74.6	0.97
chr1	87301021	87301295	CpG: 23	274	23	171	16.8	62.4	0.87
chr1	87372453	87372702	CpG: 22	249	22	181	17.7	72.7	0.67
chr1	87419957	87420214	CpG: 20	257	20	159	15.6	61.9	0.84
chr1	87564568	87564792	CpG: 16	224	16	130	14.3	58.0	0.87
chr1	87610585	87610817	CpG: 17	232	17	139	14.7	59.9	0.84
chr1	87713822	87714107	CpG: 25	285	25	179	17.5	62.8	0.90
chr1	87732201	87732475	CpG: 23	274	23	169	16.8	61.7	0.89
chr1	87738383	87738664	CpG: 25	281	25	175	17.8	62.3	0.94
chr1	88185212	88185458	CpG: 21	246	21	148	17.1	60.2	0.94
chr1	88306108	88306585	CpG: 63	477	63	351	26.4	73.6	0.98
chr1	88310416	88310973	CpG: 53	557	53	413	19.0	74.1	0.69
chr1	88507765	88507995	CpG: 20	230	20	142	17.4	61.7	0.94
chr1	88509908	88510152	CpG: 24	244	24	157	19.7	64.3	0.97
chr1	88527326	88528450	CpG: 112	1124	112	761	19.9	67.7	0.88
chr1	88573352	88573577	CpG: 16	225	16	130	14.2	57.8	0.87
chr1	88614022	88614296	CpG: 24	274	24	171	17.5	62.4	0.91
chr1	88734680	88735108	CpG: 44	428	44	267	20.6	62.4	1.07
chr1	88835437	88836318	CpG: 81	881	81	568	18.4	64.5	0.89
chr1	88935188	88935402	CpG: 18	214	18	129	16.8	60.3	0.94
chr1	88971526	88971787	CpG: 24	261	24	189	18.4	72.4	0.70
chr1	89025884	89026113	CpG: 18	229	18	136	15.7	59.4	0.90
chr1	89261486	89261713	CpG: 23	227	23	138	20.3	60.8	1.10
chr1	89367492	89368668	CpG: 122	1176	122	811	20.7	69.0	0.87
chr1	89384683	89384919	CpG: 21	236	21	146	17.8	61.9	0.95
chr1	89465599	89465822	CpG: 16	223	16	132	14.3	59.2	0.83
chr1	89475906	89476968	CpG: 132	1062	132	778	24.9	73.3	0.93
chr1	89565198	89565472	CpG: 22	274	22	170	16.1	62.0	0.84
chr1	89595916	89596132	CpG: 17	216	17	128	15.7	59.3	0.90
chr1	89606416	89606845	CpG: 30	429	30	253	14.0	59.0	0.86
chr1	89641011	89641467	CpG: 43	456	43	343	18.9	75.2	0.67
chr1	89663869	89665161	CpG: 146	1292	146	937	22.6	72.5	0.86
chr1	89686507	89687274	CpG: 62	767	62	528	16.2	68.8	0.68
chr1	89832365	89832610	CpG: 20	245	20	152	16.3	62.0	0.88
chr1	89838062	89838900	CpG: 98	838	98	591	23.4	70.5	0.95
chr1	89989625	89989899	CpG: 23	274	23	170	16.8	62.0	0.88
chr1	90075731	90076012	CpG: 21	281	21	172	14.9	61.2	0.81
chr1	90500040	90500265	CpG: 19	225	19	137	16.9	60.9	0.95
chr1	90530243	90530519	CpG: 23	276	23	171	16.7	62.0	0.88
chr1	90550911	90551580	CpG: 67	669	67	449	20.0	67.1	0.90
chr1	90555211	90555508	CpG: 30	297	30	205	20.2	69.0	0.86
chr1	90560904	90564399	CpG: 310	3495	310	2160	17.7	61.8	0.94
chr1	90567961	90568222	CpG: 19	261	19	155	14.6	59.4	0.83
chr1	90569311	90571626	CpG: 147	2315	147	1313	12.7	56.7	0.79
chr1	90574829	90575232	CpG: 43	403	43	232	21.3	57.6	1.31
chr1	90679872	90680784	CpG: 86	912	86	635	18.9	69.6	0.78
chr1	90695176	90696317	CpG: 109	1141	109	798	19.1	69.9	0.79
chr1	90738123	90738564	CpG: 47	441	47	308	21.3	69.8	0.92
chr1	90866218	90866869	CpG: 78	651	78	471	24.0	72.4	0.94
chr1	90880608	90880877	CpG: 23	269	23	167	17.1	62.1	0.90
chr1	90940321	90940551	CpG: 18	230	18	136	15.7	59.1	0.92
chr1	91060809	91061087	CpG: 25	278	25	175	18.0	62.9	0.92
chr1	91109077	91109310	CpG: 20	233	20	140	17.2	60.1	0.98
chr1	91131433	91131653	CpG: 20	220	20	131	18.2	59.5	1.03
chr1	91248948	91249462	CpG: 61	514	61	374	23.7	72.8	0.91
chr1	91345351	91346087	CpG: 72	736	72	469	19.6	63.7	0.97
chr1	91380089	91380510	CpG: 39	421	39	271	18.5	64.4	0.90
chr1	91390885	91391118	CpG: 20	233	20	166	17.2	71.2	0.68
chr1	91391392	91391712	CpG: 24	320	24	195	15.0	60.9	0.82
chr1	91405557	91405833	CpG: 19	276	19	165	13.8	59.8	0.78
chr1	91472326	91472566	CpG: 18	240	18	141	15.0	58.8	0.88
chr1	91613405	91613679	CpG: 24	274	24	171	17.5	62.4	0.91
chr1	91725148	91725382	CpG: 17	234	17	133	14.5	56.8	0.92
chr1	91730190	91731362	CpG: 134	1172	134	857	22.9	73.1	0.86
chr1	91763402	91763640	CpG: 19	238	19	143	16.0	60.1	0.92
chr1	91768383	91768656	CpG: 25	273	25	169	18.3	61.9	0.96
chr1	91794027	91794316	CpG: 23	289	23	177	15.9	61.2	0.86
chr1	91806744	91806968	CpG: 19	224	19	138	17.0	61.6	0.93
chr1	91830517	91830753	CpG: 20	236	20	144	16.9	61.0	0.92
chr1	91839413	91839651	CpG: 20	238	20	145	16.8	60.9	0.92
chr1	91874649	91875246	CpG: 76	597	76	445	25.5	74.5	0.92
chr1	91925118	91925779	CpG: 52	661	52	419	15.7	63.4	0.78
chr1	91926451	91926682	CpG: 20	231	20	138	17.3	59.7	0.99
chr1	92062793	92063037	CpG: 21	244	21	155	17.2	63.5	0.85
chr1	92143525	92144278	CpG: 72	753	72	510	19.1	67.7	0.85
chr1	92297102	92297368	CpG: 19	266	19	157	14.3	59.0	0.84
chr1	92325204	92331963	CpG: 522	6759	522	4339	15.4	64.2	0.75
chr1	92384124	92384357	CpG: 18	233	18	140	15.5	60.1	0.89
chr1	92496453	92496683	CpG: 19	230	19	140	16.5	60.9	0.90
chr1	92546869	92547144	CpG: 24	275	24	172	17.5	62.5	0.90
chr1	92629584	92630738	CpG: 119	1154	119	794	20.6	68.8	0.88
chr1	92656006	92656210	CpG: 20	204	20	129	19.6	63.2	1.03
chr1	92677083	92677707	CpG: 55	624	55	397	17.6	63.6	0.89
chr1	92804639	92804904	CpG: 19	265	19	161	14.3	60.8	0.80
chr1	92806128	92807370	CpG: 148	1242	148	929	23.8	74.8	0.85
chr1	92855550	92855827	CpG: 21	277	21	164	15.2	59.2	0.88
chr1	92877900	92878175	CpG: 23	275	23	170	16.7	61.8	0.88
chr1	92882762	92882973	CpG: 15	211	15	126	14.2	59.7	0.82
chr1	92909107	92909381	CpG: 23	274	23	170	16.8	62.0	0.89
chr1	92924588	92925062	CpG: 45	474	45	300	19.0	63.3	0.95
chr1	92950472	92950700	CpG: 16	228	16	138	14.0	60.5	0.79
chr1	93015716	93015961	CpG: 23	245	23	182	18.8	74.3	0.68
chr1	93025465	93026504	CpG: 102	1039	102	692	19.6	66.6	0.89
chr1	93191382	93192104	CpG: 81	722	81	505	22.4	69.9	0.93
chr1	93219066	93219336	CpG: 21	270	21	168	15.6	62.2	0.81
chr1	93293659	93294714	CpG: 119	1055	119	775	22.6	73.5	0.84
chr1	93357426	93357666	CpG: 21	240	21	149	17.5	62.1	0.93
chr1	93526499	93527682	CpG: 127	1183	127	815	21.5	68.9	0.91
chr1	93631624	93631902	CpG: 25	278	25	176	18.0	63.3	0.91
chr1	93692023	93693819	CpG: 207	1796	207	1227	23.1	68.3	0.99
chr1	93727205	93727543	CpG: 37	338	37	216	21.9	63.9	1.09
chr1	93757078	93758176	CpG: 140	1098	140	796	25.5	72.5	0.97
chr1	93998848	93999078	CpG: 18	230	18	137	15.7	59.6	0.91
chr1	94044492	94044766	CpG: 23	274	23	170	16.8	62.0	0.88
chr1	94085320	94086011	CpG: 97	691	97	522	28.1	75.5	1.04
chr1	94095560	94096171	CpG: 93	611	93	476	30.4	77.9	1.04
chr1	94104817	94105050	CpG: 17	233	17	137	14.6	58.8	0.87
chr1	94266092	94267021	CpG: 114	929	114	668	24.5	71.9	0.95
chr1	94389319	94390533	CpG: 116	1214	116	850	19.1	70.0	0.78
chr1	94408878	94409111	CpG: 18	233	18	134	15.5	57.5	0.96
chr1	94668091	94668808	CpG: 77	717	77	529	21.5	73.8	0.79
chr1	94725205	94725437	CpG: 20	232	20	140	17.2	60.3	0.96
chr1	94726358	94726582	CpG: 16	224	16	136	14.3	60.7	0.78
chr1	94774634	94775913	CpG: 151	1279	151	968	23.6	75.7	0.83
chr1	94921093	94921742	CpG: 49	649	49	349	15.1	53.8	1.05
chr1	94939783	94940113	CpG: 31	330	31	237	18.8	71.8	0.73
chr1	94954031	94954259	CpG: 19	228	19	137	16.7	60.1	0.94
chr1	94965631	94966453	CpG: 111	822	111	627	27.0	76.3	0.93
chr1	95036501	95036776	CpG: 19	275	19	166	13.8	60.4	0.76
chr1	95075979	95076268	CpG: 22	289	22	174	15.2	60.2	0.85
chr1	95081876	95082671	CpG: 81	795	81	567	20.4	71.3	0.80
chr1	95083191	95083433	CpG: 21	242	21	146	17.4	60.3	0.97
chr1	95368895	95369169	CpG: 21	274	21	169	15.3	61.7	0.82
chr1	95417986	95418260	CpG: 23	274	23	172	16.8	62.8	0.86
chr1	95517633	95518021	CpG: 32	388	32	282	16.5	72.7	0.63
chr1	95718269	95718502	CpG: 17	233	17	131	14.6	56.2	0.94
chr1	95931746	95931963	CpG: 17	217	17	128	15.7	59.0	0.91
chr1	95959722	95959980	CpG: 25	258	25	164	19.4	63.6	0.97
chr1	96091623	96091901	CpG: 24	278	24	173	17.3	62.2	0.90
chr1	96116851	96117094	CpG: 20	243	20	149	16.5	61.3	0.89
chr1	96327811	96328077	CpG: 24	266	24	168	18.0	63.2	0.92
chr1	96367641	96367914	CpG: 21	273	21	163	15.4	59.7	0.87
chr1	96419968	96420170	CpG: 16	202	16	125	15.8	61.9	0.84
chr1	96437282	96437557	CpG: 21	275	21	161	15.3	58.5	0.90
chr1	96452639	96452863	CpG: 19	224	19	130	17.0	58.0	1.01
chr1	96569675	96570592	CpG: 93	917	93	644	20.3	70.2	0.83
chr1	96610390	96611536	CpG: 97	1146	97	830	16.9	72.4	0.65
chr1	97534230	97534497	CpG: 22	267	22	165	16.5	61.8	0.88
chr1	97686402	97686683	CpG: 23	281	23	176	16.4	62.6	0.85
chr1	97768477	97769012	CpG: 59	535	59	384	22.1	71.8	0.87
chr1	97893299	97894172	CpG: 87	873	87	578	19.9	66.2	0.94
chr1	97901353	97902335	CpG: 91	982	91	671	18.5	68.3	0.80
chr1	98142525	98142798	CpG: 25	273	25	171	18.3	62.6	0.95
chr1	98165165	98165446	CpG: 22	281	22	173	15.7	61.6	0.84
chr1	98509449	98510288	CpG: 94	839	94	615	22.4	73.3	0.83
chr1	98520761	98521042	CpG: 24	281	24	175	17.1	62.3	0.90
chr1	98852521	98853557	CpG: 115	1036	115	738	22.2	71.2	0.89
chr1	99103432	99103706	CpG: 24	274	24	171	17.5	62.4	0.91
chr1	99112767	99113120	CpG: 31	353	31	237	17.6	67.1	0.80
chr1	99226521	99226787	CpG: 27	266	27	170	20.3	63.9	1.01
chr1	99298199	99298400	CpG: 15	201	15	116	14.9	57.7	0.94
chr1	99356990	99357259	CpG: 22	269	22	182	16.4	67.7	0.71
chr1	99671208	99672023	CpG: 59	815	59	561	14.5	68.8	0.61
chr1	99681543	99681813	CpG: 21	270	21	164	15.6	60.7	0.85
chr1	99698097	99698686	CpG: 63	589	63	414	21.4	70.3	0.87
chr1	99705245	99705938	CpG: 54	693	54	476	15.6	68.7	0.66
chr1	99745101	99745376	CpG: 20	275	20	169	14.5	61.5	0.77
chr1	99808834	99809108	CpG: 24	274	24	170	17.5	62.0	0.92
chr1	99817861	99818634	CpG: 70	773	70	524	18.1	67.8	0.84
chr1	99885995	99886964	CpG: 117	969	117	687	24.1	70.9	0.96
chr1	99914872	99915102	CpG: 20	230	20	141	17.4	61.3	0.94
chr1	99968886	99969160	CpG: 22	274	22	170	16.1	62.0	0.85
chr1	99980689	99981313	CpG: 45	624	45	379	14.4	60.7	0.79
chr1	100006612	100006847	CpG: 21	235	21	143	17.9	60.9	0.98
chr1	100028723	100028963	CpG: 22	240	22	149	18.3	62.1	0.97
chr1	100029624	100029886	CpG: 25	262	25	166	19.1	63.4	0.96
chr1	100061261	100061593	CpG: 38	332	38	238	22.9	71.7	0.92
chr1	100114048	100114416	CpG: 35	368	35	241	19.0	65.5	0.89
chr1	100134122	100134367	CpG: 18	245	18	142	14.7	58.0	0.92
chr1	100200131	100201321	CpG: 94	1190	94	787	15.8	66.1	0.72
chr1	100373732	100374006	CpG: 23	274	23	169	16.8	61.7	0.90
chr1	100376703	100376984	CpG: 23	281	23	175	16.4	62.3	0.86
chr1	100387310	100388724	CpG: 158	1414	158	1012	22.3	71.6	0.88
chr1	100587934	100588217	CpG: 20	283	20	173	14.1	61.1	0.76
chr1	100610353	100610561	CpG: 16	208	16	121	15.4	58.2	0.92
chr1	100736610	100736845	CpG: 18	235	18	139	15.3	59.1	0.90
chr1	100743878	100744122	CpG: 22	244	22	156	18.0	63.9	0.88
chr1	100744839	100745098	CpG: 32	259	32	183	24.7	70.7	1.01
chr1	100771876	100772145	CpG: 22	269	22	169	16.4	62.8	0.84
chr1	100874601	100874964	CpG: 31	363	31	236	17.1	65.0	0.81
chr1	100895483	100895718	CpG: 17	235	17	137	14.5	58.3	0.88
chr1	101085093	101085376	CpG: 26	283	26	195	18.4	68.9	0.78
chr1	101085750	101086050	CpG: 35	300	35	197	23.3	65.7	1.15
chr1	101573966	101574196	CpG: 18	230	18	137	15.7	59.6	0.89
chr1	101798836	101799076	CpG: 19	240	19	145	15.8	60.4	0.88
chr1	101799649	101799929	CpG: 20	280	20	166	14.3	59.3	0.82
chr1	102073579	102073819	CpG: 21	240	21	148	17.5	61.7	0.95
chr1	102079754	102080035	CpG: 22	281	22	172	15.7	61.2	0.85
chr1	102329644	102329877	CpG: 18	233	18	143	15.5	61.4	0.84
chr1	102391832	102392106	CpG: 22	274	22	169	16.1	61.7	0.85
chr1	102487018	102487220	CpG: 14	202	14	119	13.9	58.9	0.83
chr1	102508862	102509335	CpG: 45	473	45	349	19.0	73.8	0.70
chr1	102513869	102514153	CpG: 21	284	21	177	14.8	62.3	0.77
chr1	102702665	102703123	CpG: 51	458	51	343	22.3	74.9	0.79
chr1	102771415	102771654	CpG: 19	239	19	141	15.9	59.0	0.93
chr1	102816203	102816433	CpG: 18	230	18	137	15.7	59.6	0.89
chr1	102914120	102914397	CpG: 19	277	19	167	13.7	60.3	0.76
chr1	102935361	102935606	CpG: 19	245	19	151	15.5	61.6	0.84
chr1	102976772	102977036	CpG: 21	264	21	164	15.9	62.1	0.84
chr1	103019242	103019522	CpG: 24	280	24	170	17.1	60.7	0.94
chr1	103028158	103028431	CpG: 24	273	24	169	17.6	61.9	0.92
chr1	103126779	103127053	CpG: 23	274	23	170	16.8	62.0	0.88
chr1	103374395	103375233	CpG: 89	838	89	540	21.2	64.4	1.05
chr1	103828104	103828335	CpG: 19	231	19	135	16.5	58.4	1.00
chr1	103831359	103831604	CpG: 16	245	16	137	13.1	55.9	0.86
chr1	103968617	103968886	CpG: 26	269	26	170	19.3	63.2	0.98
chr1	104219663	104219937	CpG: 25	274	25	173	18.2	63.1	0.93
chr1	104472821	104473057	CpG: 20	236	20	143	16.9	60.6	0.94
chr1	104552029	104552415	CpG: 30	386	30	217	15.5	56.2	0.99
chr1	104657468	104657706	CpG: 20	238	20	144	16.8	60.5	0.94
chr1	104682734	104682998	CpG: 25	264	25	164	18.9	62.1	0.99
chr1	104707065	104707425	CpG: 28	360	28	209	15.6	58.1	0.93
chr1	104728651	104728925	CpG: 21	274	21	166	15.3	60.6	0.85
chr1	104817748	104818175	CpG: 33	427	33	259	15.5	60.7	0.84
chr1	104891392	104891634	CpG: 22	242	22	148	18.2	61.2	0.97
chr1	105403291	105403565	CpG: 23	274	23	170	16.8	62.0	0.88
chr1	105631900	105632170	CpG: 20	270	20	164	14.8	60.7	0.81
chr1	105667385	105667595	CpG: 23	210	23	156	21.9	74.3	0.80
chr1	105770019	105770294	CpG: 20	275	20	166	14.5	60.4	0.81
chr1	105831809	105832052	CpG: 28	243	28	190	23.0	78.2	0.76
chr1	106047197	106047412	CpG: 16	215	16	125	14.9	58.1	0.89
chr1	106114008	106114266	CpG: 22	258	22	159	17.1	61.6	0.92
chr1	106118230	106118691	CpG: 37	461	37	296	16.1	64.2	0.78
chr1	106420894	106421166	CpG: 21	272	21	168	15.4	61.8	0.82
chr1	106429967	106430252	CpG: 24	285	24	177	16.8	62.1	0.89
chr1	106545006	106545236	CpG: 17	230	17	140	14.8	60.9	0.81
chr1	106954990	106955225	CpG: 20	235	20	137	17.0	58.3	1.02
chr1	107029941	107030189	CpG: 22	248	22	151	17.7	60.9	0.96
chr1	107082214	107082617	CpG: 36	403	36	297	17.9	73.7	0.66
chr1	107093506	107093740	CpG: 19	234	19	144	16.2	61.5	0.87
chr1	107094036	107095241	CpG: 116	1205	116	805	19.3	66.8	0.87
chr1	107130015	107130250	CpG: 18	235	18	144	15.3	61.3	0.83
chr1	107177498	107179347	CpG: 164	1849	164	1180	17.7	63.8	0.87
chr1	107518170	107518380	CpG: 22	210	22	146	21.0	69.5	0.87
chr1	107608008	107608277	CpG: 20	269	20	166	14.9	61.7	0.81
chr1	107960135	107960409	CpG: 23	274	23	172	16.8	62.8	0.86
chr1	108002105	108002892	CpG: 110	787	110	603	28.0	76.6	0.95
chr1	108003695	108003915	CpG: 19	220	19	133	17.3	60.5	0.96
chr1	108030668	108030904	CpG: 20	236	20	144	16.9	61.0	0.93
chr1	108197578	108198383	CpG: 58	805	58	543	14.4	67.5	0.63
chr1	108233423	108234224	CpG: 95	801	95	596	23.7	74.4	0.86
chr1	108306143	108307219	CpG: 82	1076	82	671	15.2	62.4	0.78
chr1	108312200	108312478	CpG: 26	278	26	176	18.7	63.3	0.94
chr1	108382080	108382334	CpG: 18	254	18	145	14.2	57.1	0.89
chr1	108448724	108449002	CpG: 26	278	26	176	18.7	63.3	0.94
chr1	108453981	108455057	CpG: 82	1076	82	671	15.2	62.4	0.78
chr1	108592904	108593578	CpG: 98	674	98	510	29.1	75.7	1.02
chr1	108673848	108674222	CpG: 30	374	30	271	16.0	72.5	0.61
chr1	108693638	108694749	CpG: 118	1111	118	715	21.2	64.4	1.03
chr1	108700485	108700913	CpG: 36	428	36	310	16.8	72.4	0.64
chr1	108725431	108726344	CpG: 73	913	73	580	16.0	63.5	0.79
chr1	108779640	108780473	CpG: 81	833	81	561	19.4	67.3	0.86
chr1	108850899	108851126	CpG: 19	227	19	137	16.7	60.4	0.94
chr1	108860859	108861091	CpG: 16	232	16	139	13.8	59.9	0.79
chr1	108910181	108910753	CpG: 71	572	71	425	24.8	74.3	0.93
chr1	108941792	108942045	CpG: 20	253	20	151	15.8	59.7	0.89
chr1	108972724	108972966	CpG: 17	242	17	146	14.0	60.3	0.79
chr1	108996421	108997005	CpG: 71	584	71	403	24.3	69.0	1.03
chr1	109074603	109075780	CpG: 122	1177	122	839	20.7	71.3	0.82
chr1	109076766	109077050	CpG: 22	284	22	167	15.5	58.8	0.91
chr1	109086173	109087112	CpG: 76	939	76	655	16.2	69.8	0.67
chr1	109096067	109096346	CpG: 22	279	22	172	15.8	61.6	0.84
chr1	109106281	109106893	CpG: 47	612	47	409	15.4	66.8	0.69
chr1	109108827	109109080	CpG: 24	253	24	158	19.0	62.5	0.97
chr1	109122787	109123876	CpG: 84	1089	84	643	15.4	59.0	0.89
chr1	109132907	109133628	CpG: 74	721	74	487	20.5	67.5	0.91
chr1	109133744	109133982	CpG: 18	238	18	135	15.1	56.7	0.96
chr1	109134262	109134498	CpG: 17	236	17	143	14.4	60.6	0.80
chr1	109145976	109146849	CpG: 69	873	69	523	15.8	59.9	0.89
chr1	109209996	109210364	CpG: 33	368	33	273	17.9	74.2	0.65
chr1	109236413	109236649	CpG: 19	236	19	142	16.1	60.2	0.92
chr1	109246630	109247286	CpG: 58	656	58	430	17.7	65.5	0.82
chr1	109282130	109282970	CpG: 117	840	117	665	27.9	79.2	0.91
chr1	109291242	109291888	CpG: 68	646	68	447	21.1	69.2	0.90
chr1	109314491	109314704	CpG: 16	213	16	143	15.0	67.1	0.67
chr1	109315888	109316385	CpG: 47	497	47	325	18.9	65.4	0.89
chr1	109405432	109405805	CpG: 27	373	27	218	14.5	58.4	0.87
chr1	109408863	109409094	CpG: 23	231	23	145	19.9	62.8	1.04
chr1	109430187	109431053	CpG: 129	866	129	672	29.8	77.6	0.99
chr1	109458811	109459733	CpG: 68	922	68	578	14.8	62.7	0.75
chr1	109499119	109500195	CpG: 113	1076	113	775	21.0	72.0	0.81
chr1	109516581	109517056	CpG: 62	475	62	352	26.1	74.1	0.95
chr1	109526698	109527096	CpG: 38	398	38	286	19.1	71.9	0.74
chr1	109542099	109542650	CpG: 88	551	88	433	31.9	78.6	1.04
chr1	109581140	109581691	CpG: 52	551	52	356	18.9	64.6	0.92
chr1	109652414	109652814	CpG: 37	400	37	278	18.5	69.5	0.78
chr1	109676064	109676267	CpG: 16	203	16	142	15.8	70.0	0.65
chr1	109677047	109677314	CpG: 21	267	21	167	15.7	62.5	0.82
chr1	109684357	109684943	CpG: 50	586	50	387	17.1	66.0	0.80
chr1	109696405	109696780	CpG: 27	375	27	261	14.4	69.6	0.61
chr1	109749874	109750829	CpG: 92	955	92	642	19.3	67.2	0.85
chr1	109920658	109921404	CpG: 86	746	86	548	23.1	73.5	0.88
chr1	109994757	109995536	CpG: 83	779	83	548	21.3	70.3	0.87
chr1	110036196	110036470	CpG: 25	274	25	172	18.2	62.8	0.94
chr1	110044710	110045453	CpG: 71	743	71	528	19.1	71.1	0.76
chr1	110077771	110080972	CpG: 292	3201	292	2116	18.2	66.1	0.83
chr1	110094029	110094985	CpG: 101	956	101	644	21.1	67.4	0.93
chr1	110145143	110145672	CpG: 38	529	38	353	14.4	66.7	0.68
chr1	110165320	110166596	CpG: 140	1276	140	905	21.9	70.9	0.87
chr1	110224604	110227142	CpG: 292	2538	292	1835	23.0	72.3	0.88
chr1	110238013	110238360	CpG: 31	347	31	215	17.9	62.0	0.93
chr1	110283266	110283501	CpG: 18	235	18	139	15.3	59.1	0.90
chr1	110352827	110353057	CpG: 18	230	18	146	15.7	63.5	0.78
chr1	110353249	110355233	CpG: 175	1984	175	1210	17.6	61.0	0.96
chr1	110411434	110411953	CpG: 43	519	43	383	16.6	73.8	0.61
chr1	110422415	110423063	CpG: 66	648	66	410	20.4	63.3	1.03
chr1	110473260	110473496	CpG: 21	236	21	145	17.8	61.4	0.96
chr1	110570488	110570784	CpG: 33	296	33	222	22.3	75.0	0.79
chr1	110621304	110622533	CpG: 133	1229	133	886	21.6	72.1	0.84
chr1	110688365	110690418	CpG: 215	2053	215	1406	20.9	68.5	0.89
chr1	110795352	110795562	CpG: 16	210	16	129	15.2	61.4	0.81
chr1	110900086	110900296	CpG: 17	210	17	127	16.2	60.5	0.92
chr1	110901920	110902153	CpG: 18	233	18	139	15.5	59.7	0.89
chr1	110930000	110930281	CpG: 22	281	22	172	15.7	61.2	0.85
chr1	110978074	110979200	CpG: 87	1126	87	651	15.5	57.8	0.93
chr1	111055095	111055369	CpG: 23	274	23	170	16.8	62.0	0.88
chr1	111083386	111083608	CpG: 17	222	17	134	15.3	60.4	0.86
chr1	111151788	111152053	CpG: 22	265	22	164	16.6	61.9	0.88
chr1	111154419	111155495	CpG: 95	1076	95	719	17.7	66.8	0.80
chr1	111173739	111174015	CpG: 24	276	24	170	17.4	61.6	0.93
chr1	111204734	111204956	CpG: 18	222	18	138	16.2	62.2	0.85
chr1	111218506	111219496	CpG: 98	990	98	726	19.8	73.3	0.74
chr1	111244218	111244454	CpG: 22	236	22	145	18.6	61.4	1.01
chr1	111285573	111286015	CpG: 36	442	36	299	16.3	67.6	0.71
chr1	111361202	111361603	CpG: 30	401	30	256	15.0	63.8	0.73
chr1	111463366	111464264	CpG: 68	898	68	562	15.1	62.6	0.77
chr1	111511812	111512042	CpG: 17	230	17	137	14.8	59.6	0.84
chr1	111523491	111523767	CpG: 22	276	22	169	15.9	61.2	0.87
chr1	111530253	111530659	CpG: 32	406	32	278	15.8	68.5	0.68
chr1	111622420	111623755	CpG: 112	1335	112	968	16.8	72.5	0.64
chr1	111634453	111635086	CpG: 75	633	75	479	23.7	75.7	0.84
chr1	111753330	111755644	CpG: 184	2314	184	1518	15.9	65.6	0.74
chr1	111770321	111771272	CpG: 96	951	96	658	20.2	69.2	0.85
chr1	111774598	111774834	CpG: 21	236	21	145	17.8	61.4	0.97
chr1	111910943	111911154	CpG: 18	211	18	132	17.1	62.6	0.87
chr1	111987146	111987382	CpG: 20	236	20	145	16.9	61.4	0.92
chr1	111996760	111997677	CpG: 87	917	87	590	19.0	64.3	0.92
chr1	112003851	112006065	CpG: 234	2214	234	1601	21.1	72.3	0.81
chr1	112037693	112037967	CpG: 24	274	24	170	17.5	62.0	0.92
chr1	112205658	112205882	CpG: 20	224	20	141	17.9	62.9	0.94
chr1	112236530	112236744	CpG: 19	214	19	121	17.8	56.5	1.11
chr1	112377901	112378137	CpG: 17	236	17	142	14.4	60.2	0.82
chr1	112408167	112408785	CpG: 46	618	46	409	14.9	66.2	0.68
chr1	112461646	112461931	CpG: 23	285	23	177	16.1	62.1	0.85
chr1	112478788	112479098	CpG: 26	310	26	200	16.8	64.5	0.81
chr1	112514357	112514939	CpG: 60	582	60	410	20.6	70.4	0.84
chr1	112520760	112522248	CpG: 144	1488	144	1040	19.4	69.9	0.80
chr1	112572679	112572920	CpG: 17	241	17	142	14.1	58.9	0.84
chr1	112631536	112632516	CpG: 76	980	76	601	15.5	61.3	0.83
chr1	112636187	112636434	CpG: 17	247	17	131	13.8	53.0	0.98
chr1	112687434	112688056	CpG: 77	622	77	461	24.8	74.1	0.90
chr1	112719269	112720125	CpG: 86	856	86	652	20.1	76.2	0.69
chr1	112726814	112728078	CpG: 120	1264	120	897	19.0	71.0	0.75
chr1	112731397	112731694	CpG: 35	297	35	226	23.6	76.1	0.82
chr1	112735502	112735716	CpG: 20	214	20	147	18.7	68.7	0.81
chr1	112740992	112741386	CpG: 26	394	26	251	13.2	63.7	0.65
chr1	112755288	112757142	CpG: 147	1854	147	1151	15.9	62.1	0.82
chr1	112785002	112785203	CpG: 16	201	16	123	15.9	61.2	0.86
chr1	112862076	112863128	CpG: 94	1052	94	696	17.9	66.2	0.82
chr1	112866294	112866504	CpG: 16	210	16	121	15.2	57.6	0.93
chr1	112867019	112867445	CpG: 43	426	43	314	20.2	73.7	0.74
chr1	112896550	112896832	CpG: 19	282	19	153	13.5	54.3	0.95
chr1	112907130	112907611	CpG: 39	481	39	350	16.2	72.8	0.61
chr1	112967948	112968168	CpG: 17	220	17	144	15.5	65.5	0.72
chr1	112968328	112969671	CpG: 130	1343	130	902	19.4	67.2	0.86
chr1	112981273	112981545	CpG: 19	272	19	164	14.0	60.3	0.79
chr1	113066660	113066889	CpG: 16	229	16	136	14.0	59.4	0.80
chr1	113077849	113078373	CpG: 45	524	45	386	17.2	73.7	0.63
chr1	113084900	113085569	CpG: 57	669	57	432	17.0	64.6	0.82
chr1	113184942	113185172	CpG: 20	230	20	142	17.4	61.7	0.92
chr1	113210748	113211020	CpG: 21	272	21	173	15.4	63.6	0.77
chr1	113305595	113305832	CpG: 21	237	21	145	17.7	61.2	0.96
chr1	113395623	113395893	CpG: 24	270	24	169	17.8	62.6	0.92
chr1	113401409	113402899	CpG: 159	1490	159	1059	21.3	71.1	0.85
chr1	113508940	113509351	CpG: 29	411	29	246	14.1	59.9	0.79
chr1	113561825	113562105	CpG: 22	280	22	160	15.7	57.1	0.97
chr1	113644976	113645254	CpG: 21	278	21	170	15.1	61.2	0.82
chr1	113692121	113692357	CpG: 18	236	18	140	15.3	59.3	0.88
chr1	113770557	113771312	CpG: 84	755	84	536	22.3	71.0	0.88
chr1	113823421	113824348	CpG: 97	927	97	623	20.9	67.2	0.93
chr1	113838364	113838638	CpG: 24	274	24	173	17.5	63.1	0.89
chr1	113854493	113854770	CpG: 24	277	24	174	17.3	62.8	0.89
chr1	113916494	113917064	CpG: 61	570	61	384	21.4	67.4	1.00
chr1	113918182	113918451	CpG: 19	269	19	163	14.1	60.6	0.79
chr1	113941004	113941938	CpG: 101	934	101	679	21.6	72.7	0.82
chr1	114025442	114025696	CpG: 20	254	20	152	15.7	59.8	0.89
chr1	114036361	114036640	CpG: 24	279	24	176	17.2	63.1	0.87
chr1	114164154	114166203	CpG: 187	2049	187	1385	18.3	67.6	0.80
chr1	114412747	114413013	CpG: 22	266	22	167	16.5	62.8	0.85
chr1	114477452	114477725	CpG: 20	273	20	161	14.7	59.0	0.86
chr1	114499353	114499634	CpG: 24	281	24	175	17.1	62.3	0.90
chr1	114521890	114523093	CpG: 151	1203	151	869	25.1	72.2	0.97
chr1	114548909	114549191	CpG: 21	282	21	168	14.9	59.6	0.85
chr1	114681066	114681812	CpG: 73	746	73	519	19.6	69.6	0.84
chr1	114694103	114694335	CpG: 17	232	17	137	14.7	59.1	0.86
chr1	114791880	114792267	CpG: 35	387	35	247	18.1	63.8	0.90
chr1	114815844	114816667	CpG: 62	823	62	581	15.1	70.6	0.60
chr1	114866266	114866760	CpG: 37	494	37	293	15.0	59.3	0.86
chr1	115037732	115038006	CpG: 21	274	21	167	15.3	60.9	0.84
chr1	115100680	115101414	CpG: 78	734	78	539	21.3	73.4	0.79
chr1	115348705	115349870	CpG: 103	1165	103	814	17.7	69.9	0.74
chr1	115652839	115654020	CpG: 138	1181	138	866	23.4	73.3	0.87
chr1	115836199	115837016	CpG: 78	817	78	551	19.1	67.4	0.84
chr1	115845746	115847751	CpG: 209	2005	209	1371	20.8	68.4	0.89
chr1	115936484	115936766	CpG: 25	282	25	178	17.7	63.1	0.90
chr1	115984127	115984907	CpG: 89	780	89	572	22.8	73.3	0.85
chr1	116154518	116154908	CpG: 30	390	30	278	15.4	71.3	0.61
chr1	116160016	116160335	CpG: 38	319	38	233	23.8	73.0	0.90
chr1	116175582	116175971	CpG: 25	389	25	252	12.9	64.8	0.61
chr1	116176259	116176662	CpG: 41	403	41	283	20.3	70.2	0.83
chr1	116380739	116382260	CpG: 159	1521	159	1118	20.9	73.5	0.78
chr1	116426630	116426990	CpG: 44	360	44	251	24.4	69.7	1.01
chr1	116427905	116428177	CpG: 21	272	21	169	15.4	62.1	0.81
chr1	116544845	116545102	CpG: 30	257	30	197	23.3	76.7	0.79
chr1	116545987	116546253	CpG: 23	266	23	167	17.3	62.8	0.89
chr1	116580786	116581709	CpG: 98	923	98	652	21.2	70.6	0.86
chr1	116677648	116678445	CpG: 99	797	99	609	24.8	76.4	0.87
chr1	116841604	116841880	CpG: 23	276	23	172	16.7	62.3	0.87
chr1	116901060	116901261	CpG: 14	201	14	119	13.9	59.2	0.83
chr1	116920029	116921278	CpG: 140	1249	140	887	22.4	71.0	0.91
chr1	116955075	116955559	CpG: 49	484	49	339	20.2	70.0	0.83
chr1	117070207	117071173	CpG: 69	966	69	586	14.3	60.7	0.78
chr1	117098679	117098949	CpG: 22	270	22	169	16.3	62.6	0.85
chr1	117131981	117132949	CpG: 98	968	98	646	20.2	66.7	0.91
chr1	117226005	117226242	CpG: 20	237	20	144	16.9	60.8	0.93
chr1	117375596	117376870	CpG: 152	1274	152	921	23.9	72.3	0.91
chr1	117385024	117385260	CpG: 21	236	21	146	17.8	61.9	0.95
chr1	117604406	117604681	CpG: 23	275	23	170	16.7	61.8	0.89
chr1	117614551	117616263	CpG: 136	1712	136	1101	15.9	64.3	0.77
chr1	117938463	117939343	CpG: 73	880	73	565	16.6	64.2	0.80
chr1	118071390	118071620	CpG: 20	230	20	140	17.4	60.9	0.95
chr1	118194500	118194781	CpG: 23	281	23	178	16.4	63.3	0.82
chr1	118436197	118436475	CpG: 26	278	26	176	18.7	63.3	0.94
chr1	118865576	118866003	CpG: 32	427	32	255	15.0	59.7	0.84
chr1	118992949	118993202	CpG: 40	253	40	198	31.6	78.3	1.04
chr1	118997344	118997817	CpG: 39	473	39	298	16.5	63.0	0.83
chr1	119000381	119001274	CpG: 84	893	84	593	18.8	66.4	0.87
chr1	119002551	119002756	CpG: 19	205	19	125	18.5	61.0	1.00
chr1	119006225	119006546	CpG: 36	321	36	222	22.4	69.2	0.94
chr1	119013617	119014901	CpG: 85	1284	85	769	13.2	59.9	0.74
chr1	119019708	119021884	CpG: 180	2176	180	1388	16.5	63.8	0.81
chr1	119029376	119029649	CpG: 25	273	25	169	18.3	61.9	0.97
chr1	119144749	119144988	CpG: 18	239	18	145	15.1	60.7	0.83
chr1	119153478	119154015	CpG: 47	537	47	326	17.5	60.7	0.96
chr1	119165453	119165734	CpG: 22	281	22	173	15.7	61.6	0.84
chr1	119340831	119341140	CpG: 25	309	25	202	16.2	65.4	0.76
chr1	119347950	119348298	CpG: 30	348	30	209	17.2	60.1	0.96
chr1	119590285	119590559	CpG: 21	274	21	168	15.3	61.3	0.82
chr1	119635882	119637206	CpG: 148	1324	148	929	22.4	70.2	0.91
chr1	119644382	119644964	CpG: 44	582	44	398	15.1	68.4	0.65
chr1	119660961	119661835	CpG: 82	874	82	620	18.8	70.9	0.75
chr1	119681691	119681972	CpG: 24	281	24	174	17.1	61.9	0.91
chr1	119725014	119725247	CpG: 18	233	18	136	15.5	58.4	0.96
chr1	119725461	119726116	CpG: 56	655	56	439	17.1	67.0	0.76
chr1	119866424	119866690	CpG: 21	266	21	180	15.8	67.7	0.70
chr1	119909647	119909854	CpG: 22	207	22	138	21.3	66.7	0.96
chr1	120081995	120083150	CpG: 122	1155	122	824	21.1	71.3	0.84
chr1	120189410	120189801	CpG: 32	391	32	235	16.4	60.1	0.91
chr1	120190364	120190604	CpG: 21	240	21	146	17.5	60.8	0.96
chr1	120210363	120210725	CpG: 41	362	41	261	22.7	72.1	0.88
chr1	120242176	120242452	CpG: 25	276	25	171	18.1	62.0	0.95
chr1	120246019	120246459	CpG: 43	440	43	293	19.5	66.6	0.88
chr1	120324943	120325186	CpG: 23	243	23	147	18.9	60.5	1.05
chr1	120334166	120334447	CpG: 22	281	22	174	15.7	61.9	0.83
chr1	120354179	120355713	CpG: 144	1534	144	1035	18.8	67.5	0.82
chr1	120367918	120368245	CpG: 24	327	24	212	14.7	64.8	0.80
chr1	120400819	120401091	CpG: 23	272	23	169	16.9	62.1	0.88
chr1	120408251	120408468	CpG: 18	217	18	130	16.6	59.9	0.94
chr1	120415352	120415629	CpG: 24	277	24	177	17.3	63.9	0.86
chr1	120416136	120416440	CpG: 22	304	22	183	14.5	60.2	0.80
chr1	120425612	120425827	CpG: 15	215	15	130	14.0	60.5	0.78
chr1	120427972	120428871	CpG: 86	899	86	606	19.1	67.4	0.87
chr1	120571016	120572303	CpG: 114	1287	114	831	17.7	64.6	0.85
chr1	120599692	120599935	CpG: 23	243	23	147	18.9	60.5	1.05
chr1	120678433	120678873	CpG: 43	440	43	293	19.5	66.6	0.88
chr1	120682452	120682728	CpG: 26	276	26	172	18.8	62.3	0.98
chr1	120714131	120714493	CpG: 41	362	41	261	22.7	72.1	0.88
chr1	120736905	120738068	CpG: 117	1163	117	826	20.1	71.0	0.81
chr1	120852130	120852366	CpG: 19	236	19	139	16.1	58.9	0.94
chr1	120853651	120854606	CpG: 69	955	69	598	14.5	62.6	0.74
chr1	120856811	120857266	CpG: 33	455	33	280	14.5	61.5	0.77
chr1	120857657	120857867	CpG: 17	210	17	129	16.2	61.4	0.88
chr1	120860096	120860721	CpG: 44	625	44	362	14.1	57.9	0.92
chr1	120862277	120862483	CpG: 15	206	15	122	14.6	59.2	0.84
chr1	120922077	120923646	CpG: 146	1569	146	1064	18.6	67.8	0.81
chr1	120951588	120951977	CpG: 32	389	32	245	16.5	63.0	0.90
chr1	120961883	120962472	CpG: 43	589	43	369	14.6	62.6	0.75
chr1	120992645	120992884	CpG: 22	239	22	166	18.4	69.5	0.77
chr1	121018013	121020307	CpG: 148	2294	148	1365	12.9	59.5	0.73
chr1	121061503	121061829	CpG: 30	326	30	206	18.4	63.2	0.92
chr1	121106590	121107493	CpG: 87	903	87	628	19.3	69.5	0.80
chr1	121124912	121125194	CpG: 26	282	26	177	18.4	62.8	0.94
chr1	121126271	121126696	CpG: 38	425	38	250	17.9	58.8	1.04
chr1	121127591	121127969	CpG: 42	378	42	255	22.2	67.5	0.98
chr1	121152782	121153019	CpG: 17	237	17	135	14.3	57.0	0.93
chr1	121159230	121159511	CpG: 23	281	23	174	16.4	61.9	0.87
chr1	121193295	121196725	CpG: 264	3430	264	2209	15.4	64.4	0.76
chr1	121298459	121298846	CpG: 31	387	31	277	16.0	71.6	0.63
chr1	121405287	121406560	CpG: 154	1273	154	883	24.2	69.4	1.05
chr1	121431441	121431724	CpG: 20	283	20	165	14.1	58.3	0.84
chr1	121528431	121529099	CpG: 75	668	75	482	22.5	72.2	0.87
chr1	121547192	121547619	CpG: 30	427	30	254	14.1	59.5	0.80
chr1	121677273	121677565	CpG: 27	292	27	181	18.5	62.0	0.98
chr1	126641723	126642149	CpG: 33	426	33	256	15.5	60.1	0.86
chr1	126846324	126848844	CpG: 314	2520	314	1749	24.9	69.4	1.16
chr1	126879039	126880584	CpG: 171	1545	171	1014	22.1	65.6	1.07
chr1	127719898	127720110	CpG: 18	212	18	155	17.0	73.1	0.67
chr1	127773789	127774048	CpG: 19	259	19	171	14.7	66.0	0.67
chr1	127775702	127776009	CpG: 28	307	28	212	18.2	69.1	0.77
chr1	127780299	127780650	CpG: 28	351	28	250	16.0	71.2	0.63
chr1	127933583	127933984	CpG: 34	401	34	284	17.0	70.8	0.69
chr1	128098992	128099239	CpG: 19	247	19	168	15.4	68.0	0.67
chr1	128121332	128121932	CpG: 45	600	45	393	15.0	65.5	0.70
chr1	128129502	128130914	CpG: 102	1412	102	957	14.4	67.8	0.63
chr1	128138305	128139106	CpG: 57	801	57	532	14.2	66.4	0.65
chr1	128139903	128140219	CpG: 25	316	25	219	15.8	69.3	0.71
chr1	128148131	128149289	CpG: 83	1158	83	783	14.3	67.6	0.63
chr1	128149422	128149787	CpG: 25	365	25	240	13.7	65.8	0.70
chr1	128153575	128153883	CpG: 25	308	25	212	16.2	68.8	0.72
chr1	128154451	128156168	CpG: 113	1717	113	1126	13.2	65.6	0.61
chr1	128165410	128165816	CpG: 31	406	31	284	15.3	70.0	0.65
chr1	128193555	128194582	CpG: 69	1027	69	681	13.4	66.3	0.61
chr1	128202065	128202269	CpG: 15	204	15	143	14.7	70.1	0.69
chr1	128208921	128210095	CpG: 86	1174	86	797	14.7	67.9	0.64
chr1	128217086	128219068	CpG: 135	1982	135	1312	13.6	66.2	0.62
chr1	128221895	128222124	CpG: 18	229	18	159	15.7	69.4	0.70
chr1	128229489	128230022	CpG: 42	533	42	377	15.8	70.7	0.63
chr1	128239517	128240050	CpG: 42	533	42	377	15.8	70.7	0.63
chr1	128250177	128250598	CpG: 41	421	41	278	19.5	66.0	0.90
chr1	128254607	128256470	CpG: 126	1863	126	1239	13.5	66.5	0.61
chr1	128256681	128257015	CpG: 24	334	24	208	14.4	62.3	0.76
chr1	128262007	128262732	CpG: 57	725	57	474	15.7	65.4	0.74
chr1	128264743	128265020	CpG: 21	277	21	170	15.2	61.4	0.82
chr1	128267655	128267909	CpG: 20	254	20	176	15.7	69.3	0.71
chr1	128268082	128268628	CpG: 39	546	39	377	14.3	69.0	0.60
chr1	128275051	128275758	CpG: 49	707	49	467	13.9	66.1	0.65
chr1	128288296	128289437	CpG: 90	1141	90	770	15.8	67.5	0.69
chr1	128299397	128299982	CpG: 50	585	50	427	17.1	73.0	0.64
chr1	128304949	128306304	CpG: 89	1355	89	893	13.1	65.9	0.61
chr1	128314595	128315822	CpG: 82	1227	82	814	13.4	66.3	0.61
chr1	128342986	128343189	CpG: 17	203	17	135	16.7	66.5	0.81
chr1	128343777	128344942	CpG: 94	1165	94	798	16.1	68.5	0.69
chr1	128350631	128351373	CpG: 61	742	61	516	16.4	69.5	0.68
chr1	128356407	128356636	CpG: 22	229	22	152	19.2	66.4	0.87
chr1	128361451	128362479	CpG: 77	1028	77	695	15.0	67.6	0.66
chr1	128370132	128370703	CpG: 41	571	41	361	14.4	63.2	0.72
chr1	128380408	128380729	CpG: 25	321	25	201	15.6	62.6	0.80
chr1	128381004	128382680	CpG: 112	1676	112	1115	13.4	66.5	0.60
chr1	128389228	128389457	CpG: 18	229	18	152	15.7	66.4	0.73
chr1	128389995	128391547	CpG: 102	1552	102	1023	13.1	65.9	0.61
chr1	128399060	128399560	CpG: 35	500	35	340	14.0	68.0	0.62
chr1	128407720	128408085	CpG: 29	365	29	235	15.9	64.4	0.77
chr1	128414841	128415778	CpG: 68	937	68	612	14.5	65.3	0.68
chr1	128421957	128423032	CpG: 78	1075	78	714	14.5	66.4	0.66
chr1	128436161	128436774	CpG: 49	613	49	431	16.0	70.3	0.65
chr1	128458875	128459626	CpG: 55	751	55	494	14.6	65.8	0.68
chr1	128470870	128471579	CpG: 58	709	58	487	16.4	68.7	0.69
chr1	128474849	128475059	CpG: 15	210	15	140	14.3	66.7	0.68
chr1	128488147	128489876	CpG: 118	1729	118	1164	13.6	67.3	0.60
chr1	128500945	128501211	CpG: 22	266	22	186	16.5	69.9	0.68
chr1	128501508	128501778	CpG: 20	270	20	178	14.8	65.9	0.68
chr1	128502209	128502479	CpG: 21	270	21	164	15.6	60.7	0.86
chr1	128522750	128523687	CpG: 66	937	66	622	14.1	66.4	0.64
chr1	128541651	128541922	CpG: 22	271	22	179	16.2	66.1	0.75
chr1	128546828	128547128	CpG: 23	300	23	198	15.3	66.0	0.73
chr1	128551356	128552251	CpG: 62	895	62	584	13.9	65.3	0.65
chr1	128562809	128563178	CpG: 29	369	29	241	15.7	65.3	0.74
chr1	128572348	128573261	CpG: 63	913	63	603	13.8	66.0	0.63
chr1	128583024	128584104	CpG: 75	1080	75	728	13.9	67.4	0.61
chr1	128588877	128590261	CpG: 96	1384	96	925	13.9	66.8	0.62
chr1	128802104	128804135	CpG: 209	2031	209	1338	20.6	65.9	0.97
chr1	128837187	128837511	CpG: 27	324	27	229	16.7	70.7	0.67
chr1	128911386	128911616	CpG: 20	230	20	137	17.4	59.6	0.99
chr1	128921793	128923465	CpG: 196	1672	196	1124	23.4	67.2	1.08
chr1	128947703	128950731	CpG: 352	3028	352	2071	23.2	68.4	1.08
chr1	128983750	128985781	CpG: 209	2031	209	1338	20.6	65.9	0.97
chr1	142280494	142286285	CpG: 715	5791	715	4042	24.7	69.8	1.11
chr1	142307932	142310820	CpG: 373	2888	373	2022	25.8	70.0	1.18
chr1	142398550	142399763	CpG: 235	1213	235	976	38.7	80.5	1.32
chr1	142405956	142406734	CpG: 65	778	65	521	16.7	67.0	0.75
chr1	142425592	142426769	CpG: 113	1177	113	853	19.2	72.5	0.75
chr1	142496767	142497074	CpG: 31	307	31	209	20.2	68.1	0.88
chr1	142521442	142521667	CpG: 17	225	17	138	15.1	61.3	0.80
chr1	142521897	142523362	CpG: 124	1465	124	987	16.9	67.4	0.74
chr1	142559874	142560206	CpG: 28	332	28	217	16.9	65.4	0.80
chr1	142569200	142571020	CpG: 218	1820	218	1276	24.0	70.1	1.04
chr1	142647072	142647352	CpG: 20	280	20	193	14.3	68.9	0.61
chr1	142709331	142711216	CpG: 164	1885	164	1434	17.4	76.1	0.60
chr1	142715019	142715876	CpG: 76	857	76	578	17.7	67.4	0.79
chr1	142723675	142724553	CpG: 57	878	57	553	13.0	63.0	0.66
chr1	142725612	142725841	CpG: 19	229	19	153	16.6	66.8	0.75
chr1	142726717	142726972	CpG: 19	255	19	158	14.9	62.0	0.78
chr1	142733173	142733401	CpG: 18	228	18	133	15.8	58.3	0.93
chr1	142733591	142734156	CpG: 46	565	46	342	16.3	60.5	0.89
chr1	142739874	142740100	CpG: 20	226	20	148	17.7	65.5	0.83
chr1	142800251	142800515	CpG: 20	264	20	158	15.2	59.8	0.85
chr1	142801715	142802119	CpG: 30	404	30	268	14.9	66.3	0.74
chr1	142808244	142808670	CpG: 30	426	30	272	14.1	63.8	0.69
chr1	142838454	142838715	CpG: 25	261	25	183	19.2	70.1	0.78
chr1	142864282	142866209	CpG: 127	1927	127	1158	13.2	60.1	0.73
chr1	142910479	142910875	CpG: 35	396	35	255	17.7	64.4	0.85
chr1	142911271	142911597	CpG: 31	326	31	207	19.0	63.5	0.94
chr1	142914982	142915256	CpG: 24	274	24	172	17.5	62.8	0.90
chr1	142956653	142957514	CpG: 87	861	87	606	20.2	70.4	0.82
chr1	142974924	142975206	CpG: 26	282	26	177	18.4	62.8	0.95
chr1	142976268	142976693	CpG: 42	425	42	253	19.8	59.5	1.12
chr1	142977341	142977961	CpG: 55	620	55	392	17.7	63.2	0.89
chr1	142988884	142989120	CpG: 21	236	21	144	17.8	61.0	0.98
chr1	142995304	142995589	CpG: 24	285	24	179	16.8	62.8	0.87
chr1	143003383	143003621	CpG: 17	238	17	135	14.3	56.7	0.93
chr1	143043603	143047023	CpG: 264	3420	264	2202	15.4	64.4	0.76
chr1	143148418	143150129	CpG: 217	1711	217	1203	25.4	70.3	1.15
chr1	143217358	143217594	CpG: 22	236	22	147	18.6	62.3	0.99
chr1	143252735	143254310	CpG: 306	1575	306	1277	38.9	81.1	1.32
chr1	143260507	143261285	CpG: 64	778	64	520	16.5	66.8	0.74
chr1	143280125	143281283	CpG: 109	1158	109	838	18.8	72.4	0.74
chr1	143351259	143351566	CpG: 31	307	31	210	20.2	68.4	0.87
chr1	143375913	143376138	CpG: 17	225	17	136	15.1	60.4	0.83
chr1	143376368	143377833	CpG: 126	1465	126	990	17.2	67.6	0.75
chr1	143414344	143414709	CpG: 29	365	29	239	15.9	65.5	0.75
chr1	143423672	143425428	CpG: 204	1756	204	1222	23.2	69.6	1.01
chr1	143494860	143495070	CpG: 18	210	18	129	17.1	61.4	0.93
chr1	143495461	143495733	CpG: 23	272	23	177	16.9	65.1	0.80
chr1	143498163	143499103	CpG: 71	940	71	599	15.1	63.7	0.75
chr1	143500413	143500649	CpG: 19	236	19	141	16.1	59.7	0.92
chr1	143505376	143505773	CpG: 30	397	30	259	15.1	65.2	0.76
chr1	143506981	143507245	CpG: 20	264	20	159	15.2	60.2	0.84
chr1	143512534	143512772	CpG: 19	238	19	145	16.0	60.9	0.89
chr1	143514346	143514658	CpG: 28	312	28	202	17.9	64.7	0.93
chr1	143518900	143519155	CpG: 22	255	22	158	17.3	62.0	0.91
chr1	143519591	143519907	CpG: 23	316	23	199	14.6	63.0	0.77
chr1	143526398	143526676	CpG: 22	278	22	193	15.8	69.4	0.66
chr1	143604605	143605591	CpG: 95	986	95	667	19.3	67.6	0.86
chr1	143645742	143645978	CpG: 19	236	19	140	16.1	59.3	0.93
chr1	143647270	143648214	CpG: 72	944	72	601	15.3	63.7	0.76
chr1	143650621	143650903	CpG: 22	282	22	182	15.6	64.5	0.75
chr1	143651294	143651504	CpG: 19	210	19	129	18.1	61.4	0.99
chr1	143653749	143654374	CpG: 46	625	46	379	14.7	60.6	0.87
chr1	143656528	143656780	CpG: 18	252	18	153	14.3	60.7	0.78
chr1	143741982	143743344	CpG: 154	1362	154	947	22.6	69.5	0.97
chr1	143752026	143752679	CpG: 46	653	46	426	14.1	65.2	0.67
chr1	143789226	143790691	CpG: 127	1465	127	992	17.3	67.7	0.76
chr1	143790921	143791146	CpG: 17	225	17	137	15.1	60.9	0.82
chr1	143815519	143815826	CpG: 31	307	31	210	20.2	68.4	0.87
chr1	143885825	143887003	CpG: 112	1178	112	854	19.0	72.5	0.74
chr1	143905873	143906651	CpG: 65	778	65	521	16.7	67.0	0.75
chr1	143912848	143914053	CpG: 233	1205	233	969	38.7	80.4	1.33
chr1	143946941	143947177	CpG: 22	236	22	147	18.6	62.3	0.99
chr1	144007129	144008839	CpG: 217	1710	217	1202	25.4	70.3	1.15
chr1	144049209	144049475	CpG: 22	266	22	161	16.5	60.5	0.92
chr1	144115394	144115781	CpG: 31	387	31	278	16.0	71.8	0.62
chr1	144134040	144134318	CpG: 25	278	25	175	18.0	62.9	0.92
chr1	144217696	144221116	CpG: 264	3420	264	2202	15.4	64.4	0.76
chr1	144291811	144293737	CpG: 125	1926	125	1158	13.0	60.1	0.72
chr1	144339568	144341119	CpG: 146	1551	146	1052	18.8	67.8	0.82
chr1	144357563	144357769	CpG: 37	206	37	169	35.9	82.0	1.07
chr1	144403097	144403303	CpG: 15	206	15	123	14.6	59.7	0.83
chr1	144405502	144406133	CpG: 46	631	46	375	14.6	59.4	0.91
chr1	144408381	144408591	CpG: 18	210	18	128	17.1	61.0	0.95
chr1	144408982	144409254	CpG: 22	272	22	177	16.2	65.1	0.77
chr1	144411638	144412581	CpG: 68	943	68	594	14.4	63.0	0.73
chr1	144413883	144414119	CpG: 17	236	17	138	14.4	58.5	0.85
chr1	144525651	144525924	CpG: 24	273	24	171	17.6	62.6	0.91
chr1	144541839	144542846	CpG: 99	1007	99	688	19.7	68.3	0.86
chr1	144548019	144549063	CpG: 75	1044	75	655	14.4	62.7	0.73
chr1	144555169	144555442	CpG: 22	273	22	165	16.1	60.4	0.91
chr1	144556177	144556447	CpG: 23	270	23	169	17.0	62.6	0.88
chr1	144564170	144564670	CpG: 36	500	36	314	14.4	62.8	0.74
chr1	144570778	144571538	CpG: 86	760	86	527	22.6	69.3	0.94
chr1	144576568	144576927	CpG: 29	359	29	222	16.2	61.8	0.85
chr1	144582716	144583163	CpG: 31	447	31	277	13.9	62.0	0.75
chr1	144592179	144593195	CpG: 76	1016	76	607	15.0	59.7	0.84
chr1	144593485	144593734	CpG: 22	249	22	151	17.7	60.6	0.99
chr1	144604047	144604439	CpG: 38	392	38	256	19.4	65.3	0.91
chr1	144604998	144605340	CpG: 26	342	26	214	15.2	62.6	0.80
chr1	144622555	144623112	CpG: 48	557	48	382	17.2	68.6	0.74
chr1	144724632	144725348	CpG: 66	716	66	481	18.4	67.2	0.82
chr1	144810276	144810493	CpG: 17	217	17	131	15.7	60.4	0.87
chr1	144837660	144837903	CpG: 18	243	18	162	14.8	66.7	0.67
chr1	144839436	144839678	CpG: 19	242	19	145	15.7	59.9	0.89
chr1	144880849	144881656	CpG: 65	807	65	570	16.1	70.6	0.65
chr1	144940396	144941236	CpG: 87	840	87	550	20.7	65.5	0.97
chr1	144962335	144962735	CpG: 40	400	40	277	20.0	69.2	0.84
chr1	144975502	144976748	CpG: 101	1246	101	832	16.2	66.8	0.73
chr1	144978316	144978541	CpG: 21	225	21	137	18.7	60.9	1.05
chr1	145002570	145003076	CpG: 36	506	36	344	14.2	68.0	0.62
chr1	145024645	145024878	CpG: 17	233	17	140	14.6	60.1	0.83
chr1	145035270	145035869	CpG: 48	599	48	372	16.0	62.1	0.86
chr1	145043980	145044323	CpG: 26	343	26	198	15.2	57.7	1.01
chr1	145051113	145051388	CpG: 21	275	21	166	15.3	60.4	0.85
chr1	145074423	145074880	CpG: 45	457	45	343	19.7	75.1	0.70
chr1	145077200	145078922	CpG: 130	1722	130	1119	15.1	65.0	0.72
chr1	145081233	145081665	CpG: 31	432	31	255	14.4	59.0	0.83
chr1	145087411	145087680	CpG: 20	269	20	160	14.9	59.5	0.85
chr1	145113425	145113628	CpG: 18	203	18	129	17.7	63.5	0.88
chr1	145117878	145118154	CpG: 24	276	24	169	17.4	61.2	0.94
chr1	145132083	145132587	CpG: 37	504	37	275	14.7	54.6	0.99
chr1	145136187	145136484	CpG: 29	297	29	209	19.5	70.4	0.83
chr1	145144173	145144447	CpG: 22	274	22	169	16.1	61.7	0.86
chr1	145151436	145151678	CpG: 20	242	20	143	16.5	59.1	0.98
chr1	145154644	145155249	CpG: 43	605	43	326	14.2	53.9	0.99
chr1	145166243	145166595	CpG: 30	352	30	220	17.0	62.5	0.90
chr1	145169144	145169469	CpG: 27	325	27	217	16.6	66.8	0.80
chr1	145344965	145346139	CpG: 126	1174	126	841	21.5	71.6	0.85
chr1	145368830	145369241	CpG: 30	411	30	250	14.6	60.8	0.79
chr1	145380096	145380333	CpG: 17	237	17	141	14.3	59.5	0.82
chr1	145402306	145403017	CpG: 52	711	52	388	14.6	54.6	0.98
chr1	145415385	145415857	CpG: 62	472	62	346	26.3	73.3	0.98
chr1	145475317	145475679	CpG: 41	362	41	262	22.7	72.4	0.87
chr1	145507139	145507415	CpG: 26	276	26	172	18.8	62.3	0.98
chr1	145510995	145511435	CpG: 42	440	42	291	19.1	66.1	0.87
chr1	145524163	145524444	CpG: 24	281	24	173	17.1	61.6	0.92
chr1	145589415	145589636	CpG: 16	221	16	131	14.5	59.3	0.83
chr1	145590331	145590575	CpG: 23	244	23	149	18.9	61.1	1.03
chr1	145618664	145619940	CpG: 114	1276	114	822	17.9	64.4	0.87
chr1	145760559	145761551	CpG: 99	992	99	671	20.0	67.6	0.89
chr1	145820558	145820946	CpG: 30	388	30	241	15.5	62.1	0.90
chr1	145833167	145834721	CpG: 145	1554	145	1055	18.7	67.9	0.81
chr1	145864154	145864398	CpG: 23	244	23	149	18.9	61.1	1.03
chr1	145943270	145943709	CpG: 43	439	43	291	19.6	66.3	0.89
chr1	145947288	145947564	CpG: 26	276	26	172	18.8	62.3	0.98
chr1	145979017	145979379	CpG: 41	362	41	262	22.7	72.4	0.87
chr1	146038861	146039353	CpG: 65	492	65	364	26.4	74.0	0.97
chr1	146051723	146052444	CpG: 53	721	53	385	14.7	53.4	1.03
chr1	146074415	146074652	CpG: 17	237	17	141	14.3	59.5	0.82
chr1	146108282	146109456	CpG: 126	1174	126	839	21.5	71.5	0.85
chr1	146278007	146278957	CpG: 71	950	71	602	14.9	63.4	0.75
chr1	146281426	146281628	CpG: 19	202	19	132	18.8	65.3	0.88
chr1	146282019	146282229	CpG: 19	210	19	130	18.1	61.9	0.96
chr1	146284472	146285101	CpG: 43	629	43	374	13.7	59.5	0.86
chr1	146303118	146303392	CpG: 23	274	23	172	16.8	62.8	0.86
chr1	146347019	146348573	CpG: 148	1554	148	1055	19.0	67.9	0.83
chr1	146404629	146404995	CpG: 33	366	33	233	18.0	63.7	0.99
chr1	146427827	146428147	CpG: 22	320	22	214	13.8	66.9	0.62
chr1	146444441	146444780	CpG: 24	339	24	224	14.2	66.1	0.74
chr1	146447955	146448228	CpG: 21	273	21	161	15.4	59.0	0.89
chr1	146453062	146453283	CpG: 16	221	16	134	14.5	60.6	0.81
chr1	146472288	146472593	CpG: 21	305	21	181	13.8	59.3	0.82
chr1	146489510	146489959	CpG: 34	449	34	292	15.1	65.0	0.72
chr1	146496923	146497416	CpG: 37	493	37	303	15.0	61.5	0.80
chr1	146503896	146504694	CpG: 57	798	57	478	14.3	59.9	0.80
chr1	146525885	146526622	CpG: 53	737	53	446	14.4	60.5	0.79
chr1	146542289	146542685	CpG: 27	396	27	241	13.6	60.9	0.74
chr1	146543949	146544251	CpG: 26	302	26	193	17.2	63.9	0.93
chr1	146560620	146561538	CpG: 70	918	70	571	15.3	62.2	0.80
chr1	146646348	146647906	CpG: 97	1558	97	957	12.5	61.4	0.66
chr1	146649369	146649652	CpG: 26	283	26	174	18.4	61.5	0.99
chr1	146655035	146656045	CpG: 93	1010	93	691	18.4	68.4	0.80
chr1	146657727	146658487	CpG: 78	760	78	539	20.5	70.9	0.82
chr1	146660482	146661336	CpG: 79	854	79	619	18.5	72.5	0.70
chr1	146728026	146728583	CpG: 48	557	48	382	17.2	68.6	0.74
chr1	146745829	146747106	CpG: 87	1277	87	738	13.6	57.8	0.82
chr1	146757416	146757665	CpG: 22	249	22	150	17.7	60.2	1.00
chr1	146757955	146758971	CpG: 76	1016	76	605	15.0	59.5	0.85
chr1	146767986	146768433	CpG: 31	447	31	277	13.9	62.0	0.75
chr1	146774229	146774588	CpG: 29	359	29	222	16.2	61.8	0.85
chr1	146785951	146786224	CpG: 22	273	22	166	16.1	60.8	0.89
chr1	146792343	146793387	CpG: 72	1044	72	649	13.8	62.2	0.72
chr1	146802961	146803174	CpG: 16	213	16	122	15.0	57.3	0.94
chr1	146878575	146879308	CpG: 68	733	68	496	18.6	67.7	0.81
chr1	146899303	146899647	CpG: 31	344	31	218	18.0	63.4	0.90
chr1	147126577	147126981	CpG: 33	404	33	294	16.3	72.8	0.62
chr1	147136934	147138010	CpG: 80	1076	80	697	14.9	64.8	0.71
chr1	147207619	147208621	CpG: 113	1002	113	760	22.6	75.8	0.81
chr1	147211364	147211643	CpG: 20	279	20	174	14.3	62.4	0.74
chr1	147384703	147384945	CpG: 18	242	18	146	14.9	60.3	0.82
chr1	147414971	147415247	CpG: 23	276	23	173	16.7	62.7	0.86
chr1	147480498	147480858	CpG: 26	360	26	207	14.4	57.5	0.88
chr1	147564733	147565922	CpG: 110	1189	110	768	18.5	64.6	0.89
chr1	147630135	147630365	CpG: 34	230	34	168	29.6	73.0	1.15
chr1	147635099	147636517	CpG: 118	1418	118	927	16.6	65.4	0.78
chr1	147722980	147724050	CpG: 69	1070	69	583	12.9	54.5	0.90
chr1	147727410	147727659	CpG: 20	249	20	160	16.1	64.3	0.78
chr1	147728017	147730136	CpG: 146	2119	146	1299	13.8	61.3	0.73
chr1	147735546	147735948	CpG: 34	402	34	246	16.9	61.2	0.91
chr1	147746555	147747007	CpG: 30	452	30	290	13.3	64.2	0.65
chr1	147757401	147757738	CpG: 31	337	31	240	18.4	71.2	0.74
chr1	147869064	147870159	CpG: 107	1095	107	749	19.5	68.4	0.84
chr1	147875528	147875811	CpG: 25	283	25	173	17.7	61.1	0.96
chr1	148085199	148085626	CpG: 35	427	35	259	16.4	60.7	0.90
chr1	148123549	148123832	CpG: 26	283	26	180	18.4	63.6	0.92
chr1	148195708	148195943	CpG: 21	235	21	143	17.9	60.9	1.01
chr1	148261485	148261701	CpG: 18	216	18	134	16.7	62.0	0.88
chr1	148320862	148321780	CpG: 68	918	68	572	14.8	62.3	0.77
chr1	148335676	148336157	CpG: 40	481	40	319	16.6	66.3	0.77
chr1	148350656	148350960	CpG: 24	304	24	187	15.8	61.5	0.84
chr1	148358296	148358513	CpG: 17	217	17	130	15.7	59.9	0.88
chr1	148379826	148380099	CpG: 22	273	22	170	16.1	62.3	0.84
chr1	148398423	148398811	CpG: 29	388	29	241	14.9	62.1	0.87
chr1	148414404	148414685	CpG: 24	281	24	196	17.1	69.8	0.70
chr1	148421076	148421422	CpG: 26	346	26	221	15.0	63.9	0.78
chr1	148421854	148422109	CpG: 21	255	21	158	16.5	62.0	0.87
chr1	148430128	148430392	CpG: 20	264	20	163	15.2	61.7	0.80
chr1	148431204	148432005	CpG: 53	801	53	464	13.2	57.9	0.83
chr1	148436685	148436921	CpG: 19	236	19	140	16.1	59.3	0.93
chr1	148438247	148439158	CpG: 68	911	68	578	14.9	63.4	0.75
chr1	148441402	148441857	CpG: 33	455	33	279	14.5	61.3	0.78
chr1	148442244	148442458	CpG: 20	214	20	134	18.7	62.6	0.99
chr1	148471649	148471923	CpG: 22	274	22	169	16.1	61.7	0.86
chr1	148519269	148520437	CpG: 126	1168	126	834	21.6	71.4	0.86
chr1	148521688	148521961	CpG: 25	273	25	170	18.3	62.3	0.95
chr1	148546035	148546304	CpG: 21	269	21	166	15.6	61.7	0.83
chr1	148681051	148681287	CpG: 18	236	18	138	15.3	58.5	0.90
chr1	148682579	148683531	CpG: 71	952	71	599	14.9	62.9	0.76
chr1	148685935	148686140	CpG: 19	205	19	133	18.5	64.9	0.88
chr1	148730949	148732494	CpG: 146	1545	146	1044	18.9	67.6	0.83
chr1	148760495	148760884	CpG: 34	389	34	247	17.5	63.5	0.96
chr1	148770784	148771373	CpG: 43	589	43	369	14.6	62.6	0.75
chr1	148824923	148826850	CpG: 128	1927	128	1158	13.3	60.1	0.74
chr1	148871140	148871516	CpG: 34	376	34	244	18.1	64.9	0.86
chr1	148871912	148872238	CpG: 30	326	30	206	18.4	63.2	0.92
chr1	148916714	148917575	CpG: 86	861	86	603	20.0	70.0	0.82
chr1	148936104	148936604	CpG: 45	500	45	284	18.0	56.8	1.12
chr1	148937172	148937792	CpG: 58	620	58	397	18.7	64.0	0.91
chr1	148956271	148957358	CpG: 86	1087	86	628	15.8	57.8	0.95
chr1	148961222	148961458	CpG: 19	236	19	140	16.1	59.3	0.92
chr1	148964332	148967617	CpG: 299	3285	299	2076	18.2	63.2	0.92
chr1	148974474	148977764	CpG: 300	3290	300	2083	18.2	63.3	0.92
chr1	148980644	148980880	CpG: 19	236	19	140	16.1	59.3	0.92
chr1	148984744	148985831	CpG: 86	1087	86	628	15.8	57.8	0.95
chr1	149010357	149012058	CpG: 133	1701	133	975	15.6	57.3	0.95
chr1	149023668	149024535	CpG: 75	867	75	566	17.3	65.3	0.81
chr1	149052216	149052484	CpG: 30	268	30	177	22.4	66.0	1.04
chr1	149134746	149135453	CpG: 70	707	70	492	19.8	69.6	0.83
chr1	149191848	149192339	CpG: 35	491	35	293	14.3	59.7	0.81
chr1	149274182	149275565	CpG: 190	1383	190	1029	27.5	74.4	1.00
chr1	149338407	149338611	CpG: 21	204	21	131	20.6	64.2	1.00
chr1	149346953	149347156	CpG: 14	203	14	117	13.8	57.6	0.84
chr1	149356933	149357173	CpG: 22	240	22	149	18.3	62.1	0.97
chr1	149359499	149360370	CpG: 97	871	97	582	22.3	66.8	1.00
chr1	149393564	149394171	CpG: 54	607	54	399	17.8	65.7	0.82
chr1	149406879	149407151	CpG: 22	272	22	159	16.2	58.5	0.95
chr1	149419005	149419218	CpG: 17	213	17	111	16.0	52.1	1.20
chr1	149435682	149435905	CpG: 16	223	16	131	14.3	58.7	0.85
chr1	149436069	149436540	CpG: 33	471	33	269	14.0	57.1	0.86
chr1	149445400	149445631	CpG: 18	231	18	135	15.6	58.4	0.92
chr1	149446002	149446683	CpG: 59	681	59	411	17.3	60.4	0.97
chr1	149489435	149489880	CpG: 40	445	40	270	18.0	60.7	0.99
chr1	149490729	149490974	CpG: 19	245	19	147	15.5	60.0	0.88
chr1	149501667	149501907	CpG: 20	240	20	149	16.7	62.1	0.88
chr1	149640398	149640866	CpG: 44	468	44	330	18.8	70.5	0.76
chr1	149672901	149673920	CpG: 120	1019	120	761	23.6	74.7	0.84
chr1	149681213	149681462	CpG: 18	249	18	170	14.5	68.3	0.65
chr1	149685633	149685859	CpG: 19	226	19	155	16.8	68.6	0.72
chr1	149702877	149703884	CpG: 111	1007	111	681	22.0	67.6	0.96
chr1	149708120	149708353	CpG: 16	233	16	135	13.7	57.9	0.83
chr1	149711938	149712219	CpG: 24	281	24	175	17.1	62.3	0.90
chr1	149753268	149753759	CpG: 35	491	35	303	14.3	61.7	0.75
chr1	149754060	149754374	CpG: 22	314	22	172	14.0	54.8	0.95
chr1	149807329	149807561	CpG: 19	232	19	141	16.4	60.8	0.91
chr1	149904818	149905636	CpG: 64	818	64	562	15.6	68.7	0.67
chr1	149916156	149916437	CpG: 22	281	22	173	15.7	61.6	0.84
chr1	149974078	149975082	CpG: 80	1004	80	706	15.9	70.3	0.65
chr1	149999930	150000818	CpG: 68	888	68	578	15.3	65.1	0.74
chr1	150009598	150009848	CpG: 18	250	18	146	14.4	58.4	0.86
chr1	150048482	150048684	CpG: 16	202	16	118	15.8	58.4	0.94
chr1	150048802	150049066	CpG: 20	264	20	154	15.2	58.3	0.90
chr1	150049245	150049512	CpG: 24	267	24	170	18.0	63.7	0.91
chr1	150049828	150050137	CpG: 27	309	27	186	17.5	60.2	0.99
chr1	150097717	150099474	CpG: 190	1757	190	1249	21.6	71.1	0.87
chr1	150131949	150132306	CpG: 42	357	42	246	23.5	68.9	1.00
chr1	150170662	150170936	CpG: 21	274	21	163	15.3	59.5	0.87
chr1	150171366	150171831	CpG: 49	465	49	324	21.1	69.7	0.87
chr1	150182966	150183551	CpG: 53	585	53	413	18.1	70.6	0.73
chr1	150187160	150187396	CpG: 18	236	18	143	15.3	60.6	0.87
chr1	150193505	150194941	CpG: 94	1436	94	837	13.1	58.3	0.78
chr1	150235200	150235426	CpG: 16	226	16	135	14.2	59.7	0.81
chr1	150249324	150249599	CpG: 24	275	24	169	17.5	61.5	0.93
chr1	150254908	150257323	CpG: 214	2415	214	1647	17.7	68.2	0.77
chr1	150269274	150270598	CpG: 113	1324	113	888	17.1	67.1	0.76
chr1	150321041	150321308	CpG: 21	267	21	167	15.7	62.5	0.82
chr1	150322104	150322789	CpG: 52	685	52	412	15.2	60.1	0.86
chr1	150335376	150335656	CpG: 21	280	21	171	15.0	61.1	0.82
chr1	150377912	150378714	CpG: 52	802	52	487	13.0	60.7	0.71
chr1	150404122	150404539	CpG: 29	417	29	240	13.9	57.6	0.85
chr1	150404875	150406987	CpG: 162	2112	162	1366	15.3	64.7	0.73
chr1	150451744	150451946	CpG: 21	202	21	119	20.8	58.9	1.21
chr1	150470553	150470772	CpG: 18	219	18	150	16.4	68.5	0.73
chr1	150513731	150514008	CpG: 22	277	22	167	15.9	60.3	0.88
chr1	150523090	150523815	CpG: 58	725	58	419	16.0	57.8	0.96
chr1	150582216	150583252	CpG: 151	1036	151	796	29.2	76.8	0.99
chr1	150597089	150597360	CpG: 29	271	29	189	21.4	69.7	0.98
chr1	150634791	150635342	CpG: 65	551	65	410	23.6	74.4	0.85
chr1	150663855	150664504	CpG: 63	649	63	421	19.4	64.9	0.92
chr1	150735264	150736096	CpG: 100	832	100	619	24.0	74.4	0.87
chr1	150790932	150791208	CpG: 23	276	23	170	16.7	61.6	0.89
chr1	150811034	150811303	CpG: 24	269	24	168	17.8	62.5	0.92
chr1	150844835	150845193	CpG: 35	358	35	257	19.6	71.8	0.77
chr1	150886358	150887006	CpG: 60	648	60	436	18.5	67.3	0.83
chr1	150892576	150893421	CpG: 70	845	70	604	16.6	71.5	0.65
chr1	150913613	150915072	CpG: 108	1459	108	906	14.8	62.1	0.77
chr1	150961482	150962706	CpG: 154	1224	154	903	25.2	73.8	0.93
chr1	150963275	150963547	CpG: 30	272	30	190	22.1	69.9	0.98
chr1	151032791	151033435	CpG: 67	644	67	451	20.8	70.0	0.85
chr1	151097847	151098119	CpG: 22	272	22	165	16.2	60.7	0.89
chr1	151103182	151103440	CpG: 20	258	20	156	15.5	60.5	0.86
chr1	151116702	151117938	CpG: 115	1236	115	845	18.6	68.4	0.80
chr1	151159907	151160181	CpG: 23	274	23	171	16.8	62.4	0.86
chr1	151161136	151161483	CpG: 28	347	28	205	16.1	59.1	0.93
chr1	151231090	151236290	CpG: 377	5200	377	3188	14.5	61.3	0.84
chr1	151312412	151313019	CpG: 51	607	51	402	16.8	66.2	0.77
chr1	151319657	151320323	CpG: 53	666	53	485	15.9	72.8	0.60
chr1	151339951	151340164	CpG: 16	213	16	136	15.0	63.8	0.74
chr1	151341361	151341574	CpG: 18	213	18	137	16.9	64.3	0.82
chr1	151342771	151342984	CpG: 16	213	16	136	15.0	63.8	0.74
chr1	151344181	151344394	CpG: 18	213	18	137	16.9	64.3	0.82
chr1	151346299	151346512	CpG: 17	213	17	137	16.0	64.3	0.77
chr1	151348417	151348630	CpG: 17	213	17	137	16.0	64.3	0.77
chr1	151349827	151350040	CpG: 18	213	18	138	16.9	64.8	0.81
chr1	151351945	151352158	CpG: 17	213	17	137	16.0	64.3	0.77
chr1	151353355	151353568	CpG: 18	213	18	138	16.9	64.8	0.81
chr1	151521907	151522143	CpG: 21	236	21	145	17.8	61.4	0.96
chr1	151599160	151599433	CpG: 23	273	23	164	16.8	60.1	0.95
chr1	151651916	151652343	CpG: 42	427	42	307	19.7	71.9	0.77
chr1	151729047	151729278	CpG: 22	231	22	140	19.0	60.6	1.05
chr1	151897027	151897407	CpG: 25	380	25	238	13.2	62.6	0.73
chr1	152018047	152018332	CpG: 23	285	23	177	16.1	62.1	0.85
chr1	152061622	152061896	CpG: 22	274	22	169	16.1	61.7	0.85
chr1	152086010	152086251	CpG: 18	241	18	143	14.9	59.3	0.88
chr1	152398212	152399065	CpG: 113	853	113	657	26.5	77.0	0.92
chr1	152659042	152659423	CpG: 40	381	40	283	21.0	74.3	0.76
chr1	152673204	152673620	CpG: 40	416	40	282	19.2	67.8	0.84
chr1	152712258	152712784	CpG: 45	526	45	375	17.1	71.3	0.67
chr1	152719698	152720599	CpG: 74	901	74	628	16.4	69.7	0.68
chr1	152769597	152769835	CpG: 16	238	16	143	13.4	60.1	0.77
chr1	152770965	152771762	CpG: 68	797	68	501	17.1	62.9	0.87
chr1	152794613	152794871	CpG: 18	258	18	160	14.0	62.0	0.73
chr1	152795854	152796158	CpG: 36	304	36	214	23.7	70.4	0.96
chr1	152808107	152808318	CpG: 19	211	19	118	18.0	55.9	1.24
chr1	152815619	152817164	CpG: 158	1545	158	1085	20.5	70.2	0.83
chr1	152826992	152827228	CpG: 20	236	20	161	16.9	68.2	0.73
chr1	152833755	152834041	CpG: 23	286	23	177	16.1	61.9	0.85
chr1	152846286	152846560	CpG: 21	274	21	163	15.3	59.5	0.88
chr1	152864516	152864751	CpG: 18	235	18	141	15.3	60.0	0.87
chr1	152865009	152865400	CpG: 34	391	34	261	17.4	66.8	0.81
chr1	152912433	152913476	CpG: 106	1043	106	739	20.3	70.9	0.81
chr1	152920577	152921112	CpG: 55	535	55	363	20.6	67.9	0.90
chr1	153059618	153060702	CpG: 105	1084	105	728	19.4	67.2	0.87
chr1	153062232	153062440	CpG: 16	208	16	126	15.4	60.6	0.85
chr1	153079128	153079363	CpG: 20	235	20	163	17.0	69.4	0.71
chr1	153083157	153084119	CpG: 114	962	114	736	23.7	76.5	0.81
chr1	153095331	153095915	CpG: 69	584	69	417	23.6	71.4	1.05
chr1	153100566	153101061	CpG: 45	495	45	339	18.2	68.5	0.79
chr1	153104428	153104876	CpG: 45	448	45	294	20.1	65.6	0.94
chr1	153114499	153115312	CpG: 75	813	75	517	18.5	63.6	0.91
chr1	153125496	153125850	CpG: 24	354	24	208	13.6	58.8	0.79
chr1	153126326	153127112	CpG: 59	786	59	433	15.0	55.1	0.99
chr1	153128014	153128297	CpG: 26	283	26	176	18.4	62.2	0.95
chr1	153240635	153240922	CpG: 26	287	26	181	18.1	63.1	0.92
chr1	153263014	153263293	CpG: 27	279	27	177	19.4	63.4	0.97
chr1	153271683	153271955	CpG: 22	272	22	170	16.2	62.5	0.83
chr1	153320025	153320683	CpG: 49	658	49	429	14.9	65.2	0.73
chr1	153353056	153353330	CpG: 19	274	19	167	13.9	60.9	0.76
chr1	153357564	153358573	CpG: 105	1009	105	689	20.8	68.3	0.90
chr1	153409441	153410020	CpG: 43	579	43	339	14.9	58.5	0.88
chr1	153424543	153425026	CpG: 40	483	40	347	16.6	71.8	0.64
chr1	153462526	153463235	CpG: 75	709	75	533	21.2	75.2	0.77
chr1	153465666	153466219	CpG: 67	553	67	409	24.2	74.0	0.89
chr1	153542278	153543053	CpG: 75	775	75	554	19.4	71.5	0.76
chr1	153586049	153586332	CpG: 23	283	23	173	16.3	61.1	0.88
chr1	153595142	153595420	CpG: 20	278	20	166	14.4	59.7	0.81
chr1	153638769	153640497	CpG: 205	1728	205	1265	23.7	73.2	0.89
chr1	153669489	153669765	CpG: 23	276	23	196	16.7	71.0	0.66
chr1	153695332	153696213	CpG: 105	881	105	676	23.8	76.7	0.84
chr1	153698103	153698382	CpG: 21	279	21	167	15.1	59.9	0.85
chr1	153704877	153705217	CpG: 36	340	36	245	21.2	72.1	0.84
chr1	153708462	153709357	CpG: 86	895	86	581	19.2	64.9	0.91
chr1	153745042	153746033	CpG: 87	991	87	598	17.6	60.3	0.97
chr1	153764432	153765174	CpG: 66	742	66	500	17.8	67.4	0.79
chr1	153807889	153808118	CpG: 19	229	19	169	16.6	73.8	0.61
chr1	153899703	153900317	CpG: 63	614	63	433	20.5	70.5	0.83
chr1	153911472	153911750	CpG: 22	278	22	170	15.8	61.2	0.87
chr1	154072914	154073149	CpG: 17	235	17	136	14.5	57.9	0.88
chr1	154075847	154076816	CpG: 79	969	79	579	16.3	59.8	0.92
chr1	154100813	154101620	CpG: 103	807	103	612	25.5	75.8	0.89
chr1	154113122	154113383	CpG: 19	261	19	144	14.6	55.2	1.09
chr1	154113627	154114371	CpG: 61	744	61	421	16.4	56.6	1.04
chr1	154121447	154121707	CpG: 21	260	21	148	16.2	56.9	1.02
chr1	154138750	154139284	CpG: 49	534	49	369	18.4	69.1	0.77
chr1	154142095	154142297	CpG: 19	202	19	152	18.8	75.2	0.67
chr1	154142583	154143510	CpG: 65	927	65	618	14.0	66.7	0.63
chr1	154156822	154157131	CpG: 32	309	32	231	20.7	74.8	0.74
chr1	154189897	154191241	CpG: 140	1344	140	956	20.8	71.1	0.82
chr1	154201836	154203489	CpG: 124	1653	124	1053	15.0	63.7	0.74
chr1	154210314	154210824	CpG: 51	510	51	357	20.0	70.0	0.82
chr1	154218053	154222189	CpG: 314	4136	314	2771	15.2	67.0	0.68
chr1	154224085	154224954	CpG: 76	869	76	582	17.5	67.0	0.79
chr1	154265306	154267323	CpG: 164	2017	164	1305	16.3	64.7	0.78
chr1	154274887	154276095	CpG: 96	1208	96	791	15.9	65.5	0.77
chr1	154279858	154280061	CpG: 21	203	21	139	20.7	68.5	0.88
chr1	154312482	154313078	CpG: 51	596	51	395	17.1	66.3	0.80
chr1	154314325	154314584	CpG: 20	259	20	174	15.4	67.2	0.85
chr1	154328152	154333932	CpG: 440	5780	440	4063	15.2	70.3	0.63
chr1	154347169	154347752	CpG: 58	583	58	424	19.9	72.7	0.76
chr1	154365676	154366300	CpG: 46	624	46	337	14.7	54.0	1.01
chr1	154382678	154383472	CpG: 62	794	62	459	15.6	57.8	0.96
chr1	154388849	154389316	CpG: 39	467	39	340	16.7	72.8	0.65
chr1	154393391	154394422	CpG: 83	1031	83	721	16.1	69.9	0.66
chr1	154400581	154401081	CpG: 40	500	40	310	16.0	62.0	0.86
chr1	154408047	154408263	CpG: 21	216	21	127	19.4	58.8	1.13
chr1	154411630	154412205	CpG: 75	575	75	419	26.1	72.9	1.04
chr1	154412659	154412892	CpG: 18	233	18	133	15.5	57.1	0.97
chr1	154413281	154413554	CpG: 22	273	22	172	16.1	63.0	0.82
chr1	154415760	154416517	CpG: 73	757	73	535	19.3	70.7	0.78
chr1	154433085	154434303	CpG: 88	1218	88	806	14.4	66.2	0.66
chr1	154447156	154447492	CpG: 31	336	31	206	18.5	61.3	0.99
chr1	154459355	154459750	CpG: 34	395	34	268	17.2	67.8	0.79
chr1	154461218	154464182	CpG: 221	2964	221	2042	14.9	68.9	0.63
chr1	154585203	154585462	CpG: 23	259	23	161	17.8	62.2	0.93
chr1	154656373	154656647	CpG: 21	274	21	168	15.3	61.3	0.82
chr1	154689932	154690210	CpG: 24	278	24	174	17.3	62.6	0.89
chr1	154700676	154702042	CpG: 144	1366	144	958	21.1	70.1	0.86
chr1	154705887	154706150	CpG: 26	263	26	165	19.8	62.7	1.02
chr1	154726028	154726303	CpG: 22	275	22	170	16.0	61.8	0.85
chr1	154747127	154747362	CpG: 22	235	22	144	18.7	61.3	1.02
chr1	154748506	154749102	CpG: 63	596	63	410	21.1	68.8	0.89
chr1	154786471	154786723	CpG: 18	252	18	150	14.3	59.5	0.82
chr1	154812449	154812723	CpG: 21	274	21	167	15.3	60.9	0.83
chr1	154824689	154824919	CpG: 17	230	17	136	14.8	59.1	0.87
chr1	154826604	154827897	CpG: 128	1293	128	881	19.8	68.1	0.86
chr1	154884375	154884986	CpG: 65	611	65	419	21.3	68.6	0.91
chr1	154985106	154985347	CpG: 18	241	18	143	14.9	59.3	0.87
chr1	154996324	154996554	CpG: 19	230	19	138	16.5	60.0	0.93
chr1	154998186	154998508	CpG: 25	322	25	197	15.5	61.2	0.84
chr1	154999272	154999566	CpG: 23	294	23	189	15.6	64.3	0.77
chr1	155014383	155014614	CpG: 18	231	18	141	15.6	61.0	0.86
chr1	155061060	155061296	CpG: 20	236	20	145	16.9	61.4	0.92
chr1	155072414	155072649	CpG: 27	235	27	152	23.0	64.7	1.20
chr1	155088981	155089228	CpG: 22	247	22	180	17.8	72.9	0.67
chr1	155116004	155116816	CpG: 88	812	88	575	21.7	70.8	0.86
chr1	155124357	155124624	CpG: 22	267	22	165	16.5	61.8	0.87
chr1	155159061	155159452	CpG: 33	391	33	254	16.9	65.0	0.85
chr1	155175782	155176019	CpG: 17	237	17	139	14.3	58.6	0.86
chr1	155191637	155193849	CpG: 166	2212	166	1460	15.0	66.0	0.70
chr1	155215017	155216058	CpG: 92	1041	92	694	17.7	66.7	0.80
chr1	155219913	155221477	CpG: 125	1564	125	1064	16.0	68.0	0.70
chr1	155253144	155253796	CpG: 72	652	72	460	22.1	70.6	0.89
chr1	155274364	155274828	CpG: 31	464	31	305	13.4	65.7	0.62
chr1	155299561	155299919	CpG: 35	358	35	277	19.6	77.4	0.69
chr1	155325864	155326101	CpG: 20	237	20	144	16.9	60.8	0.94
chr1	155331955	155332712	CpG: 59	757	59	437	15.6	57.7	0.94
chr1	155333614	155334047	CpG: 32	433	32	258	14.8	59.6	0.84
chr1	155351247	155351760	CpG: 52	513	52	330	20.3	64.3	0.98
chr1	155354900	155355310	CpG: 53	410	53	312	25.9	76.1	0.89
chr1	155384034	155384565	CpG: 59	531	59	391	22.2	73.6	0.82
chr1	155420910	155421386	CpG: 46	476	46	336	19.3	70.6	0.83
chr1	155429871	155430097	CpG: 22	226	22	154	19.5	68.1	0.85
chr1	155476993	155477262	CpG: 27	269	27	171	20.1	63.6	1.00
chr1	155507578	155508071	CpG: 42	493	42	334	17.0	67.7	0.75
chr1	155526864	155527377	CpG: 63	513	63	374	24.6	72.9	0.93
chr1	155537355	155537646	CpG: 24	291	24	182	16.5	62.5	0.87
chr1	155559031	155560531	CpG: 127	1500	127	998	16.9	66.5	0.77
chr1	155573968	155575146	CpG: 125	1178	125	785	21.2	66.6	0.96
chr1	155575301	155575561	CpG: 18	260	18	155	13.8	59.6	0.79
chr1	155595329	155596142	CpG: 60	813	60	506	14.8	62.2	0.76
chr1	155638406	155639849	CpG: 130	1443	130	1014	18.0	70.3	0.73
chr1	155640508	155640790	CpG: 23	282	23	172	16.3	61.0	0.89
chr1	155643730	155644404	CpG: 48	674	48	394	14.2	58.5	0.84
chr1	155708663	155709066	CpG: 34	403	34	279	16.9	69.2	0.75
chr1	155728059	155728464	CpG: 52	405	52	307	25.7	75.8	0.91
chr1	155760264	155762073	CpG: 174	1809	174	1277	19.2	70.6	0.78
chr1	155764763	155765025	CpG: 19	262	19	160	14.5	61.1	0.79
chr1	155778227	155779035	CpG: 74	808	74	571	18.3	70.7	0.74
chr1	155783149	155783542	CpG: 50	393	50	272	25.4	69.2	1.06
chr1	155793938	155794172	CpG: 25	234	25	158	21.4	67.5	0.94
chr1	155796446	155796826	CpG: 33	380	33	261	17.4	68.7	0.81
chr1	155812902	155813870	CpG: 109	968	109	699	22.5	72.2	0.87
chr1	155831541	155831810	CpG: 19	269	19	163	14.1	60.6	0.78
chr1	155841467	155843263	CpG: 128	1796	128	1167	14.3	65.0	0.68
chr1	155864722	155865527	CpG: 83	805	83	533	20.6	66.2	0.94
chr1	155877839	155878187	CpG: 27	348	27	211	15.5	60.6	0.85
chr1	155887790	155889112	CpG: 162	1322	162	951	24.5	71.9	0.95
chr1	155904094	155905072	CpG: 70	978	70	630	14.3	64.4	0.69
chr1	155950584	155951098	CpG: 50	514	50	363	19.5	70.6	0.78
chr1	155981908	155982819	CpG: 74	911	74	614	16.2	67.4	0.73
chr1	155985649	155986219	CpG: 51	570	51	381	17.9	66.8	0.80
chr1	155995846	155998144	CpG: 170	2298	170	1533	14.8	66.7	0.66
chr1	156028888	156030749	CpG: 122	1861	122	1145	13.1	61.5	0.69
chr1	156044807	156045687	CpG: 70	880	70	610	15.9	69.3	0.66
chr1	156057297	156057860	CpG: 61	563	61	400	21.7	71.0	0.86
chr1	156060573	156061286	CpG: 62	713	62	478	17.4	67.0	0.78
chr1	156064253	156064850	CpG: 57	597	57	404	19.1	67.7	0.84
chr1	156128578	156128852	CpG: 24	274	24	171	17.5	62.4	0.91
chr1	156133384	156133601	CpG: 17	217	17	131	15.7	60.4	0.87
chr1	156182171	156183257	CpG: 144	1086	144	801	26.5	73.8	1.04
chr1	156274803	156275699	CpG: 95	896	95	653	21.2	72.9	0.82
chr1	156331615	156332521	CpG: 78	906	78	662	17.2	73.1	0.65
chr1	156583458	156583836	CpG: 34	378	34	277	18.0	73.3	0.67
chr1	156626157	156626398	CpG: 20	241	20	143	16.6	59.3	0.96
chr1	156804506	156804779	CpG: 21	273	21	170	15.4	62.3	0.80
chr1	157083920	157084194	CpG: 24	274	24	171	17.5	62.4	0.91
chr1	157116020	157116353	CpG: 28	333	28	230	16.8	69.1	0.72
chr1	157130607	157131251	CpG: 68	644	68	463	21.1	71.9	0.82
chr1	157225597	157225882	CpG: 25	285	25	178	17.5	62.5	0.91
chr1	157250499	157250842	CpG: 45	343	45	257	26.2	74.9	0.95
chr1	157286795	157287011	CpG: 20	216	20	137	18.5	63.4	0.96
chr1	157314738	157315159	CpG: 37	421	37	286	17.6	67.9	0.80
chr1	157317925	157318808	CpG: 72	883	72	567	16.3	64.2	0.80
chr1	157336172	157336426	CpG: 19	254	19	145	15.0	57.1	0.93
chr1	157372399	157372677	CpG: 22	278	22	171	15.8	61.5	0.85
chr1	157511380	157511593	CpG: 18	213	18	152	16.9	71.4	0.66
chr1	157695625	157695898	CpG: 23	273	23	167	16.8	61.2	0.91
chr1	157796724	157797005	CpG: 24	281	24	174	17.1	61.9	0.91
chr1	157879343	157879617	CpG: 25	274	25	171	18.2	62.4	0.94
chr1	158008018	158008235	CpG: 19	217	19	129	17.5	59.4	1.02
chr1	158159054	158159305	CpG: 20	251	20	153	15.9	61.0	0.87
chr1	158308444	158309198	CpG: 61	754	61	525	16.2	69.6	0.67
chr1	158325473	158325743	CpG: 23	270	23	176	17.0	65.2	0.83
chr1	158369117	158369357	CpG: 20	240	20	142	16.7	59.2	0.97
chr1	158590241	158590465	CpG: 18	224	18	132	16.1	58.9	0.93
chr1	158658795	158659070	CpG: 23	275	23	170	16.7	61.8	0.88
chr1	158692701	158692977	CpG: 24	276	24	171	17.4	62.0	0.92
chr1	158817209	158817454	CpG: 18	245	18	137	14.7	55.9	0.97
chr1	158902235	158902461	CpG: 16	226	16	131	14.2	58.0	0.87
chr1	158917638	158918575	CpG: 87	937	87	652	18.6	69.6	0.77
chr1	158991221	158992226	CpG: 94	1005	94	709	18.7	70.5	0.76
chr1	158992742	158993081	CpG: 34	339	34	243	20.1	71.7	0.78
chr1	159036555	159036829	CpG: 22	274	22	170	16.1	62.0	0.84
chr1	159037177	159037419	CpG: 24	242	24	169	19.8	69.8	0.85
chr1	159061607	159062676	CpG: 78	1069	78	725	14.6	67.8	0.64
chr1	159066709	159067130	CpG: 39	421	39	296	18.5	70.3	0.76
chr1	159082644	159083073	CpG: 48	429	48	311	22.4	72.5	0.85
chr1	159168582	159169276	CpG: 60	694	60	432	17.3	62.2	0.90
chr1	159207135	159207759	CpG: 52	624	52	425	16.7	68.1	0.80
chr1	159221010	159222027	CpG: 124	1017	124	703	24.4	69.1	1.02
chr1	159235327	159236289	CpG: 86	962	86	715	17.9	74.3	0.67
chr1	159342376	159342988	CpG: 72	612	72	452	23.5	73.9	0.87
chr1	159399039	159399735	CpG: 62	696	62	457	17.8	65.7	0.83
chr1	159422654	159422918	CpG: 21	264	21	165	15.9	62.5	0.82
chr1	159480210	159480620	CpG: 38	410	38	261	18.5	63.7	0.92
chr1	159507886	159508125	CpG: 29	239	29	180	24.3	75.3	0.86
chr1	159520649	159520882	CpG: 20	233	20	138	17.2	59.2	1.00
chr1	159537398	159537970	CpG: 61	572	61	424	21.3	74.1	0.78
chr1	159556390	159556673	CpG: 26	283	26	184	18.4	65.0	0.87
chr1	159938839	159939191	CpG: 29	352	29	246	16.5	69.9	0.68
chr1	160102338	160102612	CpG: 24	274	24	170	17.5	62.0	0.92
chr1	160118405	160118612	CpG: 15	207	15	122	14.5	58.9	0.87
chr1	160119923	160120313	CpG: 30	390	30	226	15.4	57.9	0.92
chr1	160158006	160158513	CpG: 41	507	41	323	16.2	63.7	0.82
chr1	160166190	160167077	CpG: 69	887	69	609	15.6	68.7	0.66
chr1	160176094	160176547	CpG: 48	453	48	320	21.2	70.6	0.86
chr1	160216214	160216477	CpG: 19	263	19	156	14.4	59.3	0.83
chr1	160217060	160217425	CpG: 36	365	36	251	19.7	68.8	0.84
chr1	160235753	160236534	CpG: 71	781	71	535	18.2	68.5	0.78
chr1	160255401	160255791	CpG: 44	390	44	268	22.6	68.7	0.96
chr1	160269792	160270221	CpG: 50	429	50	323	23.3	75.3	0.90
chr1	160278539	160278809	CpG: 27	270	27	183	20.0	67.8	0.88
chr1	160282590	160282826	CpG: 18	236	18	138	15.3	58.5	0.91
chr1	160285745	160286030	CpG: 20	285	20	179	14.0	62.8	0.73
chr1	160288511	160288769	CpG: 18	258	18	154	14.0	59.7	0.79
chr1	160292001	160292238	CpG: 18	237	18	143	15.2	60.3	0.85
chr1	160296805	160297356	CpG: 52	551	52	389	18.9	70.6	0.79
chr1	160303668	160304353	CpG: 51	685	51	428	14.9	62.5	0.76
chr1	160314730	160315120	CpG: 36	390	36	268	18.5	68.7	0.79
chr1	160339460	160339907	CpG: 41	447	41	276	18.3	61.7	0.98
chr1	160372784	160373024	CpG: 19	240	19	142	15.8	59.2	0.92
chr1	160381563	160381844	CpG: 23	281	23	174	16.4	61.9	0.87
chr1	160396148	160396699	CpG: 54	551	54	383	19.6	69.5	0.82
chr1	160418891	160419700	CpG: 65	809	65	572	16.1	70.7	0.64
chr1	160451418	160451650	CpG: 17	232	17	126	14.7	54.3	1.01
chr1	160451761	160452094	CpG: 27	333	27	222	16.2	66.7	0.73
chr1	160461199	160461436	CpG: 17	237	17	141	14.3	59.5	0.83
chr1	160527158	160528045	CpG: 84	887	84	603	18.9	68.0	0.87
chr1	160536515	160537584	CpG: 81	1069	81	632	15.2	59.1	0.87
chr1	160559797	160560771	CpG: 73	974	73	671	15.0	68.9	0.63
chr1	160577148	160735334	CpG: 12639	158186	12639	100923	16.0	63.8	0.80
chr1	160786862	160788194	CpG: 127	1332	127	880	19.1	66.1	0.87
chr1	160793266	160793950	CpG: 54	684	54	375	15.8	54.8	1.05
chr1	160802855	160803085	CpG: 22	230	22	136	19.1	59.1	1.10
chr1	160868434	160869669	CpG: 122	1235	122	829	19.8	67.1	0.88
chr1	160874795	160875454	CpG: 54	659	54	369	16.4	56.0	1.05
chr1	160879106	160879361	CpG: 23	255	23	187	18.0	73.3	0.67
chr1	160884220	160884452	CpG: 23	232	23	133	19.8	57.3	1.21
chr1	160950084	160951458	CpG: 128	1374	128	921	18.6	67.0	0.83
chr1	160956584	160957243	CpG: 54	659	54	368	16.4	55.8	1.05
chr1	160960964	160961603	CpG: 44	639	44	421	13.8	65.9	0.64
chr1	160966008	160966240	CpG: 23	232	23	135	19.8	58.2	1.17
chr1	161070178	161071829	CpG: 149	1651	149	1111	18.0	67.3	0.80
chr1	161093943	161094605	CpG: 62	662	62	449	18.7	67.8	0.82
chr1	161109227	161109505	CpG: 21	278	21	168	15.1	60.4	0.84
chr1	161156709	161156983	CpG: 23	274	23	171	16.8	62.4	0.87
chr1	161211309	161211542	CpG: 17	233	17	137	14.6	58.8	0.87
chr1	161303719	161303949	CpG: 19	230	19	139	16.5	60.4	0.91
chr1	161328134	161328557	CpG: 28	423	28	251	13.2	59.3	0.75
chr1	161367534	161368643	CpG: 100	1109	100	725	18.0	65.4	0.87
chr1	161413741	161414575	CpG: 108	834	108	624	25.9	74.8	0.94
chr1	161617222	161617481	CpG: 19	259	19	156	14.7	60.2	0.82
chr1	161711064	161711509	CpG: 43	445	43	305	19.3	68.5	0.83
chr1	161777173	161777560	CpG: 40	387	40	288	20.7	74.4	0.75
chr1	161801185	161801465	CpG: 22	280	22	166	15.7	59.3	0.90
chr1	161809540	161810267	CpG: 57	727	57	502	15.7	69.1	0.66
chr1	161817313	161817534	CpG: 18	221	18	133	16.3	60.2	0.91
chr1	161830997	161831275	CpG: 22	278	22	172	15.8	61.9	0.83
chr1	161841829	161842257	CpG: 49	428	49	306	22.9	71.5	0.90
chr1	161884499	161884743	CpG: 21	244	21	146	17.2	59.8	0.98
chr1	161905076	161906073	CpG: 115	997	115	721	23.1	72.3	0.89
chr1	162134696	162135168	CpG: 45	472	45	305	19.1	64.6	0.93
chr1	162135807	162136082	CpG: 25	275	25	173	18.2	62.9	0.93
chr1	162166949	162167347	CpG: 34	398	34	265	17.1	66.6	0.80
chr1	162195174	162195398	CpG: 19	224	19	138	17.0	61.6	0.91
chr1	162323473	162323712	CpG: 17	239	17	141	14.2	59.0	0.83
chr1	162351833	162352107	CpG: 25	274	25	176	18.2	64.2	0.90
chr1	162463662	162463940	CpG: 24	278	24	174	17.3	62.6	0.89
chr1	162525669	162525897	CpG: 21	228	21	137	18.4	60.1	1.04
chr1	162666620	162667162	CpG: 52	542	52	348	19.2	64.2	0.93
chr1	162689589	162689863	CpG: 21	274	21	168	15.3	61.3	0.83
chr1	162697895	162698125	CpG: 17	230	17	137	14.8	59.6	0.84
chr1	162738856	162739096	CpG: 21	240	21	146	17.5	60.8	0.96
chr1	162753632	162753849	CpG: 22	217	22	131	20.3	60.4	1.28
chr1	162768310	162768533	CpG: 18	223	18	153	16.1	68.6	0.69
chr1	162893678	162893915	CpG: 18	237	18	145	15.2	61.2	0.82
chr1	162991030	162991457	CpG: 30	427	30	256	14.1	60.0	0.78
chr1	163393837	163394118	CpG: 24	281	24	175	17.1	62.3	0.90
chr1	163667032	163667284	CpG: 34	252	34	198	27.0	78.6	0.88
chr1	163704999	163705280	CpG: 23	281	23	174	16.4	61.9	0.87
chr1	163804562	163804798	CpG: 21	236	21	143	17.8	60.6	0.99
chr1	163805601	163805889	CpG: 26	288	26	176	18.1	61.1	0.98
chr1	163895176	163895450	CpG: 23	274	23	170	16.8	62.0	0.88
chr1	163922569	163922946	CpG: 45	377	45	269	23.9	71.4	0.96
chr1	163957547	163957784	CpG: 20	237	20	144	16.9	60.8	0.94
chr1	164023361	164023642	CpG: 22	281	22	173	15.7	61.6	0.84
chr1	164107749	164108022	CpG: 22	273	22	166	16.1	60.8	0.88
chr1	164304997	164305272	CpG: 23	275	23	171	16.7	62.2	0.87
chr1	164555082	164555319	CpG: 18	237	18	141	15.2	59.5	0.88
chr1	164581618	164582630	CpG: 87	1012	87	615	17.2	60.8	0.93
chr1	164638140	164638417	CpG: 25	277	25	170	18.1	61.4	0.97
chr1	164698820	164699435	CpG: 49	615	49	385	15.9	62.6	0.82
chr1	164700603	164700928	CpG: 29	325	29	195	17.8	60.0	1.00
chr1	164701308	164703445	CpG: 181	2137	181	1402	16.9	65.6	0.79
chr1	164791442	164791723	CpG: 27	281	27	175	19.2	62.3	0.99
chr1	164863291	164863522	CpG: 20	231	20	141	17.3	61.0	0.94
chr1	164944433	164944735	CpG: 24	302	24	194	15.9	64.2	0.77
chr1	164946507	164946784	CpG: 24	277	24	173	17.3	62.5	0.90
chr1	164976718	164977750	CpG: 80	1032	80	625	15.5	60.6	0.85
chr1	165044736	165045069	CpG: 46	333	46	245	27.6	73.6	1.04
chr1	165076404	165076698	CpG: 24	294	24	176	16.3	59.9	0.92
chr1	165114676	165115410	CpG: 54	734	54	415	14.7	56.5	0.92
chr1	165117259	165117492	CpG: 16	233	16	137	13.7	58.8	0.83
chr1	165154221	165154495	CpG: 24	274	24	170	17.5	62.0	0.92
chr1	165163462	165163841	CpG: 29	379	29	223	15.3	58.8	0.90
chr1	165173587	165174617	CpG: 133	1030	133	756	25.8	73.4	0.97
chr1	165207498	165207776	CpG: 24	278	24	174	17.3	62.6	0.89
chr1	165270604	165270836	CpG: 22	232	22	142	19.0	61.2	1.03
chr1	165287510	165287848	CpG: 26	338	26	218	15.4	64.5	0.75
chr1	165511050	165513239	CpG: 224	2189	224	1530	20.5	69.9	0.84
chr1	165541005	165541239	CpG: 17	234	17	141	14.5	60.3	0.83
chr1	165594680	165595107	CpG: 31	427	31	255	14.5	59.7	0.82
chr1	165855897	165856130	CpG: 17	233	17	136	14.6	58.4	0.89
chr1	166184941	166185941	CpG: 130	1000	130	755	26.0	75.5	0.91
chr1	166221593	166222370	CpG: 83	777	83	543	21.4	69.9	0.90
chr1	166229841	166230378	CpG: 44	537	44	350	16.4	65.2	0.77
chr1	166266368	166267241	CpG: 115	873	115	633	26.3	72.5	1.00
chr1	166293458	166293808	CpG: 36	350	36	231	20.6	66.0	0.94
chr1	166321165	166321765	CpG: 94	600	94	476	31.3	79.3	1.00
chr1	166334819	166335282	CpG: 43	463	43	287	18.6	62.0	0.98
chr1	166468330	166468849	CpG: 48	519	48	333	18.5	64.2	0.90
chr1	166542520	166542750	CpG: 20	230	20	140	17.4	60.9	0.95
chr1	166571291	166573523	CpG: 216	2232	216	1531	19.4	68.6	0.84
chr1	166633563	166633832	CpG: 21	269	21	161	15.6	59.9	0.89
chr1	166715660	166715890	CpG: 20	230	20	141	17.4	61.3	0.94
chr1	166790696	166791325	CpG: 51	629	51	409	16.2	65.0	0.77
chr1	166806315	166807443	CpG: 104	1128	104	791	18.4	70.1	0.76
chr1	166904687	166905288	CpG: 82	601	82	450	27.3	74.9	0.97
chr1	166950913	166951190	CpG: 23	277	23	169	16.6	61.0	0.90
chr1	166964964	166965178	CpG: 17	214	17	129	15.9	60.3	0.88
chr1	166981729	166982104	CpG: 46	375	46	273	24.5	72.8	0.93
chr1	167050320	167050585	CpG: 21	265	21	163	15.8	61.5	0.85
chr1	167065735	167066286	CpG: 61	551	61	380	22.1	69.0	0.94
chr1	167066537	167066750	CpG: 15	213	15	126	14.1	59.2	0.81
chr1	167073237	167074111	CpG: 93	874	93	644	21.3	73.7	0.80
chr1	167157596	167157954	CpG: 25	358	25	237	14.0	66.2	0.64
chr1	167171644	167171895	CpG: 28	251	28	188	22.3	74.9	0.80
chr1	167240083	167240336	CpG: 22	253	22	156	17.4	61.7	0.95
chr1	167249183	167249419	CpG: 22	236	22	145	18.6	61.4	1.01
chr1	167279531	167279769	CpG: 17	238	17	140	14.3	58.8	0.86
chr1	167287255	167289029	CpG: 138	1774	138	1144	15.6	64.5	0.75
chr1	167407737	167407951	CpG: 33	214	33	168	30.8	78.5	1.01
chr1	167483795	167484032	CpG: 17	237	17	139	14.3	58.6	0.86
chr1	167487565	167488903	CpG: 139	1338	139	961	20.8	71.8	0.84
chr1	167499263	167499494	CpG: 17	231	17	137	14.7	59.3	0.88
chr1	167530222	167530896	CpG: 55	674	55	420	16.3	62.3	0.84
chr1	167544118	167544340	CpG: 17	222	17	136	15.3	61.3	0.84
chr1	167559200	167560011	CpG: 61	811	61	555	15.0	68.4	0.64
chr1	167577207	167578101	CpG: 87	894	87	638	19.5	71.4	0.77
chr1	167644072	167644283	CpG: 18	211	18	128	17.1	60.7	0.96
chr1	167705931	167706325	CpG: 32	394	32	239	16.2	60.7	0.89
chr1	167825164	167825438	CpG: 23	274	23	170	16.8	62.0	0.88
chr1	168025718	168025996	CpG: 22	278	22	169	15.8	60.8	0.87
chr1	168141251	168141525	CpG: 22	274	22	170	16.1	62.0	0.84
chr1	168192098	168192764	CpG: 51	666	51	453	15.3	68.0	0.66
chr1	168257958	168258230	CpG: 20	272	20	164	14.7	60.3	0.82
chr1	168364046	168364324	CpG: 25	278	25	175	18.0	62.9	0.92
chr1	168461006	168462654	CpG: 178	1648	178	1201	21.6	72.9	0.81
chr1	168546314	168546592	CpG: 23	278	23	173	16.5	62.2	0.86
chr1	168782700	168782951	CpG: 21	251	21	153	16.7	61.0	0.92
chr1	168840666	168841685	CpG: 99	1019	99	662	19.4	65.0	0.93
chr1	169117075	169117349	CpG: 21	274	21	170	15.3	62.0	0.81
chr1	169150611	169150985	CpG: 30	374	30	229	16.0	61.2	0.86
chr1	169166650	169166932	CpG: 23	282	23	175	16.3	62.1	0.86
chr1	169249039	169249541	CpG: 66	502	66	388	26.3	77.3	0.89
chr1	169309280	169309516	CpG: 17	236	17	141	14.4	59.7	0.83
chr1	169430364	169430751	CpG: 30	387	30	247	15.5	63.8	0.77
chr1	169450721	169450964	CpG: 19	243	19	141	15.6	58.0	0.93
chr1	169522061	169522338	CpG: 21	277	21	167	15.2	60.3	0.84
chr1	169571834	169572081	CpG: 18	247	18	146	14.6	59.1	0.85
chr1	169606973	169607215	CpG: 18	242	18	171	14.9	70.7	0.60
chr1	169774346	169775289	CpG: 72	943	72	660	15.3	70.0	0.62
chr1	169887160	169887400	CpG: 19	240	19	144	15.8	60.0	0.90
chr1	169990271	169990534	CpG: 26	263	26	166	19.8	63.1	1.00
chr1	170006177	170006448	CpG: 22	271	22	167	16.2	61.6	0.87
chr1	170017582	170017977	CpG: 38	395	38	263	19.2	66.6	0.88
chr1	170020418	170021322	CpG: 73	904	73	606	16.2	67.0	0.74
chr1	170203174	170203416	CpG: 18	242	18	144	14.9	59.5	0.86
chr1	170263406	170263676	CpG: 21	270	21	165	15.6	61.1	0.84
chr1	170293886	170294162	CpG: 24	276	24	171	17.4	62.0	0.92
chr1	170314242	170314450	CpG: 18	208	18	124	17.3	59.6	0.99
chr1	170648399	170648674	CpG: 24	275	24	173	17.5	62.9	0.89
chr1	170729990	170730300	CpG: 26	310	26	188	16.8	60.6	0.92
chr1	170757740	170757994	CpG: 24	254	24	160	18.9	63.0	0.96
chr1	170781932	170782209	CpG: 25	277	25	174	18.1	62.8	0.93
chr1	170841817	170842539	CpG: 56	722	56	457	15.5	63.3	0.78
chr1	171027272	171027549	CpG: 28	277	28	190	20.2	68.6	0.88
chr1	171098177	171098939	CpG: 72	762	72	503	18.9	66.0	0.87
chr1	171137733	171138268	CpG: 53	535	53	341	19.8	63.7	0.98
chr1	171140750	171140963	CpG: 16	213	16	141	15.0	66.2	0.70
chr1	171197668	171198778	CpG: 108	1110	108	780	19.5	70.3	0.80
chr1	171257425	171257696	CpG: 22	271	22	165	16.2	60.9	0.90
chr1	171463592	171463877	CpG: 25	285	25	179	17.5	62.8	0.91
chr1	171800421	171800835	CpG: 35	414	35	282	16.9	68.1	0.73
chr1	171836404	171836632	CpG: 20	228	20	143	17.5	62.7	0.90
chr1	171882827	171883099	CpG: 21	272	21	171	15.4	62.9	0.80
chr1	171889477	171890112	CpG: 69	635	69	451	21.7	71.0	0.88
chr1	172075137	172075412	CpG: 25	275	25	172	18.2	62.5	0.94
chr1	172324042	172324304	CpG: 20	262	20	156	15.3	59.5	0.87
chr1	172479391	172479601	CpG: 16	210	16	122	15.2	58.1	0.91
chr1	172602458	172602728	CpG: 23	270	23	169	17.0	62.6	0.88
chr1	172608580	172608854	CpG: 20	274	20	168	14.6	61.3	0.79
chr1	172707240	172707451	CpG: 17	211	17	129	16.1	61.1	0.89
chr1	172834995	172836122	CpG: 125	1127	125	802	22.2	71.2	0.89
chr1	172970891	172971869	CpG: 80	978	80	704	16.4	72.0	0.63
chr1	173027683	173028066	CpG: 32	383	32	259	16.7	67.6	0.74
chr1	173073004	173073422	CpG: 32	418	32	261	15.3	62.4	0.82
chr1	173147000	173147263	CpG: 19	263	19	158	14.4	60.1	0.81
chr1	173182314	173183121	CpG: 67	807	67	474	16.6	58.7	0.97
chr1	173183683	173183920	CpG: 20	237	20	147	16.9	62.0	0.90
chr1	173184096	173184368	CpG: 26	272	26	170	19.1	62.5	1.00
chr1	173225333	173225587	CpG: 19	254	19	145	15.0	57.1	0.92
chr1	173226154	173226899	CpG: 64	745	64	526	17.2	70.6	0.72
chr1	173347655	173347936	CpG: 23	281	23	173	16.4	61.6	0.88
chr1	173379600	173380644	CpG: 105	1044	105	738	20.1	70.7	0.82
chr1	173414318	173414670	CpG: 31	352	31	263	17.6	74.7	0.63
chr1	173506488	173506762	CpG: 23	274	23	170	16.8	62.0	0.88
chr1	173517137	173518130	CpG: 116	993	116	719	23.4	72.4	0.89
chr1	173596863	173597222	CpG: 27	359	27	212	15.0	59.1	0.87
chr1	173626916	173627228	CpG: 24	312	24	181	15.4	58.0	0.93
chr1	173722253	173722527	CpG: 23	274	23	170	16.8	62.0	0.88
chr1	173741405	173741631	CpG: 21	226	21	135	18.6	59.7	1.04
chr1	173904724	173904990	CpG: 20	266	20	163	15.0	61.3	0.81
chr1	173953897	173954184	CpG: 23	287	23	174	16.0	60.6	0.87
chr1	174069346	174069687	CpG: 27	341	27	245	15.8	71.8	0.61
chr1	174121333	174121608	CpG: 23	275	23	170	16.7	61.8	0.89
chr1	174142050	174142280	CpG: 18	230	18	136	15.7	59.1	0.92
chr1	174191346	174191609	CpG: 22	263	22	162	16.7	61.6	0.89
chr1	174201511	174201803	CpG: 25	292	25	177	17.1	60.6	0.93
chr1	174353108	174354243	CpG: 121	1135	121	741	21.3	65.3	1.00
chr1	174355518	174355753	CpG: 19	235	19	139	16.2	59.1	0.93
chr1	174376984	174377415	CpG: 32	431	32	263	14.8	61.0	0.83
chr1	174433143	174433467	CpG: 37	324	37	231	22.8	71.3	0.91
chr1	174546487	174546961	CpG: 46	474	46	346	19.4	73.0	0.78
chr1	174740126	174740362	CpG: 17	236	17	146	14.4	61.9	0.75
chr1	174756091	174756372	CpG: 23	281	23	174	16.4	61.9	0.87
chr1	174953227	174953659	CpG: 42	432	42	284	19.4	65.7	0.91
chr1	175163072	175163348	CpG: 19	276	19	168	13.8	60.9	0.75
chr1	175347740	175347965	CpG: 17	225	17	131	15.1	58.2	0.89
chr1	175363320	175363538	CpG: 20	218	20	131	18.3	60.1	1.02
chr1	175404219	175404500	CpG: 22	281	22	173	15.7	61.6	0.84
chr1	175412781	175413501	CpG: 56	720	56	502	15.6	69.7	0.64
chr1	175558324	175558562	CpG: 19	238	19	148	16.0	62.2	0.84
chr1	175561845	175562947	CpG: 132	1102	132	759	24.0	68.9	1.01
chr1	175617002	175617361	CpG: 27	359	27	211	15.0	58.8	0.87
chr1	175622908	175623182	CpG: 25	274	25	171	18.2	62.4	0.95
chr1	175704505	175704849	CpG: 35	344	35	257	20.3	74.7	0.73
chr1	175879511	175879766	CpG: 19	255	19	139	14.9	54.5	1.03
chr1	175936759	175936991	CpG: 16	232	16	136	13.8	58.6	0.82
chr1	175955150	175955428	CpG: 26	278	26	176	18.7	63.3	0.94
chr1	176080389	176080781	CpG: 28	392	28	211	14.3	53.8	1.00
chr1	176498954	176499186	CpG: 18	232	18	139	15.5	59.9	0.88
chr1	176518929	176519437	CpG: 51	508	51	356	20.1	70.1	0.84
chr1	176525659	176526240	CpG: 48	581	48	377	16.5	64.9	0.80
chr1	176536350	176536701	CpG: 30	351	30	225	17.1	64.1	0.84
chr1	176804664	176804940	CpG: 22	276	22	171	15.9	62.0	0.84
chr1	176958142	176958416	CpG: 22	274	22	168	16.1	61.3	0.86
chr1	176988700	176989007	CpG: 23	307	23	180	15.0	58.6	0.88
chr1	177183698	177183976	CpG: 23	278	23	175	16.5	62.9	0.84
chr1	177392525	177392920	CpG: 45	395	45	293	22.8	74.2	0.83
chr1	177448263	177449397	CpG: 122	1134	122	826	21.5	72.8	0.81
chr1	177639835	177640120	CpG: 21	285	21	175	14.7	61.4	0.80
chr1	177675152	177675394	CpG: 18	242	18	146	14.9	60.3	0.82
chr1	177687761	177688034	CpG: 21	273	21	167	15.4	61.2	0.83
chr1	177841387	177841874	CpG: 49	487	49	357	20.1	73.3	0.77
chr1	177896950	177897944	CpG: 83	994	83	671	16.7	67.5	0.74
chr1	177995716	177995951	CpG: 17	235	17	140	14.5	59.6	0.84
chr1	178079554	178081061	CpG: 179	1507	179	1081	23.8	71.7	0.93
chr1	178182145	178182420	CpG: 23	275	23	170	16.7	61.8	0.89
chr1	178214454	178214703	CpG: 19	249	19	154	15.3	61.8	0.82
chr1	178333808	178334091	CpG: 24	283	24	175	17.0	61.8	0.90
chr1	178380737	178381850	CpG: 150	1113	150	857	27.0	77.0	0.93
chr1	178436945	178437818	CpG: 87	873	87	624	19.9	71.5	0.78
chr1	178584050	178585087	CpG: 110	1037	110	770	21.2	74.3	0.83
chr1	178648666	178649216	CpG: 56	550	56	393	20.4	71.5	0.81
chr1	178719597	178719868	CpG: 19	271	19	158	14.0	58.3	0.83
chr1	178720709	178721253	CpG: 48	544	48	342	17.6	62.9	0.90
chr1	178773635	178774579	CpG: 71	944	71	656	15.0	69.5	0.62
chr1	178807426	178807710	CpG: 23	284	23	176	16.2	62.0	0.86
chr1	178930595	178931182	CpG: 70	587	70	443	23.9	75.5	0.84
chr1	178941231	178941917	CpG: 67	686	67	480	19.5	70.0	0.80
chr1	178946535	178947463	CpG: 79	928	79	642	17.0	69.2	0.71
chr1	179000117	179000391	CpG: 24	274	24	171	17.5	62.4	0.91
chr1	179098574	179100578	CpG: 204	2004	204	1415	20.4	70.6	0.82
chr1	179204643	179204854	CpG: 15	211	15	119	14.2	56.4	0.92
chr1	179233493	179233720	CpG: 23	227	23	146	20.3	64.3	1.04
chr1	179238089	179238978	CpG: 87	889	87	584	19.6	65.7	0.91
chr1	179309007	179309259	CpG: 19	252	19	149	15.1	59.1	0.88
chr1	179310253	179310956	CpG: 68	703	68	490	19.3	69.7	0.80
chr1	179370991	179371232	CpG: 17	241	17	144	14.1	59.8	0.81
chr1	179445984	179446258	CpG: 22	274	22	171	16.1	62.4	0.83
chr1	179510155	179511184	CpG: 122	1029	122	747	23.7	72.6	0.91
chr1	179584408	179591242	CpG: 516	6834	516	4244	15.1	62.1	0.79
chr1	179828168	179828447	CpG: 22	279	22	173	15.8	62.0	0.83
chr1	179857189	179858141	CpG: 92	952	92	635	19.3	66.7	0.87
chr1	179986904	179987693	CpG: 81	789	81	563	20.5	71.4	0.81
chr1	180065896	180066607	CpG: 53	711	53	497	14.9	69.9	0.61
chr1	180195074	180195351	CpG: 23	277	23	173	16.6	62.5	0.87
chr1	180227592	180228019	CpG: 33	427	33	257	15.5	60.2	0.86
chr1	180267387	180268663	CpG: 147	1276	147	961	23.0	75.3	0.81
chr1	180290391	180290786	CpG: 46	395	46	293	23.3	74.2	0.85
chr1	180309021	180309798	CpG: 87	777	87	579	22.4	74.5	0.81
chr1	180377358	180377596	CpG: 18	238	18	147	15.1	61.8	0.83
chr1	180377850	180378280	CpG: 48	430	48	313	22.3	72.8	0.89
chr1	180401029	180401458	CpG: 36	429	36	317	16.8	73.9	0.62
chr1	180433029	180433308	CpG: 25	279	25	172	17.9	61.6	0.95
chr1	180443426	180445099	CpG: 195	1673	195	1166	23.3	69.7	0.96
chr1	180459834	180460925	CpG: 130	1091	130	808	23.8	74.1	0.87
chr1	180672876	180673143	CpG: 28	267	28	171	21.0	64.0	1.10
chr1	180673577	180674150	CpG: 53	573	53	384	18.5	67.0	0.83
chr1	180728971	180729184	CpG: 16	213	16	129	15.0	60.6	0.83
chr1	180768568	180769126	CpG: 56	558	56	404	20.1	72.4	0.77
chr1	180837595	180838333	CpG: 78	738	78	515	21.1	69.8	0.87
chr1	180838990	180839357	CpG: 32	367	32	236	17.4	64.3	0.85
chr1	180841258	180841545	CpG: 27	287	27	184	18.8	64.1	0.93
chr1	180942968	180943189	CpG: 17	221	17	121	15.4	54.8	1.06
chr1	181153767	181154167	CpG: 28	400	28	260	14.0	65.0	0.70
chr1	181215433	181215712	CpG: 25	279	25	175	17.9	62.7	0.92
chr1	181385177	181385593	CpG: 51	416	51	318	24.5	76.4	0.85
chr1	181411835	181412742	CpG: 91	907	91	623	20.1	68.7	0.86
chr1	181465205	181465447	CpG: 17	242	17	141	14.0	58.3	0.84
chr1	181679789	181680063	CpG: 23	274	23	170	16.8	62.0	0.88
chr1	181750135	181752001	CpG: 174	1866	174	1282	18.6	68.7	0.79
chr1	181799403	181800095	CpG: 51	692	51	472	14.7	68.2	0.64
chr1	181963737	181964122	CpG: 34	385	34	264	17.7	68.6	0.79
chr1	181974538	181974906	CpG: 44	368	44	260	23.9	70.7	0.96
chr1	182100329	182101837	CpG: 126	1508	126	1116	16.7	74.0	0.61
chr1	182148426	182149128	CpG: 86	702	86	484	24.5	68.9	1.06
chr1	182198340	182199150	CpG: 93	810	93	552	23.0	68.1	0.99
chr1	182199494	182199762	CpG: 23	268	23	163	17.2	60.8	0.93
chr1	182286576	182286850	CpG: 22	274	22	170	16.1	62.0	0.85
chr1	182311858	182312683	CpG: 85	825	85	590	20.6	71.5	0.81
chr1	182313414	182313684	CpG: 22	270	22	164	16.3	60.7	0.90
chr1	182342082	182342355	CpG: 24	273	24	169	17.6	61.9	0.92
chr1	182381847	182383388	CpG: 174	1541	174	1140	22.6	74.0	0.83
chr1	182772937	182773212	CpG: 23	275	23	169	16.7	61.5	0.89
chr1	182776174	182777838	CpG: 117	1664	117	1018	14.1	61.2	0.79
chr1	182830501	182832405	CpG: 148	1904	148	1264	15.5	66.4	0.72
chr1	182941018	182941268	CpG: 21	250	21	151	16.8	60.4	0.95
chr1	182994430	182995480	CpG: 101	1050	101	714	19.2	68.0	0.83
chr1	183132032	183132313	CpG: 21	281	21	173	14.9	61.6	0.81
chr1	183135461	183135735	CpG: 24	274	24	171	17.5	62.4	0.91
chr1	183164361	183164584	CpG: 37	223	37	169	33.2	75.8	1.17
chr1	183399394	183400801	CpG: 140	1407	140	988	19.9	70.2	0.81
chr1	183414815	183415088	CpG: 38	273	38	205	27.8	75.1	1.00
chr1	183636379	183636607	CpG: 16	228	16	137	14.0	60.1	0.78
chr1	183672778	183673052	CpG: 22	274	22	169	16.1	61.7	0.85
chr1	183749525	183750919	CpG: 140	1394	140	1013	20.1	72.7	0.76
chr1	183934231	183934518	CpG: 25	287	25	177	17.4	61.7	0.93
chr1	183949533	183949806	CpG: 21	273	21	172	15.4	63.0	0.78
chr1	184027286	184027726	CpG: 36	440	36	298	16.4	67.7	0.71
chr1	184117306	184118492	CpG: 116	1186	116	806	19.6	68.0	0.85
chr1	184162963	184163237	CpG: 22	274	22	168	16.1	61.3	0.86
chr1	184330611	184331526	CpG: 95	915	95	632	20.8	69.1	0.87
chr1	184358569	184358794	CpG: 20	225	20	136	17.8	60.4	0.97
chr1	184402122	184402974	CpG: 114	852	114	627	26.8	73.6	0.99
chr1	184513469	184514482	CpG: 85	1013	85	669	16.8	66.0	0.78
chr1	184614332	184614558	CpG: 22	226	22	137	19.5	60.6	1.06
chr1	184625815	184626047	CpG: 19	232	19	139	16.4	59.9	0.93
chr1	184673101	184674507	CpG: 155	1406	155	960	22.0	68.3	0.97
chr1	184678609	184678961	CpG: 30	352	30	256	17.0	72.7	0.65
chr1	184723739	184724000	CpG: 18	261	18	155	13.8	59.4	0.79
chr1	184760882	184761167	CpG: 23	285	23	177	16.1	62.1	0.85
chr1	185089014	185089218	CpG: 26	204	26	152	25.5	74.5	0.92
chr1	185152372	185152646	CpG: 23	274	23	170	16.8	62.0	0.88
chr1	185607078	185607352	CpG: 24	274	24	171	17.5	62.4	0.91
chr1	185634605	185634890	CpG: 24	285	24	175	16.8	61.4	0.91
chr1	185729723	185730447	CpG: 69	724	69	477	19.1	65.9	0.89
chr1	185736088	185736361	CpG: 22	273	22	171	16.1	62.6	0.83
chr1	185754758	185755031	CpG: 22	273	22	166	16.1	60.8	0.88
chr1	185810489	185810730	CpG: 19	241	19	138	15.8	57.3	0.99
chr1	185821341	185821552	CpG: 17	211	17	123	16.1	58.3	0.97
chr1	185956666	185956887	CpG: 19	221	19	137	17.2	62.0	0.90
chr1	185979170	185979451	CpG: 23	281	23	165	16.4	58.7	0.97
chr1	185992272	185992516	CpG: 21	244	21	144	17.2	59.0	0.99
chr1	186034900	186035774	CpG: 64	874	64	525	14.6	60.1	0.81
chr1	186263600	186263837	CpG: 17	237	17	140	14.3	59.1	0.84
chr1	186317100	186317374	CpG: 22	274	22	166	16.1	60.6	0.89
chr1	186334549	186334807	CpG: 19	258	19	158	14.7	61.2	0.80
chr1	186428383	186428772	CpG: 32	389	32	284	16.5	73.0	0.62
chr1	186463154	186463424	CpG: 21	270	21	166	15.6	61.5	0.83
chr1	186518182	186518457	CpG: 23	275	23	172	16.7	62.5	0.87
chr1	186703876	186704168	CpG: 22	292	22	176	15.1	60.3	0.83
chr1	186708752	186708990	CpG: 18	238	18	138	15.1	58.0	0.93
chr1	186950553	186950854	CpG: 25	301	25	177	16.6	58.8	0.97
chr1	187056618	187057006	CpG: 38	388	38	286	19.6	73.7	0.72
chr1	187057548	187057794	CpG: 16	246	16	137	13.0	55.7	0.86
chr1	187109544	187109783	CpG: 19	239	19	144	15.9	60.3	0.89
chr1	187347560	187347838	CpG: 24	278	24	172	17.3	61.9	0.91
chr1	187359979	187360349	CpG: 41	370	41	272	22.2	73.5	0.82
chr1	187720455	187720733	CpG: 25	278	25	174	18.0	62.6	0.93
chr1	187815788	187816063	CpG: 25	275	25	173	18.2	62.9	0.93
chr1	187891197	187891471	CpG: 22	274	22	167	16.1	60.9	0.87
chr1	188185843	188186121	CpG: 21	278	21	167	15.1	60.1	0.86
chr1	188187266	188187654	CpG: 34	388	34	286	17.5	73.7	0.65
chr1	188203718	188204027	CpG: 26	309	26	224	16.8	72.5	0.64
chr1	188346417	188346690	CpG: 24	273	24	170	17.6	62.3	0.92
chr1	188404730	188404973	CpG: 19	243	19	144	15.6	59.3	0.90
chr1	188485335	188486081	CpG: 53	746	53	505	14.2	67.7	0.62
chr1	188570766	188571587	CpG: 62	821	62	552	15.1	67.2	0.67
chr1	188623533	188623806	CpG: 24	273	24	169	17.6	61.9	0.93
chr1	188849620	188849895	CpG: 18	275	18	163	13.1	59.3	0.76
chr1	189024456	189024726	CpG: 23	270	23	164	17.0	60.7	0.94
chr1	189042480	189042681	CpG: 16	201	16	118	15.9	58.7	0.92
chr1	189042911	189043138	CpG: 17	227	17	136	15.0	59.9	0.85
chr1	189043259	189043507	CpG: 20	248	20	166	16.1	66.9	0.76
chr1	189053502	189053743	CpG: 18	241	18	139	14.9	57.7	0.91
chr1	189064272	189064695	CpG: 34	423	34	307	16.1	72.6	0.61
chr1	189260131	189260405	CpG: 24	274	24	171	17.5	62.4	0.91
chr1	189281543	189281845	CpG: 21	302	21	178	13.9	58.9	0.81
chr1	189283804	189284074	CpG: 21	270	21	165	15.6	61.1	0.85
chr1	189751550	189751776	CpG: 17	226	17	139	15.0	61.5	0.81
chr1	189758841	189759071	CpG: 19	230	19	140	16.5	60.9	0.90
chr1	189930704	189930934	CpG: 18	230	18	137	15.7	59.6	0.90
chr1	190183436	190183718	CpG: 20	282	20	169	14.2	59.9	0.80
chr1	190187089	190187319	CpG: 19	230	19	140	16.5	60.9	0.90
chr1	190191519	190191775	CpG: 20	256	20	152	15.6	59.4	0.89
chr1	190238863	190239156	CpG: 20	293	20	179	13.7	61.1	0.74
chr1	190445258	190445488	CpG: 22	230	22	142	19.1	61.7	1.01
chr1	190478991	190479272	CpG: 23	281	23	175	16.4	62.3	0.86
chr1	190497844	190498191	CpG: 34	347	34	253	19.6	72.9	0.74
chr1	190555060	190555334	CpG: 24	274	24	174	17.5	63.5	0.89
chr1	190631578	190631852	CpG: 21	274	21	167	15.3	60.9	0.83
chr1	190771766	190772045	CpG: 23	279	23	174	16.5	62.4	0.86
chr1	190858893	190859171	CpG: 26	278	26	176	18.7	63.3	0.94
chr1	191050100	191050378	CpG: 26	278	26	175	18.7	62.9	0.96
chr1	191078149	191078674	CpG: 48	525	48	387	18.3	73.7	0.67
chr1	191079126	191079373	CpG: 19	247	19	142	15.4	57.5	0.97
chr1	191140781	191141018	CpG: 18	237	18	145	15.2	61.2	0.84
chr1	191192314	191192589	CpG: 20	275	20	166	14.5	60.4	0.80
chr1	191333831	191334067	CpG: 17	236	17	143	14.4	60.6	0.81
chr1	191847782	191848001	CpG: 18	219	18	129	16.4	58.9	0.95
chr1	192155572	192156138	CpG: 63	566	63	399	22.3	70.5	0.91
chr1	192334113	192334464	CpG: 30	351	30	258	17.1	73.5	0.64
chr1	192406299	192407349	CpG: 94	1050	94	704	17.9	67.0	0.81
chr1	192452252	192452856	CpG: 68	604	68	434	22.5	71.9	0.92
chr1	192453709	192453917	CpG: 15	208	15	126	14.4	60.6	0.79
chr1	192468807	192469435	CpG: 77	628	77	440	24.5	70.1	1.02
chr1	192524484	192524729	CpG: 18	245	18	138	14.7	56.3	0.94
chr1	192742915	192743144	CpG: 19	229	19	144	16.6	62.9	0.85
chr1	193072358	193072696	CpG: 26	338	26	203	15.4	60.1	0.85
chr1	193211048	193211322	CpG: 23	274	23	170	16.8	62.0	0.88
chr1	193267810	193268199	CpG: 30	389	30	278	15.4	71.5	0.61
chr1	193297294	193297539	CpG: 19	245	19	145	15.5	59.2	0.90
chr1	193349728	193349975	CpG: 19	247	19	146	15.4	59.1	0.91
chr1	193661727	193661987	CpG: 21	260	21	158	16.2	60.8	0.88
chr1	193707057	193707276	CpG: 16	219	16	126	14.6	57.5	0.88
chr1	193707619	193708010	CpG: 36	391	36	283	18.4	72.4	0.71
chr1	193731491	193731760	CpG: 23	269	23	166	17.1	61.7	0.90
chr1	193895779	193896012	CpG: 16	233	16	140	13.7	60.1	0.78
chr1	193909343	193909617	CpG: 24	274	24	172	17.5	62.8	0.90
chr1	194205287	194205561	CpG: 27	274	27	197	19.7	71.9	0.76
chr1	194341577	194341851	CpG: 24	274	24	172	17.5	62.8	0.90
chr1	194594511	194594739	CpG: 16	228	16	132	14.0	57.9	0.87
chr1	194955756	194955982	CpG: 18	226	18	130	15.9	57.5	0.99
chr1	195129645	195129883	CpG: 17	238	17	139	14.3	58.4	0.87
chr1	195262346	195262582	CpG: 19	236	19	143	16.1	60.6	0.90
chr1	195530477	195530760	CpG: 23	283	23	174	16.3	61.5	0.87
chr1	195571018	195571310	CpG: 23	292	23	177	15.8	60.6	0.86
chr1	195638616	195638858	CpG: 21	242	21	150	17.4	62.0	0.93
chr1	195826962	195827201	CpG: 18	239	18	143	15.1	59.8	0.86
chr1	195949136	195949417	CpG: 23	281	23	175	16.4	62.3	0.86
chr1	195954917	195955220	CpG: 24	303	24	200	15.8	66.0	0.73
chr1	196139777	196140037	CpG: 29	260	29	186	22.3	71.5	0.87
chr1	196238653	196238878	CpG: 16	225	16	131	14.2	58.2	0.86
chr1	196407972	196408685	CpG: 59	713	59	439	16.5	61.6	0.88
chr1	196462719	196463433	CpG: 63	714	63	461	17.6	64.6	0.86
chr1	196592757	196592961	CpG: 16	204	16	120	15.7	58.8	0.92
chr1	196667014	196667833	CpG: 60	819	60	563	14.7	68.7	0.62
chr1	196671621	196671896	CpG: 19	275	19	164	13.8	59.6	0.79
chr1	196790351	196790587	CpG: 21	236	21	143	17.8	60.6	0.99
chr1	196914693	196914968	CpG: 21	275	21	170	15.3	61.8	0.81
chr1	196966889	196967316	CpG: 32	427	32	257	15.0	60.2	0.83
chr1	197034193	197035050	CpG: 102	857	102	655	23.8	76.4	0.82
chr1	197161854	197162565	CpG: 89	711	89	505	25.0	71.0	1.00
chr1	197170279	197171900	CpG: 105	1621	105	1015	13.0	62.6	0.66
chr1	197175322	197175651	CpG: 30	329	30	214	18.2	65.0	0.91
chr1	197177350	197178053	CpG: 58	703	58	434	16.5	61.7	0.87
chr1	197180742	197181088	CpG: 27	346	27	220	15.6	63.6	0.78
chr1	197392477	197392738	CpG: 23	261	23	158	17.6	60.5	0.97
chr1	197416147	197417093	CpG: 118	946	118	686	24.9	72.5	0.96
chr1	197418398	197418615	CpG: 21	217	21	154	19.4	71.0	0.79
chr1	197470153	197470383	CpG: 19	230	19	139	16.5	60.4	0.92
chr1	197560653	197560927	CpG: 23	274	23	171	16.8	62.4	0.87
chr1	197574477	197574791	CpG: 23	314	23	182	14.6	58.0	0.88
chr1	197844007	197844402	CpG: 33	395	33	280	16.7	70.9	0.67
chr1	198104583	198104821	CpG: 22	238	22	149	18.5	62.6	0.96
chr1	198236269	198236547	CpG: 19	278	19	157	13.7	56.5	0.87
chr1	198254787	198255077	CpG: 23	290	23	181	15.9	62.4	0.83
chr1	198315142	198315420	CpG: 23	278	23	172	16.5	61.9	0.87
chr1	198452445	198452719	CpG: 25	274	25	172	18.2	62.8	0.94
chr1	199161426	199162232	CpG: 57	806	57	549	14.1	68.1	0.61
chr1	199166901	199167182	CpG: 22	281	22	172	15.7	61.2	0.85
chr1	199179466	199179677	CpG: 15	211	15	130	14.2	61.6	0.76
chr1	199216567	199217015	CpG: 42	448	42	325	18.8	72.5	0.71
chr1	199286101	199286357	CpG: 42	256	42	191	32.8	74.6	1.18
chr1	199292361	199292820	CpG: 36	459	36	277	15.7	60.3	0.86
chr1	199295673	199296089	CpG: 28	416	28	275	13.5	66.1	0.63
chr1	199296279	199296934	CpG: 78	655	78	476	23.8	72.7	0.90
chr1	199297694	199297923	CpG: 24	229	24	155	21.0	67.7	0.94
chr1	199298512	199298719	CpG: 16	207	16	124	15.5	59.9	0.88
chr1	199299287	199299942	CpG: 55	655	55	395	16.8	60.3	0.92
chr1	199404502	199405010	CpG: 53	508	53	341	20.9	67.1	0.93
chr1	199543001	199543235	CpG: 18	234	18	136	15.4	58.1	0.93
chr1	199559081	199559343	CpG: 25	262	25	160	19.1	61.1	1.05
chr1	199612168	199612400	CpG: 17	232	17	136	14.7	58.6	0.88
chr1	199666316	199667187	CpG: 86	871	86	601	19.7	69.0	0.83
chr1	199833114	199833388	CpG: 25	274	25	171	18.2	62.4	0.95
chr1	199877347	199877919	CpG: 54	572	54	393	18.9	68.7	0.81
chr1	199924991	199925193	CpG: 16	202	16	116	15.8	57.4	0.97
chr1	199926346	199927174	CpG: 88	828	88	593	21.3	71.6	0.84
chr1	199929703	199929938	CpG: 17	235	17	141	14.5	60.0	0.83
chr1	199995745	199996844	CpG: 129	1099	129	787	23.5	71.6	0.93
chr1	200004743	200004998	CpG: 21	255	21	162	16.5	63.5	0.83
chr1	200130046	200131238	CpG: 130	1192	130	867	21.8	72.7	0.82
chr1	200147931	200148431	CpG: 53	500	53	363	21.2	72.6	0.81
chr1	200168398	200169075	CpG: 57	677	57	479	16.8	70.8	0.68
chr1	200229366	200229573	CpG: 18	207	18	147	17.4	71.0	0.70
chr1	200257437	200257778	CpG: 26	341	26	218	15.2	63.9	0.75
chr1	200280096	200280813	CpG: 96	717	96	561	26.8	78.2	0.88
chr1	200371314	200372423	CpG: 110	1109	110	787	19.8	71.0	0.79
chr1	200411093	200411593	CpG: 44	500	44	344	17.6	68.8	0.78
chr1	200427723	200428353	CpG: 51	630	51	420	16.2	66.7	0.73
chr1	200484164	200484401	CpG: 17	237	17	162	14.3	68.4	0.62
chr1	200541107	200542303	CpG: 98	1196	98	813	16.4	68.0	0.71
chr1	200656933	200657705	CpG: 85	772	85	565	22.0	73.2	0.83
chr1	200695997	200696231	CpG: 17	234	17	142	14.5	60.7	0.82
chr1	200726172	200727303	CpG: 123	1131	123	822	21.8	72.7	0.83
chr1	200739530	200739755	CpG: 22	225	22	154	19.6	68.4	0.84
chr1	200764541	200765172	CpG: 72	631	72	454	22.8	71.9	0.88
chr1	200796423	200797961	CpG: 133	1538	133	1024	17.3	66.6	0.79
chr1	200905705	200908452	CpG: 213	2747	213	1805	15.5	65.7	0.72
chr1	200997439	200998081	CpG: 50	642	50	433	15.6	67.4	0.69
chr1	201086854	201087339	CpG: 50	485	50	328	20.6	67.6	0.96
chr1	201146541	201146933	CpG: 41	392	41	297	20.9	75.8	0.74
chr1	201212502	201212742	CpG: 20	240	20	143	16.7	59.6	0.95
chr1	201212899	201213616	CpG: 51	717	51	441	14.2	61.5	0.76
chr1	201240143	201241140	CpG: 109	997	109	724	21.9	72.6	0.83
chr1	201308127	201308365	CpG: 17	238	17	141	14.3	59.2	0.84
chr1	201350580	201350964	CpG: 29	384	29	229	15.1	59.6	0.86
chr1	201401582	201402574	CpG: 131	992	131	748	26.4	75.4	0.94
chr1	201451398	201451793	CpG: 51	395	51	308	25.8	78.0	0.86
chr1	201476204	201476716	CpG: 53	512	53	372	20.7	72.7	0.80
chr1	201515957	201516231	CpG: 23	274	23	170	16.8	62.0	0.88
chr1	201594745	201595019	CpG: 24	274	24	171	17.5	62.4	0.91
chr1	201603409	201603683	CpG: 24	274	24	171	17.5	62.4	0.91
chr1	201604027	201604296	CpG: 24	269	24	165	17.8	61.3	0.96
chr1	201610643	201611182	CpG: 55	539	55	357	20.4	66.2	0.95
chr1	201640012	201640243	CpG: 20	231	20	141	17.3	61.0	0.95
chr1	201904320	201905691	CpG: 117	1371	117	923	17.1	67.3	0.76
chr1	201971944	201972832	CpG: 84	888	84	631	18.9	71.1	0.75
chr1	202069534	202071258	CpG: 178	1724	178	1236	20.6	71.7	0.82
chr1	202073321	202074215	CpG: 76	894	76	614	17.0	68.7	0.73
chr1	202123632	202124468	CpG: 78	836	78	562	18.7	67.2	0.85
chr1	202151237	202151948	CpG: 83	711	83	514	23.3	72.3	0.90
chr1	202189775	202190263	CpG: 46	488	46	310	18.9	63.5	0.93
chr1	202190543	202190938	CpG: 29	395	29	229	14.7	58.0	0.90
chr1	202191559	202191784	CpG: 18	225	18	132	16.0	58.7	0.95
chr1	202220475	202221292	CpG: 89	817	89	607	21.8	74.3	0.80
chr1	202223283	202223508	CpG: 16	225	16	136	14.2	60.4	0.79
chr1	202229642	202230616	CpG: 76	974	76	645	15.6	66.2	0.72
chr1	202256992	202257232	CpG: 17	240	17	141	14.2	58.8	0.84
chr1	202269399	202269614	CpG: 20	215	20	132	18.6	61.4	1.00
chr1	202269907	202270607	CpG: 77	700	77	470	22.0	67.1	1.00
chr1	202289068	202289781	CpG: 71	713	71	500	19.9	70.1	0.81
chr1	202338347	202339015	CpG: 67	668	67	486	20.1	72.8	0.76
chr1	202390426	202391120	CpG: 50	694	50	468	14.4	67.4	0.63
chr1	202529475	202529781	CpG: 25	306	25	221	16.3	72.2	0.63
chr1	202536222	202536521	CpG: 22	299	22	206	14.7	68.9	0.62
chr1	202567969	202569061	CpG: 105	1092	105	758	19.2	69.4	0.80
chr1	202590017	202590669	CpG: 53	652	53	435	16.3	66.7	0.73
chr1	202592199	202592437	CpG: 19	238	19	144	16.0	60.5	0.88
chr1	202749537	202749763	CpG: 16	226	16	132	14.2	58.4	0.87
chr1	202750506	202750784	CpG: 21	278	21	183	15.1	65.8	0.70
chr1	202892559	202892941	CpG: 40	382	40	254	20.9	66.5	0.95
chr1	202943526	202943765	CpG: 18	239	18	149	15.1	62.3	0.79
chr1	203043716	203043954	CpG: 17	238	17	139	14.3	58.4	0.85
chr1	203058630	203059355	CpG: 57	725	57	468	15.7	64.6	0.76
chr1	203067370	203067593	CpG: 16	223	16	132	14.3	59.2	0.84
chr1	203105680	203106425	CpG: 59	745	59	519	15.8	69.7	0.65
chr1	203125018	203125724	CpG: 47	706	47	414	13.3	58.6	0.77
chr1	203164021	203164591	CpG: 47	570	47	411	16.5	72.1	0.63
chr1	203336569	203336843	CpG: 23	274	23	170	16.8	62.0	0.88
chr1	203337222	203339524	CpG: 218	2302	218	1554	18.9	67.5	0.83
chr1	203397711	203397994	CpG: 21	283	21	175	14.8	61.8	0.79
chr1	203415433	203416581	CpG: 124	1148	124	850	21.6	74.0	0.79
chr1	203435369	203435654	CpG: 21	285	21	175	14.7	61.4	0.79
chr1	203446189	203446463	CpG: 24	274	24	170	17.5	62.0	0.92
chr1	203454467	203454849	CpG: 34	382	34	267	17.8	69.9	0.74
chr1	203521988	203522352	CpG: 25	364	25	247	13.7	67.9	0.61
chr1	203642152	203642873	CpG: 64	721	64	504	17.8	69.9	0.73
chr1	203668849	203669073	CpG: 17	224	17	133	15.2	59.4	0.87
chr1	203675787	203676680	CpG: 89	893	89	582	19.9	65.2	0.94
chr1	203738433	203738669	CpG: 20	236	20	142	16.9	60.2	0.95
chr1	203758566	203759359	CpG: 77	793	77	566	19.4	71.4	0.77
chr1	203779752	203780034	CpG: 20	282	20	170	14.2	60.3	0.79
chr1	203780741	203781099	CpG: 33	358	33	248	18.4	69.3	0.83
chr1	203949404	203950157	CpG: 100	753	100	583	26.6	77.4	0.91
chr1	204092857	204093177	CpG: 47	320	47	251	29.4	78.4	0.96
chr1	204261550	204261832	CpG: 21	282	21	181	14.9	64.2	0.86
chr1	204334021	204334390	CpG: 32	369	32	245	17.3	66.4	0.79
chr1	204389884	204390090	CpG: 16	206	16	119	15.5	57.8	0.94
chr1	204475108	204476055	CpG: 96	947	96	663	20.3	70.0	0.86
chr1	204491975	204492530	CpG: 74	555	74	427	26.7	76.9	0.90
chr1	204492816	204493143	CpG: 28	327	28	218	17.1	66.7	0.78
chr1	204505875	204506344	CpG: 36	469	36	321	15.4	68.4	0.67
chr1	204533300	204533734	CpG: 35	434	35	277	16.1	63.8	0.80
chr1	204585412	204586215	CpG: 79	803	79	542	19.7	67.5	0.87
chr1	204606014	204606249	CpG: 17	235	17	139	14.5	59.1	0.85
chr1	204607669	204608752	CpG: 117	1083	117	790	21.6	72.9	0.81
chr1	204694937	204695188	CpG: 27	251	27	175	21.5	69.7	0.92
chr1	204720042	204721769	CpG: 162	1727	162	1128	18.8	65.3	0.90
chr1	204769147	204769379	CpG: 26	232	26	160	22.4	69.0	1.04
chr1	204793272	204793859	CpG: 44	587	44	410	15.0	69.8	0.64
chr1	204833168	204833983	CpG: 97	815	97	627	23.8	76.9	0.81
chr1	204856504	204856888	CpG: 33	384	33	249	17.2	64.8	0.82
chr1	204896000	204896943	CpG: 138	943	138	714	29.3	75.7	1.03
chr1	204916150	204916378	CpG: 19	228	19	142	16.7	62.3	0.88
chr1	204927484	204927761	CpG: 22	277	22	193	15.9	69.7	0.66
chr1	204944490	204945423	CpG: 110	933	110	682	23.6	73.1	0.88
chr1	204970810	204971044	CpG: 18	234	18	138	15.4	59.0	0.91
chr1	205005698	205005967	CpG: 24	269	24	172	17.8	63.9	0.88
chr1	205007223	205007458	CpG: 20	235	20	144	17.0	61.3	0.92
chr1	205013789	205014896	CpG: 100	1107	100	758	18.1	68.5	0.77
chr1	205039441	205040209	CpG: 58	768	58	491	15.1	63.9	0.75
chr1	205077397	205078537	CpG: 102	1140	102	793	17.9	69.6	0.74
chr1	205114427	205114720	CpG: 23	293	23	184	15.7	62.8	0.81
chr1	205327536	205328804	CpG: 104	1268	104	929	16.4	73.3	0.61
chr1	205381348	205381839	CpG: 46	491	46	356	18.7	72.5	0.72
chr1	205426438	205426677	CpG: 18	239	18	137	15.1	57.3	0.97
chr1	205466652	205470072	CpG: 264	3420	264	2206	15.4	64.5	0.76
chr1	205571645	205572032	CpG: 31	387	31	278	16.0	71.8	0.62
chr1	205624039	205624317	CpG: 24	278	24	174	17.3	62.6	0.89
chr1	205638278	205638498	CpG: 18	220	18	132	16.4	60.0	0.94
chr1	205745975	205746249	CpG: 21	274	21	168	15.3	61.3	0.82
chr1	205771084	205772292	CpG: 135	1208	135	870	22.4	72.0	0.86
chr1	205821250	205821761	CpG: 60	511	60	380	23.5	74.4	0.87
chr1	205876626	205876852	CpG: 26	226	26	170	23.0	75.2	0.81
chr1	205899349	205900013	CpG: 75	664	75	475	22.6	71.5	0.88
chr1	205948926	205950486	CpG: 171	1560	171	1147	21.9	73.5	0.81
chr1	206091612	206091860	CpG: 18	248	18	151	14.5	60.9	0.80
chr1	206173652	206174161	CpG: 64	509	64	388	25.1	76.2	0.87
chr1	206315935	206316296	CpG: 38	361	38	242	21.1	67.0	0.94
chr1	206318127	206318688	CpG: 47	561	47	363	16.8	64.7	0.80
chr1	206586494	206587315	CpG: 72	821	72	550	17.5	67.0	0.79
chr1	206719487	206720236	CpG: 72	749	72	518	19.2	69.2	0.80
chr1	206761610	206761988	CpG: 45	378	45	275	23.8	72.8	0.93
chr1	206891720	206892361	CpG: 64	641	64	419	20.0	65.4	0.93
chr1	206916186	206916660	CpG: 50	474	50	327	21.1	69.0	0.90
chr1	206977352	206977595	CpG: 20	243	20	146	16.5	60.1	0.91
chr1	206983948	206984226	CpG: 25	278	25	173	18.0	62.2	0.94
chr1	206998725	206999365	CpG: 63	640	63	424	19.7	66.2	0.90
chr1	207115258	207116114	CpG: 94	856	94	629	22.0	73.5	0.83
chr1	207123817	207124038	CpG: 18	221	18	135	16.3	61.1	0.88
chr1	207157503	207157919	CpG: 43	416	43	295	20.7	70.9	0.84
chr1	207205722	207206512	CpG: 85	790	85	571	21.5	72.3	0.83
chr1	207210064	207210581	CpG: 60	517	60	372	23.2	72.0	0.90
chr1	207433445	207433728	CpG: 23	283	23	175	16.3	61.8	0.87
chr1	207489870	207491391	CpG: 174	1521	174	1075	22.9	70.7	0.92
chr1	207553838	207554112	CpG: 23	274	23	170	16.8	62.0	0.88
chr1	207735233	207735624	CpG: 38	391	38	284	19.4	72.6	0.74
chr1	207983553	207983785	CpG: 20	232	20	141	17.2	60.8	0.95
chr1	208200723	208200963	CpG: 21	240	21	148	17.5	61.7	0.94
chr1	208375412	208376436	CpG: 83	1024	83	737	16.2	72.0	0.63
chr1	208441246	208441529	CpG: 24	283	24	175	17.0	61.8	0.90
chr1	208478311	208478939	CpG: 84	628	84	494	26.8	78.7	0.87
chr1	208507986	208508256	CpG: 22	270	22	166	16.3	61.5	0.87
chr1	208566935	208567216	CpG: 23	281	23	176	16.4	62.6	0.85
chr1	208872580	208872785	CpG: 16	205	16	140	15.6	68.3	0.67
chr1	208921855	208922839	CpG: 76	984	76	665	15.4	67.6	0.68
chr1	208994366	208994758	CpG: 28	392	28	250	14.3	63.8	0.70
chr1	209031144	209031590	CpG: 41	446	41	279	18.4	62.6	0.96
chr1	209052741	209053091	CpG: 38	350	38	239	21.7	68.3	0.99
chr1	209074555	209075335	CpG: 54	780	54	449	13.8	57.6	0.84
chr1	209105459	209105940	CpG: 44	481	44	358	18.3	74.4	0.66
chr1	209135703	209136261	CpG: 59	558	59	407	21.1	72.9	0.80
chr1	209158235	209158659	CpG: 31	424	31	255	14.6	60.1	0.81
chr1	209176685	209177560	CpG: 118	875	118	669	27.0	76.5	0.93
chr1	209316954	209317228	CpG: 22	274	22	168	16.1	61.3	0.86
chr1	209447601	209447830	CpG: 19	229	19	140	16.6	61.1	0.90
chr1	209471138	209472589	CpG: 154	1451	154	1064	21.2	73.3	0.80
chr1	209472740	209472976	CpG: 20	236	20	161	16.9	68.2	0.73
chr1	209490303	209490976	CpG: 64	673	64	458	19.0	68.1	0.82
chr1	209531051	209531554	CpG: 51	503	51	360	20.3	71.6	0.79
chr1	209567416	209568122	CpG: 89	706	89	489	25.2	69.3	1.06
chr1	209624937	209625203	CpG: 23	266	23	165	17.3	62.0	0.91
chr1	209925547	209925750	CpG: 16	203	16	137	15.8	67.5	0.69
chr1	210003066	210003302	CpG: 20	236	20	143	16.9	60.6	0.94
chr1	210030814	210031088	CpG: 24	274	24	171	17.5	62.4	0.91
chr1	210281049	210281279	CpG: 20	230	20	141	17.4	61.3	0.94
chr1	210379005	210380013	CpG: 92	1008	92	694	18.3	68.8	0.77
chr1	210394445	210394655	CpG: 15	210	15	124	14.3	59.0	0.82
chr1	210442982	210443210	CpG: 22	228	22	173	19.3	75.9	0.67
chr1	210452715	210453092	CpG: 39	377	39	257	20.7	68.2	0.89
chr1	210504328	210506357	CpG: 184	2029	184	1363	18.1	67.2	0.80
chr1	210507204	210507446	CpG: 17	242	17	140	14.0	57.9	0.85
chr1	210518224	210518498	CpG: 23	274	23	170	16.8	62.0	0.88
chr1	210572200	210572905	CpG: 88	705	88	514	25.0	72.9	0.94
chr1	210628205	210628598	CpG: 42	393	42	252	21.4	64.1	1.04
chr1	210661947	210662563	CpG: 85	616	85	492	27.6	79.9	0.87
chr1	210725058	210725506	CpG: 41	448	41	315	18.3	70.3	0.74
chr1	210761212	210761855	CpG: 66	643	66	470	20.5	73.1	0.77
chr1	210823861	210825917	CpG: 219	2056	219	1472	21.3	71.6	0.83
chr1	210870680	210870915	CpG: 19	235	19	145	16.2	61.7	0.85
chr1	210921427	210921962	CpG: 43	535	43	342	16.1	63.9	0.79
chr1	210922198	210922404	CpG: 17	206	17	127	16.5	61.7	0.88
chr1	211024205	211024447	CpG: 20	242	20	147	16.5	60.7	0.92
chr1	211076215	211077064	CpG: 128	849	128	680	30.2	80.1	0.94
chr1	211094072	211094314	CpG: 20	242	20	135	16.5	55.8	1.09
chr1	211096348	211096627	CpG: 23	279	23	174	16.5	62.4	0.86
chr1	211120570	211120927	CpG: 27	357	27	253	15.1	70.9	0.60
chr1	211135517	211135915	CpG: 46	398	46	305	23.1	76.6	0.79
chr1	211177824	211178054	CpG: 19	230	19	142	16.5	61.7	0.88
chr1	211260775	211261206	CpG: 35	431	35	296	16.2	68.7	0.69
chr1	211281582	211282109	CpG: 47	527	47	324	17.8	61.5	0.94
chr1	211287651	211287892	CpG: 18	241	18	142	14.9	58.9	0.87
chr1	211529519	211529747	CpG: 17	228	17	137	14.9	60.1	0.85
chr1	211530789	211532516	CpG: 181	1727	181	1199	21.0	69.4	0.87
chr1	211658946	211659639	CpG: 77	693	77	495	22.2	71.4	0.88
chr1	211677460	211678199	CpG: 86	739	86	551	23.3	74.6	0.84
chr1	211759674	211760280	CpG: 55	606	55	432	18.2	71.3	0.72
chr1	211803264	211804053	CpG: 91	789	91	568	23.1	72.0	0.90
chr1	211851747	211854681	CpG: 254	2934	254	1916	17.3	65.3	0.81
chr1	211944081	211945669	CpG: 171	1588	171	1153	21.5	72.6	0.83
chr1	211969350	211970164	CpG: 65	814	65	576	16.0	70.8	0.64
chr1	212020854	212021083	CpG: 16	229	16	138	14.0	60.3	0.80
chr1	212035610	212035877	CpG: 18	267	18	164	13.5	61.4	0.72
chr1	212036491	212036972	CpG: 45	481	45	309	18.7	64.2	0.91
chr1	212102997	212103756	CpG: 89	759	89	559	23.5	73.6	0.87
chr1	212193408	212194853	CpG: 124	1445	124	974	17.2	67.4	0.76
chr1	212258281	212259023	CpG: 62	742	62	494	16.7	66.6	0.78
chr1	212281717	212281990	CpG: 23	273	23	173	16.8	63.4	0.85
chr1	212294358	212294614	CpG: 33	256	33	184	25.8	71.9	1.00
chr1	212514550	212514823	CpG: 23	273	23	166	16.8	60.8	0.92
chr1	212546987	212547254	CpG: 23	267	23	167	17.2	62.5	0.89
chr1	212632474	212632693	CpG: 19	219	19	145	17.4	66.2	0.79
chr1	212943605	212943878	CpG: 23	273	23	173	16.8	63.4	0.85
chr1	213219447	213219901	CpG: 42	454	42	318	18.5	70.0	0.78
chr1	213222233	213223084	CpG: 83	851	83	609	19.5	71.6	0.77
chr1	213224960	213225314	CpG: 40	354	40	236	22.6	66.7	1.02
chr1	213227032	213227268	CpG: 25	236	25	138	21.2	58.5	1.25
chr1	213227431	213227649	CpG: 17	218	17	128	15.6	58.7	0.91
chr1	213228741	213228970	CpG: 25	229	25	152	21.8	66.4	1.04
chr1	213426806	213427164	CpG: 38	358	38	239	21.2	66.8	0.96
chr1	213483787	213484015	CpG: 18	228	18	137	15.8	60.1	0.88
chr1	213520274	213521225	CpG: 125	951	125	722	26.3	75.9	0.91
chr1	213623333	213623610	CpG: 20	277	20	181	14.4	65.3	0.68
chr1	213790322	213791747	CpG: 135	1425	135	975	18.9	68.4	0.82
chr1	213842167	213842846	CpG: 60	679	60	421	17.7	62.0	0.92
chr1	213844819	213845620	CpG: 78	801	78	560	19.5	69.9	0.80
chr1	213847573	213848467	CpG: 86	894	86	647	19.2	72.4	0.73
chr1	213912357	213912745	CpG: 39	388	39	292	20.1	75.3	0.71
chr1	213973524	213973798	CpG: 22	274	22	164	16.1	59.9	0.91
chr1	214109089	214110674	CpG: 148	1585	148	1219	18.7	76.9	0.63
chr1	214261519	214261797	CpG: 22	278	22	170	15.8	61.2	0.86
chr1	214322676	214323261	CpG: 79	585	79	444	27.0	75.9	0.94
chr1	214370752	214371022	CpG: 20	270	20	162	14.8	60.0	0.84
chr1	214634475	214634710	CpG: 21	235	21	138	17.9	58.7	1.04
chr1	214635050	214635331	CpG: 26	281	26	210	18.5	74.7	0.66
chr1	214807565	214808324	CpG: 90	759	90	559	23.7	73.6	0.88
chr1	214809583	214809821	CpG: 19	238	19	140	16.0	58.8	0.94
chr1	215011669	215011947	CpG: 23	278	23	174	16.5	62.6	0.85
chr1	215192158	215192439	CpG: 22	281	22	173	15.7	61.6	0.84
chr1	215342932	215343163	CpG: 20	231	20	137	17.3	59.3	1.00
chr1	215533456	215533667	CpG: 15	211	15	124	14.2	58.8	0.85
chr1	215635078	215635357	CpG: 22	279	22	174	15.8	62.4	0.83
chr1	215841352	215841747	CpG: 43	395	43	293	21.8	74.2	0.79
chr1	216330763	216330979	CpG: 29	216	29	170	26.9	78.7	0.87
chr1	216375474	216376909	CpG: 114	1435	114	887	15.9	61.8	0.83
chr1	216378479	216379503	CpG: 80	1024	80	654	15.6	63.9	0.77
chr1	216653557	216653831	CpG: 21	274	21	174	15.3	63.5	0.77
chr1	216695423	216695636	CpG: 15	213	15	123	14.1	57.7	0.86
chr1	216699009	216699248	CpG: 21	239	21	144	17.6	60.3	0.98
chr1	216765605	216765806	CpG: 16	201	16	125	15.9	62.2	0.83
chr1	216871939	216872149	CpG: 20	210	20	130	19.0	61.9	1.00
chr1	216937164	216937495	CpG: 25	331	25	196	15.1	59.2	0.87
chr1	216945317	216945598	CpG: 23	281	23	175	16.4	62.3	0.86
chr1	217034642	217034879	CpG: 17	237	17	138	14.3	58.2	0.87
chr1	217165780	217166134	CpG: 36	354	36	248	20.3	70.1	0.83
chr1	217316788	217317064	CpG: 19	276	19	161	13.8	58.3	0.82
chr1	217399203	217400456	CpG: 131	1253	131	871	20.9	69.5	0.87
chr1	217505574	217505808	CpG: 20	234	20	145	17.1	62.0	0.91
chr1	217519442	217520107	CpG: 55	665	55	406	16.5	61.1	0.89
chr1	217580479	217581096	CpG: 64	617	64	417	20.7	67.6	0.91
chr1	217581709	217581928	CpG: 21	219	21	130	19.2	59.4	1.11
chr1	218228329	218228564	CpG: 16	235	16	137	13.6	58.3	0.82
chr1	218409737	218410200	CpG: 46	463	46	309	19.9	66.7	0.89
chr1	218588224	218588444	CpG: 19	220	19	132	17.3	60.0	0.99
chr1	218637336	218637581	CpG: 21	245	21	151	17.1	61.6	0.91
chr1	218716602	218716863	CpG: 22	261	22	160	16.9	61.3	0.90
chr1	218849257	218849585	CpG: 26	328	26	189	15.9	57.6	0.96
chr1	219165640	219166655	CpG: 116	1015	116	719	22.9	70.8	0.91
chr1	219285443	219286088	CpG: 64	645	64	423	19.8	65.6	0.93
chr1	219322627	219322942	CpG: 22	315	22	178	14.0	56.5	0.89
chr1	219333246	219333866	CpG: 68	620	68	460	21.9	74.2	0.80
chr1	219351423	219351709	CpG: 25	286	25	179	17.5	62.6	0.91
chr1	219484571	219484813	CpG: 19	242	19	143	15.7	59.1	0.90
chr1	219511418	219511871	CpG: 37	453	37	304	16.3	67.1	0.73
chr1	219618915	219619185	CpG: 19	270	19	162	14.1	60.0	0.80
chr1	219715060	219715477	CpG: 41	417	41	314	19.7	75.3	0.69
chr1	219767354	219768397	CpG: 136	1043	136	770	26.1	73.8	0.96
chr1	219904950	219905224	CpG: 25	274	25	172	18.2	62.8	0.93
chr1	219929870	219930612	CpG: 90	742	90	544	24.3	73.3	0.92
chr1	219975739	219975947	CpG: 18	208	18	126	17.3	60.6	0.95
chr1	219987775	219988540	CpG: 77	765	77	526	20.1	68.8	0.85
chr1	220026381	220026968	CpG: 67	587	67	436	22.8	74.3	0.83
chr1	220116896	220117312	CpG: 43	416	43	275	20.7	66.1	0.97
chr1	220118414	220120121	CpG: 149	1707	149	1106	17.5	64.8	0.84
chr1	220121002	220121336	CpG: 24	334	24	191	14.4	57.2	0.88
chr1	220121938	220122246	CpG: 26	308	26	193	16.9	62.7	0.86
chr1	220123903	220124652	CpG: 56	749	56	483	15.0	64.5	0.72
chr1	220127290	220127511	CpG: 21	221	21	152	19.0	68.8	0.80
chr1	220131329	220132040	CpG: 49	711	49	407	13.8	57.2	0.84
chr1	220133887	220134625	CpG: 66	738	66	475	17.9	64.4	0.87
chr1	220135222	220135599	CpG: 31	377	31	235	16.4	62.3	0.85
chr1	220429261	220429547	CpG: 26	286	26	183	18.2	64.0	0.90
chr1	220469349	220469580	CpG: 18	231	18	143	15.6	61.9	0.82
chr1	220525506	220525884	CpG: 36	378	36	283	19.0	74.9	0.68
chr1	220846865	220847143	CpG: 26	278	26	177	18.7	63.7	0.93
chr1	220981964	220983294	CpG: 134	1330	134	892	20.2	67.1	0.90
chr1	221035700	221035974	CpG: 25	274	25	173	18.2	63.1	0.93
chr1	221101003	221101281	CpG: 25	278	25	176	18.0	63.3	0.91
chr1	221204412	221204694	CpG: 24	282	24	174	17.0	61.7	0.90
chr1	221289889	221290285	CpG: 31	396	31	286	15.7	72.2	0.60
chr1	221699369	221699581	CpG: 30	212	30	156	28.3	73.6	1.05
chr1	221823425	221823674	CpG: 22	249	22	138	17.7	55.4	1.16
chr1	221851322	221852470	CpG: 117	1148	117	852	20.4	74.2	0.75
chr1	221877865	221878069	CpG: 19	204	19	126	18.6	61.8	0.99
chr1	221933557	221933810	CpG: 18	253	18	151	14.2	59.7	0.81
chr1	221934229	221934481	CpG: 20	252	20	155	15.9	61.5	0.85
chr1	221945740	221946644	CpG: 77	904	77	593	17.0	65.6	0.80
chr1	222048641	222048968	CpG: 53	327	53	249	32.4	76.1	1.12
chr1	222118603	222118824	CpG: 17	221	17	134	15.4	60.6	0.85
chr1	222121258	222121539	CpG: 22	281	22	173	15.7	61.6	0.84
chr1	222319382	222319605	CpG: 19	223	19	158	17.0	70.9	0.69
chr1	222354902	222355199	CpG: 28	297	28	222	18.9	74.7	0.68
chr1	222380862	222381366	CpG: 57	504	57	358	22.6	71.0	0.91
chr1	222601608	222603394	CpG: 193	1786	193	1272	21.6	71.2	0.85
chr1	222631401	222632017	CpG: 59	616	59	447	19.2	72.6	0.73
chr1	222632440	222632745	CpG: 24	305	24	208	15.7	68.2	0.70
chr1	222735002	222735276	CpG: 23	274	23	169	16.8	61.7	0.89
chr1	222902013	222902846	CpG: 104	833	104	630	25.0	75.6	0.87
chr1	222938368	222939070	CpG: 71	702	71	474	20.2	67.5	0.89
chr1	223035111	223036289	CpG: 163	1178	163	885	27.7	75.1	0.98
chr1	223074445	223074688	CpG: 17	243	17	146	14.0	60.1	0.80
chr1	223182312	223182874	CpG: 63	562	63	389	22.4	69.2	0.94
chr1	223289558	223290380	CpG: 62	822	62	563	15.1	68.5	0.64
chr1	223303365	223304005	CpG: 55	640	55	438	17.2	68.4	0.74
chr1	223356633	223356908	CpG: 24	275	24	170	17.5	61.8	0.92
chr1	223372126	223373348	CpG: 144	1222	144	891	23.6	72.9	0.89
chr1	223389488	223389767	CpG: 19	279	19	165	13.6	59.1	0.79
chr1	223461672	223461946	CpG: 24	274	24	170	17.5	62.0	0.92
chr1	223497667	223497907	CpG: 18	240	18	142	15.0	59.2	0.87
chr1	223518908	223519372	CpG: 39	464	39	280	16.8	60.3	0.92
chr1	223529853	223530067	CpG: 19	214	19	159	17.8	74.3	0.65
chr1	223538569	223539010	CpG: 35	441	35	313	15.9	71.0	0.63
chr1	223541371	223541913	CpG: 48	542	48	391	17.7	72.1	0.68
chr1	223545688	223546389	CpG: 72	701	72	502	20.5	71.6	0.80
chr1	223622653	223623965	CpG: 130	1312	130	960	19.8	73.2	0.75
chr1	223804738	223806415	CpG: 166	1677	166	1125	19.8	67.1	0.88
chr1	223806509	223806954	CpG: 29	445	29	277	13.0	62.2	0.71
chr1	224118190	224118751	CpG: 71	561	71	414	25.3	73.8	0.93
chr1	224119291	224119566	CpG: 19	275	19	167	13.8	60.7	0.75
chr1	224262372	224262646	CpG: 20	274	20	166	14.6	60.6	0.80
chr1	224345148	224345423	CpG: 25	275	25	171	18.2	62.2	0.95
chr1	224462640	224462908	CpG: 26	268	26	169	19.4	63.1	0.99
chr1	224561494	224561696	CpG: 18	202	18	130	17.8	64.4	0.90
chr1	224583605	224583879	CpG: 21	274	21	166	15.3	60.6	0.84
chr1	224615310	224617101	CpG: 194	1791	194	1196	21.7	66.8	0.97
chr1	224644040	224644277	CpG: 20	237	20	144	16.9	60.8	0.93
chr1	224660982	224661376	CpG: 34	394	34	286	17.3	72.6	0.66
chr1	224661917	224662124	CpG: 15	207	15	116	14.5	56.0	0.95
chr1	224663337	224663613	CpG: 30	276	30	202	21.7	73.2	0.81
chr1	224803154	224803847	CpG: 55	693	55	465	15.9	67.1	0.71
chr1	224809282	224809556	CpG: 24	274	24	171	17.5	62.4	0.91
chr1	224840538	224842063	CpG: 177	1525	177	1116	23.2	73.2	0.87
chr1	224865377	224865637	CpG: 24	260	24	188	18.5	72.3	0.71
chr1	224867684	224867920	CpG: 18	236	18	140	15.3	59.3	0.88
chr1	224931774	224932051	CpG: 24	277	24	173	17.3	62.5	0.90
chr1	224965561	224966049	CpG: 41	488	41	310	16.8	63.5	0.83
chr1	224980404	224980678	CpG: 20	274	20	168	14.6	61.3	0.78
chr1	224997890	224998533	CpG: 80	643	80	466	24.9	72.5	0.95
chr1	225069650	225070976	CpG: 121	1326	121	904	18.3	68.2	0.79
chr1	225075199	225075729	CpG: 61	530	61	394	23.0	74.3	0.84
chr1	225111722	225112950	CpG: 107	1228	107	801	17.4	65.2	0.82
chr1	225127192	225127775	CpG: 64	583	64	425	22.0	72.9	0.83
chr1	225157738	225157992	CpG: 24	254	24	188	18.9	74.0	0.69
chr1	225163538	225163772	CpG: 21	234	21	145	17.9	62.0	0.95
chr1	225187016	225187549	CpG: 51	533	51	356	19.1	66.8	0.86
chr1	225249668	225251667	CpG: 215	1999	215	1355	21.5	67.8	0.94
chr1	225267122	225267350	CpG: 18	228	18	137	15.8	60.1	0.90
chr1	225270923	225272076	CpG: 103	1153	103	796	17.9	69.0	0.76
chr1	225273320	225273552	CpG: 17	232	17	139	14.7	59.9	0.83
chr1	225297490	225298789	CpG: 138	1299	138	921	21.2	70.9	0.86
chr1	225309112	225310629	CpG: 182	1517	182	1120	24.0	73.8	0.88
chr1	225374219	225374943	CpG: 75	724	75	529	20.7	73.1	0.78
chr1	225379790	225380022	CpG: 18	232	18	136	15.5	58.6	0.92
chr1	225411174	225412047	CpG: 113	873	113	651	25.9	74.6	0.94
chr1	225478452	225478686	CpG: 17	234	17	140	14.5	59.8	0.84
chr1	225496714	225497854	CpG: 134	1140	134	829	23.5	72.7	0.89
chr1	225505722	225505999	CpG: 24	277	24	171	17.3	61.7	0.92
chr1	225595737	225596343	CpG: 81	606	81	454	26.7	74.9	0.96
chr1	225736763	225737821	CpG: 132	1058	132	774	25.0	73.2	0.93
chr1	225830062	225830283	CpG: 15	221	15	145	13.6	65.6	0.64
chr1	225891517	225891866	CpG: 49	349	49	268	28.1	76.8	0.95
chr1	225925046	225927039	CpG: 189	1993	189	1381	19.0	69.3	0.79
chr1	225983804	225984032	CpG: 17	228	17	139	14.9	61.0	0.83
chr1	226058231	226059092	CpG: 99	861	99	641	23.0	74.4	0.83
chr1	226124560	226124790	CpG: 21	230	21	142	18.3	61.7	0.97
chr1	226127286	226128647	CpG: 128	1361	128	925	18.8	68.0	0.81
chr1	226164451	226164901	CpG: 38	450	38	325	16.9	72.2	0.72
chr1	226224815	226225091	CpG: 21	276	21	174	15.2	63.0	0.77
chr1	226381465	226381696	CpG: 18	231	18	133	15.6	57.6	0.97
chr1	226464100	226464969	CpG: 70	869	70	604	16.1	69.5	0.67
chr1	226482936	226483210	CpG: 24	274	24	171	17.5	62.4	0.91
chr1	226499101	226499342	CpG: 17	241	17	137	14.1	56.8	0.91
chr1	226506101	226507409	CpG: 141	1308	141	940	21.6	71.9	0.83
chr1	226603125	226603399	CpG: 23	274	23	170	16.8	62.0	0.88
chr1	226683409	226683620	CpG: 16	211	16	144	15.2	68.2	0.66
chr1	226683868	226684131	CpG: 25	263	25	182	19.0	69.2	0.80
chr1	226694981	226695703	CpG: 51	722	51	489	14.1	67.7	0.62
chr1	226730733	226731710	CpG: 105	977	105	738	21.5	75.5	0.75
chr1	226747396	226747746	CpG: 26	350	26	237	14.9	67.7	0.65
chr1	226748450	226748812	CpG: 26	362	26	248	14.4	68.5	0.62
chr1	226749660	226750615	CpG: 80	955	80	656	16.8	68.7	0.71
chr1	226752642	226752868	CpG: 25	226	25	160	22.1	70.8	0.88
chr1	226923876	226924664	CpG: 99	788	99	584	25.1	74.1	0.92
chr1	226975661	226976060	CpG: 31	399	31	276	15.5	69.2	0.65
chr1	226976528	226977803	CpG: 117	1275	117	889	18.4	69.7	0.81
chr1	227025323	227025601	CpG: 25	278	25	175	18.0	62.9	0.92
chr1	227066128	227066402	CpG: 23	274	23	170	16.8	62.0	0.88
chr1	227076596	227076969	CpG: 32	373	32	242	17.2	64.9	0.82
chr1	227114270	227114535	CpG: 26	265	26	187	19.6	70.6	0.79
chr1	227135742	227137602	CpG: 224	1860	224	1363	24.1	73.3	0.90
chr1	227162733	227162941	CpG: 15	208	15	145	14.4	69.7	0.60
chr1	227183129	227183394	CpG: 19	265	19	162	14.3	61.1	0.78
chr1	227195462	227197852	CpG: 235	2390	235	1666	19.7	69.7	0.81
chr1	227226776	227227343	CpG: 69	567	69	393	24.3	69.3	1.01
chr1	227247941	227248507	CpG: 66	566	66	392	23.3	69.3	0.97
chr1	227271013	227272785	CpG: 185	1772	185	1258	20.9	71.0	0.83
chr1	227290954	227292909	CpG: 202	1955	202	1365	20.7	69.8	0.86
chr1	227296653	227296854	CpG: 14	201	14	133	13.9	66.2	0.65
chr1	227298072	227298561	CpG: 53	489	53	345	21.7	70.6	0.89
chr1	227328712	227329859	CpG: 125	1147	125	790	21.8	68.9	0.94
chr1	227346672	227347995	CpG: 150	1323	150	967	22.7	73.1	0.85
chr1	227354365	227355281	CpG: 104	916	104	675	22.7	73.7	0.84
chr1	227362909	227363775	CpG: 72	866	72	601	16.6	69.4	0.70
chr1	227382332	227382617	CpG: 25	285	25	178	17.5	62.5	0.91
chr1	227400562	227403128	CpG: 267	2566	267	1824	20.8	71.1	0.82
chr1	227404322	227404618	CpG: 22	296	22	198	14.9	66.9	0.67
chr1	227405238	227405487	CpG: 23	249	23	174	18.5	69.9	0.76
chr1	227405807	227406103	CpG: 23	296	23	195	15.5	65.9	0.73
chr1	227458556	227458816	CpG: 30	260	30	206	23.1	79.2	0.74
chr1	227462985	227463239	CpG: 22	254	22	172	17.3	67.7	0.78
chr1	227464349	227465588	CpG: 105	1239	105	866	16.9	69.9	0.74
chr1	227469067	227469600	CpG: 40	533	40	348	15.0	65.3	0.70
chr1	227474941	227475149	CpG: 17	208	17	139	16.3	66.8	0.74
chr1	227504657	227505867	CpG: 93	1210	93	843	15.4	69.7	0.64
chr1	227510658	227510868	CpG: 18	210	18	132	17.1	62.9	0.87
chr1	227560082	227560383	CpG: 30	301	30	229	19.9	76.1	0.69
chr1	227567086	227568258	CpG: 112	1172	112	803	19.1	68.5	0.83
chr1	227583259	227583725	CpG: 32	466	32	306	13.7	65.7	0.64
chr1	227594636	227595525	CpG: 113	889	113	634	25.4	71.3	1.01
chr1	227604456	227605379	CpG: 79	923	79	641	17.1	69.4	0.72
chr1	227613391	227613914	CpG: 49	523	49	333	18.7	63.7	0.92
chr1	227634193	227634938	CpG: 57	745	57	468	15.3	62.8	0.78
chr1	227645918	227647245	CpG: 121	1327	121	790	18.2	59.5	1.03
chr1	227652258	227653340	CpG: 84	1082	84	645	15.5	59.6	0.87
chr1	227658123	227658357	CpG: 20	234	20	168	17.1	71.8	0.67
chr1	227659733	227659948	CpG: 23	215	23	153	21.4	71.2	0.86
chr1	227675144	227676550	CpG: 169	1406	169	1007	24.0	71.6	0.94
chr1	227743479	228026651	CpG: 25189	283172	25189	192557	17.8	68.0	0.78
chr1	228028461	228028679	CpG: 17	218	17	146	15.6	67.0	0.70
chr1	228112970	228114461	CpG: 177	1491	177	1048	23.7	70.3	0.97
chr1	228132906	228133115	CpG: 20	209	20	135	19.1	64.6	0.92
chr1	228151620	228152005	CpG: 34	385	34	281	17.7	73.0	0.66
chr1	228202133	228202407	CpG: 25	274	25	172	18.2	62.8	0.94
chr1	228243695	228243963	CpG: 19	268	19	161	14.2	60.1	0.80
chr1	228347042	228347316	CpG: 22	274	22	168	16.1	61.3	0.88
chr1	228611923	228612159	CpG: 20	236	20	144	16.9	61.0	0.93
chr1	228649575	228650287	CpG: 104	712	104	556	29.2	78.1	0.96
chr1	228719657	228719886	CpG: 18	229	18	139	15.7	60.7	0.87
chr1	228720757	228721892	CpG: 160	1135	160	889	28.2	78.3	0.92
chr1	228785913	228786740	CpG: 69	827	69	546	16.7	66.0	0.77
chr1	228810160	228813643	CpG: 266	3483	266	2257	15.3	64.8	0.73
chr1	228886726	228887306	CpG: 57	580	57	387	19.7	66.7	0.89
chr1	228936787	228938095	CpG: 173	1308	173	1005	26.5	76.8	0.90
chr1	228948504	228948740	CpG: 19	236	19	145	16.1	61.4	0.87
chr1	229004331	229005502	CpG: 155	1171	155	893	26.5	76.3	0.94
chr1	229053644	229053919	CpG: 20	275	20	170	14.5	61.8	0.77
chr1	229244287	229244825	CpG: 44	538	44	385	16.4	71.6	0.64
chr1	229297287	229297567	CpG: 21	280	21	172	15.0	61.4	0.81
chr1	229446316	229448031	CpG: 201	1715	201	1249	23.4	72.8	0.89
chr1	229659115	229659462	CpG: 24	347	24	214	13.8	61.7	0.73
chr1	229713229	229713575	CpG: 25	346	25	222	14.5	64.2	0.70
chr1	229737380	229737609	CpG: 19	229	19	144	16.6	62.9	0.84
chr1	229773933	229774195	CpG: 22	262	22	161	16.8	61.5	0.90
chr1	229805695	229807295	CpG: 226	1600	226	1245	28.2	77.8	0.94
chr1	229849280	229849521	CpG: 19	241	19	148	15.8	61.4	0.86
chr1	230022832	230023348	CpG: 58	516	58	358	22.5	69.4	0.93
chr1	230227291	230227609	CpG: 29	318	29	190	18.2	59.7	1.03
chr1	230248346	230249370	CpG: 121	1024	121	746	23.6	72.9	0.92
chr1	230284736	230285011	CpG: 23	275	23	168	16.7	61.1	0.91
chr1	230304829	230305051	CpG: 18	222	18	134	16.2	60.4	0.90
chr1	230358603	230359605	CpG: 110	1002	110	739	22.0	73.8	0.81
chr1	230420227	230422174	CpG: 200	1947	200	1417	20.5	72.8	0.81
chr1	230510911	230511695	CpG: 55	784	55	529	14.0	67.5	0.62
chr1	230543677	230544463	CpG: 57	786	57	503	14.5	64.0	0.71
chr1	230544930	230546895	CpG: 217	1965	217	1434	22.1	73.0	0.83
chr1	230550208	230550486	CpG: 26	278	26	176	18.7	63.3	0.94
chr1	230624313	230624760	CpG: 41	447	41	296	18.3	66.2	0.84
chr1	230630149	230630361	CpG: 16	212	16	129	15.1	60.8	0.82
chr1	230700562	230700816	CpG: 32	254	32	197	25.2	77.6	0.85
chr1	230720516	230721886	CpG: 123	1370	123	866	18.0	63.2	0.90
chr1	230723333	230723574	CpG: 20	241	20	140	16.6	58.1	0.99
chr1	230804158	230805924	CpG: 220	1766	220	1294	24.9	73.3	0.93
chr1	230836922	230837668	CpG: 54	746	54	509	14.5	68.2	0.62
chr1	230874467	230874694	CpG: 19	227	19	137	16.7	60.4	0.96
chr1	230879118	230879354	CpG: 17	236	17	141	14.4	59.7	0.82
chr1	230911487	230912096	CpG: 56	609	56	375	18.4	61.6	0.97
chr1	230982667	230982905	CpG: 18	238	18	145	15.1	60.9	0.83
chr1	230986448	230986690	CpG: 19	242	19	146	15.7	60.3	0.88
chr1	231009816	231010575	CpG: 75	759	75	538	19.8	70.9	0.79
chr1	231024431	231024646	CpG: 21	215	21	120	19.5	55.8	1.30
chr1	231025178	231025677	CpG: 45	499	45	363	18.0	72.7	0.68
chr1	231087724	231087958	CpG: 17	234	17	141	14.5	60.3	0.81
chr1	231301950	231302181	CpG: 20	231	20	142	17.3	61.5	0.93
chr1	231837607	231837881	CpG: 23	274	23	171	16.8	62.4	0.87
chr1	232015173	232016615	CpG: 188	1442	188	1056	26.1	73.2	0.98
chr1	232025652	232025929	CpG: 25	277	25	174	18.1	62.8	0.92
chr1	232102322	232102596	CpG: 23	274	23	170	16.8	62.0	0.88
chr1	232121414	232121657	CpG: 17	243	17	141	14.0	58.0	0.85
chr1	232191735	232192388	CpG: 69	653	69	457	21.1	70.0	0.87
chr1	232235757	232235992	CpG: 18	235	18	138	15.3	58.7	0.90
chr1	232257811	232258197	CpG: 30	386	30	274	15.5	71.0	0.62
chr1	232336784	232337188	CpG: 40	404	40	286	19.8	70.8	0.79
chr1	232460685	232460966	CpG: 23	281	23	174	16.4	61.9	0.86
chr1	232504113	232504383	CpG: 23	270	23	167	17.0	61.9	0.90
chr1	232555726	232555999	CpG: 25	273	25	170	18.3	62.3	0.95
chr1	232681758	232682149	CpG: 49	391	49	294	25.1	75.2	0.90
chr1	232713628	232715142	CpG: 196	1514	196	1154	25.9	76.2	0.90
chr1	232748329	232748539	CpG: 17	210	17	129	16.2	61.4	0.92
chr1	233000093	233001270	CpG: 114	1177	114	822	19.4	69.8	0.79
chr1	233053917	233054153	CpG: 22	236	22	146	18.6	61.9	1.00
chr1	233085874	233086150	CpG: 20	276	20	166	14.5	60.1	0.81
chr1	233115857	233116142	CpG: 22	285	22	177	15.4	62.1	0.82
chr1	233237557	233237777	CpG: 17	220	17	136	15.5	61.8	0.83
chr1	233291005	233292164	CpG: 141	1159	141	852	24.3	73.5	0.90
chr1	233463451	233463732	CpG: 23	281	23	175	16.4	62.3	0.86
chr1	233603747	233604334	CpG: 63	587	63	433	21.5	73.8	0.81
chr1	233620763	233621468	CpG: 55	705	55	472	15.6	67.0	0.70
chr1	233640433	233640707	CpG: 24	274	24	170	17.5	62.0	0.92
chr1	233657465	233658448	CpG: 74	983	74	682	15.1	69.4	0.63
chr1	233746867	233747243	CpG: 32	376	32	242	17.0	64.4	0.82
chr1	233763330	233763900	CpG: 51	570	51	338	17.9	59.3	1.02
chr1	233841844	233842120	CpG: 24	276	24	171	17.4	62.0	0.92
chr1	233868592	233869628	CpG: 163	1036	163	816	31.5	78.8	1.03
chr1	233903965	233904209	CpG: 18	244	18	141	14.8	57.8	0.93
chr1	233990181	233990767	CpG: 84	586	84	433	28.7	73.9	1.05
chr1	233998935	234001687	CpG: 389	2752	389	2050	28.3	74.5	1.02
chr1	234060464	234060700	CpG: 21	236	21	144	17.8	61.0	0.98
chr1	234133030	234133237	CpG: 17	207	17	119	16.4	57.5	1.00
chr1	234163946	234164214	CpG: 24	268	24	172	17.9	64.2	0.89
chr1	234376948	234377171	CpG: 18	223	18	133	16.1	59.6	0.93
chr1	234495963	234496238	CpG: 30	275	30	173	21.8	62.9	1.10
chr1	234520141	234520788	CpG: 69	647	69	428	21.3	66.2	0.98
chr1	234533430	234533644	CpG: 16	214	16	121	15.0	56.5	0.95
chr1	234552655	234553108	CpG: 46	453	46	293	20.3	64.7	1.00
chr1	234700314	234701377	CpG: 80	1063	80	745	15.1	70.1	0.61
chr1	234718736	234720558	CpG: 166	1822	166	1203	18.2	66.0	0.84
chr1	234721914	234722190	CpG: 21	276	21	167	15.2	60.5	0.85
chr1	234732214	234732444	CpG: 21	230	21	143	18.3	62.2	0.96
chr1	234740829	234741103	CpG: 25	274	25	172	18.2	62.8	0.93
chr1	234765392	234765623	CpG: 21	231	21	140	18.2	60.6	1.01
chr1	234792145	234792358	CpG: 17	213	17	126	16.0	59.2	0.91
chr1	234899660	234901562	CpG: 183	1902	183	1282	19.2	67.4	0.85
chr1	234914135	234914409	CpG: 21	274	21	169	15.3	61.7	0.81
chr1	234918699	234918910	CpG: 19	211	19	129	18.0	61.1	0.97
chr1	234969390	234969628	CpG: 16	238	16	138	13.4	58.0	0.81
chr1	235038644	235039107	CpG: 36	463	36	282	15.6	60.9	0.84
chr1	235045168	235047429	CpG: 240	2261	240	1610	21.2	71.2	0.84
chr1	235047643	235047851	CpG: 15	208	15	122	14.4	58.7	0.85
chr1	235262895	235263905	CpG: 114	1010	114	720	22.6	71.3	0.89
chr1	235280750	235281028	CpG: 24	278	24	173	17.3	62.2	0.90
chr1	235389799	235390203	CpG: 38	404	38	269	18.8	66.6	0.85
chr1	235460695	235461830	CpG: 136	1135	136	836	24.0	73.7	0.88
chr1	235465901	235466125	CpG: 17	224	17	132	15.2	58.9	0.88
chr1	235543598	235543865	CpG: 23	267	23	180	17.2	67.4	0.76
chr1	235544149	235545474	CpG: 158	1325	158	955	23.8	72.1	0.93
chr1	235683577	235684674	CpG: 116	1097	116	760	21.1	69.3	0.89
chr1	235750384	235750805	CpG: 37	421	37	285	17.6	67.7	0.77
chr1	235795271	235796148	CpG: 101	877	101	633	23.0	72.2	0.89
chr1	235828574	235829245	CpG: 49	671	49	446	14.6	66.5	0.67
chr1	235924669	235925206	CpG: 49	537	49	364	18.2	67.8	0.80
chr1	235938009	235938248	CpG: 20	239	20	148	16.7	61.9	0.89
chr1	236005021	236005658	CpG: 45	637	45	351	14.1	55.1	0.94
chr1	236087059	236087910	CpG: 114	851	114	644	26.8	75.7	0.94
chr1	236157065	236157339	CpG: 19	274	19	170	13.9	62.0	0.73
chr1	236187745	236188023	CpG: 26	278	26	178	18.7	64.0	0.92
chr1	236206063	236206951	CpG: 84	888	84	570	18.9	64.2	0.92
chr1	236252964	236253237	CpG: 23	273	23	171	16.8	62.6	0.87
chr1	236426499	236426773	CpG: 25	274	25	172	18.2	62.8	0.93
chr1	236436057	236436484	CpG: 34	427	34	258	15.9	60.4	0.88
chr1	236452841	236454359	CpG: 181	1518	181	1108	23.8	73.0	0.91
chr1	236486281	236486708	CpG: 32	427	32	256	15.0	60.0	0.84
chr1	236538365	236539275	CpG: 70	910	70	650	15.4	71.4	0.60
chr1	236721076	236721403	CpG: 28	327	28	243	17.1	74.3	0.62
chr1	236920265	236920501	CpG: 21	236	21	145	17.8	61.4	0.96
chr1	236948039	236948486	CpG: 33	447	33	268	14.8	60.0	0.84
chr1	237043029	237043260	CpG: 18	231	18	140	15.6	60.6	0.86
chr1	237057279	237057491	CpG: 16	212	16	125	15.1	59.0	0.88
chr1	237063076	237063312	CpG: 17	236	17	137	14.4	58.1	0.90
chr1	237080753	237081487	CpG: 55	734	55	498	15.0	67.8	0.65
chr1	237133768	237133990	CpG: 18	222	18	134	16.2	60.4	0.91
chr1	237195201	237195462	CpG: 22	261	22	134	16.9	51.3	1.29
chr1	237315904	237316179	CpG: 21	275	21	165	15.3	60.0	0.88
chr1	237650506	237650746	CpG: 18	240	18	146	15.0	60.8	0.83
chr1	237697777	237697984	CpG: 15	207	15	122	14.5	58.9	0.85
chr1	237704873	237705139	CpG: 20	266	20	166	15.0	62.4	0.78
chr1	237738447	237738907	CpG: 32	460	32	309	13.9	67.2	0.62
chr1	237809102	237809332	CpG: 19	230	19	140	16.5	60.9	0.90
chr1	237953200	237953434	CpG: 18	234	18	138	15.4	59.0	0.92
chr1	238004814	238005085	CpG: 22	271	22	164	16.2	60.5	0.89
chr1	238097055	238097486	CpG: 36	431	36	308	16.7	71.5	0.65
chr1	238213873	238214147	CpG: 22	274	22	165	16.1	60.2	0.89
chr1	238283735	238284008	CpG: 23	273	23	165	16.8	60.4	0.94
chr1	238387747	238387993	CpG: 20	246	20	155	16.3	63.0	0.84
chr1	238589822	238590097	CpG: 24	275	24	172	17.5	62.5	0.91
chr1	238798870	238800469	CpG: 135	1599	135	1015	16.9	63.5	0.86
chr1	239042664	239043091	CpG: 31	427	31	257	14.5	60.2	0.81
chr1	239226774	239227010	CpG: 21	236	21	145	17.8	61.4	0.96
chr1	239279178	239279437	CpG: 18	259	18	154	13.9	59.5	0.80
chr1	239294152	239294388	CpG: 20	236	20	146	16.9	61.9	0.91
chr1	239384631	239384905	CpG: 24	274	24	170	17.5	62.0	0.92
chr1	239410893	239411672	CpG: 105	779	105	591	27.0	75.9	0.94
chr1	239504983	239507084	CpG: 204	2101	204	1488	19.4	70.8	0.78
chr1	239517264	239517504	CpG: 17	240	17	144	14.2	60.0	0.81
chr1	239621064	239621812	CpG: 50	748	50	534	13.4	71.4	0.66
chr1	239622743	239623370	CpG: 43	627	43	372	13.7	59.3	0.78
chr1	239653501	239653784	CpG: 23	283	23	175	16.3	61.8	0.87
chr1	239817585	239817944	CpG: 26	359	26	245	14.5	68.2	0.82
chr1	239904135	239904681	CpG: 51	546	51	368	18.7	67.4	0.83
chr1	239921348	239921626	CpG: 23	278	23	176	16.5	63.3	0.84
chr1	240035235	240035471	CpG: 18	236	18	141	15.3	59.7	0.87
chr1	240140998	240141274	CpG: 28	276	28	180	20.3	65.2	0.97
chr1	240173714	240174278	CpG: 50	564	50	412	17.7	73.0	0.67
chr1	240234816	240235071	CpG: 29	255	29	185	22.7	72.5	0.87
chr1	240246002	240246274	CpG: 19	272	19	167	14.0	61.4	0.76
chr1	240344420	240344689	CpG: 20	269	20	171	14.9	63.6	0.75
chr1	240600958	240601178	CpG: 17	220	17	134	15.5	60.9	0.86
chr1	240608392	240608666	CpG: 24	274	24	171	17.5	62.4	0.91
chr1	240737772	240738053	CpG: 22	281	22	174	15.7	61.9	0.83
chr1	240768118	240768969	CpG: 121	851	121	661	28.4	77.7	0.95
chr1	240820049	240820325	CpG: 21	276	21	165	15.2	59.8	0.87
chr1	240835255	240836013	CpG: 65	758	65	553	17.2	73.0	0.65
chr1	240930588	240931227	CpG: 76	639	76	472	23.8	73.9	0.87
chr1	241051132	241052063	CpG: 114	931	114	701	24.5	75.3	0.87
chr1	241259891	241260484	CpG: 59	593	59	388	19.9	65.4	0.93
chr1	241262044	241262317	CpG: 22	273	22	167	16.1	61.2	0.88
chr1	241267612	241267998	CpG: 35	386	35	284	18.1	73.6	0.67
chr1	241340610	241340873	CpG: 18	263	18	157	13.7	59.7	0.78
chr1	241357290	241357522	CpG: 17	232	17	140	14.7	60.3	0.83
chr1	241442636	241442903	CpG: 19	267	19	163	14.2	61.0	0.78
chr1	241443096	241443369	CpG: 22	273	22	169	16.1	61.9	0.85
chr1	241463223	241463533	CpG: 24	310	24	190	15.5	61.3	0.83
chr1	241469063	241469394	CpG: 29	331	29	238	17.5	71.9	0.68
chr1	241469528	241469779	CpG: 19	251	19	168	15.1	66.9	0.69
chr1	241659075	241659348	CpG: 23	273	23	170	16.8	62.3	0.88
chr1	241709730	241710008	CpG: 24	278	24	175	17.3	62.9	0.89
chr1	241882070	241882344	CpG: 22	274	22	166	16.1	60.6	0.88
chr1	241935601	241937367	CpG: 177	1766	177	1241	20.0	70.3	0.81
chr1	242221533	242221744	CpG: 16	211	16	125	15.2	59.2	0.88
chr1	242302247	242302722	CpG: 43	475	43	343	18.1	72.2	0.70
chr1	242335994	242336201	CpG: 15	207	15	118	14.5	57.0	0.90
chr1	242386978	242387217	CpG: 19	239	19	146	15.9	61.1	0.89
chr1	242512655	242512936	CpG: 37	281	37	189	26.3	67.3	1.17
chr1	242632118	242632353	CpG: 18	235	18	147	15.3	62.6	0.79
chr1	242665464	242666498	CpG: 106	1034	106	702	20.5	67.9	0.89
chr1	242707630	242707895	CpG: 26	265	26	166	19.6	62.6	1.01
chr1	242759228	242759482	CpG: 22	254	22	155	17.3	61.0	0.94
chr1	242841671	242841875	CpG: 14	204	14	122	13.7	59.8	0.78
chr1	242885488	242885991	CpG: 48	503	48	363	19.1	72.2	0.74
chr1	242894893	242895387	CpG: 54	494	54	363	21.9	73.5	0.82
chr1	242899490	242900029	CpG: 39	539	39	364	14.5	67.5	0.65
chr1	242900913	242901263	CpG: 28	350	28	225	16.0	64.3	0.81
chr1	243155602	243155838	CpG: 22	236	22	145	18.6	61.4	1.01
chr1	243206625	243206903	CpG: 24	278	24	174	17.3	62.6	0.89
chr1	243264909	243266793	CpG: 212	1884	212	1417	22.5	75.2	0.80
chr1	243281201	243281411	CpG: 16	210	16	126	15.2	60.0	0.86
chr1	243302983	243303235	CpG: 24	252	24	158	19.0	62.7	0.97
chr1	243332772	243333325	CpG: 55	553	55	353	19.9	63.8	0.98
chr1	243347033	243347395	CpG: 26	362	26	236	14.4	65.2	0.68
chr1	243395090	243396266	CpG: 76	1176	76	868	12.9	73.8	0.64
chr1	243464217	243466094	CpG: 223	1877	223	1423	23.8	75.8	0.83
chr1	243466582	243466804	CpG: 16	222	16	131	14.4	59.0	0.83
chr1	243471462	243471726	CpG: 26	264	26	170	19.7	64.4	0.96
chr1	243524779	243525022	CpG: 21	243	21	151	17.3	62.1	0.92
chr1	243716294	243716524	CpG: 17	230	17	135	14.8	58.7	0.88
chr1	243766707	243766941	CpG: 18	234	18	142	15.4	60.7	0.85
chr1	243860544	243860810	CpG: 23	266	23	166	17.3	62.4	0.90
chr1	243867470	243868619	CpG: 117	1149	117	808	20.4	70.3	0.83
chr1	243877520	243877939	CpG: 48	419	48	306	22.9	73.0	0.86
chr1	244069156	244070037	CpG: 99	881	99	636	22.5	72.2	0.86
chr1	244146438	244147363	CpG: 109	925	109	660	23.6	71.4	0.93
chr1	244167226	244167472	CpG: 18	246	18	147	14.6	59.8	0.85
chr1	244248421	244248691	CpG: 21	270	21	166	15.6	61.5	0.84
chr1	244251026	244252145	CpG: 122	1119	122	747	21.8	66.8	0.99
chr1	244279186	244281024	CpG: 233	1838	233	1316	25.4	71.6	1.03
chr1	244320995	244321501	CpG: 43	506	43	290	17.0	57.3	1.05
chr1	244334141	244334406	CpG: 20	265	20	165	15.1	62.3	0.79
chr1	244334848	244335216	CpG: 47	368	47	286	25.5	77.7	0.86
chr1	244376265	244376539	CpG: 22	274	22	172	16.1	62.8	0.82
chr1	244386388	244388045	CpG: 160	1657	160	1128	19.3	68.1	0.83
chr1	244570710	244574411	CpG: 340	3701	340	2457	18.4	66.4	0.83
chr1	244720834	244721111	CpG: 26	277	26	173	18.8	62.5	0.97
chr1	244753203	244753538	CpG: 23	335	23	215	13.7	64.2	0.73
chr1	244857485	244857719	CpG: 18	234	18	143	15.4	61.1	0.85
chr1	244944954	244945217	CpG: 20	263	20	160	15.2	60.8	0.83
chr1	244995045	244995256	CpG: 17	211	17	129	16.1	61.1	0.86
chr1	245003962	245004246	CpG: 23	284	23	174	16.2	61.3	0.88
chr1	245007455	245007692	CpG: 26	237	26	187	21.9	78.9	0.73
chr1	245017481	245017696	CpG: 15	215	15	128	14.0	59.5	0.80
chr1	245094008	245094401	CpG: 34	393	34	279	17.3	71.0	0.73
chr1	245106136	245106700	CpG: 43	564	43	375	15.2	66.5	0.69
chr1	245108774	245110111	CpG: 125	1337	125	968	18.7	72.4	0.71
chr1	245195555	245195998	CpG: 33	443	33	290	14.9	65.5	0.70
chr1	245237863	245238156	CpG: 26	293	26	180	17.7	61.4	0.94
chr1	245247228	245247502	CpG: 24	274	24	172	17.5	62.8	0.90
chr1	245372791	245373044	CpG: 17	253	17	142	13.4	56.1	0.87
chr1	245395996	245397708	CpG: 120	1712	120	1080	14.0	63.1	0.71
chr1	245422255	245422655	CpG: 31	400	31	242	15.5	60.5	0.86
chr1	245509549	245509775	CpG: 16	226	16	136	14.2	60.2	0.78
chr1	245673579	245673842	CpG: 25	263	25	170	19.0	64.6	0.91
chr1	245728990	245729264	CpG: 24	274	24	172	17.5	62.8	0.90
chr1	245746615	245747365	CpG: 54	750	54	539	14.4	71.9	1.47
chr1	245784739	245785508	CpG: 60	769	60	534	15.6	69.4	0.65
chr1	245849883	245850113	CpG: 21	230	21	143	18.3	62.2	0.96
chr1	245929673	245930347	CpG: 78	674	78	471	23.1	69.9	0.95
chr1	245986314	245986557	CpG: 20	243	20	142	16.5	58.4	0.99
chr1	245986795	245987864	CpG: 96	1069	96	691	18.0	64.6	0.87
chr1	245997276	245997554	CpG: 25	278	25	177	18.0	63.7	0.90
chr1	246026692	246027122	CpG: 40	430	40	277	18.6	64.4	0.91
chr1	246037393	246037623	CpG: 20	230	20	142	17.4	61.7	0.92
chr1	246042251	246042539	CpG: 18	288	18	167	12.5	58.0	0.75
chr1	246056721	246057053	CpG: 28	332	28	208	16.9	62.7	0.87
chr1	246067127	246067381	CpG: 21	254	21	159	16.5	62.6	0.87
chr1	246091649	246091917	CpG: 19	268	19	159	14.2	59.3	0.82
chr1	246150436	246151200	CpG: 93	764	93	566	24.3	74.1	0.89
chr1	246212161	246213431	CpG: 80	1270	80	852	12.6	67.1	0.65
chr1	246216538	246216835	CpG: 34	297	34	214	22.9	72.1	0.91
chr1	246265916	246266157	CpG: 20	241	20	148	16.6	61.4	0.90
chr1	246325378	246325581	CpG: 16	203	16	117	15.8	57.6	0.96
chr1	246362259	246363435	CpG: 154	1176	154	848	26.2	72.1	1.01
chr1	246372220	246372469	CpG: 19	249	19	153	15.3	61.4	0.82
chr1	246420444	246420767	CpG: 24	323	24	183	14.9	56.7	0.93
chr1	246438826	246439733	CpG: 74	907	74	584	16.3	64.4	0.79
chr1	246443650	246443924	CpG: 20	274	20	166	14.6	60.6	0.81
chr1	246444745	246445011	CpG: 24	266	24	172	18.0	64.7	0.87
chr1	246499158	246499432	CpG: 24	274	24	171	17.5	62.4	0.91
chr1	246509884	246510506	CpG: 55	622	55	422	17.7	67.8	0.77
chr1	246535511	246536216	CpG: 58	705	58	470	16.5	66.7	0.74
chr1	246541858	246542205	CpG: 29	347	29	198	16.7	57.1	1.04
chr1	246542673	246544089	CpG: 160	1416	160	1055	22.6	74.5	0.82
chr1	246547536	246547793	CpG: 17	257	17	181	13.2	70.4	0.63
chr1	246555586	246555873	CpG: 20	287	20	174	13.9	60.6	0.76
chr1	246558730	246559292	CpG: 66	562	66	415	23.5	73.8	0.86
chr1	246604575	246605137	CpG: 66	562	66	415	23.5	73.8	0.86
chr1	246643564	246644133	CpG: 46	569	46	393	16.2	69.1	0.68
chr1	246653243	246653820	CpG: 50	577	50	400	17.3	69.3	0.72
chr1	246718618	246718881	CpG: 20	263	20	164	15.2	62.4	0.79
chr1	246723566	246723793	CpG: 26	227	26	157	22.9	69.2	0.96
chr1	246733666	246734528	CpG: 61	862	61	542	14.2	62.9	0.72
chr1	246764061	246765651	CpG: 195	1590	195	1181	24.5	74.3	0.89
chr1	246807305	246807627	CpG: 28	322	28	204	17.4	63.4	0.88
chr1	246839685	246840172	CpG: 37	487	37	271	15.2	55.6	1.00
chr1	246888036	246888285	CpG: 17	249	17	156	13.7	62.7	0.70
chr1	246954892	246955564	CpG: 74	672	74	463	22.0	68.9	0.93
chr1	246958689	246959195	CpG: 44	506	44	381	17.4	75.3	0.61
chr1	246967524	246968076	CpG: 61	552	61	397	22.1	71.9	0.85
chr1	247076290	247076693	CpG: 52	403	52	306	25.8	75.9	0.90
chr1	247287444	247287707	CpG: 21	263	21	162	16.0	61.6	0.85
chr1	247287860	247288782	CpG: 112	922	112	668	24.3	72.5	0.93
chr1	247302348	247302614	CpG: 18	266	18	150	13.5	56.4	0.87
chr1	247315611	247315886	CpG: 22	275	22	168	16.0	61.1	0.87
chr1	247361341	247361580	CpG: 18	239	18	142	15.1	59.4	0.86
chr1	247362864	247363361	CpG: 46	497	46	341	18.5	68.6	0.79
chr1	247407945	247408152	CpG: 15	207	15	124	14.5	59.9	0.83
chr1	247420209	247420432	CpG: 18	223	18	136	16.1	61.0	0.89
chr1	247470540	247470855	CpG: 28	315	28	194	17.8	61.6	0.94
chr1	247598406	247598629	CpG: 18	223	18	131	16.1	58.7	0.94
chr1	247833739	247853589	CpG: 1271	19850	1271	10659	12.8	53.7	1.00
chr1	247878530	247878892	CpG: 32	362	32	212	17.7	58.6	1.03
chr1	248096134	248096493	CpG: 32	359	32	211	17.8	58.8	1.03
chr1	248114772	248115242	CpG: 38	470	38	328	16.2	69.8	0.66
chr1	248129981	248130419	CpG: 49	438	49	318	22.4	72.6	0.85
chr1	248184841	248186503	CpG: 137	1662	137	1286	16.5	77.4	0.64
chr1	248250380	248250802	CpG: 43	422	43	305	20.4	72.3	0.78
chr1	248264734	248265015	CpG: 33	281	33	182	23.5	64.8	1.12
chr1	248268377	248268943	CpG: 45	566	45	387	15.9	68.4	0.68
chr1	248276364	248277594	CpG: 130	1230	130	859	21.1	69.8	0.87
chr1	248285847	248287080	CpG: 145	1233	145	854	23.5	69.3	0.99
chr1	248296723	248297731	CpG: 86	1008	86	668	17.1	66.3	0.78
chr1	248311140	248311376	CpG: 17	236	17	142	14.4	60.2	0.81
chr1	248311706	248312441	CpG: 56	735	56	433	15.2	58.9	0.88
chr1	248344553	248345291	CpG: 86	738	86	528	23.3	71.5	0.98
chr1	248381876	248382161	CpG: 22	285	22	174	15.4	61.1	0.84
chr1	248383019	248383769	CpG: 102	750	102	543	27.2	72.4	1.04
chr2	3384	5038	CpG: 231	1654	231	1214	27.9	73.4	1.05
chr2	38876	40603	CpG: 193	1727	193	1238	22.4	71.7	0.87
chr2	191500	192494	CpG: 96	994	96	629	19.3	63.3	0.97
chr2	213926	214160	CpG: 24	234	24	151	20.5	64.5	0.99
chr2	229705	229979	CpG: 21	274	21	168	15.3	61.3	0.82
chr2	263655	265493	CpG: 182	1838	182	1250	19.8	68.0	0.87
chr2	287613	290356	CpG: 295	2743	295	1895	21.5	69.1	0.91
chr2	306750	307807	CpG: 67	1057	67	602	12.7	57.0	0.84
chr2	313407	314005	CpG: 53	598	53	374	17.7	62.5	0.91
chr2	317706	318300	CpG: 48	594	48	386	16.2	65.0	1.15
chr2	417611	419026	CpG: 147	1415	147	947	20.8	66.9	1.01
chr2	424356	426196	CpG: 202	1840	202	1432	22.0	77.8	0.74
chr2	466270	467128	CpG: 81	858	81	606	18.9	70.6	0.76
chr2	486360	487110	CpG: 93	750	93	553	24.8	73.7	1.30
chr2	493693	494334	CpG: 65	641	65	405	20.3	63.2	1.05
chr2	495301	495538	CpG: 21	237	21	157	17.7	66.2	0.84
chr2	501494	502002	CpG: 48	508	48	297	18.9	58.5	1.12
chr2	502171	502402	CpG: 18	231	18	155	15.6	67.1	0.73
chr2	556516	556916	CpG: 28	400	28	258	14.0	64.5	0.75
chr2	580839	581087	CpG: 18	248	18	163	14.5	65.7	0.68
chr2	581258	581825	CpG: 50	567	50	359	17.6	63.3	0.89
chr2	619407	620762	CpG: 99	1355	99	888	14.6	65.5	0.68
chr2	627677	627958	CpG: 22	281	22	173	15.7	61.6	0.83
chr2	634909	635900	CpG: 104	991	104	704	21.0	71.0	0.83
chr2	659966	660209	CpG: 19	243	19	160	15.6	65.8	0.76
chr2	676122	677149	CpG: 102	1027	102	707	19.9	68.8	0.86
chr2	729647	729915	CpG: 20	268	20	159	14.9	59.3	0.85
chr2	731500	732311	CpG: 89	811	89	621	21.9	76.6	0.87
chr2	834926	835157	CpG: 19	231	19	142	16.5	61.5	0.88
chr2	867710	868783	CpG: 136	1073	136	703	25.3	65.5	1.22
chr2	909954	910259	CpG: 21	305	21	194	13.8	63.6	0.72
chr2	949933	951533	CpG: 161	1600	161	1170	20.1	73.1	0.75
chr2	1056137	1056992	CpG: 76	855	76	664	17.8	77.7	0.78
chr2	1166468	1167206	CpG: 46	738	46	453	12.5	61.4	0.68
chr2	1232199	1232584	CpG: 35	385	35	276	18.2	71.7	0.71
chr2	1265323	1265592	CpG: 29	269	29	172	21.6	63.9	1.05
chr2	1281641	1281883	CpG: 25	242	25	149	20.7	61.6	1.13
chr2	1285848	1286097	CpG: 20	249	20	168	16.1	67.5	0.77
chr2	1476053	1476268	CpG: 18	215	18	124	16.7	57.7	1.02
chr2	1477468	1478341	CpG: 95	873	95	628	21.8	71.9	0.84
chr2	1491419	1492106	CpG: 43	687	43	431	12.5	62.7	0.64
chr2	1513888	1514089	CpG: 17	201	17	139	16.9	69.2	0.71
chr2	1545917	1546134	CpG: 19	217	19	141	17.5	65.0	0.85
chr2	1573623	1574876	CpG: 165	1253	165	898	26.3	71.7	1.11
chr2	1598290	1598908	CpG: 40	618	40	399	12.9	64.6	0.62
chr2	1655830	1657236	CpG: 117	1406	117	904	16.6	64.3	0.82
chr2	1673803	1674015	CpG: 20	212	20	132	18.9	62.3	0.98
chr2	1750797	1752952	CpG: 217	2155	217	1511	20.1	70.1	0.82
chr2	1767195	1767431	CpG: 21	236	21	174	17.8	73.7	0.66
chr2	1805055	1805379	CpG: 22	324	22	190	13.6	58.6	0.80
chr2	1805658	1806100	CpG: 60	442	60	337	27.1	76.2	0.97
chr2	1821302	1821834	CpG: 47	532	47	334	17.7	62.8	0.90
chr2	1846958	1847249	CpG: 27	291	27	197	18.6	67.7	0.81
chr2	1850538	1851004	CpG: 39	466	39	306	16.7	65.7	0.82
chr2	1901559	1902059	CpG: 48	500	48	359	19.2	71.8	0.75
chr2	1946933	1947425	CpG: 39	492	39	281	15.9	57.1	0.99
chr2	2195622	2196560	CpG: 115	938	115	676	24.5	72.1	0.95
chr2	2199939	2200145	CpG: 21	206	21	132	20.4	64.1	1.02
chr2	2660587	2660837	CpG: 18	250	18	144	14.4	57.6	0.87
chr2	2761680	2762078	CpG: 31	398	31	252	15.6	63.3	0.78
chr2	2780341	2780559	CpG: 15	218	15	134	13.8	61.5	0.74
chr2	3073690	3073990	CpG: 23	300	23	199	15.3	66.3	0.70
chr2	3184708	3185211	CpG: 36	503	36	354	14.3	70.4	0.60
chr2	3194546	3202620	CpG: 610	8074	610	4796	15.1	59.4	0.88
chr2	3223108	3223345	CpG: 19	237	19	141	16.0	59.5	0.92
chr2	3304233	3304439	CpG: 19	206	19	147	18.4	71.4	0.73
chr2	3305785	3306181	CpG: 33	396	33	280	16.7	70.7	0.68
chr2	3307337	3307613	CpG: 30	276	30	180	21.7	65.2	1.03
chr2	3308934	3309330	CpG: 29	396	29	208	14.6	52.5	1.19
chr2	3331851	3332087	CpG: 17	236	17	142	14.4	60.2	0.82
chr2	3335383	3335642	CpG: 19	259	19	174	14.7	67.2	0.65
chr2	3339489	3339719	CpG: 18	230	18	158	15.7	68.7	0.69
chr2	3340162	3340383	CpG: 15	221	15	145	13.6	65.6	0.63
chr2	3399694	3400322	CpG: 55	628	55	398	17.5	63.4	0.88
chr2	3401700	3402326	CpG: 56	626	56	434	17.9	69.3	0.74
chr2	3409749	3410847	CpG: 123	1098	123	778	22.4	70.9	0.90
chr2	3411309	3411741	CpG: 34	432	34	284	15.7	65.7	0.73
chr2	3470628	3470864	CpG: 30	236	30	163	25.4	69.1	1.24
chr2	3479935	3480144	CpG: 18	209	18	146	17.2	69.9	0.71
chr2	3497848	3498162	CpG: 27	314	27	177	17.2	56.4	1.09
chr2	3522565	3522911	CpG: 29	346	29	232	16.8	67.1	0.75
chr2	3540547	3541894	CpG: 137	1347	137	952	20.3	70.7	0.82
chr2	3550344	3550940	CpG: 48	596	48	415	16.1	69.6	0.67
chr2	3580427	3581270	CpG: 93	843	93	596	22.1	70.7	0.88
chr2	3591600	3592410	CpG: 60	810	60	551	14.8	68.0	0.64
chr2	3595983	3596218	CpG: 20	235	20	146	17.0	62.1	0.91
chr2	3597288	3598657	CpG: 111	1369	111	861	16.2	62.9	0.82
chr2	3599652	3599866	CpG: 15	214	15	126	14.0	58.9	0.83
chr2	3617701	3617905	CpG: 23	204	23	145	22.5	71.1	0.89
chr2	3627971	3628611	CpG: 42	640	42	461	13.1	72.0	0.66
chr2	3640392	3640620	CpG: 18	228	18	119	15.8	52.2	1.17
chr2	3658273	3658534	CpG: 18	261	18	167	13.8	64.0	0.71
chr2	3663448	3663844	CpG: 33	396	33	276	16.7	69.7	0.93
chr2	3666622	3666954	CpG: 31	332	31	219	18.7	66.0	0.86
chr2	3674030	3675057	CpG: 68	1027	68	614	13.2	59.8	0.77
chr2	3705085	3705321	CpG: 20	236	20	146	16.9	61.9	0.91
chr2	3725810	3726909	CpG: 134	1099	134	826	24.4	75.2	0.87
chr2	3809770	3810028	CpG: 25	258	25	179	19.4	69.4	0.81
chr2	3823340	3823557	CpG: 18	217	18	128	16.6	59.0	0.95
chr2	4026416	4026619	CpG: 19	203	19	118	18.7	58.1	1.20
chr2	4131946	4132236	CpG: 19	290	19	188	13.1	64.8	0.66
chr2	4170906	4171459	CpG: 41	553	41	301	14.8	54.4	1.02
chr2	4485389	4485618	CpG: 21	229	21	144	18.3	62.9	0.93
chr2	4587112	4587393	CpG: 25	281	25	176	17.8	62.6	0.91
chr2	4667392	4667743	CpG: 28	351	28	211	16.0	60.1	0.89
chr2	4740103	4740381	CpG: 25	278	25	174	18.0	62.6	0.93
chr2	4757990	4758228	CpG: 18	238	18	138	15.1	58.0	0.93
chr2	4791246	4791521	CpG: 23	275	23	171	16.7	62.2	0.87
chr2	4953933	4954321	CpG: 35	388	35	281	18.0	72.4	0.69
chr2	5095192	5095426	CpG: 16	234	16	138	13.7	59.0	0.82
chr2	5369285	5369499	CpG: 18	214	18	129	16.8	60.3	0.94
chr2	5388604	5388878	CpG: 22	274	22	170	16.1	62.0	0.84
chr2	5405242	5405516	CpG: 24	274	24	170	17.5	62.0	0.92
chr2	5428631	5428901	CpG: 23	270	23	170	17.0	63.0	0.87
chr2	5446526	5446766	CpG: 18	240	18	146	15.0	60.8	0.82
chr2	5576287	5576566	CpG: 22	279	22	171	15.8	61.3	0.86
chr2	5646231	5646473	CpG: 19	242	19	138	15.7	57.0	1.01
chr2	5694777	5695005	CpG: 25	228	25	183	21.9	80.3	0.71
chr2	5712482	5715503	CpG: 335	3021	335	2078	22.2	68.8	0.94
chr2	5717363	5718938	CpG: 158	1575	158	1104	20.1	70.1	0.82
chr2	5728459	5729164	CpG: 56	705	56	465	15.9	66.0	0.74
chr2	5766384	5766662	CpG: 25	278	25	174	18.0	62.6	0.93
chr2	5783757	5783999	CpG: 20	242	20	148	16.5	61.2	0.91
chr2	6020372	6020641	CpG: 24	269	24	166	17.8	61.7	0.95
chr2	6260112	6260772	CpG: 73	660	73	433	22.1	65.6	1.06
chr2	6441491	6441765	CpG: 24	274	24	171	17.5	62.4	0.91
chr2	6517366	6517652	CpG: 25	286	25	158	17.5	55.2	1.15
chr2	6886534	6887711	CpG: 148	1177	148	885	25.1	75.2	0.89
chr2	6912986	6913255	CpG: 19	269	19	162	14.1	60.2	0.79
chr2	6938752	6940258	CpG: 177	1506	177	1099	23.5	73.0	0.88
chr2	7053615	7053939	CpG: 28	324	28	217	17.3	67.0	0.81
chr2	7452452	7453023	CpG: 51	571	51	383	17.9	67.1	0.80
chr2	7791351	7791761	CpG: 29	410	29	263	14.1	64.1	0.69
chr2	7815313	7815544	CpG: 19	231	19	142	16.5	61.5	0.88
chr2	7937112	7937340	CpG: 15	228	15	134	13.2	58.8	0.80
chr2	8029424	8029761	CpG: 29	337	29	204	17.2	60.5	0.94
chr2	8051935	8052199	CpG: 23	264	23	189	17.4	71.6	0.70
chr2	8147951	8148232	CpG: 23	281	23	175	16.4	62.3	0.86
chr2	8185656	8185865	CpG: 15	209	15	121	14.4	57.9	0.87
chr2	8383189	8383425	CpG: 19	236	19	145	16.1	61.4	0.88
chr2	8480739	8481405	CpG: 61	666	61	478	18.3	71.8	0.71
chr2	8607381	8607619	CpG: 22	238	22	177	18.5	74.4	0.68
chr2	8668999	8669612	CpG: 54	613	54	444	17.6	72.4	0.67
chr2	8699909	8700859	CpG: 75	950	75	609	15.8	64.1	0.77
chr2	8701887	8703180	CpG: 125	1293	125	847	19.3	65.5	0.90
chr2	8705481	8706332	CpG: 73	851	73	559	17.2	65.7	0.82
chr2	8708700	8709782	CpG: 133	1082	133	819	24.6	75.7	0.86
chr2	8860994	8861479	CpG: 59	485	59	360	24.3	74.2	0.89
chr2	8863723	8863927	CpG: 17	204	17	120	16.7	58.8	0.97
chr2	8902550	8902824	CpG: 23	274	23	170	16.8	62.0	0.88
chr2	9019455	9019660	CpG: 16	205	16	125	15.6	61.0	0.85
chr2	9026771	9028274	CpG: 181	1503	181	1136	24.1	75.6	0.85
chr2	9225967	9226248	CpG: 24	281	24	175	17.1	62.3	0.89
chr2	9230040	9231601	CpG: 233	1561	233	1199	29.9	76.8	1.01
chr2	9294620	9294895	CpG: 26	275	26	173	18.9	62.9	0.97
chr2	9398692	9398964	CpG: 21	272	21	149	15.4	54.8	1.04
chr2	9417541	9417776	CpG: 17	235	17	166	14.5	70.6	0.65
chr2	9447973	9449232	CpG: 125	1259	125	844	19.9	67.0	0.88
chr2	9491249	9491483	CpG: 40	234	40	158	34.2	67.5	1.84
chr2	9498793	9500154	CpG: 153	1361	153	966	22.5	71.0	0.90
chr2	9500570	9500801	CpG: 20	231	20	136	17.3	58.9	1.00
chr2	9580432	9581516	CpG: 103	1084	103	750	19.0	69.2	0.81
chr2	9655074	9656447	CpG: 154	1373	154	960	22.4	69.9	0.92
chr2	9775530	9775817	CpG: 23	287	23	176	16.0	61.3	0.87
chr2	9847075	9847356	CpG: 23	281	23	174	16.4	61.9	0.87
chr2	9871060	9871699	CpG: 76	639	76	435	23.8	68.1	1.05
chr2	9978685	9980257	CpG: 231	1572	231	1212	29.4	77.1	0.99
chr2	10034347	10034817	CpG: 52	470	52	340	22.1	72.3	0.85
chr2	10038674	10044985	CpG: 414	6311	414	3963	13.1	62.8	0.89
chr2	10071257	10073453	CpG: 265	2196	265	1555	24.1	70.8	0.96
chr2	10108255	10109623	CpG: 178	1368	178	1086	26.0	79.4	0.83
chr2	10110300	10110536	CpG: 19	236	19	141	16.1	59.7	0.92
chr2	10119989	10120545	CpG: 51	556	51	397	18.3	71.4	0.72
chr2	10148864	10149516	CpG: 60	652	60	423	18.4	64.9	0.88
chr2	10150654	10152066	CpG: 149	1412	149	988	21.1	70.0	0.86
chr2	10154139	10154346	CpG: 15	207	15	122	14.5	58.9	0.86
chr2	10330757	10332962	CpG: 212	2205	212	1544	19.2	70.0	0.79
chr2	10383724	10384004	CpG: 24	280	24	177	17.1	63.2	0.87
chr2	10449189	10449767	CpG: 54	578	54	374	18.7	64.7	0.89
chr2	10456364	10456623	CpG: 20	259	20	173	15.4	66.8	0.72
chr2	10461863	10462223	CpG: 28	360	28	256	15.6	71.1	0.62
chr2	10477311	10478639	CpG: 175	1328	175	1024	26.4	77.1	0.89
chr2	10518862	10519138	CpG: 19	276	19	164	13.8	59.4	0.79
chr2	10555887	10556111	CpG: 18	224	18	156	16.1	69.6	0.66
chr2	10565782	10566562	CpG: 49	780	49	455	12.6	58.3	1.01
chr2	10571530	10571774	CpG: 19	244	19	148	15.6	60.7	0.86
chr2	10573729	10573943	CpG: 16	214	16	129	15.0	60.3	0.84
chr2	10719626	10720741	CpG: 83	1115	83	677	14.9	60.7	0.81
chr2	10728503	10728788	CpG: 26	285	26	181	18.2	63.5	0.92
chr2	10751023	10752291	CpG: 140	1268	140	909	22.1	71.7	0.86
chr2	10842057	10843261	CpG: 128	1204	128	832	21.3	69.1	0.90
chr2	10932532	10933504	CpG: 79	972	79	697	16.3	71.7	0.63
chr2	10941494	10943112	CpG: 175	1618	175	1120	21.6	69.2	0.90
chr2	10943297	10943588	CpG: 21	291	21	186	14.4	63.9	0.71
chr2	10992666	10993123	CpG: 37	457	37	315	16.2	68.9	0.68
chr2	11033453	11033745	CpG: 24	292	24	177	16.4	60.6	0.90
chr2	11170313	11170536	CpG: 16	223	16	134	14.3	60.1	0.81
chr2	11187350	11188330	CpG: 116	980	116	738	23.7	75.3	0.88
chr2	11197462	11198291	CpG: 61	829	61	569	14.7	68.6	0.63
chr2	11208897	11209229	CpG: 28	332	28	195	16.9	58.7	0.99
chr2	11245989	11246263	CpG: 23	274	23	170	16.8	62.0	0.88
chr2	11304450	11304660	CpG: 15	210	15	130	14.3	61.9	0.76
chr2	11319005	11319279	CpG: 22	274	22	169	16.1	61.7	0.85
chr2	11377139	11378751	CpG: 197	1612	197	1211	24.4	75.1	0.87
chr2	11436491	11436724	CpG: 21	233	21	144	18.0	61.8	0.97
chr2	11498629	11499271	CpG: 83	642	83	469	25.9	73.1	0.98
chr2	11514904	11516462	CpG: 177	1558	177	1144	22.7	73.4	0.87
chr2	11517888	11518100	CpG: 18	212	18	127	17.0	59.9	0.96
chr2	11528746	11528973	CpG: 16	227	16	125	14.1	55.1	0.93
chr2	11585677	11585960	CpG: 25	283	25	176	17.7	62.2	0.92
chr2	11625662	11626124	CpG: 50	462	50	320	21.6	69.3	0.91
chr2	11643584	11643890	CpG: 29	306	29	207	19.0	67.6	0.83
chr2	11647548	11647762	CpG: 15	214	15	128	14.0	59.8	0.80
chr2	11651595	11652047	CpG: 33	452	33	310	14.6	68.6	0.65
chr2	11667318	11667529	CpG: 15	211	15	141	14.2	66.8	0.64
chr2	11689868	11690254	CpG: 32	386	32	260	16.6	67.4	0.74
chr2	11702624	11703481	CpG: 96	857	96	608	22.4	70.9	0.89
chr2	11779274	11780232	CpG: 99	958	99	672	20.7	70.1	0.84
chr2	11785603	11785877	CpG: 24	274	24	171	17.5	62.4	0.91
chr2	11792850	11793271	CpG: 42	421	42	327	20.0	77.7	0.66
chr2	11817902	11818253	CpG: 34	351	34	237	19.4	67.5	0.85
chr2	11907506	11907908	CpG: 27	402	27	319	13.4	79.4	0.99
chr2	12097159	12097382	CpG: 21	223	21	137	18.8	61.4	1.02
chr2	12389532	12389813	CpG: 24	281	24	174	17.1	61.9	0.91
chr2	12495580	12495819	CpG: 20	239	20	146	16.7	61.1	0.91
chr2	12503788	12504062	CpG: 24	274	24	171	17.5	62.4	0.91
chr2	12556459	12556752	CpG: 23	293	23	178	15.7	60.8	0.85
chr2	12745564	12747958	CpG: 226	2394	226	1506	18.9	62.9	0.96
chr2	12905269	12905505	CpG: 19	236	19	144	16.1	61.0	0.88
chr2	12938801	12939076	CpG: 23	275	23	168	16.7	61.1	0.91
chr2	12954899	12955133	CpG: 17	234	17	138	14.5	59.0	0.85
chr2	12955690	12956104	CpG: 39	414	39	304	18.8	73.4	0.70
chr2	13018698	13018919	CpG: 16	221	16	133	14.5	60.2	0.82
chr2	13294801	13295049	CpG: 19	248	19	144	15.3	58.1	0.92
chr2	13337790	13338316	CpG: 53	526	53	391	20.2	74.3	0.73
chr2	13768761	13768996	CpG: 20	235	20	141	17.0	60.0	0.95
chr2	14145547	14145956	CpG: 33	409	33	249	16.1	60.9	0.89
chr2	14239559	14239833	CpG: 23	274	23	170	16.8	62.0	0.88
chr2	14605756	14606030	CpG: 20	274	20	169	14.6	61.7	0.78
chr2	14663040	14666472	CpG: 268	3432	268	2245	15.6	65.4	0.73
chr2	14851730	14852005	CpG: 23	275	23	166	16.7	60.4	0.92
chr2	14878901	14879294	CpG: 29	393	29	235	14.8	59.8	0.83
chr2	14974798	14975033	CpG: 21	235	21	143	17.9	60.9	0.99
chr2	15054414	15054696	CpG: 22	282	22	174	15.6	61.7	0.84
chr2	15102107	15102317	CpG: 16	210	16	127	15.2	60.5	0.84
chr2	15410489	15410763	CpG: 25	274	25	173	18.2	63.1	0.93
chr2	15592612	15592990	CpG: 27	378	27	239	14.3	63.2	0.74
chr2	15623289	15623991	CpG: 71	702	71	484	20.2	68.9	0.85
chr2	15711704	15712523	CpG: 59	819	59	560	14.4	68.4	0.62
chr2	15742462	15742736	CpG: 23	274	23	170	16.8	62.0	0.88
chr2	15888404	15888682	CpG: 25	278	25	173	18.0	62.2	0.95
chr2	15971311	15974542	CpG: 253	3231	253	2084	15.7	64.5	0.75
chr2	16045391	16045866	CpG: 31	475	31	275	13.1	57.9	0.78
chr2	16088439	16088675	CpG: 19	236	19	145	16.1	61.4	0.87
chr2	16106221	16106498	CpG: 22	277	22	176	15.9	63.5	0.80
chr2	16142426	16142703	CpG: 24	277	24	171	17.3	61.7	0.92
chr2	16162895	16163172	CpG: 24	277	24	170	17.3	61.4	0.93
chr2	16190633	16190907	CpG: 22	274	22	170	16.1	62.0	0.84
chr2	16204623	16204893	CpG: 20	270	20	162	14.8	60.0	0.83
chr2	16266718	16266960	CpG: 23	242	23	149	19.0	61.6	1.01
chr2	16365618	16365883	CpG: 20	265	20	158	15.1	59.6	0.86
chr2	16479139	16479413	CpG: 23	274	23	171	16.8	62.4	0.87
chr2	16539798	16540257	CpG: 50	459	50	341	21.8	74.3	0.79
chr2	16607273	16607514	CpG: 19	241	19	144	15.8	59.8	0.91
chr2	16631011	16631303	CpG: 24	292	24	179	16.4	61.3	0.88
chr2	16697249	16697772	CpG: 72	523	72	415	27.5	79.3	0.93
chr2	16950428	16950702	CpG: 19	274	19	164	13.9	59.9	0.78
chr2	17050282	17050511	CpG: 19	229	19	142	16.6	62.0	0.87
chr2	17186084	17186323	CpG: 19	239	19	144	15.9	60.3	0.89
chr2	17225322	17225691	CpG: 33	369	33	265	17.9	71.8	0.69
chr2	17272150	17272390	CpG: 20	240	20	145	16.7	60.4	0.95
chr2	17404511	17404785	CpG: 21	274	21	168	15.3	61.3	0.82
chr2	17462653	17462905	CpG: 20	252	20	154	15.9	61.1	0.87
chr2	17570655	17570917	CpG: 41	262	41	199	31.3	76.0	1.09
chr2	17572036	17572520	CpG: 37	484	37	306	15.3	63.2	0.77
chr2	17583727	17583951	CpG: 16	224	16	134	14.3	59.8	0.82
chr2	17784981	17786402	CpG: 144	1421	144	951	20.3	66.9	0.91
chr2	17897597	17897833	CpG: 17	236	17	141	14.4	59.7	0.82
chr2	17909547	17909754	CpG: 18	207	18	132	17.4	63.8	0.86
chr2	17910002	17911429	CpG: 153	1427	153	1017	21.4	71.3	0.84
chr2	18049167	18049409	CpG: 19	242	19	142	15.7	58.7	0.91
chr2	18353847	18354116	CpG: 24	269	24	164	17.8	61.0	0.97
chr2	18425122	18425383	CpG: 21	261	21	163	16.1	62.5	0.83
chr2	18592204	18592812	CpG: 76	608	76	463	25.0	76.2	0.88
chr2	18616597	18617032	CpG: 43	435	43	306	19.8	70.3	0.81
chr2	18908169	18908442	CpG: 25	273	25	170	18.3	62.3	0.95
chr2	18915568	18915806	CpG: 20	238	20	145	16.8	60.9	0.92
chr2	18984324	18984599	CpG: 24	275	24	166	17.5	60.4	0.97
chr2	19338776	19339018	CpG: 23	242	23	147	19.0	60.7	1.03
chr2	19380530	19381340	CpG: 71	810	71	520	17.5	64.2	0.85
chr2	19384783	19385009	CpG: 25	226	25	151	22.1	66.8	1.00
chr2	19386205	19386480	CpG: 23	275	23	172	16.7	62.5	0.87
chr2	19388833	19391760	CpG: 181	2927	181	1750	12.4	59.8	0.70
chr2	19394007	19394694	CpG: 59	687	59	429	17.2	62.4	0.88
chr2	19395794	19396010	CpG: 22	216	22	131	20.4	60.6	1.13
chr2	19581587	19581861	CpG: 24	274	24	170	17.5	62.0	0.92
chr2	19902215	19902694	CpG: 41	479	41	330	17.1	68.9	0.74
chr2	19934775	19935837	CpG: 93	1062	93	635	17.5	59.8	0.98
chr2	19990169	19990442	CpG: 22	273	22	167	16.1	61.2	0.87
chr2	20023331	20023972	CpG: 70	641	70	429	21.8	66.9	0.98
chr2	20045806	20046522	CpG: 85	716	85	547	23.7	76.4	0.81
chr2	20084824	20085648	CpG: 64	824	64	507	15.5	61.5	0.83
chr2	20140307	20140595	CpG: 33	288	33	212	22.9	73.6	0.88
chr2	20256871	20259550	CpG: 266	2679	266	1905	19.9	71.1	0.79
chr2	20292207	20292488	CpG: 21	281	21	172	14.9	61.2	0.81
chr2	20383775	20384825	CpG: 120	1050	120	751	22.9	71.5	0.92
chr2	20448800	20449030	CpG: 19	230	19	141	16.5	61.3	0.89
chr2	20476170	20476447	CpG: 26	277	26	175	18.8	63.2	0.95
chr2	20480310	20481870	CpG: 163	1560	163	1073	20.9	68.8	0.88
chr2	20631875	20632153	CpG: 25	278	25	175	18.0	62.9	0.91
chr2	20684158	20684718	CpG: 64	560	64	414	22.9	73.9	0.84
chr2	20691868	20692146	CpG: 24	278	24	173	17.3	62.2	0.90
chr2	20698834	20704970	CpG: 471	6136	471	3982	15.4	64.9	0.73
chr2	20844279	20844554	CpG: 24	275	24	172	17.5	62.5	0.90
chr2	20856042	20856412	CpG: 30	370	30	244	16.2	65.9	0.75
chr2	20922307	20922569	CpG: 23	262	23	163	17.6	62.2	0.92
chr2	21004847	21005121	CpG: 23	274	23	169	16.8	61.7	0.89
chr2	21077017	21077309	CpG: 37	292	37	231	25.3	79.1	0.81
chr2	21134718	21135148	CpG: 29	430	29	233	13.5	54.2	0.94
chr2	21191496	21191777	CpG: 22	281	22	172	15.7	61.2	0.85
chr2	21258570	21258809	CpG: 18	239	18	142	15.1	59.4	0.87
chr2	21294545	21294775	CpG: 20	230	20	142	17.4	61.7	0.93
chr2	21320568	21320850	CpG: 21	282	21	168	14.9	59.6	0.85
chr2	21383373	21383603	CpG: 22	230	22	143	19.1	62.2	1.00
chr2	21607387	21607649	CpG: 26	262	26	166	19.8	63.4	1.00
chr2	21674668	21674904	CpG: 17	236	17	143	14.4	60.6	0.80
chr2	22217075	22217311	CpG: 19	236	19	142	16.1	60.2	0.90
chr2	22222197	22222537	CpG: 30	340	30	248	17.6	72.9	0.66
chr2	22373337	22373618	CpG: 23	281	23	172	16.4	61.2	0.89
chr2	22697374	22697605	CpG: 18	231	18	138	15.6	59.7	0.89
chr2	22764684	22764979	CpG: 25	295	25	182	16.9	61.7	0.91
chr2	22851064	22851305	CpG: 17	241	17	143	14.1	59.3	0.82
chr2	23019780	23020191	CpG: 29	411	29	245	14.1	59.6	0.80
chr2	23265963	23266257	CpG: 24	294	24	181	16.3	61.6	0.86
chr2	23404042	23404310	CpG: 26	268	26	170	19.4	63.4	0.98
chr2	23420240	23422636	CpG: 296	2396	296	1785	24.7	74.5	0.89
chr2	23466973	23467219	CpG: 17	246	17	146	13.8	59.3	0.81
chr2	23469398	23469676	CpG: 23	278	23	168	16.5	60.4	0.91
chr2	23561580	23561785	CpG: 15	205	15	131	14.6	63.9	0.78
chr2	23597528	23597818	CpG: 28	290	28	207	19.3	71.4	0.77
chr2	23608197	23608466	CpG: 21	269	21	156	15.6	58.0	0.93
chr2	23664025	23664274	CpG: 22	249	22	171	17.7	68.7	0.75
chr2	23677754	23677957	CpG: 16	203	16	144	15.8	70.9	0.65
chr2	23725487	23725748	CpG: 20	261	20	183	15.3	70.1	0.62
chr2	23949246	23949490	CpG: 17	244	17	146	13.9	59.8	0.78
chr2	23958599	23958833	CpG: 20	234	20	144	17.1	61.5	0.92
chr2	23961078	23962176	CpG: 121	1098	121	794	22.0	72.3	0.84
chr2	23975008	23975701	CpG: 101	693	101	515	29.1	74.3	1.07
chr2	24044507	24045087	CpG: 66	580	66	431	22.8	74.3	0.82
chr2	24060480	24060703	CpG: 16	223	16	130	14.3	58.3	0.89
chr2	24084271	24085134	CpG: 89	863	89	636	20.6	73.7	0.76
chr2	24110778	24112103	CpG: 99	1325	99	886	14.9	66.9	0.73
chr2	24119108	24119494	CpG: 35	386	35	271	18.1	70.2	0.74
chr2	24120642	24120876	CpG: 20	234	20	143	17.1	61.1	0.95
chr2	24157817	24158620	CpG: 110	803	110	600	27.4	74.7	0.98
chr2	24209355	24210126	CpG: 76	771	76	514	19.7	66.7	0.89
chr2	24210240	24210496	CpG: 19	256	19	147	14.8	57.4	0.96
chr2	24369411	24369685	CpG: 24	274	24	171	17.5	62.4	0.91
chr2	24394369	24395360	CpG: 119	991	119	730	24.0	73.7	0.90
chr2	24437468	24438006	CpG: 54	538	54	414	20.1	77.0	0.73
chr2	24525365	24526996	CpG: 217	1631	217	1231	26.6	75.5	0.95
chr2	24811031	24811271	CpG: 16	240	16	140	13.3	58.3	0.82
chr2	24827810	24828558	CpG: 68	748	68	493	18.2	65.9	0.84
chr2	24897001	24897282	CpG: 21	281	21	172	14.9	61.2	0.81
chr2	24954345	24955562	CpG: 179	1217	179	985	29.4	80.9	0.90
chr2	25006001	25007075	CpG: 98	1074	98	705	18.2	65.6	0.85
chr2	25076236	25077294	CpG: 131	1058	131	791	24.8	74.8	0.89
chr2	25080961	25081238	CpG: 23	277	23	175	16.6	63.2	0.84
chr2	25163133	25163410	CpG: 24	277	24	168	17.3	60.6	0.96
chr2	25165866	25166585	CpG: 65	719	65	509	18.1	70.8	0.76
chr2	25195523	25196347	CpG: 85	824	85	575	20.6	69.8	0.85
chr2	25202318	25203460	CpG: 101	1142	101	748	17.7	65.5	0.83
chr2	25239537	25240013	CpG: 57	476	57	356	23.9	74.8	0.86
chr2	25251163	25251830	CpG: 79	667	79	461	23.7	69.1	0.99
chr2	25252172	25252382	CpG: 16	210	16	122	15.2	58.1	0.90
chr2	25283243	25283457	CpG: 16	214	16	143	15.0	66.8	0.70
chr2	25287234	25288075	CpG: 74	841	74	626	17.6	74.4	0.64
chr2	25288183	25288405	CpG: 17	222	17	141	15.3	63.5	0.78
chr2	25312246	25312912	CpG: 61	666	61	490	18.3	73.6	0.68
chr2	25375778	25378073	CpG: 319	2295	319	1864	27.8	81.2	0.85
chr2	25412136	25412355	CpG: 31	219	31	170	28.3	77.6	0.94
chr2	25498021	25498295	CpG: 22	274	22	169	16.1	61.7	0.86
chr2	25668587	25669791	CpG: 102	1204	102	870	16.9	72.3	0.65
chr2	25708337	25709480	CpG: 161	1143	161	870	28.2	76.1	0.99
chr2	25740513	25741303	CpG: 57	790	57	528	14.4	66.8	0.65
chr2	25758492	25759351	CpG: 66	859	66	596	15.4	69.4	0.64
chr2	25912970	25914110	CpG: 110	1140	110	763	19.3	66.9	0.87
chr2	25945625	25946836	CpG: 101	1211	101	872	16.7	72.0	0.64
chr2	25950676	25951203	CpG: 44	527	44	378	16.7	71.7	0.65
chr2	25951963	25952170	CpG: 16	207	16	111	15.5	53.6	1.12
chr2	26017306	26018144	CpG: 77	838	77	598	18.4	71.4	0.72
chr2	26068851	26070014	CpG: 127	1163	127	795	21.8	68.4	0.94
chr2	26207850	26209638	CpG: 186	1788	186	1364	20.8	76.3	0.72
chr2	26214128	26214562	CpG: 45	434	45	319	20.7	73.5	0.80
chr2	26219567	26220712	CpG: 155	1145	155	850	27.1	74.2	0.98
chr2	26278152	26278388	CpG: 20	236	20	146	16.9	61.9	0.91
chr2	26279575	26280419	CpG: 63	844	63	559	14.9	66.2	0.68
chr2	26280633	26280880	CpG: 17	247	17	138	13.8	55.9	0.90
chr2	26293745	26293954	CpG: 17	209	17	129	16.3	61.7	0.87
chr2	26382179	26382419	CpG: 20	240	20	140	16.7	58.3	1.00
chr2	26384220	26385178	CpG: 87	958	87	620	18.2	64.7	0.87
chr2	26440336	26440926	CpG: 59	590	59	402	20.0	68.1	0.87
chr2	26451401	26451668	CpG: 21	267	21	164	15.7	61.4	0.86
chr2	26542415	26542936	CpG: 38	521	38	344	14.6	66.0	0.67
chr2	26601404	26601977	CpG: 58	573	58	402	20.2	70.2	0.83
chr2	26602171	26602391	CpG: 17	220	17	136	15.5	61.8	0.82
chr2	26695365	26695646	CpG: 22	281	22	173	15.7	61.6	0.84
chr2	26731554	26732798	CpG: 142	1244	142	908	22.8	73.0	0.87
chr2	26769228	26770164	CpG: 106	936	106	632	22.6	67.5	1.00
chr2	26805750	26806220	CpG: 55	470	55	339	23.4	72.1	0.90
chr2	26827481	26828186	CpG: 78	705	78	482	22.1	68.4	0.95
chr2	26828864	26829104	CpG: 19	240	19	147	15.8	61.2	0.87
chr2	26855610	26856373	CpG: 59	763	59	511	15.5	67.0	0.70
chr2	26856910	26857158	CpG: 18	248	18	131	14.5	52.8	1.07
chr2	26889053	26891673	CpG: 266	2620	266	1876	20.3	71.6	0.80
chr2	26909096	26909370	CpG: 25	274	25	172	18.2	62.8	0.93
chr2	27003833	27004072	CpG: 19	239	19	146	15.9	61.1	0.87
chr2	27012073	27012664	CpG: 74	591	74	446	25.0	75.5	0.90
chr2	27047573	27047788	CpG: 17	215	17	130	15.8	60.5	0.88
chr2	27074244	27074967	CpG: 79	723	79	488	21.9	67.5	0.97
chr2	27091665	27093772	CpG: 169	2107	169	1300	16.0	61.7	0.84
chr2	27112944	27113720	CpG: 93	776	93	563	24.0	72.6	0.91
chr2	27124117	27124417	CpG: 24	300	24	213	16.0	71.0	0.67
chr2	27127351	27128575	CpG: 143	1224	143	878	23.4	71.7	0.91
chr2	27153158	27153645	CpG: 47	487	47	357	19.3	73.3	0.72
chr2	27159393	27159633	CpG: 18	240	18	137	15.0	57.1	0.94
chr2	27160362	27160954	CpG: 78	592	78	441	26.4	74.5	0.95
chr2	27165175	27165561	CpG: 39	386	39	274	20.2	71.0	0.81
chr2	27175757	27176643	CpG: 98	886	98	605	22.1	68.3	0.95
chr2	27191792	27191993	CpG: 19	201	19	142	18.9	70.6	0.77
chr2	27252412	27252643	CpG: 19	231	19	139	16.5	60.2	0.92
chr2	27253188	27254487	CpG: 127	1299	127	864	19.6	66.5	0.89
chr2	27258899	27259488	CpG: 63	589	63	415	21.4	70.5	0.89
chr2	27288855	27289080	CpG: 17	225	17	135	15.1	60.0	0.87
chr2	27303647	27306963	CpG: 281	3316	281	2225	16.9	67.1	0.75
chr2	27348630	27351012	CpG: 187	2382	187	1615	15.7	67.8	0.68
chr2	27397626	27397860	CpG: 16	234	16	135	13.7	57.7	0.83
chr2	27398812	27399651	CpG: 74	839	74	533	17.6	63.5	0.88
chr2	27401308	27402101	CpG: 64	793	64	555	16.1	70.0	0.66
chr2	27412375	27413629	CpG: 128	1254	128	859	20.4	68.5	0.87
chr2	27420869	27421204	CpG: 24	335	24	229	14.3	68.4	0.65
chr2	27422878	27423592	CpG: 74	714	74	504	20.7	70.6	0.84
chr2	27435737	27435972	CpG: 28	235	28	165	23.8	70.2	1.02
chr2	27451411	27452349	CpG: 105	938	105	668	22.4	71.2	0.89
chr2	27452909	27453147	CpG: 18	238	18	145	15.1	60.9	0.84
chr2	27470769	27471633	CpG: 106	864	106	654	24.5	75.7	0.87
chr2	27484425	27485156	CpG: 74	731	74	520	20.2	71.1	0.80
chr2	27489074	27489355	CpG: 22	281	22	173	15.7	61.6	0.84
chr2	27532043	27532331	CpG: 30	288	30	177	20.8	61.5	1.13
chr2	27537172	27537828	CpG: 84	656	84	513	25.6	78.2	0.84
chr2	27625973	27626297	CpG: 30	324	30	204	18.5	63.0	0.97
chr2	27637236	27637746	CpG: 43	510	43	372	16.9	72.9	0.63
chr2	27706480	27707631	CpG: 78	1151	78	684	13.6	59.4	0.77
chr2	27758546	27758873	CpG: 36	327	36	230	22.0	70.3	0.93
chr2	27778407	27778923	CpG: 48	516	48	366	18.6	70.9	0.75
chr2	27814756	27815230	CpG: 40	474	40	311	16.9	65.6	0.81
chr2	27827159	27827433	CpG: 25	274	25	172	18.2	62.8	0.93
chr2	27933313	27934017	CpG: 78	704	78	487	22.2	69.2	0.93
chr2	27958007	27958277	CpG: 22	270	22	165	16.3	61.1	0.88
chr2	28067635	28067903	CpG: 20	268	20	163	14.9	60.8	0.81
chr2	28083835	28084113	CpG: 25	278	25	175	18.0	62.9	0.91
chr2	28433387	28437174	CpG: 359	3787	359	2462	19.0	65.0	0.90
chr2	28610397	28610771	CpG: 36	374	36	247	19.3	66.0	0.90
chr2	28794962	28796138	CpG: 151	1176	151	838	25.7	71.3	1.04
chr2	28854095	28854957	CpG: 101	862	101	632	23.4	73.3	0.88
chr2	28883175	28883412	CpG: 17	237	17	136	14.3	57.4	0.89
chr2	28913455	28914166	CpG: 65	711	65	446	18.3	62.7	0.93
chr2	28924657	28924894	CpG: 18	237	18	143	15.2	60.3	0.85
chr2	28937439	28938744	CpG: 115	1305	115	823	17.6	63.1	0.89
chr2	28956599	28956841	CpG: 17	242	17	143	14.0	59.1	0.82
chr2	29158575	29159501	CpG: 130	926	130	735	28.1	79.4	0.90
chr2	29489414	29489695	CpG: 25	281	25	176	17.8	62.6	0.91
chr2	29634368	29634642	CpG: 22	274	22	165	16.1	60.2	0.90
chr2	29638957	29639195	CpG: 20	238	20	142	16.8	59.7	0.97
chr2	29796042	29796319	CpG: 24	277	24	171	17.3	61.7	0.92
chr2	29963932	29965725	CpG: 156	1793	156	1228	17.4	68.5	0.74
chr2	30069853	30070125	CpG: 21	272	21	163	15.4	59.9	0.87
chr2	30190697	30192307	CpG: 179	1610	179	1172	22.2	72.8	0.84
chr2	30274951	30277040	CpG: 203	2089	203	1429	19.4	68.4	0.84
chr2	30491457	30492189	CpG: 79	732	79	497	21.6	67.9	0.95
chr2	30506127	30506403	CpG: 25	276	25	174	18.1	63.0	0.92
chr2	30597855	30598136	CpG: 23	281	23	174	16.4	61.9	0.87
chr2	30912746	30913022	CpG: 24	276	24	171	17.4	62.0	0.92
chr2	30948474	30948760	CpG: 20	286	20	165	14.0	57.7	0.85
chr2	31164034	31164308	CpG: 24	274	24	171	17.5	62.4	0.91
chr2	31181612	31183117	CpG: 166	1505	166	1096	22.1	72.8	0.83
chr2	31278038	31278938	CpG: 78	900	78	612	17.3	68.0	0.75
chr2	31381205	31381483	CpG: 25	278	25	175	18.0	62.9	0.92
chr2	31483957	31484234	CpG: 20	277	20	171	14.4	61.7	0.77
chr2	31625007	31626119	CpG: 101	1112	101	744	18.2	66.9	0.82
chr2	31626261	31626498	CpG: 19	237	19	157	16.0	66.2	0.78
chr2	31735196	31735458	CpG: 25	262	25	165	19.1	63.0	0.98
chr2	31771915	31772152	CpG: 21	237	21	145	17.7	61.2	0.97
chr2	31848781	31849091	CpG: 30	310	30	231	19.4	74.5	0.70
chr2	31914253	31914527	CpG: 23	274	23	171	16.8	62.4	0.87
chr2	31944277	31944501	CpG: 16	224	16	137	14.3	61.2	0.77
chr2	32049473	32049696	CpG: 19	223	19	137	17.0	61.4	0.92
chr2	32057992	32059587	CpG: 185	1595	185	1207	23.2	75.7	0.81
chr2	32088132	32088349	CpG: 24	217	24	145	22.1	66.8	1.00
chr2	32111473	32112822	CpG: 133	1349	133	897	19.7	66.5	0.89
chr2	32116418	32116684	CpG: 20	266	20	161	15.0	60.5	0.83
chr2	32126427	32126641	CpG: 17	214	17	129	15.9	60.3	0.88
chr2	32174344	32174570	CpG: 19	226	19	132	16.8	58.4	0.99
chr2	32213786	32214438	CpG: 45	652	45	372	13.8	57.1	0.86
chr2	32326419	32326925	CpG: 51	506	51	353	20.2	69.8	0.83
chr2	32327551	32327792	CpG: 20	241	20	146	16.6	60.6	0.94
chr2	32327991	32328234	CpG: 20	243	20	143	16.5	58.8	0.96
chr2	32328992	32329206	CpG: 17	214	17	126	15.9	58.9	0.92
chr2	32360734	32361012	CpG: 23	278	23	174	16.5	62.6	0.86
chr2	32361250	32361515	CpG: 20	265	20	164	15.1	61.9	0.80
chr2	32364009	32364234	CpG: 18	225	18	135	16.0	60.0	0.91
chr2	32390945	32391179	CpG: 17	234	17	140	14.5	59.8	0.82
chr2	32402585	32402862	CpG: 22	277	22	166	15.9	59.9	0.89
chr2	32405191	32406712	CpG: 151	1521	151	1078	19.9	70.9	0.80
chr2	32495834	32497078	CpG: 102	1244	102	906	16.4	72.8	0.62
chr2	32676591	32676854	CpG: 20	263	20	164	15.2	62.4	0.78
chr2	32678115	32678342	CpG: 16	227	16	130	14.1	57.3	0.87
chr2	32816275	32816524	CpG: 19	249	19	151	15.3	60.6	0.85
chr2	32934493	32934801	CpG: 26	308	26	225	16.9	73.1	0.64
chr2	32992108	32993824	CpG: 192	1716	192	1224	22.4	71.3	0.89
chr2	33052451	33052725	CpG: 24	274	24	172	17.5	62.8	0.90
chr2	33103728	33104016	CpG: 25	288	25	208	17.4	72.2	0.67
chr2	33184895	33185169	CpG: 25	274	25	172	18.2	62.8	0.94
chr2	33216185	33216473	CpG: 21	288	21	173	14.6	60.1	0.81
chr2	33392980	33393252	CpG: 19	272	19	165	14.0	60.7	0.77
chr2	33602411	33602692	CpG: 24	281	24	175	17.1	62.3	0.90
chr2	33645357	33645904	CpG: 52	547	52	345	19.0	63.1	0.96
chr2	33651980	33652246	CpG: 20	266	20	163	15.0	61.3	0.81
chr2	33775520	33775782	CpG: 26	262	26	172	19.8	65.6	0.93
chr2	33780282	33780560	CpG: 25	278	25	175	18.0	62.9	0.92
chr2	33809504	33810252	CpG: 56	748	56	503	15.0	67.2	0.66
chr2	33823653	33823857	CpG: 19	204	19	151	18.6	74.0	0.71
chr2	33867682	33867898	CpG: 17	216	17	132	15.7	61.1	0.86
chr2	33975241	33975515	CpG: 22	274	22	167	16.1	60.9	0.87
chr2	34400945	34401223	CpG: 21	278	21	168	15.1	60.4	0.84
chr2	34437188	34437462	CpG: 21	274	21	165	15.3	60.2	0.85
chr2	34438402	34438637	CpG: 18	235	18	135	15.3	57.4	0.95
chr2	34453660	34453877	CpG: 18	217	18	131	16.6	60.4	0.93
chr2	34460608	34460874	CpG: 27	266	27	169	20.3	63.5	1.02
chr2	34997029	34997291	CpG: 24	262	24	195	18.3	74.4	0.66
chr2	35397767	35397984	CpG: 16	217	16	127	14.7	58.5	0.88
chr2	35400644	35400855	CpG: 18	211	18	127	17.1	60.2	0.96
chr2	35505273	35505503	CpG: 17	230	17	138	14.8	60.0	0.84
chr2	35596606	35596872	CpG: 24	266	24	167	18.0	62.8	0.92
chr2	35711407	35711688	CpG: 24	281	24	174	17.1	61.9	0.91
chr2	35870560	35870834	CpG: 25	274	25	172	18.2	62.8	0.94
chr2	36123552	36123911	CpG: 29	359	29	214	16.2	59.6	0.91
chr2	36184847	36186008	CpG: 87	1161	87	817	15.0	70.4	0.61
chr2	36215831	36216034	CpG: 15	203	15	104	14.8	51.2	1.17
chr2	36349287	36349555	CpG: 21	268	21	166	15.7	61.9	0.82
chr2	36361909	36363772	CpG: 225	1863	225	1395	24.2	74.9	0.87
chr2	36364012	36364494	CpG: 33	482	33	280	13.7	58.1	0.83
chr2	36604313	36604903	CpG: 73	590	73	453	24.7	76.8	0.84
chr2	36695189	36695526	CpG: 31	337	31	250	18.4	74.2	0.67
chr2	36735397	36735671	CpG: 24	274	24	171	17.5	62.4	0.91
chr2	36784000	36784234	CpG: 20	234	20	141	17.1	60.3	0.95
chr2	36815733	36815953	CpG: 19	220	19	133	17.3	60.5	0.95
chr2	36973126	36974282	CpG: 122	1156	122	820	21.1	70.9	0.84
chr2	37041465	37041738	CpG: 25	273	25	173	18.3	63.4	0.92
chr2	37091064	37091885	CpG: 72	821	72	511	17.5	62.2	0.91
chr2	37158960	37159170	CpG: 23	210	23	132	21.9	62.9	1.12
chr2	37163886	37164387	CpG: 58	501	58	375	23.2	74.9	0.84
chr2	37171453	37171727	CpG: 23	274	23	171	16.8	62.4	0.87
chr2	37203492	37204309	CpG: 72	817	72	525	17.6	64.3	0.87
chr2	37225095	37225309	CpG: 16	214	16	129	15.0	60.3	0.84
chr2	37238296	37239097	CpG: 72	801	72	504	18.0	62.9	0.91
chr2	37331192	37332391	CpG: 157	1199	157	863	26.2	72.0	1.01
chr2	37336241	37336484	CpG: 17	243	17	144	14.0	59.3	0.82
chr2	37351524	37352245	CpG: 70	721	70	524	19.4	72.7	0.75
chr2	37352535	37352814	CpG: 22	279	22	170	15.8	60.9	0.86
chr2	37542839	37543117	CpG: 24	278	24	167	17.3	60.1	0.97
chr2	37677953	37679836	CpG: 192	1883	192	1296	20.4	68.8	0.86
chr2	37705040	37705311	CpG: 20	271	20	162	14.8	59.8	0.84
chr2	37931352	37931596	CpG: 17	244	17	142	13.9	58.2	0.85
chr2	37931921	37932675	CpG: 86	754	86	532	22.8	70.6	0.93
chr2	37939571	37940533	CpG: 74	962	74	678	15.4	70.5	0.62
chr2	37970693	37971138	CpG: 39	445	39	338	17.5	76.0	0.61
chr2	37984207	37985105	CpG: 65	898	65	605	14.5	67.4	0.64
chr2	38081019	38084262	CpG: 311	3243	311	2170	19.2	66.9	0.86
chr2	38101472	38101747	CpG: 20	275	20	166	14.5	60.4	0.81
chr2	38365353	38365568	CpG: 16	215	16	130	14.9	60.5	0.82
chr2	38376755	38377080	CpG: 24	325	24	184	14.8	56.6	0.93
chr2	38383310	38384433	CpG: 144	1123	144	815	25.6	72.6	0.99
chr2	38394261	38394491	CpG: 19	230	19	140	16.5	60.9	0.90
chr2	38404048	38404253	CpG: 16	205	16	143	15.6	69.8	0.64
chr2	38409701	38410701	CpG: 77	1000	77	708	15.4	70.8	0.61
chr2	38427467	38427705	CpG: 19	238	19	143	16.0	60.1	0.90
chr2	38488547	38488752	CpG: 15	205	15	121	14.6	59.0	0.84
chr2	38542883	38543333	CpG: 48	450	48	322	21.3	71.6	0.83
chr2	38608874	38610575	CpG: 186	1701	186	1150	21.9	67.6	0.96
chr2	38628721	38629000	CpG: 20	279	20	169	14.3	60.6	0.79
chr2	38631220	38631493	CpG: 28	273	28	173	20.5	63.4	1.03
chr2	38644162	38644399	CpG: 19	237	19	147	16.0	62.0	0.85
chr2	38644596	38644827	CpG: 17	231	17	136	14.7	58.9	0.88
chr2	38649984	38650327	CpG: 32	343	32	255	18.7	74.3	0.68
chr2	38651996	38652271	CpG: 20	275	20	169	14.5	61.5	0.78
chr2	38735038	38735279	CpG: 21	241	21	148	17.4	61.4	0.94
chr2	38759180	38760329	CpG: 116	1149	116	720	20.2	62.7	1.04
chr2	38764613	38765375	CpG: 60	762	60	532	15.7	69.8	0.65
chr2	38779929	38780203	CpG: 22	274	22	167	16.1	60.9	0.88
chr2	38798381	38798658	CpG: 22	277	22	162	15.9	58.5	0.95
chr2	38884006	38884559	CpG: 42	553	42	365	15.2	66.0	0.70
chr2	38968152	38969343	CpG: 137	1191	137	833	23.0	69.9	0.94
chr2	39096871	39097145	CpG: 25	274	25	171	18.2	62.4	0.95
chr2	39115277	39115552	CpG: 25	275	25	173	18.2	62.9	0.93
chr2	39129083	39130193	CpG: 137	1110	137	838	24.7	75.5	0.87
chr2	39133185	39133563	CpG: 47	378	47	261	24.9	69.0	1.05
chr2	39153724	39154097	CpG: 31	373	31	217	16.6	58.2	0.99
chr2	39252421	39253492	CpG: 100	1071	100	752	18.7	70.2	0.77
chr2	39254015	39254289	CpG: 19	274	19	152	13.9	55.5	0.92
chr2	39272116	39272432	CpG: 24	316	24	187	15.2	59.2	0.87
chr2	39374291	39374572	CpG: 24	281	24	175	17.1	62.3	0.90
chr2	39445639	39446409	CpG: 104	770	104	576	27.0	74.8	0.99
chr2	39457946	39458191	CpG: 19	245	19	149	15.5	60.8	0.85
chr2	39594366	39594746	CpG: 29	380	29	268	15.3	70.5	0.61
chr2	39637089	39638056	CpG: 75	967	75	685	15.5	70.8	0.62
chr2	39674569	39675504	CpG: 114	935	114	711	24.4	76.0	0.87
chr2	39717433	39717710	CpG: 26	277	26	174	18.8	62.8	0.96
chr2	39776322	39776596	CpG: 24	274	24	171	17.5	62.4	0.91
chr2	39787947	39788320	CpG: 53	373	53	280	28.4	75.1	1.01
chr2	40023245	40023488	CpG: 24	243	24	149	19.8	61.3	1.05
chr2	40247293	40247666	CpG: 28	373	28	223	15.0	59.8	0.84
chr2	40460332	40460572	CpG: 16	240	16	154	13.3	64.2	0.65
chr2	40460924	40461477	CpG: 79	553	79	411	28.6	74.3	1.04
chr2	40491848	40492054	CpG: 18	206	18	119	17.5	57.8	1.10
chr2	40575767	40576045	CpG: 23	278	23	173	16.5	62.2	0.87
chr2	40760044	40760332	CpG: 26	288	26	180	18.1	62.5	0.94
chr2	41167105	41167379	CpG: 21	274	21	168	15.3	61.3	0.82
chr2	41344810	41345162	CpG: 32	352	32	263	18.2	74.7	0.65
chr2	41671928	41672143	CpG: 17	215	17	131	15.8	60.9	0.85
chr2	41702980	41703337	CpG: 36	357	36	241	20.2	67.5	0.90
chr2	41721033	41721255	CpG: 18	222	18	134	16.2	60.4	0.90
chr2	41846315	41846581	CpG: 22	266	22	162	16.5	60.9	0.89
chr2	41846742	41846973	CpG: 16	231	16	149	13.9	64.5	0.67
chr2	42000644	42001094	CpG: 40	450	40	303	17.8	67.3	0.78
chr2	42038904	42039178	CpG: 23	274	23	172	16.8	62.8	0.86
chr2	42052787	42054363	CpG: 208	1576	208	1232	26.4	78.2	0.87
chr2	42106665	42108018	CpG: 113	1353	113	879	16.7	65.0	0.80
chr2	42174653	42175291	CpG: 87	638	87	469	27.3	73.5	1.02
chr2	42366350	42367153	CpG: 61	803	61	497	15.2	61.9	0.79
chr2	42397079	42397353	CpG: 24	274	24	171	17.5	62.4	0.91
chr2	42498081	42500465	CpG: 297	2384	297	1712	24.9	71.8	0.97
chr2	42574041	42574662	CpG: 67	621	67	482	21.6	77.6	0.72
chr2	42626871	42627566	CpG: 50	695	50	457	14.4	65.8	0.67
chr2	42797775	42798619	CpG: 88	844	88	596	20.9	70.6	0.84
chr2	42802230	42802492	CpG: 24	262	24	166	18.3	63.4	0.93
chr2	42815408	42816994	CpG: 152	1586	152	1093	19.2	68.9	0.81
chr2	42833141	42833725	CpG: 41	584	41	364	14.0	62.3	0.72
chr2	42994752	42995096	CpG: 32	344	32	203	18.6	59.0	1.07
chr2	43068286	43069127	CpG: 68	841	68	586	16.2	69.7	0.67
chr2	43073333	43073761	CpG: 50	428	50	312	23.4	72.9	0.91
chr2	43078154	43078424	CpG: 25	270	25	169	18.5	62.6	0.95
chr2	43106059	43106460	CpG: 45	401	45	275	22.4	68.6	0.95
chr2	43176194	43176430	CpG: 18	236	18	150	15.3	63.6	0.76
chr2	43229672	43233178	CpG: 396	3506	396	2500	22.6	71.3	0.90
chr2	43437068	43437527	CpG: 38	459	38	270	16.6	58.8	0.97
chr2	43472270	43472552	CpG: 24	282	24	178	17.0	63.1	0.87
chr2	43601177	43601619	CpG: 42	442	42	277	19.0	62.7	0.97
chr2	43642601	43643235	CpG: 72	634	72	476	22.7	75.1	0.82
chr2	43671492	43671716	CpG: 18	224	18	132	16.1	58.9	0.93
chr2	43683145	43683924	CpG: 60	779	60	537	15.4	68.9	0.65
chr2	43775059	43775267	CpG: 15	208	15	124	14.4	59.6	0.82
chr2	43836957	43837424	CpG: 42	467	42	323	18.0	69.2	0.77
chr2	43992570	43992829	CpG: 18	259	18	156	13.9	60.2	0.77
chr2	44000879	44001958	CpG: 86	1079	86	682	15.9	63.2	0.80
chr2	44092485	44092761	CpG: 23	276	23	180	16.7	65.2	0.82
chr2	44123387	44123612	CpG: 20	225	20	138	17.8	61.3	0.99
chr2	44173195	44174848	CpG: 144	1653	144	1058	17.4	64.0	0.86
chr2	44291869	44292151	CpG: 19	282	19	178	13.5	63.1	0.78
chr2	44367117	44367521	CpG: 40	404	40	277	19.8	68.6	0.87
chr2	44483985	44484255	CpG: 22	270	22	167	16.3	61.9	0.87
chr2	44773847	44774053	CpG: 22	206	22	162	21.4	78.6	0.69
chr2	44807136	44808216	CpG: 82	1080	82	642	15.2	59.4	0.86
chr2	44933320	44935175	CpG: 176	1855	176	1271	19.0	68.5	0.81
chr2	44938019	44938238	CpG: 18	219	18	141	16.4	64.4	0.80
chr2	44939553	44941184	CpG: 117	1631	117	1055	14.3	64.7	0.70
chr2	44942687	44944693	CpG: 142	2006	142	1310	14.2	65.3	0.67
chr2	44947425	44950010	CpG: 203	2585	203	1680	15.7	65.0	0.75
chr2	44954850	44955386	CpG: 42	536	42	367	15.7	68.5	0.67
chr2	44957379	44958514	CpG: 96	1135	96	746	16.9	65.7	0.78
chr2	44960009	44961230	CpG: 90	1221	90	777	14.7	63.6	0.73
chr2	45005732	45006871	CpG: 85	1139	85	741	14.9	65.1	0.71
chr2	45009299	45010637	CpG: 94	1338	94	812	14.1	60.7	0.76
chr2	45013598	45015879	CpG: 220	2281	220	1565	19.3	68.6	0.82
chr2	45018459	45019666	CpG: 134	1207	134	871	22.2	72.2	0.85
chr2	45070441	45070759	CpG: 28	318	28	190	17.6	59.7	0.99
chr2	45081124	45081340	CpG: 21	216	21	129	19.4	59.7	1.09
chr2	45173975	45176277	CpG: 217	2302	217	1531	18.9	66.5	0.86
chr2	45316158	45316405	CpG: 19	247	19	144	15.4	58.3	1.11
chr2	45616197	45616487	CpG: 35	290	35	198	24.1	68.3	1.04
chr2	45648600	45648955	CpG: 42	355	42	259	23.7	73.0	0.89
chr2	45655082	45657589	CpG: 251	2507	251	1682	20.0	67.1	0.90
chr2	45756841	45757115	CpG: 24	274	24	171	17.5	62.4	0.91
chr2	45834802	45835080	CpG: 25	278	25	175	18.0	62.9	0.92
chr2	45885881	45886155	CpG: 23	274	23	170	16.8	62.0	0.88
chr2	45922661	45923055	CpG: 44	394	44	299	22.3	75.9	0.78
chr2	45974057	45974338	CpG: 24	281	24	175	17.1	62.3	0.90
chr2	46028126	46028411	CpG: 24	285	24	177	16.8	62.1	0.89
chr2	46080351	46080626	CpG: 20	275	20	167	14.5	60.7	0.80
chr2	46301670	46305021	CpG: 302	3351	302	2192	18.0	65.4	0.84
chr2	46428620	46428847	CpG: 19	227	19	136	16.7	59.9	0.94
chr2	46485487	46485817	CpG: 26	330	26	220	15.8	66.7	0.72
chr2	46530221	46530487	CpG: 27	266	27	169	20.3	63.5	1.02
chr2	46547365	46548682	CpG: 161	1317	161	1008	24.4	76.5	0.84
chr2	46621530	46622187	CpG: 62	657	62	444	18.9	67.6	0.84
chr2	46703307	46704378	CpG: 117	1071	117	782	21.8	73.0	0.82
chr2	46706389	46706619	CpG: 21	230	21	143	18.3	62.2	0.96
chr2	46920103	46920896	CpG: 75	793	75	562	18.9	70.9	0.76
chr2	46945495	46946615	CpG: 145	1120	145	855	25.9	76.3	0.89
chr2	47096977	47097218	CpG: 18	241	18	144	14.9	59.8	0.86
chr2	47180782	47182078	CpG: 132	1296	132	874	20.4	67.4	0.92
chr2	47277371	47277720	CpG: 35	349	35	248	20.1	71.1	0.80
chr2	47374102	47375151	CpG: 126	1049	126	776	24.0	74.0	0.88
chr2	47375365	47375605	CpG: 17	240	17	141	14.2	58.8	0.83
chr2	47407962	47408686	CpG: 76	724	76	486	21.0	67.1	0.95
chr2	47496162	47496392	CpG: 19	230	19	140	16.5	60.9	0.90
chr2	47525904	47526974	CpG: 119	1070	119	753	22.2	70.4	0.91
chr2	47574837	47577080	CpG: 261	2243	261	1626	23.3	72.5	0.89
chr2	47677137	47677407	CpG: 24	270	24	168	17.8	62.2	0.93
chr2	47695746	47696341	CpG: 47	595	47	354	15.8	59.5	0.90
chr2	47788607	47790242	CpG: 170	1635	170	1164	20.8	71.2	0.84
chr2	47790460	47790729	CpG: 21	269	21	158	15.6	58.7	0.92
chr2	47911113	47912881	CpG: 179	1768	179	1239	20.2	70.1	0.85
chr2	47933295	47933531	CpG: 16	236	16	141	13.6	59.7	0.77
chr2	47969838	47970074	CpG: 18	236	18	140	15.3	59.3	0.90
chr2	48050172	48050453	CpG: 23	281	23	173	16.4	61.6	0.87
chr2	48118437	48118682	CpG: 18	245	18	148	14.7	60.4	0.82
chr2	48320081	48321416	CpG: 132	1335	132	947	19.8	70.9	0.79
chr2	48410155	48410403	CpG: 21	248	21	147	16.9	59.3	0.98
chr2	48427614	48427869	CpG: 20	255	20	146	15.7	57.3	0.96
chr2	48446368	48447167	CpG: 72	799	72	544	18.0	68.1	0.78
chr2	48535739	48536543	CpG: 68	804	68	571	16.9	71.0	0.67
chr2	48617340	48618152	CpG: 65	812	65	563	16.0	69.3	0.67
chr2	48620415	48620649	CpG: 22	234	22	145	18.8	62.0	1.09
chr2	48694894	48695107	CpG: 19	213	19	139	17.8	65.3	0.86
chr2	48751530	48751867	CpG: 36	337	36	246	21.4	73.0	0.81
chr2	48927681	48927954	CpG: 24	273	24	172	17.6	63.0	0.90
chr2	48981741	48982036	CpG: 25	295	25	181	16.9	61.4	0.91
chr2	49488667	49488941	CpG: 22	274	22	167	16.1	60.9	0.87
chr2	49502022	49502303	CpG: 24	281	24	175	17.1	62.3	0.90
chr2	49569133	49569420	CpG: 25	287	25	180	17.4	62.7	0.90
chr2	49725667	49725942	CpG: 23	275	23	168	16.7	61.1	0.91
chr2	49806700	49806985	CpG: 23	285	23	177	16.1	62.1	0.85
chr2	49850346	49850570	CpG: 20	224	20	135	17.9	60.3	1.00
chr2	49861316	49861597	CpG: 24	281	24	174	17.1	61.9	0.91
chr2	50066399	50066629	CpG: 19	230	19	139	16.5	60.4	0.91
chr2	50342095	50343433	CpG: 115	1338	115	882	17.2	65.9	0.79
chr2	50371322	50371603	CpG: 24	281	24	176	17.1	62.6	0.89
chr2	50407260	50407847	CpG: 42	587	42	400	14.3	68.1	0.62
chr2	50477856	50478137	CpG: 25	281	25	174	17.8	61.9	0.94
chr2	51023542	51024518	CpG: 103	976	103	671	21.1	68.8	0.90
chr2	51038461	51038695	CpG: 21	234	21	144	17.9	61.5	0.97
chr2	51044454	51044727	CpG: 25	273	25	167	18.3	61.2	0.99
chr2	51147791	51147992	CpG: 16	201	16	148	15.9	73.6	0.62
chr2	51277066	51277351	CpG: 24	285	24	177	16.8	62.1	0.89
chr2	51589317	51589602	CpG: 22	285	22	171	15.4	60.0	0.86
chr2	51746226	51746511	CpG: 23	285	23	178	16.1	62.5	0.85
chr2	51776659	51777001	CpG: 27	342	27	246	15.8	71.9	0.61
chr2	51798163	51798437	CpG: 25	274	25	170	18.2	62.0	0.96
chr2	51802661	51802879	CpG: 19	218	19	136	17.4	62.4	0.92
chr2	51968344	51968630	CpG: 24	286	24	179	16.8	62.6	0.87
chr2	52003119	52003443	CpG: 34	324	34	244	21.0	75.3	0.74
chr2	52106138	52106421	CpG: 22	283	22	168	15.5	59.4	0.89
chr2	52152219	52152499	CpG: 24	280	24	175	17.1	62.5	0.89
chr2	52169668	52169943	CpG: 25	275	25	172	18.2	62.5	0.94
chr2	52298075	52298353	CpG: 22	278	22	171	15.8	61.5	0.84
chr2	52309246	52309516	CpG: 20	270	20	164	14.8	60.7	0.81
chr2	52343129	52343403	CpG: 23	274	23	170	16.8	62.0	0.88
chr2	52401911	52402181	CpG: 23	270	23	168	17.0	62.2	0.88
chr2	52502160	52502425	CpG: 22	265	22	161	16.6	60.8	0.91
chr2	52567569	52569223	CpG: 123	1654	123	1083	14.9	65.5	0.73
chr2	52625857	52626287	CpG: 39	430	39	269	18.1	62.6	0.93
chr2	52963459	52963775	CpG: 25	316	25	195	15.8	61.7	0.84
chr2	53256115	53256361	CpG: 26	246	26	181	21.1	73.6	0.78
chr2	53505685	53505927	CpG: 21	242	21	143	17.4	59.1	1.01
chr2	53559347	53559582	CpG: 18	235	18	141	15.3	60.0	0.87
chr2	53583518	53583811	CpG: 27	293	27	183	18.4	62.5	0.94
chr2	53602519	53602802	CpG: 20	283	20	168	14.1	59.4	0.82
chr2	53613278	53613480	CpG: 15	202	15	119	14.9	58.9	0.89
chr2	53640807	53641085	CpG: 25	278	25	174	18.0	62.6	0.93
chr2	53763959	53764237	CpG: 28	278	28	185	20.1	66.5	0.91
chr2	53782867	53783564	CpG: 73	697	73	466	20.9	66.9	0.94
chr2	53788131	53788407	CpG: 20	276	20	165	14.5	59.8	0.82
chr2	53853204	53853493	CpG: 24	289	24	178	16.6	61.6	0.89
chr2	53855865	53856355	CpG: 60	490	60	372	24.5	75.9	0.87
chr2	53917761	53918035	CpG: 24	274	24	169	17.5	61.7	0.93
chr2	53966727	53967569	CpG: 96	842	96	626	22.8	74.3	0.84
chr2	53968242	53968605	CpG: 28	363	28	219	15.4	60.3	0.86
chr2	54111704	54112255	CpG: 52	551	52	370	18.9	67.2	0.84
chr2	54252024	54252556	CpG: 37	532	37	327	13.9	61.5	0.74
chr2	54326666	54327075	CpG: 44	409	44	276	21.5	67.5	0.97
chr2	54450102	54451932	CpG: 197	1830	197	1358	21.5	74.2	0.78
chr2	54479315	54480142	CpG: 62	827	62	568	15.0	68.7	0.64
chr2	54551895	54552838	CpG: 88	943	88	597	18.7	63.3	0.94
chr2	54622968	54623357	CpG: 30	389	30	234	15.4	60.2	0.88
chr2	54692521	54693257	CpG: 63	736	63	512	17.1	69.6	0.71
chr2	54717257	54719351	CpG: 197	2094	197	1338	18.8	63.9	0.93
chr2	54783239	54783518	CpG: 24	279	24	173	17.2	62.0	0.90
chr2	54784758	54785036	CpG: 22	278	22	170	15.8	61.2	0.86
chr2	54883580	54883853	CpG: 23	273	23	173	16.8	63.4	0.85
chr2	54925308	54925589	CpG: 25	281	25	177	17.8	63.0	0.91
chr2	54988031	54988250	CpG: 17	219	17	134	15.5	61.2	0.83
chr2	55046633	55048123	CpG: 138	1490	138	1039	18.5	69.7	0.77
chr2	55220612	55221186	CpG: 66	574	66	400	23.0	69.7	0.95
chr2	55266154	55266650	CpG: 42	496	42	305	16.9	61.5	0.90
chr2	55279321	55279808	CpG: 57	487	57	335	23.4	68.8	0.99
chr2	55416688	55417396	CpG: 76	708	76	494	21.5	69.8	0.92
chr2	55514769	55515002	CpG: 20	233	20	145	17.2	62.2	0.89
chr2	55516367	55517430	CpG: 65	1063	65	605	12.2	56.9	0.76
chr2	55614321	55615121	CpG: 84	800	84	523	21.0	65.4	1.00
chr2	55642232	55642473	CpG: 19	241	19	146	15.8	60.6	0.88
chr2	55647415	55648415	CpG: 85	1000	85	720	17.0	72.0	0.66
chr2	55690779	55691142	CpG: 32	363	32	226	17.6	62.3	0.91
chr2	55692039	55692368	CpG: 22	329	22	182	13.4	55.3	0.89
chr2	55692999	55693284	CpG: 24	285	24	176	16.8	61.8	0.90
chr2	55705469	55705738	CpG: 23	269	23	168	17.1	62.5	0.88
chr2	55739148	55739400	CpG: 21	252	21	148	16.7	58.7	0.97
chr2	55750738	55750979	CpG: 19	241	19	145	15.8	60.2	0.88
chr2	55792332	55792617	CpG: 22	285	22	174	15.4	61.1	0.84
chr2	55853341	55853615	CpG: 24	274	24	170	17.5	62.0	0.92
chr2	55892466	55892738	CpG: 24	272	24	171	17.6	62.9	0.90
chr2	55920097	55920937	CpG: 73	840	73	566	17.4	67.4	0.77
chr2	56180696	56182372	CpG: 173	1676	173	1213	20.6	72.4	0.79
chr2	57088728	57088956	CpG: 21	228	21	144	18.4	63.2	0.94
chr2	57112649	57112934	CpG: 25	285	25	178	17.5	62.5	0.91
chr2	57199499	57199733	CpG: 20	234	20	142	17.1	60.7	0.95
chr2	57371028	57371258	CpG: 20	230	20	141	17.4	61.3	0.94
chr2	57446150	57446424	CpG: 25	274	25	172	18.2	62.8	0.94
chr2	57609422	57609725	CpG: 23	303	23	177	15.2	58.4	0.90
chr2	57949160	57949394	CpG: 19	234	19	139	16.2	59.4	0.93
chr2	57997251	57997532	CpG: 23	281	23	174	16.4	61.9	0.87
chr2	58018291	58018553	CpG: 25	262	25	166	19.1	63.4	0.96
chr2	58051196	58051976	CpG: 81	780	81	536	20.8	68.7	0.89
chr2	58139005	58139286	CpG: 24	281	24	175	17.1	62.3	0.90
chr2	58225762	58225974	CpG: 17	212	17	129	16.0	60.8	0.89
chr2	58245807	58246326	CpG: 50	519	50	340	19.3	65.5	0.90
chr2	58256261	58256632	CpG: 32	371	32	258	17.3	69.5	0.74
chr2	58317012	58317293	CpG: 22	281	22	172	15.7	61.2	0.85
chr2	58398187	58398424	CpG: 17	237	17	137	14.3	57.8	0.87
chr2	58423192	58423423	CpG: 18	231	18	137	15.6	59.3	0.89
chr2	58433105	58433810	CpG: 74	705	74	516	21.0	73.2	0.78
chr2	58458731	58458967	CpG: 20	236	20	143	16.9	60.6	0.94
chr2	58578382	58578662	CpG: 25	280	25	171	17.9	61.1	0.96
chr2	58797373	58797651	CpG: 24	278	24	174	17.3	62.6	0.89
chr2	59070544	59070827	CpG: 23	283	23	173	16.3	61.1	0.88
chr2	59071780	59072241	CpG: 56	461	56	350	24.3	75.9	0.84
chr2	59325984	59326214	CpG: 16	230	16	138	13.9	60.0	0.78
chr2	59844554	59844835	CpG: 23	281	23	174	16.4	61.9	0.87
chr2	59976378	59976648	CpG: 21	270	21	164	15.6	60.7	0.85
chr2	59985532	59985810	CpG: 24	278	24	171	17.3	61.5	0.92
chr2	60021697	60021973	CpG: 22	276	22	168	15.9	60.9	0.87
chr2	60023252	60023489	CpG: 19	237	19	144	16.0	60.8	0.88
chr2	60089371	60089674	CpG: 23	303	23	179	15.2	59.1	0.87
chr2	60190310	60190584	CpG: 25	274	25	172	18.2	62.8	0.93
chr2	60271790	60272019	CpG: 16	229	16	136	14.0	59.4	0.81
chr2	60466485	60467655	CpG: 110	1170	110	775	18.8	66.2	0.86
chr2	60555299	60561482	CpG: 430	6183	430	3772	13.9	61.0	0.75
chr2	60587514	60587927	CpG: 50	413	50	305	24.2	73.8	0.89
chr2	60591226	60591453	CpG: 21	227	21	141	18.5	62.1	1.02
chr2	60691673	60691940	CpG: 20	267	20	158	15.0	59.2	0.87
chr2	60741441	60741733	CpG: 42	292	42	212	28.8	72.6	1.16
chr2	60761875	60762552	CpG: 50	677	50	424	14.8	62.6	0.77
chr2	60886836	60887727	CpG: 97	891	97	651	21.8	73.1	0.82
chr2	60977976	60978294	CpG: 28	318	28	196	17.6	61.6	0.93
chr2	61071576	61072293	CpG: 103	717	103	560	28.7	78.1	0.94
chr2	61149848	61150123	CpG: 22	275	22	165	16.0	60.0	0.90
chr2	61150360	61150568	CpG: 15	208	15	112	14.4	53.8	1.01
chr2	61181840	61182089	CpG: 21	249	21	147	16.9	59.0	0.98
chr2	61182757	61184078	CpG: 140	1321	140	937	21.2	70.9	0.84
chr2	61401393	61401659	CpG: 27	266	27	169	20.3	63.5	1.02
chr2	61435816	61436088	CpG: 21	272	21	163	15.4	59.9	0.86
chr2	61476060	61477503	CpG: 172	1443	172	1053	23.8	73.0	0.90
chr2	61538272	61538512	CpG: 22	240	22	150	18.3	62.5	0.96
chr2	61543349	61545042	CpG: 140	1693	140	1112	16.5	65.7	0.78
chr2	61555314	61555558	CpG: 18	244	18	148	14.8	60.7	0.81
chr2	61577901	61578115	CpG: 17	214	17	129	15.9	60.3	0.91
chr2	61592238	61592475	CpG: 20	237	20	143	16.9	60.3	0.95
chr2	61595837	61596100	CpG: 21	263	21	164	16.0	62.4	0.83
chr2	61621559	61621835	CpG: 25	276	25	170	18.1	61.6	0.96
chr2	61664483	61664694	CpG: 18	211	18	130	17.1	61.6	0.92
chr2	61700612	61700874	CpG: 23	262	23	192	17.6	73.3	0.74
chr2	61738490	61738699	CpG: 18	209	18	128	17.2	61.2	0.93
chr2	61763351	61763626	CpG: 20	275	20	164	14.5	59.6	0.83
chr2	61769825	61770744	CpG: 88	919	88	564	19.2	61.4	1.02
chr2	61770997	61771232	CpG: 18	235	18	143	15.3	60.9	0.84
chr2	61833408	61833640	CpG: 17	232	17	138	14.7	59.5	0.85
chr2	61859864	61860335	CpG: 40	471	40	321	17.0	68.2	0.73
chr2	61894468	61895727	CpG: 107	1259	107	772	17.0	61.3	0.90
chr2	62048676	62048889	CpG: 25	213	25	164	23.5	77.0	0.79
chr2	62136123	62136369	CpG: 19	246	19	145	15.4	58.9	0.92
chr2	62201283	62203550	CpG: 194	2267	194	1571	17.1	69.3	0.71
chr2	62236232	62236513	CpG: 24	281	24	175	17.1	62.3	0.89
chr2	62256880	62257102	CpG: 20	222	20	138	18.0	62.2	0.95
chr2	62276530	62276805	CpG: 21	275	21	166	15.3	60.4	0.84
chr2	62293222	62293488	CpG: 21	266	21	164	15.8	61.7	0.84
chr2	62317605	62317840	CpG: 19	235	19	140	16.2	59.6	0.93
chr2	62463311	62463741	CpG: 41	430	41	315	19.1	73.3	0.71
chr2	62504758	62505032	CpG: 24	274	24	172	17.5	62.8	0.90
chr2	62511946	62512685	CpG: 78	739	78	513	21.1	69.4	0.88
chr2	62520020	62520254	CpG: 16	234	16	139	13.7	59.4	0.79
chr2	62711752	62712510	CpG: 72	758	72	527	19.0	69.5	0.88
chr2	62842690	62842924	CpG: 20	234	20	142	17.1	60.7	0.93
chr2	63052069	63052351	CpG: 24	282	24	190	17.0	67.4	0.81
chr2	63054417	63059372	CpG: 362	4955	362	3057	14.6	61.7	0.77
chr2	63060976	63061289	CpG: 33	313	33	207	21.1	66.1	0.97
chr2	63062456	63063064	CpG: 55	608	55	405	18.1	66.6	0.82
chr2	63063878	63064089	CpG: 26	211	26	155	24.6	73.5	0.93
chr2	63065891	63067039	CpG: 106	1148	106	816	18.5	71.1	0.73
chr2	63298918	63299154	CpG: 21	236	21	146	17.8	61.9	0.97
chr2	63501815	63502093	CpG: 23	278	23	172	16.5	61.9	0.88
chr2	63559302	63559589	CpG: 24	287	24	178	16.7	62.0	0.88
chr2	63595720	63596630	CpG: 70	910	70	534	15.4	58.7	0.90
chr2	63630368	63630647	CpG: 30	279	30	198	21.5	71.0	0.86
chr2	63695730	63695973	CpG: 18	243	18	144	14.8	59.3	0.87
chr2	63729387	63730297	CpG: 75	910	75	656	16.5	72.1	0.64
chr2	63740739	63741027	CpG: 24	288	24	178	16.7	61.8	0.89
chr2	63816008	63816897	CpG: 66	889	66	610	14.8	68.6	0.63
chr2	63848304	63849318	CpG: 87	1014	87	683	17.2	67.4	0.77
chr2	63885259	63885544	CpG: 25	285	25	180	17.5	63.2	0.90
chr2	64026312	64027396	CpG: 115	1084	115	780	21.2	72.0	0.82
chr2	64049644	64049984	CpG: 27	340	27	219	15.9	64.4	0.77
chr2	64096643	64096881	CpG: 20	238	20	147	16.8	61.8	0.90
chr2	64151395	64152319	CpG: 112	924	112	673	24.2	72.8	0.92
chr2	64463033	64464259	CpG: 150	1226	150	937	24.5	76.4	0.84
chr2	64533445	64534387	CpG: 91	942	91	660	19.3	70.1	0.79
chr2	64557521	64557835	CpG: 25	314	25	190	15.9	60.5	0.88
chr2	64618514	64619073	CpG: 79	559	79	445	28.3	79.6	0.90
chr2	64662622	64664171	CpG: 176	1549	176	1128	22.7	72.8	0.86
chr2	64711297	64711574	CpG: 23	277	23	167	16.6	60.3	0.93
chr2	64738017	64738254	CpG: 21	237	21	145	17.7	61.2	0.97
chr2	64760303	64761252	CpG: 89	949	89	660	18.8	69.5	0.80
chr2	64777312	64777885	CpG: 64	573	64	411	22.3	71.7	0.87
chr2	64868975	64869351	CpG: 42	376	42	297	22.3	79.0	0.73
chr2	64874391	64875135	CpG: 67	744	67	513	18.0	69.0	0.77
chr2	64882238	64882519	CpG: 24	281	24	176	17.1	62.6	0.89
chr2	64909007	64909403	CpG: 28	396	28	242	14.1	61.1	0.76
chr2	64978622	64979013	CpG: 36	391	36	287	18.4	73.4	0.68
chr2	64998085	64999700	CpG: 183	1615	183	1169	22.7	72.4	0.87
chr2	65065518	65066555	CpG: 127	1037	127	732	24.5	70.6	0.99
chr2	65124230	65124513	CpG: 23	283	23	175	16.3	61.8	0.87
chr2	65139264	65140503	CpG: 109	1239	109	855	17.6	69.0	0.74
chr2	65228271	65228508	CpG: 19	237	19	142	16.0	59.9	0.92
chr2	65237094	65237985	CpG: 90	891	90	608	20.2	68.2	0.87
chr2	65289788	65290025	CpG: 16	237	16	139	13.5	58.6	0.80
chr2	65323297	65323847	CpG: 57	550	57	356	20.7	64.7	0.99
chr2	65348084	65348830	CpG: 61	746	61	529	16.4	70.9	0.65
chr2	65440303	65442521	CpG: 223	2218	223	1504	20.1	67.8	0.88
chr2	65442956	65443403	CpG: 32	447	32	243	14.3	54.4	0.97
chr2	65445449	65446414	CpG: 99	965	99	658	20.5	68.2	0.89
chr2	65556410	65556618	CpG: 16	208	16	123	15.4	59.1	0.88
chr2	65582556	65582792	CpG: 20	236	20	143	16.9	60.6	0.95
chr2	65650978	65651209	CpG: 16	231	16	135	13.9	58.4	0.83
chr2	65651813	65652103	CpG: 21	290	21	177	14.5	61.0	0.81
chr2	65670613	65670890	CpG: 24	277	24	172	17.3	62.1	0.91
chr2	65687368	65687642	CpG: 23	274	23	170	16.8	62.0	0.88
chr2	65852059	65852333	CpG: 23	274	23	169	16.8	61.7	0.89
chr2	65959887	65960174	CpG: 25	287	25	179	17.4	62.4	0.91
chr2	66161521	66161795	CpG: 23	274	23	170	16.8	62.0	0.88
chr2	66328444	66328674	CpG: 19	230	19	140	16.5	60.9	0.90
chr2	66386018	66386258	CpG: 17	240	17	144	14.2	60.0	0.80
chr2	66399912	66400271	CpG: 25	359	25	204	13.9	56.8	0.86
chr2	66434323	66435850	CpG: 116	1527	116	976	15.2	63.9	0.75
chr2	66440623	66440896	CpG: 23	273	23	173	16.8	63.4	0.85
chr2	66442400	66442742	CpG: 28	342	28	216	16.4	63.2	0.85
chr2	66443066	66443605	CpG: 56	539	56	372	20.8	69.0	0.88
chr2	66443990	66444286	CpG: 23	296	23	182	15.5	61.5	0.82
chr2	66454375	66455580	CpG: 91	1205	91	759	15.1	63.0	0.77
chr2	66539514	66539752	CpG: 17	238	17	141	14.3	59.2	0.83
chr2	66584822	66586763	CpG: 129	1941	129	1223	13.3	63.0	0.67
chr2	66590497	66591335	CpG: 72	838	72	552	17.2	65.9	0.79
chr2	66614965	66615246	CpG: 24	281	24	173	17.1	61.6	0.91
chr2	67406953	67407425	CpG: 50	472	50	315	21.2	66.7	0.96
chr2	68167602	68168659	CpG: 70	1057	70	626	13.2	59.2	0.76
chr2	68175683	68175913	CpG: 19	230	19	140	16.5	60.9	0.90
chr2	68219636	68219903	CpG: 22	267	22	164	16.5	61.4	0.88
chr2	68262327	68263472	CpG: 159	1145	159	864	27.8	75.5	1.03
chr2	68313479	68313717	CpG: 19	238	19	146	16.0	61.3	0.86
chr2	68329777	68330549	CpG: 75	772	75	531	19.4	68.8	0.82
chr2	68365255	68365477	CpG: 16	222	16	134	14.4	60.4	0.80
chr2	68473673	68473965	CpG: 25	292	25	183	17.1	62.7	0.89
chr2	68479277	68480327	CpG: 98	1050	98	692	18.7	65.9	0.86
chr2	68504576	68504846	CpG: 19	270	19	162	14.1	60.0	0.80
chr2	68655551	68656255	CpG: 87	704	87	531	24.7	75.4	0.87
chr2	68667543	68667775	CpG: 19	232	19	135	16.4	58.2	0.99
chr2	68850925	68851128	CpG: 15	203	15	117	14.8	57.6	0.93
chr2	69025361	69026281	CpG: 84	920	84	604	18.3	65.7	0.85
chr2	69318842	69320008	CpG: 95	1166	95	805	16.3	69.0	0.68
chr2	69399137	69399842	CpG: 92	705	92	537	26.1	76.2	0.93
chr2	69449459	69449984	CpG: 51	525	51	353	19.4	67.2	0.87
chr2	69655164	69656894	CpG: 143	1730	143	1066	16.5	61.6	0.87
chr2	69753926	69754769	CpG: 88	843	88	617	20.9	73.2	0.80
chr2	69841735	69842719	CpG: 106	984	106	676	21.5	68.7	0.92
chr2	69925967	69927547	CpG: 132	1580	132	1087	16.7	68.8	0.71
chr2	69960441	69960806	CpG: 27	365	27	250	14.8	68.5	0.72
chr2	69973103	69973318	CpG: 17	215	17	142	15.8	66.0	0.73
chr2	70045593	70045858	CpG: 19	265	19	164	14.3	61.9	0.76
chr2	70068044	70068318	CpG: 25	274	25	169	18.2	61.7	0.97
chr2	70097792	70100082	CpG: 201	2290	201	1418	17.6	61.9	0.92
chr2	70124398	70124604	CpG: 15	206	15	121	14.6	58.7	0.85
chr2	70135925	70136160	CpG: 19	235	19	152	16.2	64.7	0.82
chr2	70136434	70137141	CpG: 60	707	60	435	17.0	61.5	0.90
chr2	70153749	70154740	CpG: 118	991	118	727	23.8	73.4	0.89
chr2	70161236	70161483	CpG: 18	247	18	144	14.6	58.3	0.88
chr2	70165518	70165752	CpG: 17	234	17	140	14.5	59.8	0.85
chr2	70202356	70202920	CpG: 54	564	54	373	19.1	66.1	0.90
chr2	70212182	70212456	CpG: 24	274	24	172	17.5	62.8	0.90
chr2	70216843	70217219	CpG: 26	376	26	224	13.8	59.6	0.78
chr2	70260037	70260761	CpG: 59	724	59	419	16.3	57.9	0.98
chr2	70269753	70270288	CpG: 61	535	61	392	22.8	73.3	0.89
chr2	70278818	70279404	CpG: 45	586	45	383	15.4	65.4	0.72
chr2	70303757	70303988	CpG: 19	231	19	136	16.5	58.9	1.00
chr2	70305086	70305997	CpG: 79	911	79	537	17.3	58.9	1.00
chr2	70313226	70313955	CpG: 75	729	75	519	20.6	71.2	0.82
chr2	70341803	70342042	CpG: 18	239	18	142	15.1	59.4	0.89
chr2	70563672	70565200	CpG: 143	1528	143	1038	18.7	67.9	0.81
chr2	70566683	70566959	CpG: 24	276	24	171	17.4	62.0	0.92
chr2	70581382	70581657	CpG: 24	275	24	171	17.5	62.2	0.91
chr2	70717210	70717485	CpG: 27	275	27	183	19.6	66.5	0.89
chr2	70756055	70756333	CpG: 20	278	20	167	14.4	60.1	0.81
chr2	70778366	70779465	CpG: 114	1099	114	781	20.7	71.1	0.83
chr2	70800947	70801930	CpG: 91	983	91	667	18.5	67.9	0.81
chr2	70882662	70882933	CpG: 22	271	22	178	16.2	65.7	0.77
chr2	70898661	70900350	CpG: 137	1689	137	1020	16.2	60.4	0.91
chr2	70910657	70913146	CpG: 201	2489	201	1673	16.2	67.2	0.72
chr2	70915137	70916193	CpG: 73	1056	73	649	13.8	61.5	0.73
chr2	70918338	70918732	CpG: 30	394	30	247	15.2	62.7	0.78
chr2	70975966	70976367	CpG: 43	401	43	273	21.4	68.1	0.95
chr2	70989448	70990414	CpG: 87	966	87	697	18.0	72.2	0.69
chr2	71005359	71006185	CpG: 101	826	101	612	24.5	74.1	0.89
chr2	71079059	71079901	CpG: 73	842	73	551	17.3	65.4	0.82
chr2	71141097	71141862	CpG: 74	765	74	488	19.3	63.8	0.95
chr2	71209379	71209643	CpG: 20	264	20	163	15.2	61.7	0.81
chr2	71237511	71238241	CpG: 64	730	64	477	17.5	65.3	0.82
chr2	71287442	71288128	CpG: 88	686	88	494	25.7	72.0	1.00
chr2	71342595	71343400	CpG: 81	805	81	542	20.1	67.3	0.92
chr2	71428113	71428422	CpG: 24	309	24	184	15.5	59.5	0.88
chr2	71442410	71442651	CpG: 19	241	19	147	15.8	61.0	0.88
chr2	71451513	71451794	CpG: 23	281	23	173	16.4	61.6	0.88
chr2	71464354	71465072	CpG: 64	718	64	488	17.8	68.0	0.77
chr2	71476960	71477923	CpG: 93	963	93	691	19.3	71.8	0.75
chr2	71554016	71554839	CpG: 59	823	59	565	14.3	68.7	0.61
chr2	71798465	71798693	CpG: 18	228	18	150	15.8	65.8	0.73
chr2	71864982	71865230	CpG: 23	248	23	167	18.5	67.3	0.84
chr2	72030396	72030670	CpG: 23	274	23	164	16.8	59.9	0.94
chr2	72100750	72101057	CpG: 22	307	22	180	14.3	58.6	0.85
chr2	72156256	72163135	CpG: 544	6879	544	4368	15.8	63.5	0.79
chr2	72434656	72434925	CpG: 21	269	21	190	15.6	70.6	0.63
chr2	72536454	72536727	CpG: 21	273	21	172	15.4	63.0	0.78
chr2	72564520	72564748	CpG: 19	228	19	137	16.7	60.1	0.95
chr2	72753792	72754024	CpG: 17	232	17	138	14.7	59.5	0.84
chr2	72838446	72839036	CpG: 63	590	63	429	21.4	72.7	0.82
chr2	72839937	72840221	CpG: 20	284	20	160	14.1	56.3	0.91
chr2	72851602	72851834	CpG: 19	232	19	138	16.4	59.5	0.93
chr2	72875544	72875814	CpG: 23	270	23	177	17.0	65.6	0.79
chr2	72900031	72900732	CpG: 80	701	80	516	22.8	73.6	0.84
chr2	72928865	72934073	CpG: 457	5208	457	3359	17.5	64.5	0.84
chr2	72937013	72937873	CpG: 76	860	76	590	17.7	68.6	0.75
chr2	73083475	73085000	CpG: 162	1525	162	1066	21.2	69.9	0.87
chr2	73125136	73126577	CpG: 175	1441	175	1058	24.3	73.4	0.90
chr2	73150005	73150320	CpG: 27	315	27	187	17.1	59.4	0.98
chr2	73188494	73190658	CpG: 163	2164	163	1411	15.1	65.2	0.71
chr2	73215144	73217083	CpG: 159	1939	159	1255	16.4	64.7	0.78
chr2	73227174	73227678	CpG: 56	504	56	363	22.2	72.0	0.86
chr2	73244170	73244404	CpG: 18	234	18	142	15.4	60.7	0.85
chr2	73245045	73245281	CpG: 18	236	18	143	15.3	60.6	0.85
chr2	73245946	73247728	CpG: 157	1782	157	1142	17.6	64.1	0.86
chr2	73281783	73282773	CpG: 132	990	132	745	26.7	75.3	0.94
chr2	73297027	73297956	CpG: 89	929	89	676	19.2	72.8	0.73
chr2	73304234	73306856	CpG: 251	2622	251	1783	19.1	68.0	0.83
chr2	73398580	73399589	CpG: 99	1009	99	695	19.6	68.9	0.83
chr2	73498810	73499052	CpG: 21	242	21	146	17.4	60.3	0.95
chr2	73750312	73750671	CpG: 30	359	30	221	16.7	61.6	0.90
chr2	73792816	73793241	CpG: 34	425	34	263	16.0	61.9	0.84
chr2	73837001	73837380	CpG: 36	379	36	250	19.0	66.0	0.88
chr2	73906568	73906846	CpG: 25	278	25	174	18.0	62.6	0.93
chr2	73935193	73935621	CpG: 41	428	41	274	19.2	64.0	0.94
chr2	73992543	73994061	CpG: 210	1518	210	1202	27.7	79.2	0.89
chr2	74010811	74011330	CpG: 62	519	62	401	23.9	77.3	0.80
chr2	74033808	74034024	CpG: 15	216	15	128	13.9	59.3	0.81
chr2	74128599	74129103	CpG: 53	504	53	356	21.0	70.6	0.84
chr2	74138902	74139342	CpG: 34	440	34	275	15.5	62.5	0.79
chr2	74156167	74156586	CpG: 58	419	58	333	27.7	79.5	0.91
chr2	74182148	74182421	CpG: 21	273	21	167	15.4	61.2	0.84
chr2	74184776	74185050	CpG: 23	274	23	169	16.8	61.7	0.89
chr2	74187015	74187827	CpG: 85	812	85	545	20.9	67.1	0.95
chr2	74207092	74208071	CpG: 108	979	108	672	22.1	68.6	0.94
chr2	74312373	74312651	CpG: 23	278	23	173	16.5	62.2	0.86
chr2	74400199	74400737	CpG: 56	538	56	374	20.8	69.5	0.88
chr2	74423162	74424779	CpG: 117	1617	117	1069	14.5	66.1	0.66
chr2	74426897	74427180	CpG: 24	283	24	187	17.0	66.1	0.78
chr2	74429942	74430849	CpG: 82	907	82	595	18.1	65.6	0.85
chr2	74444748	74445132	CpG: 38	384	38	274	19.8	71.4	0.78
chr2	74449026	74450836	CpG: 143	1810	143	1216	15.8	67.2	0.70
chr2	74463402	74463634	CpG: 20	232	20	139	17.2	59.9	0.99
chr2	74465998	74467222	CpG: 96	1224	96	792	15.7	64.7	0.75
chr2	74473400	74474240	CpG: 89	840	89	585	21.2	69.6	0.88
chr2	74480680	74481349	CpG: 60	669	60	423	17.9	63.2	0.90
chr2	74490601	74491547	CpG: 96	946	96	651	20.3	68.8	0.86
chr2	74506477	74508476	CpG: 160	1999	160	1291	16.0	64.6	0.78
chr2	74510837	74512604	CpG: 131	1767	131	1140	14.8	64.5	0.71
chr2	74515760	74516711	CpG: 76	951	76	614	16.0	64.6	0.79
chr2	74521762	74525233	CpG: 299	3471	299	2367	17.2	68.2	0.74
chr2	74537614	74539369	CpG: 156	1755	156	1174	17.8	66.9	0.80
chr2	74557395	74558336	CpG: 96	941	96	658	20.4	69.9	0.84
chr2	74562687	74564124	CpG: 128	1437	128	986	17.8	68.6	0.76
chr2	74656163	74657007	CpG: 73	844	73	545	17.3	64.6	0.83
chr2	74661758	74662031	CpG: 25	273	25	170	18.3	62.3	0.96
chr2	74662805	74663465	CpG: 71	660	71	477	21.5	72.3	0.85
chr2	74723770	74724261	CpG: 50	491	50	329	20.4	67.0	0.91
chr2	74760128	74760390	CpG: 19	262	19	156	14.5	59.5	0.83
chr2	74763177	74763397	CpG: 18	220	18	134	16.4	60.9	0.88
chr2	74782152	74782640	CpG: 32	488	32	281	13.1	57.6	0.80
chr2	74784655	74784926	CpG: 22	271	22	165	16.2	60.9	0.88
chr2	74785737	74785973	CpG: 19	236	19	140	16.1	59.3	0.94
chr2	74842608	74844507	CpG: 193	1899	193	1291	20.3	68.0	0.88
chr2	74917826	74918082	CpG: 18	256	18	145	14.1	56.6	0.88
chr2	74928670	74929307	CpG: 50	637	50	386	15.7	60.6	0.86
chr2	74967296	74967906	CpG: 74	610	74	450	24.3	73.8	0.92
chr2	75124452	75124727	CpG: 19	275	19	169	13.8	61.5	0.74
chr2	75169632	75169906	CpG: 25	274	25	172	18.2	62.8	0.94
chr2	75208640	75210078	CpG: 96	1438	96	900	13.4	62.6	0.68
chr2	75246018	75246293	CpG: 24	275	24	171	17.5	62.2	0.91
chr2	75458767	75459037	CpG: 19	270	19	160	14.1	59.3	0.81
chr2	75569313	75569604	CpG: 23	291	23	183	15.8	62.9	0.81
chr2	75569901	75570495	CpG: 58	594	58	420	19.5	70.7	0.78
chr2	75585602	75585887	CpG: 24	285	24	176	16.8	61.8	0.90
chr2	75606511	75606751	CpG: 19	240	19	145	15.8	60.4	0.91
chr2	75656146	75656585	CpG: 48	439	48	307	21.9	69.9	0.90
chr2	75719751	75720233	CpG: 64	482	64	360	26.6	74.7	0.99
chr2	75720871	75721227	CpG: 30	356	30	258	16.9	72.5	0.65
chr2	75909804	75910045	CpG: 22	241	22	148	18.3	61.4	0.99
chr2	75919063	75919340	CpG: 25	277	25	173	18.1	62.5	0.93
chr2	75950001	75950275	CpG: 24	274	24	171	17.5	62.4	0.91
chr2	76071364	76071600	CpG: 20	236	20	146	16.9	61.9	0.90
chr2	76228996	76229257	CpG: 20	261	20	157	15.3	60.2	0.86
chr2	76311855	76312101	CpG: 18	246	18	143	14.6	58.1	0.89
chr2	76317602	76317842	CpG: 18	240	18	141	15.0	58.8	0.91
chr2	76451935	76452193	CpG: 22	258	22	158	17.1	61.2	0.91
chr2	76652277	76652551	CpG: 23	274	23	169	16.8	61.7	0.89
chr2	76703501	76703738	CpG: 20	237	20	169	16.9	71.3	0.67
chr2	76751345	76751619	CpG: 19	274	19	167	13.9	60.9	0.76
chr2	76786716	76786986	CpG: 20	270	20	159	14.8	58.9	0.86
chr2	76890736	76891013	CpG: 26	277	26	171	18.8	61.7	1.00
chr2	77080888	77081162	CpG: 20	274	20	168	14.6	61.3	0.78
chr2	77113860	77114090	CpG: 19	230	19	142	16.5	61.7	0.88
chr2	77136111	77136385	CpG: 23	274	23	169	16.8	61.7	0.89
chr2	77303409	77303632	CpG: 17	223	17	136	15.2	61.0	0.83
chr2	77312076	77312343	CpG: 22	267	22	167	16.5	62.5	0.86
chr2	77355157	77355442	CpG: 23	285	23	173	16.1	60.7	0.89
chr2	77443551	77443820	CpG: 21	269	21	164	15.6	61.0	0.85
chr2	77597985	77598217	CpG: 18	232	18	136	15.5	58.6	0.90
chr2	77739752	77740199	CpG: 36	447	36	323	16.1	72.3	0.62
chr2	77754687	77754961	CpG: 24	274	24	172	17.5	62.8	0.90
chr2	77758914	77759235	CpG: 23	321	23	191	14.3	59.5	0.82
chr2	77869828	77870082	CpG: 19	254	19	150	15.0	59.1	0.87
chr2	78079742	78079982	CpG: 18	240	18	142	15.0	59.2	0.87
chr2	78603196	78603484	CpG: 24	288	24	177	16.7	61.5	0.90
chr2	78607462	78607749	CpG: 20	287	20	165	13.9	57.5	0.85
chr2	78783782	78784362	CpG: 68	580	68	443	23.4	76.4	0.80
chr2	78835499	78835776	CpG: 23	277	23	170	16.6	61.4	0.89
chr2	78875881	78876123	CpG: 20	242	20	145	16.5	59.9	0.94
chr2	78885825	78886098	CpG: 22	273	22	169	16.1	61.9	0.86
chr2	78902528	78902802	CpG: 24	274	24	173	17.5	63.1	0.89
chr2	78974338	78974616	CpG: 25	278	25	175	18.0	62.9	0.92
chr2	78993327	78993727	CpG: 32	400	32	266	16.0	66.5	0.75
chr2	79111667	79111909	CpG: 21	242	21	145	17.4	59.9	0.97
chr2	79311546	79311780	CpG: 20	234	20	143	17.1	61.1	0.93
chr2	79512936	79513468	CpG: 75	532	75	419	28.2	78.8	0.92
chr2	79665048	79665320	CpG: 20	272	20	159	14.7	58.5	0.88
chr2	79668274	79668555	CpG: 22	281	22	172	15.7	61.2	0.85
chr2	79706439	79706668	CpG: 21	229	21	142	18.3	62.0	0.97
chr2	79841067	79841342	CpG: 25	275	25	171	18.2	62.2	0.95
chr2	79914187	79914461	CpG: 24	274	24	172	17.5	62.8	0.90
chr2	79963052	79963263	CpG: 17	211	17	126	16.1	59.7	0.93
chr2	80024124	80024354	CpG: 20	230	20	141	17.4	61.3	0.94
chr2	80302699	80304930	CpG: 171	2231	171	1365	15.3	61.2	0.82
chr2	80322592	80322812	CpG: 30	220	30	165	27.3	75.0	0.97
chr2	80945718	80945998	CpG: 25	280	25	175	17.9	62.5	0.92
chr2	81194530	81195858	CpG: 93	1328	93	830	14.0	62.5	0.72
chr2	81385346	81385620	CpG: 19	274	19	165	13.9	60.2	0.77
chr2	81409073	81409307	CpG: 20	234	20	141	17.1	60.3	0.96
chr2	81411876	81412099	CpG: 18	223	18	136	16.1	61.0	0.90
chr2	81467751	81468110	CpG: 32	359	32	248	17.8	69.1	0.75
chr2	81476246	81476520	CpG: 23	274	23	170	16.8	62.0	0.88
chr2	81527045	81527311	CpG: 24	266	24	167	18.0	62.8	0.93
chr2	81567123	81567404	CpG: 23	281	23	172	16.4	61.2	0.89
chr2	81610195	81610461	CpG: 23	266	23	166	17.3	62.4	0.90
chr2	81962389	81962651	CpG: 24	262	24	164	18.3	62.6	0.94
chr2	82207585	82207817	CpG: 16	232	16	135	13.8	58.2	0.83
chr2	82326514	82326977	CpG: 39	463	39	338	16.8	73.0	0.63
chr2	82472815	82473084	CpG: 22	269	22	168	16.4	62.5	0.85
chr2	82578581	82578818	CpG: 19	237	19	138	16.0	58.2	0.97
chr2	82727001	82727275	CpG: 20	274	20	165	14.6	60.2	0.82
chr2	82733160	82733433	CpG: 23	273	23	169	16.8	61.9	0.90
chr2	82834374	82834648	CpG: 25	274	25	172	18.2	62.8	0.94
chr2	82938762	82939151	CpG: 38	389	38	288	19.5	74.0	0.71
chr2	83008370	83008594	CpG: 17	224	17	130	15.2	58.0	0.93
chr2	83045014	83045235	CpG: 17	221	17	132	15.4	59.7	0.88
chr2	83056879	83057123	CpG: 17	244	17	143	13.9	58.6	0.82
chr2	83089273	83089516	CpG: 19	243	19	145	15.6	59.7	0.88
chr2	83098009	83098284	CpG: 20	275	20	164	14.5	59.6	0.83
chr2	83124744	83124988	CpG: 19	244	19	141	15.6	57.8	0.95
chr2	83295367	83295581	CpG: 15	214	15	124	14.0	57.9	0.84
chr2	83319656	83319930	CpG: 23	274	23	170	16.8	62.0	0.88
chr2	83369481	83369753	CpG: 21	272	21	165	15.4	60.7	0.85
chr2	83519074	83519768	CpG: 71	694	71	477	20.5	68.7	0.87
chr2	83523615	83523851	CpG: 20	236	20	145	16.9	61.4	0.94
chr2	83769562	83769900	CpG: 28	338	28	208	16.6	61.5	0.88
chr2	83803227	83803457	CpG: 21	230	21	147	18.3	63.9	0.94
chr2	83958928	83959209	CpG: 24	281	24	175	17.1	62.3	0.90
chr2	84291956	84292193	CpG: 27	237	27	159	22.8	67.1	1.01
chr2	84364424	84364701	CpG: 24	277	24	171	17.3	61.7	0.92
chr2	84460578	84461324	CpG: 56	746	56	471	15.0	63.1	0.76
chr2	84503331	84503604	CpG: 25	273	25	170	18.3	62.3	0.95
chr2	84518367	84518589	CpG: 18	222	18	129	16.2	58.1	0.96
chr2	84559084	84559369	CpG: 23	285	23	173	16.1	60.7	0.89
chr2	84722082	84722352	CpG: 22	270	22	168	16.3	62.2	0.85
chr2	84882364	84883064	CpG: 77	700	77	513	22.0	73.3	0.82
chr2	84906651	84906935	CpG: 20	284	20	176	14.1	62.0	0.80
chr2	84907039	84907784	CpG: 88	745	88	537	23.6	72.1	0.92
chr2	84927776	84928037	CpG: 20	261	20	168	15.3	64.4	0.74
chr2	84952628	84952901	CpG: 23	273	23	166	16.8	60.8	0.92
chr2	84972144	84974020	CpG: 265	1876	265	1465	28.3	78.1	0.93
chr2	85018954	85019229	CpG: 22	275	22	168	16.0	61.1	0.87
chr2	85025246	85025521	CpG: 19	275	19	161	13.8	58.5	0.81
chr2	85101777	85102007	CpG: 21	230	21	143	18.3	62.2	0.96
chr2	85103921	85104149	CpG: 19	228	19	139	16.7	61.0	0.91
chr2	85110155	85110439	CpG: 25	284	25	176	17.6	62.0	0.93
chr2	85131121	85131362	CpG: 18	241	18	139	14.9	57.7	0.93
chr2	85134744	85137376	CpG: 255	2632	255	1795	19.4	68.2	0.83
chr2	85152154	85152427	CpG: 20	273	20	163	14.7	59.7	0.84
chr2	85293949	85294227	CpG: 26	278	26	175	18.7	62.9	0.96
chr2	85329002	85330282	CpG: 96	1280	96	792	15.0	61.9	0.78
chr2	85336394	85336717	CpG: 30	323	30	238	18.6	73.7	0.69
chr2	85356486	85356831	CpG: 26	345	26	211	15.1	61.2	0.81
chr2	85415860	85416150	CpG: 29	290	29	219	20.0	75.5	0.70
chr2	85420233	85420773	CpG: 48	540	48	363	17.8	67.2	0.79
chr2	85434476	85434717	CpG: 20	241	20	150	16.6	62.2	0.87
chr2	85439588	85440133	CpG: 58	545	58	402	21.3	73.8	0.79
chr2	85540631	85541919	CpG: 149	1288	149	896	23.1	69.6	0.96
chr2	85563347	85563675	CpG: 37	328	37	231	22.6	70.4	0.91
chr2	85564962	85565318	CpG: 25	356	25	206	14.0	57.9	0.85
chr2	85586277	85586851	CpG: 60	574	60	413	20.9	72.0	0.81
chr2	85597341	85597920	CpG: 44	579	44	347	15.2	59.9	0.85
chr2	85604203	85605174	CpG: 100	971	100	684	20.6	70.4	0.83
chr2	85605673	85605954	CpG: 22	281	22	173	15.7	61.6	0.83
chr2	85612879	85613119	CpG: 20	240	20	148	16.7	61.7	0.90
chr2	85613676	85614222	CpG: 63	546	63	397	23.1	72.7	0.87
chr2	85617619	85619043	CpG: 122	1424	122	849	17.1	59.6	0.97
chr2	85635953	85636193	CpG: 21	240	21	147	17.5	61.2	0.95
chr2	85733929	85734172	CpG: 17	243	17	146	14.0	60.1	0.80
chr2	85755246	85756945	CpG: 191	1699	191	1198	22.5	70.5	0.91
chr2	85774296	85774568	CpG: 24	272	24	190	17.6	69.9	0.73
chr2	85813259	85813614	CpG: 30	355	30	244	16.9	68.7	0.72
chr2	85887626	85887887	CpG: 19	261	19	158	14.6	60.5	0.80
chr2	85890544	85891281	CpG: 104	737	104	567	28.2	76.9	0.96
chr2	86107926	86108597	CpG: 49	671	49	358	14.6	53.4	1.03
chr2	86111187	86111434	CpG: 19	247	19	148	15.4	59.9	0.89
chr2	86197049	86197842	CpG: 88	793	88	538	22.2	67.8	0.97
chr2	86200941	86201446	CpG: 35	505	35	276	13.9	54.7	0.94
chr2	86268361	86268634	CpG: 23	273	23	170	16.8	62.3	0.88
chr2	86339012	86339961	CpG: 129	949	129	716	27.2	75.4	0.96
chr2	86442705	86444337	CpG: 156	1632	156	1066	19.1	65.3	0.90
chr2	86538031	86538308	CpG: 23	277	23	170	16.6	61.4	0.89
chr2	86546895	86547679	CpG: 86	784	86	588	21.9	75.0	0.78
chr2	86551057	86552388	CpG: 104	1331	104	942	15.6	70.8	0.62
chr2	86564865	86565533	CpG: 60	668	60	438	18.0	65.6	0.84
chr2	86624921	86626057	CpG: 149	1136	149	838	26.2	73.8	0.97
chr2	86662885	86663107	CpG: 19	222	19	133	17.1	59.9	0.95
chr2	86718603	86718880	CpG: 22	277	22	168	15.9	60.6	0.88
chr2	86721264	86723313	CpG: 212	2049	212	1385	20.7	67.6	0.91
chr2	86788640	86788914	CpG: 20	274	20	162	14.6	59.1	0.85
chr2	86790758	86792966	CpG: 193	2208	193	1462	17.5	66.2	0.80
chr2	86809442	86809673	CpG: 22	231	22	161	19.0	69.7	0.80
chr2	86811384	86811785	CpG: 34	401	34	277	17.0	69.1	0.74
chr2	86863611	86863958	CpG: 42	347	42	270	24.2	77.8	0.81
chr2	86915535	86916976	CpG: 283	1441	283	1225	39.3	85.0	1.11
chr2	86932588	86932794	CpG: 16	206	16	148	15.5	71.8	0.69
chr2	86947446	86948726	CpG: 166	1280	166	925	25.9	72.3	1.00
chr2	86951868	86952100	CpG: 18	232	18	138	15.5	59.5	0.90
chr2	87080628	87082677	CpG: 212	2049	212	1387	20.7	67.7	0.91
chr2	87085067	87085344	CpG: 23	277	23	168	16.6	60.6	0.92
chr2	87104783	87105020	CpG: 19	237	19	142	16.0	59.9	0.92
chr2	87117819	87118100	CpG: 23	281	23	173	16.4	61.6	0.88
chr2	87177753	87177976	CpG: 20	223	20	141	17.9	63.2	0.91
chr2	87181565	87181837	CpG: 23	272	23	167	16.9	61.4	0.90
chr2	87347348	87348126	CpG: 63	778	63	519	16.2	66.7	0.73
chr2	87354331	87355056	CpG: 118	725	118	548	32.6	75.6	1.20
chr2	87811059	87811337	CpG: 24	278	24	172	17.3	61.9	0.91
chr2	87835336	87835568	CpG: 18	232	18	138	15.5	59.5	0.90
chr2	87836679	87837986	CpG: 149	1307	149	852	22.8	65.2	1.12
chr2	87972835	87973041	CpG: 21	206	21	137	20.4	66.5	0.92
chr2	88028259	88028885	CpG: 48	626	48	404	15.3	64.5	0.76
chr2	88066612	88067346	CpG: 81	734	81	514	22.1	70.0	0.90
chr2	88087497	88087772	CpG: 22	275	22	163	16.0	59.3	0.91
chr2	88181035	88182115	CpG: 113	1080	113	713	20.9	66.0	0.96
chr2	88296007	88296449	CpG: 39	442	39	294	17.6	66.5	0.80
chr2	88313343	88313622	CpG: 25	279	25	175	17.9	62.7	0.92
chr2	88318585	88318818	CpG: 20	233	20	141	17.2	60.5	0.95
chr2	88362727	88363166	CpG: 36	439	36	279	16.4	63.6	0.81
chr2	88463816	88465347	CpG: 183	1531	183	1049	23.9	68.5	1.02
chr2	88506064	88506328	CpG: 20	264	20	161	15.2	61.0	0.84
chr2	88515026	88515503	CpG: 53	477	53	358	22.2	75.1	0.79
chr2	88546314	88546581	CpG: 24	267	24	167	18.0	62.5	0.93
chr2	88561923	88562180	CpG: 22	257	22	171	17.1	66.5	0.83
chr2	88638726	88639781	CpG: 115	1055	115	730	21.8	69.2	0.93
chr2	88703448	88704066	CpG: 65	618	65	426	21.0	68.9	0.90
chr2	88773999	88775019	CpG: 102	1020	102	729	20.0	71.5	0.79
chr2	88781234	88781474	CpG: 20	240	20	146	16.7	60.8	0.92
chr2	88929067	88929815	CpG: 53	748	53	509	14.2	68.0	0.61
chr2	89421555	89422076	CpG: 58	521	58	354	22.3	67.9	1.07
chr2	89438281	89438484	CpG: 16	203	16	134	15.8	66.0	0.73
chr2	89529998	89530330	CpG: 28	332	28	217	16.9	65.4	0.80
chr2	89566903	89568017	CpG: 104	1114	104	771	18.7	69.2	0.78
chr2	89593214	89593554	CpG: 37	340	37	235	21.8	69.1	0.91
chr2	89663583	89664741	CpG: 110	1158	110	843	19.0	72.8	0.73
chr2	89681850	89682440	CpG: 88	590	88	441	29.8	74.7	1.10
chr2	89782172	89785331	CpG: 417	3159	417	2205	26.4	69.8	1.20
chr2	89818824	89820398	CpG: 176	1574	176	1055	22.4	67.0	1.03
chr2	89881011	89882585	CpG: 176	1574	176	1055	22.4	67.0	1.03
chr2	89916077	89919194	CpG: 416	3117	416	2176	26.7	69.8	1.21
chr2	90058942	90059532	CpG: 88	590	88	441	29.8	74.7	1.10
chr2	90076639	90077797	CpG: 109	1158	109	842	18.8	72.7	0.73
chr2	90147804	90148144	CpG: 36	340	36	233	21.2	68.5	0.90
chr2	90173328	90174442	CpG: 104	1114	104	771	18.7	69.2	0.78
chr2	90211033	90211365	CpG: 28	332	28	217	16.9	65.4	0.80
chr2	90302955	90303158	CpG: 16	203	16	135	15.8	66.5	0.72
chr2	90319378	90319873	CpG: 55	495	55	335	22.2	67.7	1.07
chr2	90520592	90520867	CpG: 25	275	25	172	18.2	62.5	0.94
chr2	90793627	90794410	CpG: 65	783	65	526	16.6	67.2	0.74
chr2	90800615	90801252	CpG: 87	637	87	471	27.3	73.9	1.04
chr2	90933833	90937111	CpG: 472	3278	472	2340	28.8	71.4	1.25
chr2	90970531	90971661	CpG: 127	1130	127	759	22.5	67.2	1.02
chr2	91628934	91630506	CpG: 172	1572	172	1044	21.9	66.4	1.03
chr2	91663833	91666090	CpG: 292	2257	292	1564	25.9	69.3	1.19
chr2	91737662	91737927	CpG: 23	265	23	164	17.4	61.9	0.92
chr2	91752145	91752728	CpG: 89	583	89	438	30.5	75.1	1.11
chr2	91758920	91759706	CpG: 66	786	66	527	16.8	67.0	0.75
chr2	91778523	91779691	CpG: 109	1168	109	843	18.7	72.2	0.73
chr2	91849675	91849969	CpG: 34	294	34	208	23.1	70.7	0.93
chr2	91874293	91874518	CpG: 17	225	17	137	15.1	60.9	0.82
chr2	91874748	91876226	CpG: 127	1478	127	998	17.2	67.5	0.75
chr2	91912750	91913082	CpG: 28	332	28	217	16.9	65.4	0.80
chr2	91934619	91934910	CpG: 19	291	19	169	13.1	58.1	0.77
chr2	91938590	91939003	CpG: 58	413	58	335	28.1	81.1	0.87
chr2	91998711	92000128	CpG: 206	1417	206	998	29.1	70.4	1.30
chr2	92029519	92029743	CpG: 18	224	18	133	16.1	59.4	0.92
chr2	92067111	92067954	CpG: 90	843	90	600	21.4	71.2	0.88
chr2	92198450	92198696	CpG: 20	246	20	172	16.3	69.9	0.70
chr2	92202031	92202624	CpG: 65	593	65	398	21.9	67.1	1.06
chr2	92232018	92233456	CpG: 209	1438	209	1012	29.1	70.4	1.29
chr2	92262248	92263500	CpG: 99	1252	99	767	15.8	61.3	0.90
chr2	94714260	94714929	CpG: 117	669	117	521	35.0	77.9	1.24
chr2	94749212	94749479	CpG: 20	267	20	160	15.0	59.9	0.84
chr2	94752687	94752953	CpG: 20	266	20	164	15.0	61.7	0.79
chr2	94778761	94779378	CpG: 82	617	82	432	26.6	70.0	1.21
chr2	94812612	94813946	CpG: 154	1334	154	908	23.1	68.1	1.02
chr2	94882227	94883561	CpG: 154	1334	154	908	23.1	68.1	1.02
chr2	94916834	94917666	CpG: 116	832	116	590	27.9	70.9	1.22
chr2	94943488	94943754	CpG: 20	266	20	164	15.0	61.7	0.79
chr2	94946959	94947226	CpG: 20	267	20	160	15.0	59.9	0.84
chr2	94981503	94982182	CpG: 116	679	116	526	34.2	77.5	1.23
chr2	95128667	95129232	CpG: 47	565	47	408	16.6	72.2	0.64
chr2	95179104	95179371	CpG: 21	267	21	159	15.7	59.6	0.92
chr2	95242158	95242414	CpG: 33	256	33	189	25.8	73.8	0.96
chr2	95363376	95365046	CpG: 126	1670	126	1126	15.1	67.4	0.66
chr2	95367862	95368468	CpG: 53	606	53	435	17.5	71.8	0.68
chr2	95377978	95378592	CpG: 55	614	55	416	17.9	67.8	0.78
chr2	95380964	95381498	CpG: 45	534	45	387	16.9	72.5	0.66
chr2	95401055	95401330	CpG: 24	275	24	172	17.5	62.5	0.90
chr2	95504714	95505012	CpG: 31	298	31	216	20.8	72.5	0.80
chr2	95531613	95533187	CpG: 134	1574	134	1017	17.0	64.6	0.82
chr2	95583350	95583674	CpG: 30	324	30	220	18.5	67.9	0.81
chr2	95596399	95596635	CpG: 20	236	20	145	16.9	61.4	0.92
chr2	95627847	95628709	CpG: 93	862	93	600	21.6	69.6	0.89
chr2	95665562	95666458	CpG: 104	896	104	678	23.2	75.7	0.82
chr2	95671894	95672570	CpG: 57	676	57	416	16.9	61.5	0.90
chr2	95690169	95690396	CpG: 17	227	17	133	15.0	58.6	0.90
chr2	95713618	95714275	CpG: 68	657	68	463	20.7	70.5	0.84
chr2	95739865	95740135	CpG: 20	270	20	164	14.8	60.7	0.82
chr2	95749448	95750260	CpG: 61	812	61	549	15.0	67.6	0.66
chr2	95830700	95830985	CpG: 21	285	21	174	14.7	61.1	0.80
chr2	95851864	95853929	CpG: 238	2065	238	1512	23.1	73.2	0.86
chr2	95895628	95895877	CpG: 19	249	19	165	15.3	66.3	0.70
chr2	95908951	95909574	CpG: 59	623	59	424	18.9	68.1	0.82
chr2	95933745	95933981	CpG: 22	236	22	171	18.6	72.5	0.72
chr2	95941854	95942124	CpG: 23	270	23	189	17.0	70.0	0.71
chr2	96031705	96032111	CpG: 39	406	39	290	19.2	71.4	0.76
chr2	96032789	96033806	CpG: 92	1017	92	716	18.1	70.4	0.73
chr2	96147715	96147985	CpG: 23	270	23	189	17.0	70.0	0.71
chr2	96155866	96156101	CpG: 22	235	22	170	18.7	72.3	0.72
chr2	96189276	96189657	CpG: 34	381	34	244	17.8	64.0	0.90
chr2	96200617	96200898	CpG: 26	281	26	176	18.5	62.6	0.95
chr2	96296044	96296716	CpG: 53	672	53	454	15.8	67.6	0.71
chr2	96320214	96320873	CpG: 63	659	63	451	19.1	68.4	0.82
chr2	96338451	96339461	CpG: 101	1010	101	729	20.0	72.2	0.77
chr2	96541109	96541781	CpG: 53	672	53	454	15.8	67.6	0.71
chr2	96622283	96623848	CpG: 191	1565	191	1161	24.4	74.2	0.89
chr2	96651308	96652319	CpG: 120	1011	120	744	23.7	73.6	0.88
chr2	96713125	96713404	CpG: 25	279	25	176	17.9	63.1	0.91
chr2	96714721	96715694	CpG: 116	973	116	701	23.8	72.0	0.92
chr2	96771729	96773161	CpG: 148	1432	148	1032	20.7	72.1	0.80
chr2	96782335	96782609	CpG: 20	274	20	166	14.6	60.6	0.81
chr2	96811995	96812426	CpG: 45	431	45	289	20.9	67.1	0.94
chr2	96827807	96828758	CpG: 88	951	88	612	18.5	64.4	0.89
chr2	96831727	96832153	CpG: 43	426	43	307	20.2	72.1	0.78
chr2	96842300	96842769	CpG: 60	469	60	346	25.6	73.8	0.96
chr2	96865138	96865370	CpG: 17	232	17	138	14.7	59.5	0.84
chr2	96895803	96896031	CpG: 19	228	19	137	16.7	60.1	0.97
chr2	96976268	96976509	CpG: 19	241	19	144	15.8	59.8	0.90
chr2	97007089	97007541	CpG: 59	452	59	333	26.1	73.7	0.96
chr2	97014560	97015367	CpG: 57	807	57	547	14.1	67.8	0.62
chr2	97033859	97034520	CpG: 53	661	53	449	16.0	67.9	0.70
chr2	97043195	97044669	CpG: 155	1474	155	1041	21.0	70.6	0.85
chr2	97056670	97057107	CpG: 48	437	48	325	22.0	74.4	0.80
chr2	97144485	97145284	CpG: 91	799	91	559	22.8	70.0	0.95
chr2	97246349	97246781	CpG: 35	432	35	280	16.2	64.8	0.85
chr2	97267236	97268109	CpG: 97	873	97	630	22.2	72.2	0.87
chr2	97321166	97321516	CpG: 27	350	27	207	15.4	59.1	0.89
chr2	97322249	97324169	CpG: 243	1920	243	1404	25.3	73.1	0.95
chr2	97346114	97346495	CpG: 36	381	36	271	18.9	71.1	0.75
chr2	97364250	97365489	CpG: 128	1239	128	844	20.7	68.1	0.90
chr2	97368383	97368598	CpG: 19	215	19	148	17.7	68.8	0.77
chr2	97371451	97371694	CpG: 19	243	19	164	15.6	67.5	0.70
chr2	97374993	97377171	CpG: 246	2178	246	1634	22.6	75.0	0.80
chr2	97387287	97387523	CpG: 19	236	19	147	16.1	62.3	0.84
chr2	97492647	97493568	CpG: 71	921	71	600	15.4	65.1	0.73
chr2	97505678	97505978	CpG: 23	300	23	181	15.3	60.3	0.85
chr2	97601045	97601704	CpG: 62	659	62	450	18.8	68.3	0.81
chr2	97619331	97620402	CpG: 105	1071	105	764	19.6	71.3	0.77
chr2	97670236	97670478	CpG: 19	242	19	147	15.7	60.7	0.87
chr2	98047873	98048977	CpG: 113	1104	113	789	20.5	71.5	0.80
chr2	98104120	98105026	CpG: 69	906	69	571	15.2	63.0	0.77
chr2	98121698	98123092	CpG: 140	1394	140	896	20.1	64.3	0.97
chr2	98159001	98159247	CpG: 21	246	21	151	17.1	61.4	0.95
chr2	98168550	98168818	CpG: 23	268	23	165	17.2	61.6	0.93
chr2	98182150	98182712	CpG: 64	562	64	390	22.8	69.4	0.95
chr2	98192737	98193010	CpG: 22	273	22	174	16.1	63.7	0.79
chr2	98193412	98193770	CpG: 29	358	29	245	16.2	68.4	0.71
chr2	98199546	98199792	CpG: 18	246	18	168	14.6	68.3	0.67
chr2	98207248	98207522	CpG: 21	274	21	168	15.3	61.3	0.82
chr2	98343476	98343707	CpG: 17	231	17	137	14.7	59.3	0.86
chr2	98453483	98454694	CpG: 158	1211	158	893	26.1	73.7	0.96
chr2	98545107	98545642	CpG: 61	535	61	377	22.8	70.5	0.92
chr2	98593580	98593846	CpG: 24	266	24	167	18.0	62.8	0.93
chr2	98597226	98597609	CpG: 31	383	31	279	16.2	72.8	0.61
chr2	98598198	98598410	CpG: 15	212	15	119	14.2	56.1	0.93
chr2	98804614	98805928	CpG: 114	1314	114	874	17.4	66.5	0.79
chr2	98903010	98903684	CpG: 96	674	96	528	28.5	78.3	0.95
chr2	99066417	99067527	CpG: 113	1110	113	735	20.4	66.2	0.93
chr2	99141246	99141488	CpG: 18	242	18	144	14.9	59.5	0.87
chr2	99188855	99190150	CpG: 191	1295	191	1042	29.5	80.5	0.95
chr2	99200759	99200994	CpG: 17	235	17	140	14.5	59.6	0.83
chr2	99280273	99281860	CpG: 194	1587	194	1195	24.4	75.3	0.86
chr2	99295183	99295520	CpG: 29	337	29	201	17.2	59.6	0.97
chr2	99394253	99396006	CpG: 197	1753	197	1236	22.5	70.5	0.90
chr2	99447283	99448106	CpG: 63	823	63	580	15.3	70.5	0.62
chr2	99476015	99476251	CpG: 21	236	21	145	17.8	61.4	0.96
chr2	99595380	99595648	CpG: 24	268	24	167	17.9	62.3	0.93
chr2	99599762	99600627	CpG: 92	865	92	608	21.3	70.3	0.92
chr2	99613517	99614045	CpG: 56	528	56	355	21.2	67.2	0.94
chr2	99639763	99640038	CpG: 20	275	20	161	14.5	58.5	0.85
chr2	99641142	99641428	CpG: 24	286	24	176	16.8	61.5	0.89
chr2	99741334	99741562	CpG: 16	228	16	136	14.0	59.6	0.82
chr2	99775444	99775676	CpG: 20	232	20	142	17.2	61.2	0.94
chr2	99793368	99793645	CpG: 24	277	24	173	17.3	62.5	0.91
chr2	99794657	99796570	CpG: 148	1913	148	1136	15.5	59.4	0.88
chr2	99902517	99902720	CpG: 16	203	16	119	15.8	58.6	0.92
chr2	99947738	99949352	CpG: 217	1614	217	1172	26.9	72.6	1.02
chr2	100012905	100013118	CpG: 17	213	17	136	16.0	63.8	0.82
chr2	100052352	100052696	CpG: 47	344	47	259	27.3	75.3	0.97
chr2	100148897	100149120	CpG: 18	223	18	135	16.1	60.5	0.90
chr2	100279539	100279813	CpG: 22	274	22	168	16.1	61.3	0.87
chr2	100425462	100425736	CpG: 24	274	24	170	17.5	62.0	0.92
chr2	100482978	100483214	CpG: 19	236	19	147	16.1	62.3	0.85
chr2	100562803	100564337	CpG: 213	1534	213	1186	27.8	77.3	0.94
chr2	100580723	100581004	CpG: 23	281	23	174	16.4	61.9	0.87
chr2	100624007	100624292	CpG: 24	285	24	177	16.8	62.1	0.89
chr2	100765857	100766085	CpG: 19	228	19	140	16.7	61.4	0.91
chr2	100780193	100781577	CpG: 187	1384	187	1056	27.0	76.3	0.93
chr2	100786265	100786537	CpG: 19	272	19	161	14.0	59.2	0.80
chr2	100875980	100876670	CpG: 97	690	97	503	28.1	72.9	1.06
chr2	101021603	101022366	CpG: 66	763	66	514	17.3	67.4	0.76
chr2	101120438	101120699	CpG: 22	261	22	161	16.9	61.7	0.90
chr2	101277211	101279685	CpG: 248	2474	248	1744	20.0	70.5	0.81
chr2	101416345	101416613	CpG: 23	268	23	166	17.2	61.9	0.91
chr2	101460482	101460893	CpG: 39	411	39	260	19.0	63.3	0.96
chr2	101609279	101610496	CpG: 153	1217	153	912	25.1	74.9	0.92
chr2	101675482	101675756	CpG: 24	274	24	168	17.5	61.3	0.94
chr2	101711134	101712243	CpG: 123	1109	123	755	22.2	68.1	0.96
chr2	101734098	101734440	CpG: 27	342	27	196	15.8	57.3	0.97
chr2	101766599	101767592	CpG: 125	993	125	709	25.2	71.4	0.99
chr2	101802370	101802642	CpG: 22	272	22	167	16.2	61.4	0.87
chr2	101817454	101817728	CpG: 24	274	24	171	17.5	62.4	0.91
chr2	101845519	101846497	CpG: 115	978	115	715	23.5	73.1	0.88
chr2	101866908	101867180	CpG: 21	272	21	169	15.4	62.1	0.81
chr2	101932595	101933355	CpG: 92	760	92	554	24.2	72.9	0.91
chr2	101940115	101940420	CpG: 27	305	27	188	17.7	61.6	0.94
chr2	102106381	102106655	CpG: 24	274	24	169	17.5	61.7	0.93
chr2	102155697	102156978	CpG: 180	1281	180	947	28.1	73.9	1.03
chr2	102217121	102217357	CpG: 19	236	19	142	16.1	60.2	0.92
chr2	102600636	102601407	CpG: 92	771	92	563	23.9	73.0	0.90
chr2	102645498	102646382	CpG: 71	884	71	606	16.1	68.6	0.68
chr2	102708903	102709637	CpG: 68	734	68	500	18.5	68.1	0.87
chr2	102814522	102815000	CpG: 54	478	54	352	22.6	73.6	0.84
chr2	102849519	102849795	CpG: 22	276	22	165	15.9	59.8	0.91
chr2	103005330	103005596	CpG: 20	266	20	162	15.0	60.9	0.83
chr2	103030910	103031202	CpG: 24	292	24	178	16.4	61.0	0.89
chr2	103077885	103079063	CpG: 126	1178	126	847	21.4	71.9	0.83
chr2	103195359	103195635	CpG: 34	276	34	205	24.6	74.3	0.89
chr2	103416442	103416666	CpG: 19	224	19	134	17.0	59.8	0.96
chr2	103431201	103431443	CpG: 19	242	19	144	15.7	59.5	0.91
chr2	103525341	103525568	CpG: 17	227	17	131	15.0	57.7	0.91
chr2	103576072	103576346	CpG: 22	274	22	168	16.1	61.3	0.87
chr2	103892285	103892558	CpG: 21	273	21	166	15.4	60.8	0.84
chr2	103923565	103923839	CpG: 24	274	24	171	17.5	62.4	0.91
chr2	103955188	103955466	CpG: 23	278	23	173	16.5	62.2	0.87
chr2	103991486	103991718	CpG: 18	232	18	134	15.5	57.8	0.95
chr2	104032144	104032418	CpG: 21	274	21	164	15.3	59.9	0.86
chr2	104329671	104329896	CpG: 16	225	16	134	14.2	59.6	0.82
chr2	104602578	104602856	CpG: 24	278	24	173	17.3	62.2	0.90
chr2	104647003	104647285	CpG: 24	282	24	176	17.0	62.4	0.89
chr2	104682526	104682804	CpG: 23	278	23	173	16.5	62.2	0.86
chr2	104759213	104759457	CpG: 18	244	18	138	14.8	56.6	0.96
chr2	105118958	105119310	CpG: 44	352	44	243	25.0	69.0	1.05
chr2	105303849	105306557	CpG: 237	2708	237	1782	17.5	65.8	0.81
chr2	105313574	105318421	CpG: 484	4847	484	3247	20.0	67.0	0.89
chr2	105323323	105323911	CpG: 53	588	53	388	18.0	66.0	0.87
chr2	105324923	105325486	CpG: 51	563	51	382	18.1	67.9	0.79
chr2	105328479	105329152	CpG: 51	673	51	455	15.2	67.6	0.66
chr2	105333094	105334717	CpG: 127	1623	127	995	15.7	61.3	0.84
chr2	105436435	105436679	CpG: 19	244	19	149	15.6	61.1	0.85
chr2	105499051	105499573	CpG: 46	522	46	333	17.6	63.8	0.87
chr2	105604777	105605692	CpG: 105	915	105	685	23.0	74.9	0.83
chr2	105623305	105623549	CpG: 18	244	18	144	14.8	59.0	0.87
chr2	105697791	105698000	CpG: 16	209	16	131	15.3	62.7	0.78
chr2	105698153	105698457	CpG: 29	304	29	196	19.1	64.5	0.93
chr2	105699360	105699635	CpG: 23	275	23	172	16.7	62.5	0.86
chr2	105703247	105703744	CpG: 47	497	47	332	18.9	66.8	0.85
chr2	105711894	105712748	CpG: 65	854	65	586	15.2	68.6	0.65
chr2	105730526	105730759	CpG: 18	233	18	157	15.5	67.4	0.69
chr2	105790650	105791502	CpG: 110	852	110	655	25.8	76.9	0.89
chr2	105798476	105798982	CpG: 45	506	45	323	17.8	63.8	0.87
chr2	105859589	105860595	CpG: 96	1006	96	729	19.1	72.5	0.73
chr2	105923796	105924070	CpG: 25	274	25	172	18.2	62.8	0.93
chr2	106205789	106206993	CpG: 180	1204	180	954	29.9	79.2	0.96
chr2	106342642	106343432	CpG: 78	790	78	522	19.7	66.1	0.91
chr2	106354373	106354841	CpG: 38	468	38	302	16.2	64.5	0.79
chr2	106430518	106430792	CpG: 24	274	24	172	17.5	62.8	0.90
chr2	106526961	106527627	CpG: 68	666	68	493	20.4	74.0	0.75
chr2	106591848	106592124	CpG: 23	276	23	164	16.7	59.4	0.95
chr2	106654440	106655673	CpG: 143	1233	143	893	23.2	72.4	0.89
chr2	106719315	106719593	CpG: 20	278	20	161	14.4	57.9	0.86
chr2	106726795	106727065	CpG: 23	270	23	172	17.0	63.7	0.86
chr2	106730595	106731215	CpG: 43	620	43	388	13.9	62.6	0.71
chr2	106759040	106759318	CpG: 23	278	23	172	16.5	61.9	0.87
chr2	106762997	106763271	CpG: 25	274	25	170	18.2	62.0	0.96
chr2	106803442	106803853	CpG: 33	411	33	273	16.1	66.4	0.74
chr2	106924831	106925092	CpG: 18	261	18	155	13.8	59.4	0.80
chr2	106926637	106929970	CpG: 437	3333	437	2466	26.2	74.0	0.96
chr2	106948695	106949041	CpG: 42	346	42	272	24.3	78.6	0.80
chr2	106979204	106979468	CpG: 24	264	24	166	18.2	62.9	0.93
chr2	107012342	107012587	CpG: 19	245	19	147	15.5	60.0	0.88
chr2	107045734	107046179	CpG: 43	445	43	326	19.3	73.3	0.72
chr2	107104600	107104877	CpG: 19	277	19	166	13.7	59.9	0.77
chr2	107304505	107304864	CpG: 39	359	39	250	21.7	69.6	0.90
chr2	107347337	107349200	CpG: 196	1863	196	1310	21.0	70.3	0.86
chr2	107349731	107350012	CpG: 23	281	23	174	16.4	61.9	0.87
chr2	107769776	107770013	CpG: 21	237	21	146	17.7	61.6	0.95
chr2	107856741	107856971	CpG: 18	230	18	138	15.7	60.0	0.87
chr2	107930923	107931249	CpG: 31	326	31	233	19.0	71.5	0.74
chr2	108005783	108005994	CpG: 15	211	15	121	14.2	57.3	1.05
chr2	108208827	108209216	CpG: 41	389	41	296	21.1	76.1	0.73
chr2	108288280	108291632	CpG: 451	3352	451	2494	26.9	74.4	0.97
chr2	108447945	108448588	CpG: 68	643	68	446	21.2	69.4	0.89
chr2	108462974	108463248	CpG: 24	274	24	171	17.5	62.4	0.91
chr2	108662719	108662997	CpG: 23	278	23	173	16.5	62.2	0.86
chr2	108762217	108762439	CpG: 19	222	19	133	17.1	59.9	0.98
chr2	108909646	108910217	CpG: 57	571	57	382	20.0	66.9	0.89
chr2	108994494	108995465	CpG: 130	971	130	761	26.8	78.4	0.88
chr2	109102976	109103254	CpG: 27	278	27	178	19.4	64.0	0.96
chr2	109154454	109154707	CpG: 20	253	20	157	15.8	62.1	0.83
chr2	109155861	109156109	CpG: 19	248	19	150	15.3	60.5	0.87
chr2	109173826	109174111	CpG: 23	285	23	178	16.1	62.5	0.85
chr2	109179914	109180816	CpG: 105	902	105	616	23.3	68.3	1.00
chr2	109247057	109247716	CpG: 73	659	73	464	22.2	70.4	0.91
chr2	109254232	109254500	CpG: 19	268	19	156	14.2	58.2	0.85
chr2	109403082	109403303	CpG: 21	221	21	139	19.0	62.9	0.97
chr2	109437871	109438095	CpG: 18	224	18	134	16.1	59.8	0.91
chr2	109450735	109451016	CpG: 22	281	22	173	15.7	61.6	0.84
chr2	109476658	109476937	CpG: 19	279	19	164	13.6	58.8	0.80
chr2	109481799	109482035	CpG: 17	236	17	145	14.4	61.4	0.79
chr2	109492065	109492340	CpG: 37	275	37	206	26.9	74.9	0.96
chr2	109578099	109578300	CpG: 18	201	18	123	17.9	61.2	0.96
chr2	109588647	109590876	CpG: 261	2229	261	1603	23.4	71.9	0.91
chr2	109623923	109624202	CpG: 24	279	24	174	17.2	62.4	0.89
chr2	109982017	109982234	CpG: 18	217	18	130	16.6	59.9	0.95
chr2	110074393	110076788	CpG: 278	2395	278	1741	23.2	72.7	0.89
chr2	110221431	110222421	CpG: 121	990	121	739	24.4	74.6	0.88
chr2	110255309	110256647	CpG: 217	1338	217	1061	32.4	79.3	1.05
chr2	110409054	110410726	CpG: 139	1672	139	1102	16.6	65.9	0.78
chr2	110486237	110486829	CpG: 44	592	44	395	14.9	66.7	0.67
chr2	110494200	110494542	CpG: 29	342	29	233	17.0	68.1	0.74
chr2	110507293	110507530	CpG: 17	237	17	144	14.3	60.8	0.80
chr2	110547409	110548317	CpG: 96	908	96	652	21.1	71.8	0.82
chr2	110581093	110581463	CpG: 39	370	39	246	21.1	66.5	0.96
chr2	110588542	110588918	CpG: 34	376	34	255	18.1	67.8	0.79
chr2	110677727	110678369	CpG: 60	642	60	449	18.7	69.9	0.76
chr2	110708561	110708798	CpG: 17	237	17	144	14.3	60.8	0.80
chr2	110721558	110721900	CpG: 29	342	29	233	17.0	68.1	0.74
chr2	110729262	110730023	CpG: 53	761	53	504	13.9	66.2	0.64
chr2	110805505	110807177	CpG: 139	1672	139	1102	16.6	65.9	0.78
chr2	110845593	110846501	CpG: 96	908	96	652	21.1	71.8	0.82
chr2	110997045	110997315	CpG: 19	270	19	159	14.1	58.9	0.83
chr2	110998854	111000174	CpG: 212	1320	212	1049	32.1	79.5	1.03
chr2	111033043	111034062	CpG: 129	1019	129	769	25.3	75.5	0.89
chr2	111100654	111101220	CpG: 51	566	51	387	18.0	68.4	0.77
chr2	111101443	111101765	CpG: 23	322	23	186	14.3	57.8	0.89
chr2	111155317	111156224	CpG: 94	907	94	658	20.7	72.5	0.80
chr2	111254933	111255206	CpG: 21	273	21	168	15.4	61.5	0.83
chr2	111347539	111347770	CpG: 20	231	20	141	17.3	61.0	0.94
chr2	111540693	111546455	CpG: 561	5762	561	3780	19.5	65.6	0.91
chr2	111647606	111648028	CpG: 28	422	28	215	13.3	50.9	1.17
chr2	111910453	111910684	CpG: 19	231	19	140	16.5	60.6	0.91
chr2	112067722	112067999	CpG: 24	277	24	172	17.3	62.1	0.91
chr2	112098041	112098848	CpG: 56	807	56	537	13.9	66.5	0.63
chr2	112107674	112108065	CpG: 40	391	40	293	20.5	74.9	0.73
chr2	112115747	112115986	CpG: 18	239	18	141	15.1	59.0	0.89
chr2	112215176	112215448	CpG: 23	272	23	167	16.9	61.4	0.90
chr2	112219045	112219268	CpG: 19	223	19	139	17.0	62.3	0.90
chr2	112272051	112272328	CpG: 19	277	19	165	13.7	59.6	0.78
chr2	112310169	112310738	CpG: 64	569	64	393	22.5	69.1	0.94
chr2	112324319	112326084	CpG: 160	1765	160	1214	18.1	68.8	0.77
chr2	112450081	112450315	CpG: 20	234	20	141	17.1	60.3	0.97
chr2	112481188	112483009	CpG: 178	1821	178	1338	19.5	73.5	0.81
chr2	112565150	112567091	CpG: 156	1941	156	1401	16.1	72.2	0.74
chr2	112586360	112587112	CpG: 55	752	55	458	14.6	60.9	0.80
chr2	112587459	112587663	CpG: 34	204	34	135	33.3	66.2	1.85
chr2	112608379	112608836	CpG: 48	457	48	328	21.0	71.8	0.82
chr2	112614110	112614321	CpG: 16	211	16	137	15.2	64.9	0.72
chr2	112681406	112682082	CpG: 67	676	67	453	19.8	67.0	0.90
chr2	112702092	112703256	CpG: 135	1164	135	812	23.2	69.8	0.95
chr2	112859322	112860303	CpG: 120	981	120	704	24.5	71.8	0.96
chr2	112907620	112907951	CpG: 24	331	24	212	14.5	64.0	0.71
chr2	112908311	112909646	CpG: 167	1335	167	928	25.0	69.5	1.04
chr2	112936160	112936467	CpG: 23	307	23	180	15.0	58.6	0.88
chr2	112968476	112969357	CpG: 78	881	78	568	17.7	64.5	0.85
chr2	113010700	113011504	CpG: 60	804	60	482	14.9	60.0	0.83
chr2	113072029	113073107	CpG: 142	1078	142	798	26.3	74.0	0.97
chr2	113190992	113191648	CpG: 66	656	66	444	20.1	67.7	0.88
chr2	113250120	113250401	CpG: 24	281	24	176	17.1	62.6	0.89
chr2	113278315	113278530	CpG: 18	215	18	113	16.7	52.6	1.21
chr2	113477459	113477721	CpG: 23	262	23	182	17.6	69.5	0.73
chr2	113526331	113526605	CpG: 22	274	22	171	16.1	62.4	0.83
chr2	113583685	113584400	CpG: 92	715	92	545	25.7	76.2	0.89
chr2	113625342	113626041	CpG: 83	699	83	518	23.7	74.1	0.87
chr2	113662191	113663062	CpG: 89	871	89	658	20.4	75.5	0.72
chr2	113702335	113702593	CpG: 29	258	29	157	22.5	60.9	1.22
chr2	113703569	113705016	CpG: 129	1447	129	972	17.8	67.2	0.79
chr2	113717791	113718041	CpG: 26	250	26	181	20.8	72.4	0.79
chr2	113751435	113751718	CpG: 27	283	27	199	19.1	70.3	0.85
chr2	113752760	113753026	CpG: 21	266	21	164	15.8	61.7	0.84
chr2	113775374	113775648	CpG: 24	274	24	170	17.5	62.0	0.92
chr2	113862116	113862514	CpG: 39	398	39	262	19.6	65.8	0.94
chr2	113864434	113864708	CpG: 24	274	24	171	17.5	62.4	0.91
chr2	113901626	113901937	CpG: 24	311	24	192	15.4	61.7	0.81
chr2	113922167	113922440	CpG: 21	273	21	165	15.4	60.4	0.86
chr2	113923728	113924996	CpG: 105	1268	105	855	16.6	67.4	0.74
chr2	113927049	113928748	CpG: 189	1699	189	1177	22.2	69.3	0.93
chr2	113966046	113967188	CpG: 134	1142	134	834	23.5	73.0	0.88
chr2	113978804	113979262	CpG: 34	458	34	241	14.8	52.6	1.07
chr2	114008407	114009404	CpG: 110	997	110	727	22.1	72.9	0.85
chr2	114026822	114027076	CpG: 30	254	30	178	23.6	70.1	0.98
chr2	114028276	114028952	CpG: 91	676	91	487	26.9	72.0	1.04
chr2	114029872	114030124	CpG: 19	252	19	153	15.1	60.7	0.84
chr2	114051740	114052468	CpG: 73	728	73	507	20.1	69.6	0.83
chr2	114061437	114061674	CpG: 20	237	20	144	16.9	60.8	0.94
chr2	114067381	114067650	CpG: 19	269	19	162	14.1	60.2	0.79
chr2	114080919	114081257	CpG: 24	338	24	198	14.2	58.6	0.83
chr2	114093970	114094447	CpG: 40	477	40	298	16.8	62.5	0.86
chr2	114129084	114129563	CpG: 47	479	47	361	19.6	75.4	0.70
chr2	114137071	114137342	CpG: 22	271	22	172	16.2	63.5	0.82
chr2	114180843	114181752	CpG: 98	909	98	631	21.6	69.4	0.90
chr2	114314494	114315391	CpG: 81	897	81	639	18.1	71.2	0.73
chr2	114363692	114363969	CpG: 25	277	25	172	18.1	62.1	0.94
chr2	114403914	114404903	CpG: 111	989	111	695	22.4	70.3	0.91
chr2	114701792	114702034	CpG: 19	242	19	145	15.7	59.9	0.90
chr2	114821622	114821826	CpG: 16	204	16	123	15.7	60.3	0.88
chr2	114823345	114823568	CpG: 18	223	18	135	16.1	60.5	0.90
chr2	114947264	114947676	CpG: 32	412	32	243	15.5	59.0	0.91
chr2	115087342	115088073	CpG: 63	731	63	468	17.2	64.0	0.84
chr2	115339818	115340092	CpG: 22	274	22	169	16.1	61.7	0.85
chr2	115492205	115492668	CpG: 33	463	33	273	14.3	59.0	0.82
chr2	115586077	115588106	CpG: 213	2029	213	1410	21.0	69.5	0.87
chr2	115612009	115612286	CpG: 24	277	24	170	17.3	61.4	0.94
chr2	115998162	115998373	CpG: 17	211	17	129	16.1	61.1	0.88
chr2	116214875	116215156	CpG: 24	281	24	175	17.1	62.3	0.90
chr2	116259581	116259792	CpG: 17	211	17	130	16.1	61.6	0.87
chr2	116446311	116446585	CpG: 21	274	21	166	15.3	60.6	0.84
chr2	116485526	116485752	CpG: 20	226	20	134	17.7	59.3	1.01
chr2	116520672	116520945	CpG: 25	273	25	173	18.3	63.4	0.92
chr2	117008342	117008583	CpG: 22	241	22	148	18.3	61.4	0.99
chr2	117020158	117020534	CpG: 29	376	29	243	15.4	64.6	0.76
chr2	117487220	117487808	CpG: 54	588	54	384	18.4	65.3	0.86
chr2	117503209	117503515	CpG: 26	306	26	228	17.0	74.5	0.62
chr2	117561978	117562248	CpG: 24	270	24	167	17.8	61.9	0.94
chr2	117567205	117567490	CpG: 24	285	24	177	16.8	62.1	0.89
chr2	117780522	117780796	CpG: 21	274	21	166	15.3	60.6	0.85
chr2	117948577	117948807	CpG: 17	230	17	136	14.8	59.1	0.86
chr2	117957197	117957585	CpG: 30	388	30	232	15.5	59.8	0.87
chr2	118211586	118211829	CpG: 21	243	21	147	17.3	60.5	0.95
chr2	118237193	118237505	CpG: 27	312	27	192	17.3	61.5	0.92
chr2	118247808	118248323	CpG: 48	515	48	314	18.6	61.0	1.01
chr2	118269340	118269983	CpG: 53	643	53	427	16.5	66.4	0.75
chr2	118292323	118293911	CpG: 157	1588	157	1077	19.8	67.8	0.86
chr2	118446568	118447929	CpG: 127	1361	127	932	18.7	68.5	0.80
chr2	118450762	118451000	CpG: 17	238	17	145	14.3	60.9	0.81
chr2	118456525	118456755	CpG: 17	230	17	142	14.8	61.7	0.79
chr2	118521338	118521840	CpG: 49	502	49	331	19.5	65.9	0.90
chr2	118575854	118576148	CpG: 25	294	25	182	17.0	61.9	0.89
chr2	118619554	118619930	CpG: 41	376	41	238	21.8	63.3	1.13
chr2	118657533	118658230	CpG: 71	697	71	462	20.4	66.3	0.93
chr2	118671774	118672010	CpG: 22	236	22	146	18.6	61.9	1.00
chr2	119207512	119207762	CpG: 29	250	29	169	23.2	67.6	1.05
chr2	119215855	119216128	CpG: 27	273	27	173	19.8	63.4	0.99
chr2	119268384	119269628	CpG: 105	1244	105	845	16.9	67.9	0.74
chr2	119274842	119275082	CpG: 20	240	20	165	16.7	68.8	0.72
chr2	119275241	119276750	CpG: 111	1509	111	874	14.7	57.9	0.89
chr2	119278400	119281406	CpG: 251	3006	251	1855	16.7	61.7	0.88
chr2	119281824	119282099	CpG: 22	275	22	176	16.0	64.0	0.78
chr2	119282355	119282612	CpG: 20	257	20	151	15.6	58.8	0.90
chr2	119283164	119283696	CpG: 49	532	49	302	18.4	56.8	1.15
chr2	119286047	119286294	CpG: 27	247	27	167	21.9	67.6	0.96
chr2	119287092	119287677	CpG: 42	585	42	364	14.4	62.2	0.75
chr2	119288827	119291361	CpG: 182	2534	182	1548	14.4	61.1	0.77
chr2	119291929	119292622	CpG: 48	693	48	457	13.9	65.9	0.64
chr2	119444836	119445089	CpG: 28	253	28	186	22.1	73.5	0.84
chr2	119590091	119592627	CpG: 242	2536	242	1757	19.1	69.3	0.80
chr2	119657029	119657768	CpG: 85	739	85	556	23.0	75.2	0.82
chr2	119681446	119681688	CpG: 24	242	24	164	19.8	67.8	0.89
chr2	119696604	119696899	CpG: 22	295	22	196	14.9	66.4	0.69
chr2	119800203	119801249	CpG: 84	1046	84	695	16.1	66.4	0.73
chr2	119842108	119842348	CpG: 17	240	17	144	14.2	60.0	0.81
chr2	119864836	119865646	CpG: 89	810	89	595	22.0	73.5	0.81
chr2	119865911	119866189	CpG: 22	278	22	165	15.8	59.4	0.90
chr2	119957586	119958198	CpG: 72	612	72	456	23.5	74.5	0.85
chr2	119977628	119978381	CpG: 85	753	85	545	22.6	72.4	0.87
chr2	120112591	120113071	CpG: 54	480	54	351	22.5	73.1	0.86
chr2	120193535	120194479	CpG: 86	944	86	645	18.2	68.3	0.78
chr2	120431573	120432142	CpG: 52	569	52	420	18.3	73.8	0.67
chr2	120446763	120446969	CpG: 16	206	16	124	15.5	60.2	0.86
chr2	120447588	120448342	CpG: 103	754	103	560	27.3	74.3	0.99
chr2	120495992	120496267	CpG: 24	275	24	171	17.5	62.2	0.91
chr2	120650377	120650655	CpG: 23	278	23	173	16.5	62.2	0.86
chr2	120657516	120658635	CpG: 134	1119	134	802	23.9	71.7	0.94
chr2	120687098	120688408	CpG: 124	1310	124	897	18.9	68.5	0.81
chr2	120693548	120693860	CpG: 22	312	22	176	14.1	56.4	0.92
chr2	120741286	120741560	CpG: 22	274	22	170	16.1	62.0	0.85
chr2	120778210	120781704	CpG: 410	3494	410	2572	23.5	73.6	0.87
chr2	120781882	120782105	CpG: 17	223	17	143	15.2	64.1	0.74
chr2	120784115	120784705	CpG: 42	590	42	379	14.2	64.2	0.69
chr2	120877726	120878860	CpG: 87	1134	87	735	15.3	64.8	0.73
chr2	120957828	120958169	CpG: 26	341	26	221	15.2	64.8	0.73
chr2	121012302	121012795	CpG: 44	493	44	334	17.8	67.7	0.78
chr2	121022545	121023336	CpG: 90	791	90	569	22.8	71.9	0.88
chr2	121089982	121090314	CpG: 34	332	34	241	20.5	72.6	0.78
chr2	121170998	121173376	CpG: 212	2378	212	1603	17.8	67.4	0.78
chr2	121177320	121177721	CpG: 61	401	61	309	30.4	77.1	1.04
chr2	121303010	121303392	CpG: 34	382	34	262	17.8	68.6	0.77
chr2	121420446	121420736	CpG: 22	290	22	193	15.2	66.6	0.69
chr2	121424157	121425191	CpG: 129	1034	129	774	25.0	74.9	0.90
chr2	121462119	121462393	CpG: 21	274	21	166	15.3	60.6	0.85
chr2	121598911	121599184	CpG: 24	273	24	168	17.6	61.5	0.94
chr2	121661042	121661456	CpG: 31	414	31	243	15.0	58.7	0.91
chr2	121719789	121720816	CpG: 125	1027	125	779	24.3	75.9	0.85
chr2	121965331	121966043	CpG: 60	712	60	459	16.9	64.5	0.83
chr2	121966603	121966868	CpG: 20	265	20	168	15.1	63.4	0.76
chr2	122029214	122029538	CpG: 24	324	24	190	14.8	58.6	0.88
chr2	122084102	122085646	CpG: 112	1544	112	923	14.5	59.8	0.81
chr2	122139024	122139313	CpG: 24	289	24	179	16.6	61.9	0.88
chr2	122171807	122172618	CpG: 93	811	93	560	22.9	69.1	1.00
chr2	122190688	122191227	CpG: 59	539	59	371	21.9	68.8	0.93
chr2	122242131	122242426	CpG: 26	295	26	183	17.6	62.0	0.92
chr2	122276026	122276260	CpG: 17	234	17	140	14.5	59.8	0.82
chr2	122327417	122328435	CpG: 83	1018	83	725	16.3	71.2	0.64
chr2	122453474	122453788	CpG: 21	314	21	188	13.4	59.9	0.75
chr2	122487015	122487428	CpG: 30	413	30	246	14.5	59.6	0.82
chr2	122784075	122784349	CpG: 23	274	23	171	16.8	62.4	0.87
chr2	123056831	123057101	CpG: 21	270	21	165	15.6	61.1	0.84
chr2	123080562	123080815	CpG: 17	253	17	142	13.4	56.1	0.87
chr2	123115813	123116052	CpG: 19	239	19	143	15.9	59.8	0.90
chr2	123417776	123418014	CpG: 17	238	17	140	14.3	58.8	0.84
chr2	123622535	123622809	CpG: 21	274	21	166	15.3	60.6	0.84
chr2	123707067	123707309	CpG: 18	242	18	136	14.9	56.2	0.97
chr2	123733037	123733324	CpG: 23	287	23	177	16.0	61.7	0.85
chr2	123843486	123843760	CpG: 23	274	23	170	16.8	62.0	0.88
chr2	124196339	124196585	CpG: 18	246	18	147	14.6	59.8	0.83
chr2	124264130	124264353	CpG: 17	223	17	158	15.2	70.9	0.61
chr2	124387742	124388012	CpG: 23	270	23	167	17.0	61.9	0.90
chr2	124462140	124463143	CpG: 79	1003	79	602	15.8	60.0	0.89
chr2	124473409	124473690	CpG: 24	281	24	175	17.1	62.3	0.90
chr2	124577286	124577595	CpG: 26	309	26	183	16.8	59.2	0.96
chr2	124799301	124799729	CpG: 34	428	34	255	15.9	59.6	0.90
chr2	124829086	124829323	CpG: 20	237	20	143	16.9	60.3	0.95
chr2	124845428	124845739	CpG: 26	311	26	191	16.7	61.4	0.89
chr2	124856276	124856549	CpG: 25	273	25	172	18.3	63.0	0.94
chr2	124861001	124861421	CpG: 33	420	33	242	15.7	57.6	0.96
chr2	125036232	125036659	CpG: 29	427	29	254	13.6	59.5	0.77
chr2	125714993	125715195	CpG: 18	202	18	145	17.8	71.8	0.70
chr2	125811746	125812004	CpG: 19	258	19	156	14.7	60.5	0.81
chr2	125860097	125860502	CpG: 32	405	32	290	15.8	71.6	0.62
chr2	126248458	126248689	CpG: 21	231	21	131	18.2	56.7	1.17
chr2	126361455	126361733	CpG: 22	278	22	175	15.8	62.9	0.81
chr2	126620678	126621072	CpG: 29	394	29	235	14.7	59.6	0.83
chr2	127093187	127093662	CpG: 57	475	57	365	24.0	76.8	0.82
chr2	127213698	127214654	CpG: 71	956	71	641	14.9	67.1	0.66
chr2	127215022	127215284	CpG: 21	262	21	160	16.0	61.1	0.87
chr2	127323196	127323529	CpG: 30	333	30	242	18.0	72.7	0.71
chr2	127406487	127406720	CpG: 21	233	21	166	18.0	71.2	0.72
chr2	127411216	127411490	CpG: 20	274	20	171	14.6	62.4	0.77
chr2	127459422	127459638	CpG: 17	216	17	144	15.7	66.7	0.72
chr2	127459890	127460120	CpG: 21	230	21	157	18.3	68.3	0.81
chr2	127488486	127488706	CpG: 17	220	17	146	15.5	66.4	0.80
chr2	127494803	127495040	CpG: 21	237	21	157	17.7	66.2	0.82
chr2	127540457	127542096	CpG: 161	1639	161	1165	19.6	71.1	0.78
chr2	127654050	127655631	CpG: 150	1581	150	1143	19.0	72.3	0.77
chr2	127728995	127729505	CpG: 51	510	51	355	20.0	69.6	0.83
chr2	127788111	127788973	CpG: 65	862	65	595	15.1	69.0	0.63
chr2	127822537	127823601	CpG: 150	1064	150	807	28.2	75.8	0.99
chr2	127836143	127836618	CpG: 36	475	36	313	15.2	65.9	0.70
chr2	127843249	127843892	CpG: 71	643	71	494	22.1	76.8	0.75
chr2	127851169	127851487	CpG: 35	318	35	223	22.0	70.1	0.90
chr2	127857988	127859074	CpG: 98	1086	98	769	18.0	70.8	0.72
chr2	127863790	127864063	CpG: 20	273	20	174	14.7	63.7	0.72
chr2	127961239	127962185	CpG: 81	946	81	584	17.1	61.7	0.90
chr2	127979846	127980118	CpG: 19	272	19	160	14.0	58.8	0.82
chr2	128027958	128028314	CpG: 33	356	33	250	18.5	70.2	0.75
chr2	128052771	128053063	CpG: 23	292	23	180	15.8	61.6	0.85
chr2	128059264	128059569	CpG: 23	305	23	200	15.1	65.6	0.70
chr2	128086637	128087035	CpG: 29	398	29	256	14.6	64.3	0.71
chr2	128088243	128088484	CpG: 17	241	17	160	14.1	66.4	0.65
chr2	128099399	128099862	CpG: 58	463	58	346	25.1	74.7	0.90
chr2	128109861	128111157	CpG: 119	1296	119	920	18.4	71.0	0.74
chr2	128130758	128131105	CpG: 42	347	42	260	24.2	74.9	0.86
chr2	128136503	128137596	CpG: 152	1093	152	810	27.8	74.1	1.02
chr2	128148827	128149054	CpG: 19	227	19	151	16.7	66.5	0.78
chr2	128187545	128187830	CpG: 25	285	25	179	17.5	62.8	0.90
chr2	128209797	128210005	CpG: 16	208	16	126	15.4	60.6	0.85
chr2	128215238	128215468	CpG: 17	230	17	138	14.8	60.0	0.84
chr2	128244033	128244256	CpG: 20	223	20	133	17.9	59.6	1.02
chr2	128245986	128246729	CpG: 65	743	65	458	17.5	61.6	0.93
chr2	128293163	128293688	CpG: 64	525	64	382	24.4	72.8	0.92
chr2	128320472	128322092	CpG: 178	1620	178	1152	22.0	71.1	0.88
chr2	128462229	128463977	CpG: 207	1748	207	1294	23.7	74.0	0.87
chr2	128494368	128494632	CpG: 20	264	20	156	15.2	59.1	0.88
chr2	128527321	128527882	CpG: 53	561	53	376	18.9	67.0	0.84
chr2	128644003	128644221	CpG: 19	218	19	146	17.4	67.0	0.79
chr2	128655420	128655631	CpG: 17	211	17	121	16.1	57.3	1.00
chr2	128668714	128669699	CpG: 96	985	96	689	19.5	69.9	0.80
chr2	128704144	128704793	CpG: 60	649	60	427	18.5	65.8	0.86
chr2	128753572	128756014	CpG: 269	2442	269	1751	22.0	71.7	0.86
chr2	128757847	128758545	CpG: 85	698	85	519	24.4	74.4	0.88
chr2	128781309	128782519	CpG: 80	1210	80	813	13.2	67.2	0.60
chr2	128906825	128907061	CpG: 17	236	17	167	14.4	70.8	0.65
chr2	128907349	128907653	CpG: 24	304	24	217	15.8	71.4	0.70
chr2	128922408	128922627	CpG: 17	219	17	137	15.5	62.6	0.79
chr2	128929059	128929727	CpG: 62	668	62	483	18.6	72.3	0.71
chr2	129005116	129005352	CpG: 18	236	18	141	15.3	59.7	0.88
chr2	129013924	129014210	CpG: 25	286	25	178	17.5	62.2	0.92
chr2	129022977	129023238	CpG: 18	261	18	154	13.8	59.0	0.80
chr2	129140643	129140921	CpG: 23	278	23	174	16.5	62.6	0.85
chr2	129172709	129173424	CpG: 67	715	67	496	18.7	69.4	0.79
chr2	129282321	129282550	CpG: 20	229	20	139	17.5	60.7	0.95
chr2	129290561	129290839	CpG: 24	278	24	174	17.3	62.6	0.89
chr2	129300650	129300960	CpG: 27	310	27	194	17.4	62.6	0.89
chr2	129330010	129330279	CpG: 20	269	20	169	14.9	62.8	0.75
chr2	129330392	129330658	CpG: 21	266	21	173	15.8	65.0	0.75
chr2	129357287	129357550	CpG: 19	263	19	162	14.4	61.6	0.77
chr2	129403587	129403823	CpG: 19	236	19	140	16.1	59.3	0.94
chr2	129572836	129573111	CpG: 31	275	31	206	22.5	74.9	0.81
chr2	129644891	129645165	CpG: 23	274	23	171	16.8	62.4	0.87
chr2	129766521	129766795	CpG: 22	274	22	169	16.1	61.7	0.85
chr2	129845175	129845601	CpG: 31	426	31	255	14.6	59.9	0.82
chr2	129939690	129939920	CpG: 18	230	18	138	15.7	60.0	0.88
chr2	130015734	130016170	CpG: 44	436	44	299	20.2	68.6	0.86
chr2	130116307	130116734	CpG: 32	427	32	257	15.0	60.2	0.83
chr2	130190717	130191007	CpG: 25	290	25	180	17.2	62.1	0.91
chr2	130262696	130262939	CpG: 18	243	18	155	14.8	63.8	0.73
chr2	130307129	130307489	CpG: 40	360	40	269	22.2	74.7	0.90
chr2	130363769	130364171	CpG: 37	402	37	294	18.4	73.1	0.71
chr2	130384950	130385168	CpG: 17	218	17	131	15.6	60.1	0.89
chr2	130409290	130409803	CpG: 53	513	53	366	20.7	71.3	0.81
chr2	130422181	130422501	CpG: 42	320	42	249	26.2	77.8	0.95
chr2	130435525	130435806	CpG: 39	281	39	208	27.8	74.0	1.03
chr2	130466473	130467699	CpG: 91	1226	91	798	14.8	65.1	0.73
chr2	130528794	130529086	CpG: 25	292	25	179	17.1	61.3	0.91
chr2	130554735	130555119	CpG: 48	384	48	244	25.0	63.5	1.24
chr2	130573448	130573719	CpG: 21	271	21	179	15.5	66.1	0.72
chr2	130577891	130579132	CpG: 91	1241	91	795	14.7	64.1	0.72
chr2	130613889	130614329	CpG: 31	440	31	263	14.1	59.8	0.80
chr2	130615163	130616751	CpG: 168	1588	168	1123	21.2	70.7	0.85
chr2	130631981	130632597	CpG: 45	616	45	391	14.6	63.5	0.73
chr2	130647256	130647697	CpG: 60	441	60	351	27.2	79.6	0.88
chr2	130651840	130652113	CpG: 22	273	22	166	16.1	60.8	0.88
chr2	130661980	130663506	CpG: 152	1526	152	1090	19.9	71.4	0.79
chr2	130685892	130686508	CpG: 40	616	40	403	13.0	65.4	0.63
chr2	130686833	130687087	CpG: 24	254	24	190	18.9	74.8	0.68
chr2	130722341	130722822	CpG: 48	481	48	335	20.0	69.6	0.82
chr2	130761668	130761904	CpG: 28	236	28	184	23.7	78.0	0.78
chr2	130766043	130766402	CpG: 26	359	26	220	14.5	61.3	0.77
chr2	130775820	130777214	CpG: 98	1394	98	836	14.1	60.0	0.78
chr2	130789440	130790668	CpG: 154	1228	154	923	25.1	75.2	0.89
chr2	130791500	130791736	CpG: 19	236	19	146	16.1	61.9	0.85
chr2	130806048	130806841	CpG: 86	793	86	581	21.7	73.3	0.81
chr2	130824920	130825745	CpG: 63	825	63	525	15.3	63.6	0.77
chr2	130861561	130862827	CpG: 94	1266	94	815	14.8	64.4	0.74
chr2	130943536	130943827	CpG: 42	291	42	193	28.9	66.3	1.32
chr2	130956571	130957218	CpG: 80	647	80	492	24.7	76.0	0.88
chr2	130962560	130962844	CpG: 21	284	21	166	14.8	58.5	0.88
chr2	130968197	130968475	CpG: 24	278	24	168	17.3	60.4	0.95
chr2	130983180	130983924	CpG: 60	744	60	518	16.1	69.6	0.67
chr2	131004617	131005361	CpG: 60	744	60	518	16.1	69.6	0.67
chr2	131020066	131020344	CpG: 24	278	24	168	17.3	60.4	0.95
chr2	131025697	131025981	CpG: 21	284	21	166	14.8	58.5	0.88
chr2	131031323	131031970	CpG: 80	647	80	492	24.7	76.0	0.88
chr2	131044714	131045005	CpG: 42	291	42	193	28.9	66.3	1.32
chr2	131126756	131127995	CpG: 96	1239	96	808	15.5	65.2	0.75
chr2	131161729	131162040	CpG: 32	311	32	223	20.6	71.7	0.88
chr2	131179729	131180014	CpG: 25	285	25	178	17.5	62.5	0.92
chr2	131189955	131190775	CpG: 98	820	98	616	23.9	75.1	0.85
chr2	131210182	131210444	CpG: 20	262	20	164	15.3	62.6	0.80
chr2	131231680	131232513	CpG: 93	833	93	613	22.3	73.6	0.83
chr2	131270810	131271973	CpG: 118	1163	118	847	20.3	72.8	0.77
chr2	131289159	131289423	CpG: 19	264	19	154	14.4	58.3	0.86
chr2	131350359	131350823	CpG: 48	464	48	348	20.7	75.0	0.74
chr2	131374827	131375055	CpG: 18	228	18	136	15.8	59.6	0.93
chr2	131397512	131398616	CpG: 168	1104	168	860	30.4	77.9	1.01
chr2	131425777	131426165	CpG: 32	388	32	275	16.5	70.9	0.66
chr2	131426711	131426974	CpG: 19	263	19	153	14.4	58.2	0.86
chr2	131468980	131469932	CpG: 113	952	113	712	23.7	74.8	0.85
chr2	131474104	131474830	CpG: 84	726	84	513	23.1	70.7	0.93
chr2	131526868	131527806	CpG: 139	938	139	685	29.6	73.0	1.12
chr2	131539168	131539856	CpG: 66	688	66	486	19.2	70.6	0.83
chr2	131588748	131589717	CpG: 73	969	73	658	15.1	67.9	0.67
chr2	131651653	131652037	CpG: 48	384	48	245	25.0	63.8	1.23
chr2	131733980	131735250	CpG: 90	1270	90	814	14.2	64.1	0.71
chr2	131765785	131766069	CpG: 38	284	38	212	26.8	74.6	0.99
chr2	131787972	131788304	CpG: 43	332	43	259	25.9	78.0	0.95
chr2	131798401	131798924	CpG: 57	523	57	374	21.8	71.5	0.85
chr2	131829327	131829618	CpG: 26	291	26	208	17.9	71.5	0.70
chr2	131829944	131830222	CpG: 23	278	23	184	16.5	66.2	0.76
chr2	131859499	131860308	CpG: 133	809	133	651	32.9	80.5	1.02
chr2	131872355	131872640	CpG: 20	285	20	174	14.0	61.1	0.77
chr2	131879462	131880957	CpG: 141	1495	141	1067	18.9	71.4	0.75
chr2	131891035	131891308	CpG: 21	273	21	165	15.4	60.4	0.85
chr2	131895457	131895919	CpG: 64	462	64	365	27.7	79.0	0.91
chr2	131910801	131911330	CpG: 42	529	42	344	15.9	65.0	0.76
chr2	131926530	131928170	CpG: 173	1640	173	1164	21.1	71.0	0.84
chr2	131928876	131929208	CpG: 24	332	24	196	14.5	59.0	0.85
chr2	131962511	131963744	CpG: 94	1233	94	788	15.2	63.9	0.75
chr2	131978275	131978571	CpG: 21	296	21	187	14.2	63.2	0.73
chr2	132025674	132025935	CpG: 36	261	36	173	27.6	66.3	1.26
chr2	132081358	132082034	CpG: 54	676	54	448	16.0	66.3	0.73
chr2	132092469	132092857	CpG: 31	388	31	268	16.0	69.1	0.70
chr2	132108283	132108841	CpG: 42	558	42	385	15.1	69.0	0.64
chr2	132116905	132117494	CpG: 46	589	46	392	15.6	66.6	0.71
chr2	132158625	132158985	CpG: 47	360	47	277	26.1	76.9	0.88
chr2	132188724	132189668	CpG: 61	944	61	605	12.9	64.1	0.63
chr2	132190589	132191130	CpG: 38	541	38	340	14.0	62.8	0.71
chr2	132237011	132237666	CpG: 71	655	71	500	21.7	76.3	0.75
chr2	132238224	132238520	CpG: 28	296	28	196	18.9	66.2	0.88
chr2	132249012	132249266	CpG: 20	254	20	172	15.7	67.7	0.69
chr2	132263124	132266297	CpG: 309	3173	309	2234	19.5	70.4	0.80
chr2	132328102	132328307	CpG: 15	205	15	120	14.6	58.5	0.86
chr2	132401842	132402180	CpG: 32	338	32	239	18.9	70.7	0.76
chr2	132445343	132445959	CpG: 74	616	74	406	24.0	65.9	1.15
chr2	132473322	132474415	CpG: 118	1093	118	752	21.6	68.8	0.92
chr2	132691790	132693874	CpG: 194	2084	194	1475	18.6	70.8	0.74
chr2	132788773	132790091	CpG: 105	1318	105	929	15.9	70.5	0.64
chr2	132794327	132794556	CpG: 20	229	20	141	17.5	61.6	0.94
chr2	132819823	132820045	CpG: 16	222	16	133	14.4	59.9	0.81
chr2	132854282	132855119	CpG: 65	837	65	561	15.5	67.0	0.70
chr2	132855910	132856194	CpG: 21	284	21	180	14.8	63.4	0.75
chr2	133023901	133024169	CpG: 27	268	27	179	20.1	66.8	0.92
chr2	133029331	133029612	CpG: 24	281	24	175	17.1	62.3	0.90
chr2	133083507	133083797	CpG: 32	290	32	186	22.1	64.1	1.09
chr2	133107430	133109648	CpG: 194	2218	194	1506	17.5	67.9	0.76
chr2	133597019	133597293	CpG: 25	274	25	172	18.2	62.8	0.94
chr2	133705014	133705534	CpG: 52	520	52	375	20.0	72.1	0.78
chr2	133707181	133707409	CpG: 22	228	22	143	19.3	62.7	1.01
chr2	133746747	133747021	CpG: 23	274	23	171	16.8	62.4	0.87
chr2	133747360	133747647	CpG: 23	287	23	177	16.0	61.7	0.85
chr2	133986408	133986650	CpG: 23	242	23	147	19.0	60.7	1.03
chr2	134102323	134102610	CpG: 25	287	25	182	17.4	63.4	0.88
chr2	134142097	134142339	CpG: 22	242	22	150	18.2	62.0	0.97
chr2	134226078	134226344	CpG: 23	266	23	167	17.3	62.8	0.89
chr2	134350063	134350401	CpG: 23	338	23	202	13.6	59.8	0.76
chr2	134449303	134449629	CpG: 22	326	22	216	13.5	66.3	0.64
chr2	134467563	134467783	CpG: 18	220	18	158	16.4	71.8	0.64
chr2	134530029	134530304	CpG: 25	275	25	174	18.2	63.3	0.92
chr2	134547978	134548202	CpG: 16	224	16	125	14.3	55.8	0.93
chr2	134549082	134549335	CpG: 20	253	20	181	15.8	71.5	0.62
chr2	134550723	134550959	CpG: 21	236	21	145	17.8	61.4	0.96
chr2	134559296	134561057	CpG: 196	1761	196	1300	22.3	73.8	0.83
chr2	134569256	134569763	CpG: 42	507	42	377	16.6	74.4	0.61
chr2	134630918	134631743	CpG: 70	825	70	539	17.0	65.3	0.80
chr2	134684518	134684782	CpG: 21	264	21	163	15.9	61.7	0.84
chr2	135096380	135096807	CpG: 32	427	32	255	15.0	59.7	0.85
chr2	135158396	135159691	CpG: 176	1295	176	991	27.2	76.5	0.94
chr2	135265856	135266098	CpG: 22	242	22	146	18.2	60.3	1.00
chr2	135326547	135326814	CpG: 21	267	21	161	15.7	60.3	0.89
chr2	135358498	135359854	CpG: 129	1356	129	888	19.0	65.5	0.89
chr2	135408850	135409662	CpG: 63	812	63	553	15.5	68.1	0.67
chr2	135451722	135451984	CpG: 19	262	19	158	14.5	60.3	0.80
chr2	135492686	135493152	CpG: 35	466	35	279	15.0	59.9	0.87
chr2	135520319	135520577	CpG: 23	258	23	160	17.8	62.0	0.94
chr2	135546265	135546675	CpG: 38	410	38	308	18.5	75.1	0.66
chr2	135567878	135568142	CpG: 22	264	22	156	16.7	59.1	0.96
chr2	135669905	135670145	CpG: 23	240	23	150	19.2	62.5	1.00
chr2	135715603	135715807	CpG: 19	204	19	152	18.6	74.5	0.67
chr2	135725008	135725282	CpG: 20	274	20	164	14.6	59.9	0.82
chr2	135971923	135972668	CpG: 67	745	67	516	18.0	69.3	0.75
chr2	136182066	136183065	CpG: 118	999	118	710	23.6	71.1	0.94
chr2	136213240	136213513	CpG: 22	273	22	169	16.1	61.9	0.85
chr2	136277914	136278188	CpG: 19	274	19	168	13.9	61.3	0.75
chr2	136316586	136316838	CpG: 18	252	18	144	14.3	57.1	0.88
chr2	136320212	136321078	CpG: 92	866	92	584	21.2	67.4	0.94
chr2	136429543	136430451	CpG: 74	908	74	605	16.3	66.6	0.74
chr2	136532516	136533000	CpG: 47	484	47	358	19.4	74.0	0.71
chr2	136560998	136562935	CpG: 156	1937	156	1213	16.1	62.6	0.82
chr2	136563457	136563962	CpG: 44	505	44	316	17.4	62.6	0.91
chr2	136598538	136598758	CpG: 15	220	15	128	13.6	58.2	0.82
chr2	136739270	136739548	CpG: 25	278	25	175	18.0	62.9	0.92
chr2	136754247	136754483	CpG: 21	236	21	145	17.8	61.4	0.96
chr2	136765353	136765658	CpG: 22	305	22	187	14.4	61.3	0.78
chr2	136869531	136869771	CpG: 23	240	23	155	19.2	64.6	0.92
chr2	137204443	137204720	CpG: 22	277	22	201	15.9	72.6	0.61
chr2	137210856	137212092	CpG: 112	1236	112	837	18.1	67.7	0.79
chr2	137684524	137684810	CpG: 25	286	25	178	17.5	62.2	0.92
chr2	137777747	137777957	CpG: 21	210	21	154	20.0	73.3	0.75
chr2	137894547	137894759	CpG: 17	212	17	128	16.0	60.4	0.89
chr2	137933052	137933333	CpG: 21	281	21	173	14.9	61.6	0.80
chr2	137947874	137948148	CpG: 25	274	25	172	18.2	62.8	0.94
chr2	138125205	138125440	CpG: 20	235	20	146	17.0	62.1	0.90
chr2	138416417	138416649	CpG: 16	232	16	135	13.8	58.2	0.84
chr2	138648035	138648309	CpG: 22	274	22	169	16.1	61.7	0.85
chr2	138671347	138671584	CpG: 19	237	19	139	16.0	58.6	0.94
chr2	138882746	138882981	CpG: 18	235	18	138	15.3	58.7	0.92
chr2	138947155	138948034	CpG: 99	879	99	644	22.5	73.3	0.84
chr2	139225782	139226740	CpG: 100	958	100	698	20.9	72.9	0.80
chr2	139348324	139348533	CpG: 16	209	16	138	15.3	66.0	0.72
chr2	139363197	139363433	CpG: 18	236	18	139	15.3	58.9	0.90
chr2	139589808	139590048	CpG: 18	240	18	145	15.0	60.4	0.84
chr2	139692144	139692414	CpG: 19	270	19	161	14.1	59.6	0.81
chr2	139856017	139856444	CpG: 37	427	37	313	17.3	73.3	0.65
chr2	140141660	140141941	CpG: 22	281	22	174	15.7	61.9	0.83
chr2	140435602	140435814	CpG: 15	212	15	113	14.2	53.3	1.01
chr2	140436598	140436807	CpG: 26	209	26	160	24.9	76.6	0.86
chr2	140454469	140454750	CpG: 22	281	22	173	15.7	61.6	0.84
chr2	140519584	140519958	CpG: 33	374	33	278	17.6	74.3	0.64
chr2	140957088	140957358	CpG: 25	270	25	167	18.5	61.9	0.97
chr2	141085862	141086084	CpG: 20	222	20	134	18.0	60.4	1.01
chr2	141086225	141086435	CpG: 18	210	18	130	17.1	61.9	0.92
chr2	141091401	141091633	CpG: 17	232	17	135	14.7	58.2	0.89
chr2	141101452	141101692	CpG: 19	240	19	146	15.8	60.8	0.86
chr2	141235403	141235677	CpG: 25	274	25	172	18.2	62.8	0.94
chr2	141274092	141274547	CpG: 35	455	35	268	15.4	58.9	0.90
chr2	141530476	141530712	CpG: 19	236	19	140	16.1	59.3	0.94
chr2	141652617	141652866	CpG: 19	249	19	145	15.3	58.2	0.92
chr2	141737856	141738122	CpG: 19	266	19	161	14.3	60.5	0.79
chr2	141867484	141867763	CpG: 24	279	24	174	17.2	62.4	0.89
chr2	142269833	142270063	CpG: 18	230	18	138	15.7	60.0	0.89
chr2	142310736	142311010	CpG: 25	274	25	172	18.2	62.8	0.93
chr2	142461219	142461440	CpG: 20	221	20	136	18.1	61.5	0.97
chr2	142575525	142576354	CpG: 68	829	68	509	16.4	61.4	0.88
chr2	142618038	142618316	CpG: 25	278	25	176	18.0	63.3	0.91
chr2	142950827	142951059	CpG: 18	232	18	135	15.5	58.2	0.93
chr2	142957490	142957714	CpG: 17	224	17	135	15.2	60.3	0.87
chr2	142991452	142991775	CpG: 29	323	29	240	18.0	74.3	0.65
chr2	143058787	143059193	CpG: 28	406	28	234	13.8	57.6	0.84
chr2	143147108	143147772	CpG: 49	664	49	449	14.8	67.6	0.65
chr2	143188359	143188625	CpG: 20	266	20	162	15.0	60.9	0.83
chr2	143192327	143192591	CpG: 20	264	20	157	15.2	59.5	0.88
chr2	143454460	143454752	CpG: 22	292	22	172	15.1	58.9	0.87
chr2	143719689	143719968	CpG: 22	279	22	172	15.8	61.6	0.84
chr2	144109936	144110226	CpG: 23	290	23	176	15.9	60.7	0.86
chr2	144247256	144247505	CpG: 19	249	19	148	15.3	59.4	0.88
chr2	144266842	144267078	CpG: 18	236	18	142	15.3	60.2	0.88
chr2	144308978	144309405	CpG: 31	427	31	255	14.5	59.7	0.82
chr2	144340872	144341104	CpG: 19	232	19	143	16.4	61.6	0.87
chr2	144384780	144385630	CpG: 110	850	110	622	25.9	73.2	0.97
chr2	144421527	144421800	CpG: 23	273	23	164	16.8	60.1	0.94
chr2	144694332	144694613	CpG: 25	281	25	176	17.8	62.6	0.92
chr2	144779924	144780869	CpG: 126	945	126	709	26.7	75.0	0.98
chr2	144837615	144837968	CpG: 30	353	30	206	17.0	58.4	1.08
chr2	144963894	144965818	CpG: 185	1924	185	1301	19.2	67.6	0.85
chr2	144972176	144972482	CpG: 40	306	40	241	26.1	78.8	0.90
chr2	145351306	145351613	CpG: 23	307	23	178	15.0	58.0	0.90
chr2	145931320	145931571	CpG: 19	251	19	152	15.1	60.6	0.84
chr2	145938526	145938756	CpG: 20	230	20	141	17.4	61.3	0.94
chr2	146328769	146329016	CpG: 18	247	18	141	14.6	57.1	0.92
chr2	146341804	146342012	CpG: 17	208	17	122	16.3	58.7	0.96
chr2	146480571	146480807	CpG: 18	236	18	144	15.3	61.0	0.85
chr2	146838581	146838862	CpG: 25	281	25	175	17.8	62.3	0.93
chr2	146855916	146856220	CpG: 21	304	21	179	13.8	58.9	0.81
chr2	147037401	147037979	CpG: 49	578	49	365	17.0	63.1	0.86
chr2	147280896	147281170	CpG: 24	274	24	171	17.5	62.4	0.91
chr2	147372318	147372713	CpG: 31	395	31	235	15.7	59.5	0.90
chr2	147586461	147586735	CpG: 24	274	24	171	17.5	62.4	0.91
chr2	147819896	147820125	CpG: 19	229	19	142	16.6	62.0	0.87
chr2	148053217	148053494	CpG: 23	277	23	169	16.6	61.0	0.90
chr2	148169615	148169889	CpG: 23	274	23	171	16.8	62.4	0.87
chr2	148177623	148177865	CpG: 19	242	19	144	15.7	59.5	0.89
chr2	148277172	148277749	CpG: 54	577	54	428	18.7	74.2	0.68
chr2	148294179	148295833	CpG: 177	1654	177	1077	21.4	65.1	1.01
chr2	148471107	148471415	CpG: 30	308	30	200	19.5	64.9	1.04
chr2	148510015	148510260	CpG: 19	245	19	147	15.5	60.0	0.89
chr2	148514619	148514875	CpG: 21	256	21	161	16.4	62.9	0.84
chr2	148535896	148536174	CpG: 23	278	23	172	16.5	61.9	0.87
chr2	148620387	148620628	CpG: 19	241	19	144	15.8	59.8	0.90
chr2	148629505	148629740	CpG: 20	235	20	145	17.0	61.7	0.93
chr2	148639181	148639608	CpG: 32	427	32	254	15.0	59.5	0.85
chr2	148738540	148738814	CpG: 21	274	21	168	15.3	61.3	0.82
chr2	148755187	148755467	CpG: 24	280	24	172	17.1	61.4	0.91
chr2	148836862	148837141	CpG: 25	279	25	175	17.9	62.7	0.92
chr2	148945043	148945311	CpG: 20	268	20	166	14.9	61.9	0.79
chr2	148957841	148958078	CpG: 21	237	21	147	17.7	62.0	0.94
chr2	149094486	149096314	CpG: 201	1828	201	1241	22.0	67.9	0.96
chr2	149325471	149326671	CpG: 133	1200	133	853	22.2	71.1	0.88
chr2	149338324	149338622	CpG: 28	298	28	205	18.8	68.8	0.80
chr2	149460516	149460752	CpG: 23	236	23	155	19.5	65.7	0.92
chr2	149488862	149489640	CpG: 89	778	89	590	22.9	75.8	0.81
chr2	149691635	149691910	CpG: 23	275	23	170	16.7	61.8	0.88
chr2	149725462	149725705	CpG: 18	243	18	144	14.8	59.3	0.87
chr2	149770704	149771111	CpG: 38	407	38	299	18.7	73.5	0.69
chr2	149780354	149781383	CpG: 110	1029	110	739	21.4	71.8	0.83
chr2	150357564	150357845	CpG: 21	281	21	172	14.9	61.2	0.81
chr2	150488861	150489123	CpG: 25	262	25	166	19.1	63.4	0.96
chr2	150621480	150621954	CpG: 45	474	45	350	19.0	73.8	0.70
chr2	150690582	150690856	CpG: 24	274	24	171	17.5	62.4	0.91
chr2	150796641	150796868	CpG: 17	227	17	137	15.0	60.4	0.86
chr2	150935610	150937059	CpG: 118	1449	118	946	16.3	65.3	0.77
chr2	150991723	150991938	CpG: 19	215	19	118	17.7	54.9	1.23
chr2	150992832	150993353	CpG: 43	521	43	389	16.5	74.7	0.60
chr2	151463301	151463532	CpG: 21	231	21	142	18.2	61.5	0.97
chr2	151641869	151642150	CpG: 23	281	23	174	16.4	61.9	0.87
chr2	151677583	151677830	CpG: 18	247	18	147	14.6	59.5	0.85
chr2	151713109	151713706	CpG: 55	597	55	404	18.4	67.7	0.80
chr2	151740694	151741553	CpG: 72	859	72	540	16.8	62.9	0.85
chr2	151747592	151748138	CpG: 47	546	47	400	17.2	73.3	0.64
chr2	151861518	151862533	CpG: 86	1015	86	664	16.9	65.4	0.82
chr2	151898765	151899031	CpG: 24	266	24	171	18.0	64.3	0.89
chr2	152156212	152156643	CpG: 32	431	32	254	14.8	58.9	0.86
chr2	152231899	152232165	CpG: 27	266	27	170	20.3	63.9	1.01
chr2	152279394	152280051	CpG: 80	657	80	476	24.4	72.5	0.93
chr2	152282986	152283320	CpG: 23	334	23	195	13.8	58.4	0.81
chr2	152505945	152506180	CpG: 23	235	23	146	19.6	62.1	1.03
chr2	152550081	152551232	CpG: 114	1151	114	817	19.8	71.0	0.79
chr2	152627452	152628414	CpG: 92	962	92	614	19.1	63.8	0.95
chr2	152787077	152788569	CpG: 158	1492	158	1046	21.2	70.1	0.87
chr2	152800960	152801242	CpG: 20	282	20	172	14.2	61.0	0.78
chr2	152843862	152844139	CpG: 24	277	24	171	17.3	61.7	0.92
chr2	153132474	153132701	CpG: 18	227	18	135	15.9	59.5	0.93
chr2	153169775	153171585	CpG: 170	1810	170	1200	18.8	66.3	0.86
chr2	153337782	153338056	CpG: 23	274	23	163	16.8	59.5	0.98
chr2	153465926	153466251	CpG: 24	325	24	190	14.8	58.5	0.87
chr2	153616255	153616528	CpG: 21	273	21	170	15.4	62.3	0.80
chr2	153930489	153931498	CpG: 106	1009	106	673	21.0	66.7	0.95
chr2	154007811	154008047	CpG: 22	236	22	146	18.6	61.9	1.00
chr2	154172120	154172362	CpG: 20	242	20	146	16.5	60.3	0.91
chr2	154256008	154256225	CpG: 18	217	18	133	16.6	61.3	0.89
chr2	154266714	154266950	CpG: 19	236	19	141	16.1	59.7	0.93
chr2	154323920	154325339	CpG: 146	1419	146	1006	20.6	70.9	0.83
chr2	154325624	154325929	CpG: 23	305	23	202	15.1	66.2	0.69
chr2	154348631	154348909	CpG: 24	278	24	173	17.3	62.2	0.90
chr2	154419262	154419507	CpG: 21	245	21	148	17.1	60.4	0.96
chr2	154504193	154504474	CpG: 24	281	24	176	17.1	62.6	0.89
chr2	154846827	154847101	CpG: 22	274	22	167	16.1	60.9	0.88
chr2	155023127	155023401	CpG: 25	274	25	173	18.2	63.1	0.93
chr2	155150468	155152533	CpG: 146	2065	146	1301	14.1	63.0	0.71
chr2	155487725	155488006	CpG: 24	281	24	174	17.1	61.9	0.91
chr2	155567569	155567846	CpG: 21	277	21	168	15.2	60.6	0.83
chr2	156114161	156114435	CpG: 23	274	23	169	16.8	61.7	0.89
chr2	156493790	156494073	CpG: 22	283	22	172	15.5	60.8	0.85
chr2	156707225	156707622	CpG: 29	397	29	235	14.6	59.2	0.84
chr2	156772430	156773525	CpG: 82	1095	82	680	15.0	62.1	0.78
chr2	156780565	156780808	CpG: 19	243	19	161	15.6	66.3	0.71
chr2	156781733	156782531	CpG: 65	798	65	538	16.3	67.4	0.72
chr2	156785233	156787618	CpG: 181	2385	181	1491	15.2	62.5	0.78
chr2	156794253	156795531	CpG: 135	1278	135	898	21.1	70.3	0.86
chr2	156853106	156853409	CpG: 31	303	31	212	20.5	70.0	0.84
chr2	156868038	156868278	CpG: 20	240	20	141	16.7	58.8	1.00
chr2	156878802	156879039	CpG: 17	237	17	142	14.3	59.9	0.83
chr2	156888410	156889317	CpG: 94	907	94	664	20.7	73.2	0.77
chr2	157062766	157063040	CpG: 24	274	24	169	17.5	61.7	0.93
chr2	157070800	157071216	CpG: 38	416	38	297	18.3	71.4	0.72
chr2	157088012	157088287	CpG: 24	275	24	169	17.5	61.5	0.93
chr2	157115015	157115281	CpG: 21	266	21	164	15.8	61.7	0.85
chr2	157131972	157132236	CpG: 21	264	21	164	15.9	62.1	0.84
chr2	157571863	157572093	CpG: 17	230	17	139	14.8	60.4	0.82
chr2	157649263	157649543	CpG: 21	280	21	166	15.0	59.3	0.86
chr2	157658374	157658611	CpG: 18	237	18	141	15.2	59.5	0.89
chr2	157821729	157822123	CpG: 29	394	29	239	14.7	60.7	0.81
chr2	157876624	157876898	CpG: 25	274	25	172	18.2	62.8	0.94
chr2	157968712	157969023	CpG: 24	311	24	191	15.4	61.4	0.83
chr2	158008562	158008860	CpG: 24	298	24	182	16.1	61.1	0.88
chr2	158050401	158050713	CpG: 31	312	31	223	19.9	71.5	0.80
chr2	158081446	158082283	CpG: 84	837	84	603	20.1	72.0	0.78
chr2	158085987	158086265	CpG: 25	278	25	176	18.0	63.3	0.91
chr2	158106977	158107258	CpG: 21	281	21	172	14.9	61.2	0.82
chr2	158173542	158173778	CpG: 19	236	19	142	16.1	60.2	0.91
chr2	158272219	158272497	CpG: 24	278	24	174	17.3	62.6	0.89
chr2	158328747	158329907	CpG: 147	1160	147	907	25.3	78.2	0.86
chr2	158370866	158371391	CpG: 40	525	40	289	15.2	55.0	1.01
chr2	158913465	158915106	CpG: 182	1641	182	1196	22.2	72.9	0.84
chr2	158979426	158979785	CpG: 26	359	26	214	14.5	59.6	0.82
chr2	159087844	159088058	CpG: 16	214	16	123	15.0	57.5	0.93
chr2	159242462	159242700	CpG: 18	238	18	140	15.1	58.8	0.89
chr2	159257837	159258061	CpG: 20	224	20	135	17.9	60.3	0.98
chr2	159358006	159358283	CpG: 23	277	23	170	16.6	61.4	0.89
chr2	159363708	159363931	CpG: 18	223	18	129	16.1	57.8	0.98
chr2	159429934	159431927	CpG: 171	1993	171	1309	17.2	65.7	0.81
chr2	159524748	159525033	CpG: 21	285	21	175	14.7	61.4	0.80
chr2	159577271	159577508	CpG: 16	237	16	141	13.5	59.5	0.78
chr2	159740269	159740543	CpG: 24	274	24	171	17.5	62.4	0.91
chr2	159745960	159746897	CpG: 91	937	91	635	19.4	67.8	0.85
chr2	159948664	159948935	CpG: 24	271	24	168	17.7	62.0	0.93
chr2	159952422	159952696	CpG: 24	274	24	170	17.5	62.0	0.92
chr2	159976436	159976718	CpG: 23	282	23	174	16.3	61.7	0.87
chr2	160051460	160051742	CpG: 21	282	21	174	14.9	61.7	0.79
chr2	160072929	160073577	CpG: 60	648	60	426	18.5	65.7	0.86
chr2	160087905	160088193	CpG: 24	288	24	178	16.7	61.8	0.89
chr2	160169489	160170531	CpG: 102	1042	102	722	19.6	69.3	0.83
chr2	160201363	160201638	CpG: 22	275	22	169	16.0	61.5	0.86
chr2	160255060	160255722	CpG: 82	662	82	479	24.8	72.4	0.96
chr2	160362345	160363193	CpG: 79	848	79	593	18.6	69.9	0.76
chr2	160506763	160507000	CpG: 21	237	21	146	17.7	61.6	0.96
chr2	160519815	160520527	CpG: 65	712	65	507	18.3	71.2	0.76
chr2	160727320	160727874	CpG: 48	554	48	364	17.3	65.7	0.82
chr2	160852816	160853052	CpG: 19	236	19	144	16.1	61.0	0.89
chr2	160864466	160865787	CpG: 167	1321	167	964	25.3	73.0	0.96
chr2	160867421	160867654	CpG: 17	233	17	139	14.6	59.7	0.83
chr2	160896323	160897441	CpG: 85	1118	85	790	15.2	70.7	0.61
chr2	160913217	160913491	CpG: 25	274	25	172	18.2	62.8	0.94
chr2	160934117	160934383	CpG: 23	266	23	167	17.3	62.8	0.89
chr2	160941740	160942201	CpG: 37	461	37	275	16.1	59.7	0.91
chr2	160950245	160951540	CpG: 125	1295	125	919	19.3	71.0	0.77
chr2	160992937	160993171	CpG: 19	234	19	142	16.2	60.7	0.90
chr2	161106651	161106860	CpG: 20	209	20	148	19.1	70.8	0.77
chr2	161141210	161141441	CpG: 21	231	21	142	18.2	61.5	0.98
chr2	161314755	161315064	CpG: 22	309	22	182	14.2	58.9	0.83
chr2	161427606	161427891	CpG: 24	285	24	181	16.8	63.5	0.85
chr2	161618619	161619067	CpG: 39	448	39	274	17.4	61.2	0.97
chr2	161696253	161697988	CpG: 152	1735	152	1103	17.5	63.6	0.87
chr2	161703232	161703508	CpG: 33	276	33	220	23.9	79.7	0.75
chr2	161766458	161767031	CpG: 57	573	57	382	19.9	66.7	0.90
chr2	161799276	161799671	CpG: 63	395	63	331	31.9	83.8	0.91
chr2	161872720	161873245	CpG: 58	525	58	386	22.1	73.5	0.82
chr2	161875126	161875557	CpG: 30	431	30	273	13.9	63.3	0.71
chr2	161876999	161877434	CpG: 45	435	45	295	20.7	67.8	0.90
chr2	161881679	161882741	CpG: 134	1062	134	757	25.2	71.3	1.01
chr2	161885425	161886579	CpG: 99	1154	99	721	17.2	62.5	0.89
chr2	161923030	161923308	CpG: 20	278	20	167	14.4	60.1	0.81
chr2	161964234	161964450	CpG: 37	216	37	168	34.3	77.8	1.21
chr2	162001505	162001779	CpG: 23	274	23	168	16.8	61.3	0.91
chr2	162284203	162284441	CpG: 19	238	19	144	16.0	60.5	0.89
chr2	162289386	162289631	CpG: 20	245	20	145	16.3	59.2	0.95
chr2	162316255	162316487	CpG: 20	232	20	144	17.2	62.1	0.93
chr2	162363397	162363645	CpG: 20	248	20	151	16.1	60.9	0.89
chr2	162530378	162531084	CpG: 81	706	81	492	22.9	69.7	0.96
chr2	162719345	162719614	CpG: 22	269	22	167	16.4	62.1	0.87
chr2	162775047	162775301	CpG: 28	254	28	187	22.0	73.6	0.83
chr2	162800725	162801175	CpG: 46	450	46	314	20.4	69.8	0.85
chr2	162926480	162927338	CpG: 67	858	67	595	15.6	69.3	0.65
chr2	163181040	163181314	CpG: 23	274	23	169	16.8	61.7	0.90
chr2	163299324	163299556	CpG: 19	232	19	140	16.4	60.3	0.91
chr2	163483615	163484008	CpG: 33	393	33	289	16.8	73.5	0.62
chr2	163556440	163556667	CpG: 20	227	20	142	17.6	62.6	0.95
chr2	163559524	163559798	CpG: 20	274	20	164	14.6	59.9	0.82
chr2	163805524	163805823	CpG: 28	299	28	196	18.7	65.6	0.90
chr2	163828772	163829046	CpG: 24	274	24	170	17.5	62.0	0.92
chr2	164029891	164030179	CpG: 20	288	20	174	13.9	60.4	0.77
chr2	164193419	164194286	CpG: 91	867	91	621	21.0	71.6	0.82
chr2	164307988	164308261	CpG: 20	273	20	167	14.7	61.2	0.80
chr2	164366788	164367179	CpG: 34	391	34	283	17.4	72.4	0.66
chr2	164370877	164371273	CpG: 38	396	38	289	19.2	73.0	0.72
chr2	164371862	164372077	CpG: 18	215	18	122	16.7	56.7	1.07
chr2	164561594	164561862	CpG: 20	268	20	159	14.9	59.3	0.85
chr2	164616583	164616799	CpG: 17	216	17	126	15.7	58.3	0.94
chr2	164627321	164627558	CpG: 21	237	21	145	17.7	61.2	0.97
chr2	164990604	164990828	CpG: 18	224	18	137	16.1	61.2	0.89
chr2	165078361	165079141	CpG: 101	780	101	615	25.9	78.8	0.85
chr2	165087172	165087457	CpG: 24	285	24	178	16.8	62.5	0.88
chr2	165129746	165130028	CpG: 24	282	24	176	17.0	62.4	0.89
chr2	165258481	165258755	CpG: 23	274	23	170	16.8	62.0	0.88
chr2	165260608	165260844	CpG: 22	236	22	146	18.6	61.9	0.99
chr2	165298318	165299742	CpG: 145	1424	145	1012	20.4	71.1	0.81
chr2	165452102	165452458	CpG: 32	356	32	261	18.0	73.3	0.67
chr2	165504779	165505074	CpG: 27	295	27	180	18.3	61.0	1.00
chr2	165760588	165760858	CpG: 23	270	23	167	17.0	61.9	0.90
chr2	165798421	165798657	CpG: 18	236	18	138	15.3	58.5	0.92
chr2	165807783	165808049	CpG: 23	266	23	166	17.3	62.4	0.90
chr2	165919371	165919601	CpG: 19	230	19	136	16.5	59.1	0.96
chr2	165943274	165943668	CpG: 30	394	30	235	15.2	59.6	0.86
chr2	166194570	166194880	CpG: 25	310	25	191	16.1	61.6	0.85
chr2	166250896	166251960	CpG: 99	1064	99	747	18.6	70.2	0.76
chr2	166263575	166263808	CpG: 16	233	16	137	13.7	58.8	0.81
chr2	166265773	166266054	CpG: 23	281	23	174	16.4	61.9	0.87
chr2	166410989	166411860	CpG: 77	871	77	576	17.7	66.1	0.81
chr2	166414547	166415135	CpG: 64	588	64	440	21.8	74.8	0.78
chr2	166657568	166657842	CpG: 24	274	24	171	17.5	62.4	0.91
chr2	166671983	166672249	CpG: 23	266	23	166	17.3	62.4	0.90
chr2	166680081	166680354	CpG: 23	273	23	166	16.8	60.8	0.92
chr2	166833358	166833681	CpG: 31	323	31	234	19.2	72.4	0.74
chr2	166843925	166844199	CpG: 25	274	25	173	18.2	63.1	0.92
chr2	167007624	167007889	CpG: 19	265	19	166	14.3	62.6	0.74
chr2	167446562	167446854	CpG: 24	292	24	178	16.4	61.0	0.89
chr2	167545544	167545768	CpG: 19	224	19	133	17.0	59.4	0.96
chr2	167622123	167622403	CpG: 22	280	22	168	15.7	60.0	0.88
chr2	167750408	167752172	CpG: 177	1764	177	1219	20.1	69.1	0.84
chr2	168173893	168174178	CpG: 26	285	26	196	18.2	68.8	0.78
chr2	168329811	168330040	CpG: 20	229	20	140	17.5	61.1	0.96
chr2	168334079	168334314	CpG: 19	235	19	143	16.2	60.9	0.90
chr2	168381418	168381689	CpG: 24	271	24	171	17.7	63.1	0.90
chr2	168703909	168705415	CpG: 178	1506	178	1096	23.6	72.8	0.89
chr2	168745307	168745538	CpG: 20	231	20	142	17.3	61.5	0.93
chr2	168913678	168914883	CpG: 126	1205	126	850	20.9	70.5	0.84
chr2	169218292	169218534	CpG: 23	242	23	152	19.0	62.8	0.98
chr2	169364653	169364939	CpG: 22	286	22	180	15.4	62.9	0.87
chr2	169655580	169655858	CpG: 25	278	25	175	18.0	62.9	0.92
chr2	169724827	169725119	CpG: 23	292	23	178	15.8	61.0	0.85
chr2	169837804	169839035	CpG: 119	1231	119	833	19.3	67.7	0.86
chr2	169840262	169840608	CpG: 44	346	44	254	25.4	73.4	1.00
chr2	169949732	169950010	CpG: 24	278	24	174	17.3	62.6	0.89
chr2	169955984	169956559	CpG: 66	575	66	382	23.0	66.4	1.04
chr2	169957349	169957585	CpG: 17	236	17	141	14.4	59.7	0.82
chr2	169961933	169962212	CpG: 25	279	25	175	17.9	62.7	0.92
chr2	170052449	170053165	CpG: 57	716	57	496	15.9	69.3	0.66
chr2	170061445	170061990	CpG: 42	545	42	344	15.4	63.1	0.78
chr2	170173875	170174463	CpG: 60	588	60	394	20.4	67.0	0.92
chr2	170213172	170214063	CpG: 130	891	130	683	29.2	76.7	1.01
chr2	170248176	170248972	CpG: 78	796	78	554	19.6	69.6	0.81
chr2	170276313	170276781	CpG: 53	468	53	320	22.6	68.4	0.97
chr2	170302263	170302631	CpG: 49	368	49	273	26.6	74.2	0.99
chr2	170304916	170305685	CpG: 101	769	101	572	26.3	74.4	0.96
chr2	170319065	170319449	CpG: 30	384	30	274	15.6	71.4	0.61
chr2	170333431	170334202	CpG: 59	771	59	534	15.3	69.3	0.64
chr2	170353642	170353871	CpG: 16	229	16	136	14.0	59.4	0.80
chr2	171140505	171140712	CpG: 16	207	16	123	15.5	59.4	0.89
chr2	171188940	171189485	CpG: 44	545	44	351	16.1	64.4	0.83
chr2	171190495	171194526	CpG: 383	4031	383	2717	19.0	67.4	0.84
chr2	171241095	171241369	CpG: 19	274	19	163	13.9	59.5	0.79
chr2	171244473	171244709	CpG: 19	236	19	138	16.1	58.5	0.96
chr2	171246227	171246503	CpG: 21	276	21	163	15.2	59.1	0.88
chr2	171247878	171248715	CpG: 91	837	91	609	21.7	72.8	0.85
chr2	171290743	171291182	CpG: 31	439	31	254	14.1	57.9	0.86
chr2	171292231	171292437	CpG: 16	206	16	135	15.5	65.5	0.72
chr2	171292943	171296080	CpG: 245	3137	245	1967	15.6	62.7	0.80
chr2	171297185	171297613	CpG: 34	428	34	271	15.9	63.3	0.79
chr2	171299179	171300992	CpG: 122	1813	122	1137	13.5	62.7	0.68
chr2	171331572	171331813	CpG: 17	241	17	142	14.1	58.9	0.83
chr2	171378145	171378377	CpG: 16	232	16	138	13.8	59.5	0.80
chr2	171406101	171407026	CpG: 109	925	109	665	23.6	71.9	0.91
chr2	171450514	171451312	CpG: 71	798	71	554	17.8	69.4	0.74
chr2	171637132	171638463	CpG: 167	1331	167	1001	25.1	75.2	0.90
chr2	171671692	171671961	CpG: 21	269	21	166	15.6	61.7	0.82
chr2	171742113	171742349	CpG: 17	236	17	139	14.4	58.9	0.84
chr2	171910994	171911926	CpG: 104	932	104	674	22.3	72.3	0.85
chr2	171994458	171994840	CpG: 32	382	32	246	16.8	64.4	0.81
chr2	171999461	172000828	CpG: 118	1367	118	934	17.3	68.3	0.75
chr2	172165327	172165589	CpG: 24	262	24	177	18.3	67.6	0.80
chr2	172251652	172252416	CpG: 59	764	59	528	15.4	69.1	0.65
chr2	172297924	172298198	CpG: 25	274	25	172	18.2	62.8	0.93
chr2	172370133	172370367	CpG: 18	234	18	137	15.4	58.5	0.93
chr2	172372056	172372358	CpG: 49	302	49	229	32.5	75.8	1.13
chr2	172377187	172378224	CpG: 88	1037	88	754	17.0	72.7	0.64
chr2	172400034	172400600	CpG: 56	566	56	362	19.8	64.0	0.97
chr2	172485925	172486376	CpG: 61	451	61	325	27.1	72.1	1.04
chr2	172495278	172495547	CpG: 21	269	21	164	15.6	61.0	0.85
chr2	172566503	172566899	CpG: 36	396	36	235	18.2	59.3	1.06
chr2	172567426	172567727	CpG: 23	301	23	184	15.3	61.1	0.82
chr2	172569358	172569715	CpG: 33	357	33	230	18.5	64.4	0.90
chr2	172570757	172571641	CpG: 87	884	87	625	19.7	70.7	0.81
chr2	172572804	172573674	CpG: 60	870	60	522	13.8	60.0	0.77
chr2	172574324	172574675	CpG: 26	351	26	228	14.8	65.0	0.72
chr2	172580782	172583569	CpG: 195	2787	195	1800	14.0	64.6	0.67
chr2	172585138	172585650	CpG: 55	512	55	366	21.5	71.5	0.85
chr2	172586277	172589372	CpG: 234	3095	234	2015	15.1	65.1	0.73
chr2	172592554	172592896	CpG: 24	342	24	218	14.0	63.7	0.69
chr2	172594238	172594730	CpG: 37	492	37	317	15.0	64.4	0.73
chr2	172597177	172597450	CpG: 23	273	23	173	16.8	63.4	0.85
chr2	172613177	172613435	CpG: 18	258	18	156	14.0	60.5	0.77
chr2	172658851	172659279	CpG: 53	428	53	314	24.8	73.4	0.92
chr2	172721033	172721649	CpG: 51	616	51	389	16.6	63.1	0.85
chr2	172801446	172801873	CpG: 33	427	33	258	15.5	60.4	0.85
chr2	172870201	172870431	CpG: 24	230	24	145	20.9	63.0	1.08
chr2	172913620	172914704	CpG: 123	1084	123	774	22.7	71.4	0.89
chr2	173041724	173042967	CpG: 143	1243	143	868	23.0	69.8	0.95
chr2	173155555	173155817	CpG: 19	262	19	161	14.5	61.5	0.78
chr2	173186696	173187080	CpG: 29	384	29	261	15.1	68.0	0.65
chr2	173222042	173222735	CpG: 90	693	90	545	26.0	78.6	0.84
chr2	173306029	173306303	CpG: 24	274	24	169	17.5	61.7	0.94
chr2	173510786	173511060	CpG: 22	274	22	169	16.1	61.7	0.86
chr2	173562220	173563077	CpG: 123	857	123	652	28.7	76.1	1.00
chr2	173653505	173653782	CpG: 20	277	20	165	14.4	59.6	0.83
chr2	173730223	173730519	CpG: 23	296	23	176	15.5	59.5	0.89
chr2	173769218	173769576	CpG: 29	358	29	262	16.2	73.2	0.61
chr2	173820114	173820396	CpG: 22	282	22	174	15.6	61.7	0.84
chr2	173841024	173841859	CpG: 91	835	91	582	21.8	69.7	0.90
chr2	173844140	173844414	CpG: 20	274	20	163	14.6	59.5	0.83
chr2	173903026	173903284	CpG: 20	258	20	164	15.5	63.6	0.77
chr2	173935919	173936195	CpG: 20	276	20	168	14.5	60.9	0.79
chr2	174191332	174191675	CpG: 29	343	29	206	16.9	60.1	0.94
chr2	174195716	174195982	CpG: 19	266	19	159	14.3	59.8	0.81
chr2	174254313	174254600	CpG: 20	287	20	176	13.9	61.3	0.76
chr2	174293802	174294080	CpG: 22	278	22	171	15.8	61.5	0.84
chr2	174347645	174347874	CpG: 17	229	17	133	14.8	58.1	0.90
chr2	174449924	174452211	CpG: 256	2287	256	1679	22.4	73.4	0.83
chr2	174499178	174499530	CpG: 36	352	36	253	20.5	71.9	0.88
chr2	174511858	174512429	CpG: 46	571	46	368	16.1	64.4	0.78
chr2	174736632	174737449	CpG: 87	817	87	591	21.3	72.3	0.81
chr2	174814827	174816084	CpG: 93	1257	93	783	14.8	62.3	0.76
chr2	174817244	174817725	CpG: 34	481	34	297	14.1	61.7	0.74
chr2	174823422	174826601	CpG: 323	3179	323	2063	20.3	64.9	0.97
chr2	174828805	174831515	CpG: 202	2710	202	1640	14.9	60.5	0.81
chr2	174832377	174833038	CpG: 54	661	54	440	16.3	66.6	0.74
chr2	174884513	174884971	CpG: 35	458	35	250	15.3	54.6	1.03
chr2	174898723	174899012	CpG: 26	289	26	176	18.0	60.9	0.97
chr2	174937176	174937457	CpG: 22	281	22	173	15.7	61.6	0.84
chr2	174963675	174963953	CpG: 25	278	25	175	18.0	62.9	0.92
chr2	174975300	174976090	CpG: 67	790	67	569	17.0	72.0	0.67
chr2	175037277	175037545	CpG: 21	268	21	193	15.7	72.0	0.61
chr2	175170834	175171852	CpG: 136	1018	136	774	26.7	76.0	0.93
chr2	175208500	175208766	CpG: 26	266	26	165	19.5	62.0	1.02
chr2	175218488	175219225	CpG: 56	737	56	475	15.2	64.5	0.74
chr2	175278554	175278825	CpG: 20	271	20	168	14.8	62.0	0.79
chr2	175306361	175306687	CpG: 23	326	23	180	14.1	55.2	0.94
chr2	175476840	175477070	CpG: 19	230	19	138	16.5	60.0	0.93
chr2	175493441	175494316	CpG: 120	875	120	669	27.4	76.5	0.94
chr2	175596473	175597403	CpG: 82	930	82	675	17.6	72.6	0.67
chr2	175656447	175657337	CpG: 68	890	68	559	15.3	62.8	0.77
chr2	175670024	175670559	CpG: 46	535	46	359	17.2	67.1	0.76
chr2	175745652	175746242	CpG: 66	590	66	441	22.4	74.7	0.80
chr2	175755867	175756141	CpG: 23	274	23	171	16.8	62.4	0.87
chr2	175922035	175922322	CpG: 25	287	25	179	17.4	62.4	0.91
chr2	175976248	175976674	CpG: 33	426	33	255	15.5	59.9	0.87
chr2	176082913	176083130	CpG: 20	217	20	129	18.4	59.4	1.05
chr2	176193135	176193558	CpG: 31	423	31	253	14.7	59.8	0.83
chr2	176273889	176274170	CpG: 23	281	23	175	16.4	62.3	0.86
chr2	176388861	176389146	CpG: 25	285	25	179	17.5	62.8	0.90
chr2	176490074	176490569	CpG: 48	495	48	347	19.4	70.1	0.79
chr2	176554956	176556044	CpG: 78	1088	78	687	14.3	63.1	0.72
chr2	176556512	176556830	CpG: 29	318	29	193	18.2	60.7	1.00
chr2	176559627	176560190	CpG: 48	563	48	363	17.1	64.5	0.82
chr2	176567472	176571831	CpG: 337	4359	337	2663	15.5	61.1	0.83
chr2	176572903	176573187	CpG: 21	284	21	143	14.8	50.4	1.17
chr2	176573385	176573728	CpG: 30	343	30	220	17.5	64.1	0.85
chr2	176573987	176574238	CpG: 19	251	19	151	15.1	60.2	0.84
chr2	176576087	176576690	CpG: 54	603	54	399	17.9	66.2	0.82
chr2	176580447	176581672	CpG: 136	1225	136	880	22.2	71.8	0.87
chr2	176585572	176585880	CpG: 31	308	31	209	20.1	67.9	0.88
chr2	176587455	176588902	CpG: 118	1447	118	909	16.3	62.8	0.83
chr2	176592611	176593289	CpG: 58	678	58	449	17.1	66.2	0.78
chr2	176595037	176596301	CpG: 170	1264	170	923	26.9	73.0	1.01
chr2	176596827	176597118	CpG: 26	291	26	193	17.9	66.3	0.82
chr2	176600684	176600940	CpG: 19	256	19	163	14.8	63.7	0.73
chr2	176604165	176604823	CpG: 58	658	58	453	17.6	68.8	0.74
chr2	176605507	176605802	CpG: 24	295	24	200	16.3	67.8	0.71
chr2	176607212	176607414	CpG: 17	202	17	116	16.8	57.4	1.03
chr2	176609830	176611697	CpG: 186	1867	186	1260	19.9	67.5	0.87
chr2	176612746	176612996	CpG: 21	250	21	174	16.8	69.6	0.70
chr2	176616370	176616606	CpG: 16	236	16	141	13.6	59.7	0.77
chr2	176616899	176618977	CpG: 231	2078	231	1411	22.2	67.9	0.96
chr2	176624635	176625197	CpG: 60	562	60	395	21.4	70.3	0.87
chr2	176627866	176628107	CpG: 25	241	25	161	20.7	66.8	0.93
chr2	176628778	176629080	CpG: 35	302	35	216	23.2	71.5	0.91
chr2	176638362	176638628	CpG: 18	266	18	141	13.5	53.0	0.99
chr2	176639830	176640903	CpG: 84	1073	84	707	15.7	65.9	0.74
chr2	176645138	176646076	CpG: 77	938	77	556	16.4	59.3	0.95
chr2	176647915	176649106	CpG: 93	1191	93	775	15.6	65.1	0.74
chr2	176651031	176651428	CpG: 27	397	27	237	13.6	59.7	0.77
chr2	176652827	176653651	CpG: 65	824	65	484	15.8	58.7	0.92
chr2	176659666	176660625	CpG: 95	959	95	642	19.8	66.9	0.90
chr2	176662963	176663363	CpG: 30	400	30	242	15.0	60.5	0.83
chr2	176666155	176666848	CpG: 69	693	69	476	19.9	68.7	0.84
chr2	176674717	176674953	CpG: 20	236	20	140	16.9	59.3	0.99
chr2	176676360	176677753	CpG: 157	1393	157	983	22.5	70.6	0.91
chr2	176696443	176696720	CpG: 24	277	24	175	17.3	63.2	0.88
chr2	176744580	176744850	CpG: 22	270	22	168	16.3	62.2	0.85
chr2	176757419	176757928	CpG: 56	509	56	360	22.0	70.7	0.89
chr2	176972391	176972845	CpG: 35	454	35	317	15.4	69.8	0.63
chr2	177092015	177092250	CpG: 17	235	17	139	14.5	59.1	0.84
chr2	177115551	177115830	CpG: 25	279	25	177	17.9	63.4	0.90
chr2	177119626	177120475	CpG: 97	849	97	578	22.9	68.1	0.99
chr2	177217408	177217640	CpG: 17	232	17	136	14.7	58.6	0.86
chr2	177249319	177249559	CpG: 23	240	23	150	19.2	62.5	1.00
chr2	177537239	177537529	CpG: 25	290	25	182	17.2	62.8	0.89
chr2	177692453	177692762	CpG: 23	309	23	184	14.9	59.5	0.86
chr2	177694699	177695729	CpG: 125	1030	125	724	24.3	70.3	0.99
chr2	177696758	177697024	CpG: 24	266	24	164	18.0	61.7	0.97
chr2	177745789	177747363	CpG: 185	1574	185	1136	23.5	72.2	0.90
chr2	177874773	177875438	CpG: 80	665	80	480	24.1	72.2	0.95
chr2	178034842	178035508	CpG: 60	666	60	411	18.0	61.7	0.95
chr2	178100817	178101367	CpG: 59	550	59	347	21.5	63.1	1.08
chr2	178109360	178109636	CpG: 23	276	23	168	16.7	60.9	0.91
chr2	178116710	178116980	CpG: 20	270	20	168	14.8	62.2	0.77
chr2	178266533	178266807	CpG: 24	274	24	172	17.5	62.8	0.90
chr2	178327705	178328503	CpG: 59	798	59	547	14.8	68.5	0.63
chr2	178455923	178456215	CpG: 24	292	24	178	16.4	61.0	0.89
chr2	178555359	178555915	CpG: 39	556	39	352	14.0	63.3	0.70
chr2	178595109	178595859	CpG: 56	750	56	503	14.9	67.1	0.67
chr2	178676622	178678155	CpG: 177	1533	177	1114	23.1	72.7	0.87
chr2	178793299	178793529	CpG: 16	230	16	136	13.9	59.1	0.81
chr2	178896392	178896734	CpG: 36	342	36	242	21.1	70.8	0.86
chr2	178929551	178929781	CpG: 18	230	18	138	15.7	60.0	0.88
chr2	178933280	178934639	CpG: 131	1359	131	939	19.3	69.1	0.81
chr2	178934771	178935043	CpG: 19	272	19	147	14.0	54.0	0.97
chr2	178961322	178961567	CpG: 31	245	31	167	25.3	68.2	1.11
chr2	178962919	178963824	CpG: 102	905	102	651	22.5	71.9	0.88
chr2	179168939	179169213	CpG: 23	274	23	170	16.8	62.0	0.88
chr2	179182234	179182807	CpG: 39	573	39	329	13.6	57.4	0.84
chr2	179406214	179406488	CpG: 23	274	23	170	16.8	62.0	0.88
chr2	179747103	179748148	CpG: 144	1045	144	794	27.6	76.0	0.96
chr2	180007543	180007821	CpG: 19	278	19	166	13.7	59.7	0.78
chr2	180146596	180146877	CpG: 23	281	23	168	16.4	59.8	0.94
chr2	180153178	180153445	CpG: 23	267	23	166	17.2	62.2	0.90
chr2	180344219	180344967	CpG: 97	748	97	566	25.9	75.7	0.91
chr2	180446638	180446912	CpG: 23	274	23	171	16.8	62.4	0.88
chr2	180490178	180490425	CpG: 27	247	27	159	21.9	64.4	1.12
chr2	180505134	180505350	CpG: 20	216	20	134	18.5	62.0	0.96
chr2	180631516	180631791	CpG: 23	275	23	164	16.7	59.6	0.96
chr2	180936511	180936792	CpG: 24	281	24	175	17.1	62.3	0.90
chr2	181068508	181068793	CpG: 25	285	25	180	17.5	63.2	0.89
chr2	181174917	181175271	CpG: 34	354	34	260	19.2	73.4	0.71
chr2	181175651	181175899	CpG: 21	248	21	142	16.9	57.3	1.07
chr2	181322712	181323139	CpG: 32	427	32	256	15.0	60.0	0.84
chr2	181338543	181338779	CpG: 20	236	20	142	16.9	60.2	0.96
chr2	181356841	181357089	CpG: 33	248	33	180	26.6	72.6	1.06
chr2	181390436	181390862	CpG: 32	426	32	255	15.0	59.9	0.84
chr2	181469704	181470879	CpG: 171	1175	171	916	29.1	78.0	0.96
chr2	181917888	181918124	CpG: 21	236	21	146	17.8	61.9	0.95
chr2	181947519	181948787	CpG: 119	1268	119	852	18.8	67.2	0.83
chr2	182146596	182147302	CpG: 67	706	67	501	19.0	71.0	0.77
chr2	182170589	182171025	CpG: 41	436	41	290	18.8	66.5	0.90
chr2	182173254	182174558	CpG: 115	1304	115	880	17.6	67.5	0.80
chr2	182217551	182217781	CpG: 20	230	20	141	17.4	61.3	0.94
chr2	182381397	182382579	CpG: 135	1182	135	858	22.8	72.6	0.87
chr2	182418445	182418716	CpG: 23	271	23	169	17.0	62.4	0.88
chr2	182470735	182471009	CpG: 24	274	24	171	17.5	62.4	0.91
chr2	182486050	182486261	CpG: 17	211	17	130	16.1	61.6	0.87
chr2	182519991	182520195	CpG: 16	204	16	117	15.7	57.4	0.96
chr2	183097131	183097632	CpG: 46	501	46	368	18.4	73.5	0.68
chr2	183112654	183112886	CpG: 18	232	18	140	15.5	60.3	0.86
chr2	183204902	183205411	CpG: 61	509	61	372	24.0	73.1	0.90
chr2	183355039	183355588	CpG: 38	549	38	366	13.8	66.7	0.63
chr2	183356049	183356323	CpG: 26	274	26	197	19.0	71.9	0.74
chr2	183460141	183460419	CpG: 24	278	24	174	17.3	62.6	0.89
chr2	183526696	183527919	CpG: 149	1223	149	896	24.4	73.3	0.92
chr2	183700013	183700288	CpG: 24	275	24	170	17.5	61.8	0.92
chr2	183749679	183749919	CpG: 27	240	27	165	22.5	68.8	0.96
chr2	184054850	184055119	CpG: 21	269	21	162	15.6	60.2	0.87
chr2	184545778	184546018	CpG: 20	240	20	148	16.7	61.7	0.89
chr2	184654441	184654715	CpG: 23	274	23	169	16.8	61.7	0.89
chr2	184674206	184674408	CpG: 17	202	17	120	16.8	59.4	0.98
chr2	184816431	184816709	CpG: 23	278	23	201	16.5	72.3	0.63
chr2	184950165	184950427	CpG: 23	262	23	160	17.6	61.1	0.94
chr2	185054337	185054611	CpG: 23	274	23	170	16.8	62.0	0.88
chr2	185056340	185056603	CpG: 20	263	20	153	15.2	58.2	0.91
chr2	185086808	185087640	CpG: 102	832	102	597	24.5	71.8	0.95
chr2	185092915	185093154	CpG: 18	239	18	140	15.1	58.6	0.90
chr2	185096654	185096932	CpG: 25	278	25	174	18.0	62.6	0.93
chr2	185385550	185385824	CpG: 25	274	25	172	18.2	62.8	0.93
chr2	185542522	185542796	CpG: 24	274	24	171	17.5	62.4	0.91
chr2	185621505	185621975	CpG: 39	470	39	347	16.6	73.8	0.61
chr2	185705724	185706010	CpG: 21	286	21	175	14.7	61.2	0.79
chr2	185710297	185710526	CpG: 20	229	20	138	17.5	60.3	0.97
chr2	185914090	185914401	CpG: 24	311	24	186	15.4	59.8	0.87
chr2	185993989	185994264	CpG: 23	275	23	170	16.7	61.8	0.89
chr2	186080580	186080805	CpG: 17	225	17	132	15.1	58.7	0.88
chr2	186227730	186228249	CpG: 53	519	53	374	20.4	72.1	0.80
chr2	186414256	186414534	CpG: 22	278	22	169	15.8	60.8	0.87
chr2	186418787	186418997	CpG: 17	210	17	129	16.2	61.4	0.88
chr2	186519386	186519671	CpG: 19	285	19	169	13.3	59.3	0.76
chr2	186833280	186833554	CpG: 25	274	25	173	18.2	63.1	0.93
chr2	186975056	186976170	CpG: 87	1114	87	672	15.6	60.3	0.87
chr2	187003979	187004260	CpG: 22	281	22	173	15.7	61.6	0.84
chr2	187078748	187079698	CpG: 101	950	101	670	21.3	70.5	0.86
chr2	187105452	187105730	CpG: 26	278	26	179	18.7	64.4	0.91
chr2	187183024	187183420	CpG: 49	396	49	302	24.7	76.3	0.86
chr2	187338399	187338622	CpG: 23	223	23	152	20.6	68.2	0.90
chr2	187451230	187451844	CpG: 51	614	51	425	16.6	69.2	0.70
chr2	187579138	187579377	CpG: 22	239	22	144	18.4	60.3	1.05
chr2	187785050	187785281	CpG: 17	231	17	139	14.7	60.2	0.83
chr2	187863916	187864197	CpG: 24	281	24	175	17.1	62.3	0.90
chr2	188125762	188126313	CpG: 52	551	52	411	18.9	74.6	0.68
chr2	188554891	188555165	CpG: 21	274	21	164	15.3	59.9	0.86
chr2	188604034	188604266	CpG: 18	232	18	142	15.5	61.2	0.85
chr2	188609221	188609441	CpG: 18	220	18	134	16.4	60.9	0.89
chr2	188610615	188610824	CpG: 15	209	15	126	14.4	60.3	0.80
chr2	188612496	188612806	CpG: 25	310	25	186	16.1	60.0	0.91
chr2	188776258	188776508	CpG: 20	250	20	140	16.0	56.0	1.05
chr2	188780462	188781765	CpG: 108	1303	108	835	16.6	64.1	0.82
chr2	189069109	189069383	CpG: 24	274	24	171	17.5	62.4	0.91
chr2	189095206	189095749	CpG: 46	543	46	392	16.9	72.2	0.65
chr2	189289102	189289338	CpG: 17	236	17	144	14.4	61.0	0.79
chr2	189404663	189404940	CpG: 23	277	23	170	16.6	61.4	0.89
chr2	189461604	189461837	CpG: 20	233	20	141	17.2	60.5	0.95
chr2	189583609	189583883	CpG: 25	274	25	173	18.2	63.1	0.92
chr2	189676924	189677189	CpG: 19	265	19	161	14.3	60.8	0.79
chr2	189693167	189693437	CpG: 20	270	20	164	14.8	60.7	0.81
chr2	189826445	189826723	CpG: 25	278	25	176	18.0	63.3	0.91
chr2	189930724	189931000	CpG: 26	276	26	165	18.8	59.8	1.15
chr2	190069972	190070499	CpG: 77	527	77	391	29.2	74.2	1.06
chr2	190150591	190150952	CpG: 34	361	34	230	18.8	63.7	0.93
chr2	190163542	190164049	CpG: 57	507	57	363	22.5	71.6	0.88
chr2	190208003	190208284	CpG: 22	281	22	173	15.7	61.6	0.84
chr2	190273123	190274041	CpG: 103	918	103	628	22.4	68.4	0.96
chr2	190311303	190311568	CpG: 29	265	29	195	21.9	73.6	0.83
chr2	190368776	190369105	CpG: 24	329	24	205	14.6	62.3	0.75
chr2	190445552	190445826	CpG: 23	274	23	170	16.8	62.0	0.88
chr2	190604708	190604982	CpG: 24	274	24	170	17.5	62.0	0.92
chr2	190669839	190670689	CpG: 87	850	87	629	20.5	74.0	0.75
chr2	190809168	190809612	CpG: 45	444	45	293	20.3	66.0	0.93
chr2	190833150	190833844	CpG: 99	694	99	529	28.5	76.2	0.99
chr2	190897011	190898198	CpG: 142	1187	142	886	23.9	74.6	0.86
chr2	190919985	190920890	CpG: 71	905	71	645	15.7	71.3	0.62
chr2	190972220	190972506	CpG: 23	286	23	177	16.1	61.9	0.85
chr2	191023599	191024339	CpG: 93	740	93	540	25.1	73.0	0.94
chr2	191137528	191139022	CpG: 175	1494	175	1070	23.4	71.6	0.92
chr2	191206322	191206592	CpG: 24	270	24	170	17.8	63.0	0.91
chr2	191249444	191249648	CpG: 16	204	16	118	15.7	57.8	0.99
chr2	191250189	191250638	CpG: 47	449	47	334	20.9	74.4	0.76
chr2	191338148	191338421	CpG: 23	273	23	167	16.8	61.2	0.91
chr2	191369670	191370977	CpG: 140	1307	140	932	21.4	71.3	0.84
chr2	191502995	191503640	CpG: 70	645	70	438	21.7	67.9	0.94
chr2	191509336	191509799	CpG: 59	463	59	320	25.5	69.1	1.07
chr2	191621936	191622213	CpG: 20	277	20	169	14.4	61.0	0.78
chr2	191734187	191735299	CpG: 136	1112	136	818	24.5	73.6	0.91
chr2	191833653	191833927	CpG: 22	274	22	170	16.1	62.0	0.85
chr2	192166728	192167748	CpG: 88	1020	88	649	17.3	63.6	0.85
chr2	192311248	192311490	CpG: 18	242	18	137	14.9	56.6	0.94
chr2	192370180	192370492	CpG: 35	312	35	218	22.4	69.9	0.94
chr2	192409841	192410169	CpG: 31	328	31	240	18.9	73.2	0.71
chr2	192410913	192411171	CpG: 21	258	21	143	16.3	55.4	1.11
chr2	192442125	192442397	CpG: 20	272	20	165	14.7	60.7	0.81
chr2	192463549	192463835	CpG: 24	286	24	180	16.8	62.9	0.86
chr2	192682960	192684777	CpG: 149	1817	149	1199	16.4	66.0	0.76
chr2	192706665	192706902	CpG: 22	237	22	147	18.6	62.0	0.99
chr2	192762801	192763107	CpG: 26	306	26	183	17.0	59.8	0.96
chr2	192794823	192795102	CpG: 24	279	24	171	17.2	61.3	0.93
chr2	192897484	192897717	CpG: 22	233	22	144	18.9	61.8	1.00
chr2	193329462	193329693	CpG: 20	231	20	141	17.3	61.0	0.94
chr2	193382005	193382698	CpG: 53	693	53	464	15.3	67.0	0.68
chr2	193463149	193463423	CpG: 25	274	25	172	18.2	62.8	0.94
chr2	193581823	193582053	CpG: 20	230	20	142	17.4	61.7	0.92
chr2	193659225	193659452	CpG: 20	227	20	134	17.6	59.0	1.01
chr2	193706370	193706781	CpG: 32	411	32	250	15.6	60.8	0.85
chr2	193909913	193910143	CpG: 19	230	19	140	16.5	60.9	0.90
chr2	193978597	193978807	CpG: 16	210	16	125	15.2	59.5	0.89
chr2	193990733	193991228	CpG: 41	495	41	361	16.6	72.9	0.62
chr2	194002367	194002645	CpG: 24	278	24	173	17.3	62.2	0.90
chr2	194022077	194022351	CpG: 25	274	25	172	18.2	62.8	0.93
chr2	194028970	194029244	CpG: 22	274	22	169	16.1	61.7	0.86
chr2	194108810	194109092	CpG: 21	282	21	167	14.9	59.2	0.86
chr2	194162567	194162848	CpG: 24	281	24	174	17.1	61.9	0.90
chr2	194236269	194236569	CpG: 24	300	24	183	16.0	61.0	0.87
chr2	194271655	194271894	CpG: 17	239	17	142	14.2	59.4	0.83
chr2	194303929	194304158	CpG: 18	229	18	141	15.7	61.6	0.85
chr2	194386005	194386235	CpG: 19	230	19	139	16.5	60.4	0.92
chr2	194441601	194441836	CpG: 19	235	19	139	16.2	59.1	0.94
chr2	194442124	194442355	CpG: 17	231	17	141	14.7	61.0	0.81
chr2	194725907	194726182	CpG: 21	275	21	167	15.3	60.7	0.84
chr2	195032962	195033241	CpG: 22	279	22	172	15.8	61.6	0.84
chr2	195235926	195236204	CpG: 25	278	25	174	18.0	62.6	0.93
chr2	195389194	195389431	CpG: 17	237	17	135	14.3	57.0	0.89
chr2	195558499	195558741	CpG: 20	242	20	145	16.5	59.9	0.92
chr2	196031698	196032202	CpG: 46	504	46	371	18.3	73.6	0.67
chr2	196047472	196047677	CpG: 16	205	16	167	15.6	81.5	1.12
chr2	196141171	196142566	CpG: 152	1395	152	926	21.8	66.4	1.01
chr2	196552610	196552965	CpG: 34	355	34	240	19.2	67.6	0.84
chr2	196654934	196655932	CpG: 117	998	117	732	23.4	73.3	0.88
chr2	197038145	197038407	CpG: 25	262	25	165	19.1	63.0	0.98
chr2	197076762	197077892	CpG: 164	1130	164	855	29.0	75.7	1.01
chr2	197123498	197123865	CpG: 38	367	38	251	20.7	68.4	0.89
chr2	197283159	197283519	CpG: 31	360	31	217	17.2	60.3	0.96
chr2	197283654	197283920	CpG: 21	266	21	160	15.8	60.2	0.88
chr2	197389425	197389735	CpG: 25	310	25	190	16.1	61.3	0.86
chr2	197410294	197410556	CpG: 39	262	39	201	29.8	76.7	1.04
chr2	197410696	197410956	CpG: 18	260	18	155	13.8	59.6	0.80
chr2	197614925	197615202	CpG: 25	277	25	174	18.1	62.8	0.92
chr2	197637913	197638197	CpG: 24	284	24	176	16.9	62.0	0.89
chr2	197647942	197648430	CpG: 39	488	39	348	16.0	71.3	0.63
chr2	197677300	197677548	CpG: 18	248	18	148	14.5	59.7	0.83
chr2	197793672	197794836	CpG: 148	1164	148	867	25.4	74.5	0.94
chr2	197854294	197854716	CpG: 40	422	40	313	19.0	74.2	0.69
chr2	197855225	197855430	CpG: 18	205	18	116	17.6	56.6	1.14
chr2	197918159	197919135	CpG: 76	976	76	559	15.6	57.3	0.95
chr2	197934202	197934461	CpG: 24	259	24	192	18.5	74.1	0.68
chr2	197935743	197936016	CpG: 22	273	22	172	16.1	63.0	0.82
chr2	197936891	197937555	CpG: 66	664	66	420	19.9	63.3	1.06
chr2	197982566	197984282	CpG: 165	1716	165	1143	19.2	66.6	0.87
chr2	197999299	198000177	CpG: 83	878	83	607	18.9	69.1	0.79
chr2	198014703	198014936	CpG: 17	233	17	139	14.6	59.7	0.84
chr2	198025233	198025511	CpG: 24	278	24	173	17.3	62.2	0.90
chr2	198074224	198074429	CpG: 16	205	16	114	15.6	55.6	1.04
chr2	198088893	198089133	CpG: 17	240	17	143	14.2	59.6	0.82
chr2	198101864	198102842	CpG: 74	978	74	684	15.1	69.9	0.62
chr2	198124049	198124408	CpG: 32	359	32	215	17.8	59.9	1.00
chr2	198188867	198189904	CpG: 106	1037	106	681	20.4	65.7	0.95
chr2	198268684	198270768	CpG: 180	2084	180	1373	17.3	65.9	0.79
chr2	198288014	198289095	CpG: 129	1081	129	786	23.9	72.7	0.90
chr2	198319918	198320150	CpG: 18	232	18	140	15.5	60.3	0.86
chr2	198383233	198383507	CpG: 24	274	24	171	17.5	62.4	0.91
chr2	198997520	198997756	CpG: 18	236	18	144	15.3	61.0	0.84
chr2	199089062	199089303	CpG: 19	241	19	146	15.8	60.6	0.88
chr2	199132267	199132545	CpG: 20	278	20	170	14.4	61.2	0.78
chr2	199346857	199347135	CpG: 24	278	24	174	17.3	62.6	0.89
chr2	199361984	199362207	CpG: 17	223	17	137	15.2	61.4	0.81
chr2	199407050	199407282	CpG: 17	232	17	139	14.7	59.9	0.84
chr2	199939554	199948727	CpG: 636	9173	636	5412	13.9	59.0	0.80
chr2	199952733	199953218	CpG: 41	485	41	307	16.9	63.3	0.85
chr2	199954543	199955459	CpG: 74	916	74	582	16.2	63.5	0.80
chr2	199970127	199970357	CpG: 17	230	17	138	14.8	60.0	0.84
chr2	200037290	200037609	CpG: 24	319	24	201	15.0	63.0	0.76
chr2	200087604	200088011	CpG: 37	407	37	270	18.2	66.3	0.83
chr2	200094787	200095062	CpG: 21	275	21	170	15.3	61.8	0.81
chr2	200143033	200143236	CpG: 35	203	35	156	34.5	76.8	1.17
chr2	200144508	200144736	CpG: 16	228	16	134	14.0	58.8	0.82
chr2	200215282	200215512	CpG: 19	230	19	140	16.5	60.9	0.90
chr2	200334284	200334965	CpG: 86	681	86	500	25.3	73.4	0.94
chr2	200355213	200355453	CpG: 20	240	20	145	16.7	60.4	0.94
chr2	200394612	200395414	CpG: 89	802	89	539	22.2	67.2	1.01
chr2	200438955	200439679	CpG: 65	724	65	478	18.0	66.0	0.82
chr2	200658198	200658718	CpG: 54	520	54	386	20.8	74.2	0.75
chr2	200790074	200791366	CpG: 191	1292	191	990	29.6	76.6	1.01
chr2	200993193	200993725	CpG: 70	532	70	400	26.3	75.2	0.94
chr2	201007990	201008264	CpG: 24	274	24	173	17.5	63.1	0.89
chr2	201009463	201009995	CpG: 51	532	51	350	19.2	65.8	0.89
chr2	201069283	201069784	CpG: 47	501	47	328	18.8	65.5	0.88
chr2	201279393	201279671	CpG: 25	278	25	176	18.0	63.3	0.90
chr2	201294700	201296017	CpG: 140	1317	140	914	21.3	69.4	0.89
chr2	201347158	201348302	CpG: 111	1144	111	713	19.4	62.3	1.00
chr2	201371990	201372316	CpG: 28	326	28	198	17.2	60.7	0.93
chr2	201391692	201391966	CpG: 22	274	22	166	16.1	60.6	0.88
chr2	201446738	201447237	CpG: 53	499	53	343	21.2	68.7	0.90
chr2	201447424	201447658	CpG: 20	234	20	141	17.1	60.3	0.95
chr2	201525601	201526370	CpG: 61	769	61	559	15.9	72.7	0.60
chr2	201532819	201533048	CpG: 16	229	16	132	14.0	57.6	0.85
chr2	201553815	201554051	CpG: 19	236	19	141	16.1	59.7	0.92
chr2	201554743	201555095	CpG: 29	352	29	235	16.5	66.8	0.88
chr2	201566171	201566456	CpG: 24	285	24	178	16.8	62.5	0.88
chr2	201577840	201578106	CpG: 18	266	18	164	13.5	61.7	0.72
chr2	201580851	201581125	CpG: 23	274	23	170	16.8	62.0	0.88
chr2	201599222	201600408	CpG: 98	1186	98	748	16.5	63.1	0.83
chr2	201601917	201602428	CpG: 38	511	38	314	14.9	61.4	0.80
chr2	201623410	201623614	CpG: 26	204	26	153	25.5	75.0	0.92
chr2	201649583	201650301	CpG: 58	718	58	509	16.2	70.9	0.64
chr2	201839161	201839402	CpG: 21	241	21	147	17.4	61.0	0.96
chr2	201890699	201890944	CpG: 18	245	18	152	14.7	62.0	0.78
chr2	201931913	201933068	CpG: 124	1155	124	832	21.5	72.0	0.83
chr2	201954685	201954964	CpG: 19	279	19	169	13.6	60.6	0.75
chr2	202075897	202076133	CpG: 21	236	21	147	17.8	62.3	0.93
chr2	202099513	202099886	CpG: 29	373	29	238	15.5	63.8	0.77
chr2	202123068	202124199	CpG: 104	1131	104	742	18.4	65.6	0.86
chr2	202247337	202247611	CpG: 22	274	22	169	16.1	61.7	0.86
chr2	202261579	202262347	CpG: 62	768	62	469	16.1	61.1	0.87
chr2	202274054	202274292	CpG: 19	238	19	144	16.0	60.5	0.89
chr2	202307071	202307348	CpG: 21	277	21	167	15.2	60.3	0.85
chr2	202337822	202338110	CpG: 25	288	25	178	17.4	61.8	0.92
chr2	202509628	202509868	CpG: 20	240	20	148	16.7	61.7	0.90
chr2	202513535	202517200	CpG: 378	3665	378	2463	20.6	67.2	0.91
chr2	202617530	202617834	CpG: 34	304	34	227	22.4	74.7	0.82
chr2	202652305	202652550	CpG: 28	245	28	171	22.9	69.8	0.94
chr2	202677256	202677523	CpG: 22	267	22	164	16.5	61.4	0.89
chr2	202718929	202719642	CpG: 60	713	60	480	16.8	67.3	0.75
chr2	202720248	202720528	CpG: 20	280	20	164	14.3	58.6	0.84
chr2	202746383	202747070	CpG: 53	687	53	395	15.4	57.5	0.94
chr2	202848046	202848348	CpG: 23	302	23	181	15.2	59.9	0.85
chr2	202852135	202852376	CpG: 19	241	19	144	15.8	59.8	0.90
chr2	202855469	202855747	CpG: 21	278	21	164	15.1	59.0	0.88
chr2	202856183	202858748	CpG: 218	2565	218	1611	17.0	62.8	0.86
chr2	202888554	202888802	CpG: 17	248	17	147	13.7	59.3	0.79
chr2	202921257	202921728	CpG: 34	471	34	319	14.4	67.7	0.63
chr2	202955580	202955851	CpG: 19	271	19	163	14.0	60.1	0.78
chr2	202965643	202965849	CpG: 16	206	16	127	15.5	61.7	0.83
chr2	202995218	202995491	CpG: 19	273	19	167	13.9	61.2	0.75
chr2	203008565	203008840	CpG: 23	275	23	169	16.7	61.5	0.90
chr2	203015885	203017077	CpG: 98	1192	98	877	16.4	73.6	0.61
chr2	203049167	203049441	CpG: 23	274	23	171	16.8	62.4	0.88
chr2	203116098	203117433	CpG: 167	1335	167	999	25.0	74.8	0.90
chr2	203126738	203127179	CpG: 30	441	30	264	13.6	59.9	0.76
chr2	203196555	203196987	CpG: 41	432	41	336	19.0	77.8	0.63
chr2	203255658	203255888	CpG: 35	230	35	172	30.4	74.8	1.09
chr2	203267716	203268000	CpG: 24	284	24	175	16.9	61.6	0.91
chr2	203352659	203353617	CpG: 106	958	106	665	22.1	69.4	0.92
chr2	203354005	203354284	CpG: 24	279	24	173	17.2	62.0	0.91
chr2	203393589	203394253	CpG: 60	664	60	443	18.1	66.7	0.81
chr2	203398369	203398656	CpG: 25	287	25	180	17.4	62.7	0.89
chr2	203444500	203444772	CpG: 19	272	19	166	14.0	61.0	0.76
chr2	203496041	203496684	CpG: 59	643	59	442	18.4	68.7	0.79
chr2	203688052	203688844	CpG: 60	792	60	539	15.2	68.1	0.66
chr2	203720067	203720960	CpG: 91	893	91	591	20.4	66.2	0.93
chr2	203809870	203810955	CpG: 123	1085	123	761	22.7	70.1	0.93
chr2	203854368	203855223	CpG: 69	855	69	597	16.1	69.8	0.66
chr2	203890763	203891044	CpG: 24	281	24	176	17.1	62.6	0.89
chr2	203901111	203901318	CpG: 16	207	16	120	15.5	58.0	0.93
chr2	204016679	204017560	CpG: 121	881	121	676	27.5	76.7	0.95
chr2	204033149	204033386	CpG: 18	237	18	143	15.2	60.3	0.86
chr2	204100606	204100873	CpG: 18	267	18	162	13.5	60.7	0.74
chr2	204123813	204124064	CpG: 21	251	21	144	16.7	57.4	1.05
chr2	204124785	204125095	CpG: 33	310	33	230	21.3	74.2	0.78
chr2	204258655	204258925	CpG: 19	270	19	161	14.1	59.6	0.80
chr2	204260672	204260937	CpG: 20	265	20	165	15.1	62.3	0.79
chr2	204267453	204267840	CpG: 34	387	34	283	17.6	73.1	0.66
chr2	204393507	204393778	CpG: 23	271	23	164	17.0	60.5	0.94
chr2	204468796	204469077	CpG: 22	281	22	174	15.7	61.9	0.83
chr2	204640885	204641115	CpG: 17	230	17	140	14.8	60.9	0.81
chr2	204991952	204992227	CpG: 24	275	24	171	17.5	62.2	0.91
chr2	205027515	205028485	CpG: 108	970	108	721	22.3	74.3	0.81
chr2	205311979	205312253	CpG: 20	274	20	167	14.6	60.9	0.80
chr2	205400638	205400912	CpG: 23	274	23	169	16.8	61.7	0.89
chr2	205459794	205460033	CpG: 18	239	18	147	15.1	61.5	0.82
chr2	205478993	205479352	CpG: 28	359	28	212	15.6	59.1	0.90
chr2	205628642	205628874	CpG: 18	232	18	140	15.5	60.3	0.86
chr2	205736925	205737196	CpG: 23	271	23	172	17.0	63.5	0.85
chr2	206164229	206165193	CpG: 109	964	109	679	22.6	70.4	0.91
chr2	206167222	206168937	CpG: 144	1715	144	1113	16.8	64.9	0.80
chr2	206407890	206408092	CpG: 20	202	20	141	19.8	69.8	0.81
chr2	206422372	206422576	CpG: 18	204	18	124	17.6	60.8	0.96
chr2	206456298	206456534	CpG: 17	236	17	144	14.4	61.0	0.79
chr2	206532623	206532901	CpG: 25	278	25	171	18.0	61.5	0.96
chr2	206566877	206567778	CpG: 107	901	107	692	23.8	76.8	0.81
chr2	206580148	206580384	CpG: 18	236	18	143	15.3	60.6	0.85
chr2	206588393	206588675	CpG: 23	282	23	173	16.3	61.3	0.88
chr2	206623158	206623412	CpG: 18	254	18	154	14.2	60.6	0.79
chr2	206639886	206640107	CpG: 17	221	17	138	15.4	62.4	0.81
chr2	206641079	206642151	CpG: 94	1072	94	666	17.5	62.1	0.91
chr2	206653577	206654386	CpG: 63	809	63	560	15.6	69.2	0.65
chr2	206685980	206686248	CpG: 19	268	19	159	14.2	59.3	0.82
chr2	206732742	206733021	CpG: 22	279	22	168	15.8	60.2	0.87
chr2	206756481	206757225	CpG: 100	744	100	558	26.9	75.0	0.97
chr2	206812489	206812825	CpG: 25	336	25	194	14.9	57.7	0.90
chr2	206925496	206926288	CpG: 126	792	126	637	31.8	80.4	1.00
chr2	207032749	207033034	CpG: 27	285	27	176	18.9	61.8	1.01
chr2	207065332	207065557	CpG: 17	225	17	132	15.1	58.7	0.89
chr2	207124159	207124807	CpG: 53	648	53	429	16.4	66.2	0.77
chr2	207247267	207247549	CpG: 25	282	25	167	17.7	59.2	1.03
chr2	207346599	207346850	CpG: 21	251	21	153	16.7	61.0	0.91
chr2	207508141	207508381	CpG: 22	240	22	148	18.3	61.7	0.99
chr2	207511398	207511679	CpG: 24	281	24	174	17.1	61.9	0.91
chr2	207530035	207530271	CpG: 20	236	20	142	16.9	60.2	0.96
chr2	207648318	207649321	CpG: 112	1003	112	713	22.3	71.1	0.89
chr2	207657276	207657552	CpG: 21	276	21	171	15.2	62.0	0.80
chr2	208003227	208004649	CpG: 185	1422	185	1059	26.0	74.5	0.94
chr2	208098771	208100373	CpG: 157	1602	157	1104	19.6	68.9	0.83
chr2	208105015	208105247	CpG: 16	232	16	136	13.8	58.6	0.83
chr2	208112031	208112252	CpG: 18	221	18	133	16.3	60.2	0.91
chr2	208155858	208156338	CpG: 64	480	64	364	26.7	75.8	0.93
chr2	208184617	208184891	CpG: 21	274	21	167	15.3	60.9	0.83
chr2	208185478	208186583	CpG: 116	1105	116	780	21.0	70.6	0.85
chr2	208211145	208211419	CpG: 18	274	18	163	13.1	59.5	0.75
chr2	208241044	208244420	CpG: 322	3376	322	2313	19.1	68.5	0.81
chr2	208244728	208244964	CpG: 18	236	18	140	15.3	59.3	0.89
chr2	208273297	208273577	CpG: 21	280	21	176	15.0	62.9	0.77
chr2	208318585	208318826	CpG: 18	241	18	144	14.9	59.8	0.85
chr2	208354704	208354938	CpG: 20	234	20	140	17.1	59.8	0.98
chr2	208405049	208405384	CpG: 29	335	29	200	17.3	59.7	0.97
chr2	208417839	208418113	CpG: 24	274	24	172	17.5	62.8	0.90
chr2	208422847	208423085	CpG: 24	238	24	148	20.2	62.2	1.06
chr2	208499722	208499935	CpG: 24	213	24	152	22.5	71.4	0.90
chr2	208518210	208518462	CpG: 20	252	20	152	15.9	60.3	0.88
chr2	208549764	208549978	CpG: 16	214	16	127	15.0	59.3	0.86
chr2	208592205	208592701	CpG: 47	496	47	346	19.0	69.8	0.79
chr2	208604127	208604562	CpG: 40	435	40	307	18.4	70.6	0.76
chr2	208613827	208614046	CpG: 16	219	16	130	14.6	59.4	0.85
chr2	208707624	208707835	CpG: 18	211	18	154	17.1	73.0	0.64
chr2	208722561	208722791	CpG: 18	230	18	140	15.7	60.9	0.86
chr2	208733949	208734322	CpG: 30	373	30	253	16.1	67.8	0.72
chr2	208734952	208735380	CpG: 40	428	40	284	18.7	66.4	0.85
chr2	208745815	208746202	CpG: 39	387	39	265	20.2	68.5	0.87
chr2	208747360	208747612	CpG: 19	252	19	152	15.1	60.3	0.83
chr2	208840057	208840465	CpG: 32	408	32	284	15.7	69.6	0.65
chr2	208857239	208858057	CpG: 59	818	59	567	14.4	69.3	0.60
chr2	208886402	208887052	CpG: 70	650	70	453	21.5	69.7	0.89
chr2	209038313	209038591	CpG: 21	278	21	170	15.1	61.2	0.82
chr2	209303295	209303502	CpG: 16	207	16	126	15.5	60.9	0.84
chr2	209328989	209329199	CpG: 15	210	15	124	14.3	59.0	0.83
chr2	209625234	209625508	CpG: 24	274	24	185	17.5	67.5	0.79
chr2	209688903	209689424	CpG: 44	521	44	348	16.9	66.8	0.77
chr2	209727534	209727815	CpG: 23	281	23	174	16.4	61.9	0.87
chr2	209808811	209809054	CpG: 22	243	22	147	18.1	60.5	1.00
chr2	209867120	209867623	CpG: 46	503	46	365	18.3	72.6	0.69
chr2	209875916	209876186	CpG: 20	270	20	162	14.8	60.0	0.84
chr2	209903879	209904264	CpG: 51	385	51	303	26.5	78.7	0.86
chr2	210231972	210232305	CpG: 25	333	25	193	15.0	58.0	0.90
chr2	210251759	210252400	CpG: 69	641	69	476	21.5	74.3	0.80
chr2	210288593	210288958	CpG: 30	365	30	221	16.4	60.5	0.90
chr2	210289440	210289661	CpG: 17	221	17	146	15.4	66.1	0.74
chr2	210292215	210292488	CpG: 21	273	21	161	15.4	59.0	0.89
chr2	210345460	210345700	CpG: 18	240	18	144	15.0	60.0	0.84
chr2	210483156	210483760	CpG: 52	604	52	392	17.2	64.9	0.82
chr2	210494826	210495090	CpG: 18	264	18	158	13.6	59.8	0.76
chr2	210514297	210514545	CpG: 19	248	19	142	15.3	57.3	0.96
chr2	210651470	210652614	CpG: 110	1144	110	771	19.2	67.4	0.86
chr2	210705391	210706154	CpG: 85	763	85	535	22.3	70.1	0.91
chr2	210945462	210945752	CpG: 23	290	23	178	15.9	61.4	0.87
chr2	210957253	210957609	CpG: 34	356	34	241	19.1	67.7	0.86
chr2	211045172	211045439	CpG: 19	267	19	163	14.2	61.0	0.77
chr2	211110070	211110341	CpG: 23	271	23	166	17.0	61.3	0.91
chr2	211120067	211120348	CpG: 23	281	23	174	16.4	61.9	0.87
chr2	211138064	211138340	CpG: 23	276	23	172	16.7	62.3	0.86
chr2	211406141	211406398	CpG: 20	257	20	156	15.6	60.7	0.86
chr2	211430981	211431712	CpG: 56	731	56	502	15.3	68.7	0.65
chr2	211553418	211553691	CpG: 21	273	21	163	15.4	59.7	0.88
chr2	211689284	211689511	CpG: 18	227	18	139	15.9	61.2	0.87
chr2	211690509	211690778	CpG: 19	269	19	161	14.1	59.9	0.80
chr2	211700053	211700296	CpG: 21	243	21	145	17.3	59.7	0.97
chr2	211707575	211707848	CpG: 23	273	23	173	16.8	63.4	0.85
chr2	211895639	211895916	CpG: 25	277	25	176	18.1	63.5	0.91
chr2	212043313	212043543	CpG: 18	230	18	140	15.7	60.9	0.85
chr2	212065642	212065872	CpG: 17	230	17	136	14.8	59.1	0.87
chr2	212142312	212142590	CpG: 26	278	26	177	18.7	63.7	0.93
chr2	212181761	212182001	CpG: 19	240	19	147	15.8	61.2	0.86
chr2	212196687	212196961	CpG: 22	274	22	170	16.1	62.0	0.84
chr2	212282283	212282549	CpG: 23	266	23	162	17.3	60.9	0.96
chr2	212368829	212369164	CpG: 28	335	28	201	16.7	60.0	0.93
chr2	212540923	212541197	CpG: 23	274	23	170	16.8	62.0	0.88
chr2	212825623	212825832	CpG: 16	209	16	120	15.3	57.4	0.95
chr2	213017606	213019786	CpG: 172	2180	172	1354	15.8	62.1	0.82
chr2	213038033	213038263	CpG: 18	230	18	132	15.7	57.4	0.97
chr2	213168226	213168492	CpG: 20	266	20	164	15.0	61.7	0.80
chr2	213190756	213191034	CpG: 24	278	24	173	17.3	62.2	0.90
chr2	213201832	213202250	CpG: 38	418	38	306	18.2	73.2	0.68
chr2	213312427	213314128	CpG: 180	1701	180	1157	21.2	68.0	0.92
chr2	213350106	213350380	CpG: 23	274	23	169	16.8	61.7	0.89
chr2	213418447	213418666	CpG: 17	219	17	136	15.5	62.1	0.82
chr2	213632479	213633227	CpG: 118	748	118	552	31.6	73.8	1.16
chr2	213671278	213671540	CpG: 21	262	21	160	16.0	61.1	0.88
chr2	213672118	213672402	CpG: 22	284	22	172	15.5	60.6	0.86
chr2	213679957	213680187	CpG: 21	230	21	141	18.3	61.3	0.99
chr2	213765115	213765584	CpG: 50	469	50	328	21.3	69.9	0.90
chr2	213773268	213773534	CpG: 22	266	22	165	16.5	62.0	0.87
chr2	213851012	213851286	CpG: 20	274	20	167	14.6	60.9	0.80
chr2	213872613	213872879	CpG: 22	266	22	167	16.5	62.8	0.85
chr2	213993376	213993661	CpG: 21	285	21	175	14.7	61.4	0.80
chr2	214058001	214058351	CpG: 27	350	27	208	15.4	59.4	0.88
chr2	214073632	214073913	CpG: 24	281	24	176	17.1	62.6	0.88
chr2	214141026	214141268	CpG: 18	242	18	151	14.9	62.4	0.78
chr2	214203489	214203700	CpG: 16	211	16	148	15.2	70.1	0.65
chr2	214222296	214222567	CpG: 21	271	21	163	15.5	60.1	0.86
chr2	214227715	214227970	CpG: 20	255	20	157	15.7	61.6	0.85
chr2	214262264	214262492	CpG: 17	228	17	135	14.9	59.2	0.88
chr2	214775506	214775742	CpG: 19	236	19	143	16.1	60.6	0.90
chr2	214821058	214821340	CpG: 25	282	25	179	17.7	63.5	0.89
chr2	214906413	214906684	CpG: 23	271	23	165	17.0	60.9	0.92
chr2	215006615	215006851	CpG: 17	236	17	141	14.4	59.7	0.82
chr2	215168477	215168709	CpG: 20	232	20	140	17.2	60.3	0.95
chr2	215203319	215203601	CpG: 24	282	24	175	17.0	62.1	0.90
chr2	215245374	215245596	CpG: 15	222	15	134	13.5	60.4	0.76
chr2	215293858	215294915	CpG: 119	1057	119	745	22.5	70.5	0.93
chr2	215391500	215391774	CpG: 23	274	23	168	16.8	61.3	0.91
chr2	215511793	215512031	CpG: 21	238	21	138	17.6	58.0	1.08
chr2	215703060	215703341	CpG: 24	281	24	174	17.1	61.9	0.91
chr2	215781688	215782115	CpG: 32	427	32	251	15.0	58.8	0.90
chr2	215796858	215797441	CpG: 63	583	63	430	21.6	73.8	0.80
chr2	215808038	215808287	CpG: 19	249	19	147	15.3	59.0	0.90
chr2	215920570	215921296	CpG: 64	726	64	505	17.6	69.6	0.73
chr2	216030399	216030670	CpG: 22	271	22	163	16.2	60.1	0.91
chr2	216100458	216100690	CpG: 25	232	25	173	21.6	74.6	0.78
chr2	216291295	216291527	CpG: 16	232	16	135	13.8	58.2	0.84
chr2	216495810	216496084	CpG: 20	274	20	165	14.6	60.2	0.81
chr2	216498607	216499060	CpG: 60	453	60	329	26.5	72.6	1.01
chr2	216567005	216567415	CpG: 40	410	40	288	19.5	70.2	0.80
chr2	216594487	216594946	CpG: 49	459	49	284	21.4	61.9	1.13
chr2	216853420	216854526	CpG: 101	1106	101	757	18.3	68.4	0.78
chr2	216894737	216895257	CpG: 45	520	45	336	17.3	64.6	0.84
chr2	216981214	216981516	CpG: 28	302	28	196	18.5	64.9	0.89
chr2	217049042	217049325	CpG: 21	283	21	173	14.8	61.1	0.81
chr2	217115465	217116548	CpG: 133	1083	133	786	24.6	72.6	0.94
chr2	217174507	217174881	CpG: 29	374	29	242	15.5	64.7	0.78
chr2	217176746	217177191	CpG: 48	445	48	317	21.6	71.2	0.85
chr2	217367699	217367973	CpG: 25	274	25	200	18.2	73.0	0.69
chr2	217632088	217632585	CpG: 34	497	34	284	13.7	57.1	0.84
chr2	217719941	217720222	CpG: 23	281	23	175	16.4	62.3	0.86
chr2	217831473	217831747	CpG: 26	274	26	174	19.0	63.5	0.95
chr2	217883188	217883470	CpG: 22	282	22	174	15.6	61.7	0.84
chr2	218239785	218240090	CpG: 29	305	29	215	19.0	70.5	0.77
chr2	218463324	218463873	CpG: 48	549	48	385	17.5	70.1	0.72
chr2	218494820	218495564	CpG: 77	744	77	547	20.7	73.5	0.79
chr2	218518602	218518947	CpG: 31	345	31	253	18.0	73.3	0.69
chr2	218538402	218538637	CpG: 19	235	19	142	16.2	60.4	0.91
chr2	218702632	218703542	CpG: 90	910	90	638	19.8	70.1	0.82
chr2	218755765	218756371	CpG: 59	606	59	400	19.5	66.0	0.90
chr2	218777962	218778361	CpG: 49	399	49	307	24.6	76.9	0.83
chr2	218808675	218809275	CpG: 67	600	67	462	22.3	77.0	0.76
chr2	218819739	218820020	CpG: 21	281	21	172	14.9	61.2	0.81
chr2	218853775	218854292	CpG: 59	517	59	370	22.8	71.6	0.89
chr2	218854443	218854716	CpG: 22	273	22	167	16.1	61.2	0.88
chr2	218873828	218874447	CpG: 42	619	42	403	13.6	65.1	0.65
chr2	218877356	218877617	CpG: 21	261	21	178	16.1	68.2	0.69
chr2	218884193	218886963	CpG: 258	2770	258	1911	18.6	69.0	0.78
chr2	218892412	218892873	CpG: 47	461	47	352	20.4	76.4	0.70
chr2	219012969	219013205	CpG: 23	236	23	149	19.5	63.1	1.01
chr2	219054614	219055941	CpG: 118	1327	118	844	17.8	63.6	0.88
chr2	219145735	219146411	CpG: 55	676	55	453	16.3	67.0	0.73
chr2	219158243	219158646	CpG: 31	403	31	259	15.4	64.3	0.78
chr2	219197281	219197913	CpG: 70	632	70	455	22.2	72.0	0.87
chr2	219265991	219266233	CpG: 18	242	18	146	14.9	60.3	0.85
chr2	219268266	219269016	CpG: 74	750	74	513	19.7	68.4	0.84
chr2	219331434	219331681	CpG: 18	247	18	140	14.6	56.7	0.94
chr2	219347381	219348689	CpG: 134	1308	134	927	20.5	70.9	0.85
chr2	219359813	219360273	CpG: 53	460	53	327	23.0	71.1	0.91
chr2	219361762	219362469	CpG: 86	707	86	508	24.3	71.9	0.95
chr2	219368643	219369436	CpG: 74	793	74	582	18.7	73.4	0.71
chr2	219371911	219372461	CpG: 74	550	74	424	26.9	77.1	0.96
chr2	219381104	219381647	CpG: 69	543	69	390	25.4	71.8	0.99
chr2	219386633	219387183	CpG: 44	550	44	338	16.0	61.5	0.87
chr2	219388549	219388786	CpG: 16	237	16	137	13.5	57.8	0.84
chr2	219397194	219397835	CpG: 52	641	52	407	16.2	63.5	0.81
chr2	219447803	219449516	CpG: 186	1713	186	1227	21.7	71.6	0.85
chr2	219451311	219451857	CpG: 40	546	40	342	14.7	62.6	0.76
chr2	219469944	219474194	CpG: 295	4250	295	2716	13.9	63.9	0.68
chr2	219481335	219482570	CpG: 122	1235	122	855	19.8	69.2	0.83
chr2	219484580	219484895	CpG: 33	315	33	223	21.0	70.8	0.92
chr2	219489710	219491757	CpG: 179	2047	179	1410	17.5	68.9	0.74
chr2	219529754	219529975	CpG: 19	221	19	129	17.2	58.4	1.02
chr2	219543793	219544203	CpG: 31	410	31	283	15.1	69.0	0.64
chr2	219545645	219549756	CpG: 319	4111	319	2816	15.5	68.5	0.66
chr2	219648452	219649447	CpG: 83	995	83	658	16.7	66.1	0.77
chr2	219664832	219667116	CpG: 199	2284	199	1489	17.4	65.2	0.82
chr2	219685261	219685467	CpG: 16	206	16	117	15.5	56.8	0.98
chr2	219691350	219691845	CpG: 65	495	65	367	26.3	74.1	0.96
chr2	219703035	219704056	CpG: 90	1021	90	704	17.6	69.0	0.74
chr2	219707883	219708154	CpG: 18	271	18	162	13.3	59.8	0.75
chr2	219714015	219714740	CpG: 86	725	86	496	23.7	68.4	1.01
chr2	219727889	219728393	CpG: 40	504	40	301	15.9	59.7	0.89
chr2	219730029	219730533	CpG: 40	504	40	341	15.9	67.7	0.69
chr2	219737982	219739451	CpG: 116	1469	116	995	15.8	67.7	0.69
chr2	219763913	219764667	CpG: 65	754	65	532	17.2	70.6	0.69
chr2	219779468	219780007	CpG: 56	539	56	397	20.8	73.7	0.77
chr2	219793051	219793301	CpG: 20	250	20	169	16.0	67.6	0.70
chr2	219793900	219794313	CpG: 43	413	43	298	20.8	72.2	0.81
chr2	219797425	219797955	CpG: 51	530	51	392	19.2	74.0	0.70
chr2	219800348	219800617	CpG: 25	269	25	170	18.6	63.2	0.94
chr2	219816477	219816814	CpG: 31	337	31	222	18.4	65.9	0.85
chr2	219842933	219843885	CpG: 72	952	72	656	15.1	68.9	0.65
chr2	219872059	219873488	CpG: 152	1429	152	1055	21.3	73.8	0.88
chr2	219902985	219903822	CpG: 101	837	101	601	24.1	71.8	0.94
chr2	219919541	219920301	CpG: 76	760	76	563	20.0	74.1	0.73
chr2	219926613	219927294	CpG: 83	681	83	528	24.4	77.5	0.83
chr2	219929691	219929947	CpG: 20	256	20	174	15.6	68.0	0.69
chr2	219932753	219934149	CpG: 153	1396	153	1036	21.9	74.2	0.80
chr2	219950506	219950905	CpG: 36	399	36	254	18.0	63.7	0.90
chr2	219968221	219969802	CpG: 145	1581	145	1159	18.3	73.3	0.68
chr2	219981538	219983656	CpG: 166	2118	166	1362	15.7	64.3	0.76
chr2	219997766	219997969	CpG: 15	203	15	133	14.8	65.5	0.70
chr2	220007071	220008071	CpG: 81	1000	81	698	16.2	69.8	0.67
chr2	220024133	220025312	CpG: 78	1179	78	780	13.2	66.2	0.61
chr2	220026340	220026817	CpG: 45	477	45	335	18.9	70.2	0.77
chr2	220027675	220029025	CpG: 140	1350	140	990	20.7	73.3	0.77
chr2	220032319	220032656	CpG: 26	337	26	239	15.4	70.9	0.61
chr2	220036840	220037846	CpG: 119	1006	119	725	23.7	72.1	0.92
chr2	220040705	220040970	CpG: 21	265	21	182	15.8	68.7	0.68
chr2	220047125	220047372	CpG: 19	247	19	158	15.4	64.0	0.77
chr2	220048092	220048319	CpG: 17	227	17	145	15.0	63.9	0.75
chr2	220052765	220053018	CpG: 23	253	23	165	18.2	65.2	0.86
chr2	220054778	220056158	CpG: 182	1380	182	1032	26.4	74.8	0.94
chr2	220082315	220082952	CpG: 55	637	55	408	17.3	64.1	0.84
chr2	220112112	220112794	CpG: 96	682	96	553	28.2	81.1	0.86
chr2	220205171	220205408	CpG: 19	237	19	143	16.0	60.3	0.91
chr2	220235804	220236304	CpG: 42	500	42	360	16.8	72.0	0.65
chr2	220416435	220416862	CpG: 31	427	31	259	14.5	60.7	0.79
chr2	220557974	220558249	CpG: 24	275	24	171	17.5	62.2	0.91
chr2	220625353	220625624	CpG: 22	271	22	164	16.2	60.5	0.90
chr2	220886002	220886272	CpG: 22	270	22	170	16.3	63.0	0.83
chr2	221014156	221014429	CpG: 24	273	24	170	17.6	62.3	0.91
chr2	221165748	221166022	CpG: 25	274	25	172	18.2	62.8	0.94
chr2	221307860	221308211	CpG: 25	351	25	211	14.2	60.1	0.80
chr2	221358974	221359242	CpG: 22	268	22	159	16.4	59.3	0.94
chr2	221457930	221458205	CpG: 19	275	19	165	13.8	60.0	0.79
chr2	221511177	221511447	CpG: 22	270	22	166	16.3	61.5	0.87
chr2	221654585	221654860	CpG: 22	275	22	169	16.0	61.5	0.85
chr2	221705524	221705798	CpG: 25	274	25	170	18.2	62.0	0.96
chr2	221906088	221906326	CpG: 19	238	19	145	16.0	60.9	0.90
chr2	222055880	222059294	CpG: 276	3414	276	2151	16.2	63.0	0.82
chr2	222345823	222346104	CpG: 24	281	24	175	17.1	62.3	0.90
chr2	222376712	222377570	CpG: 64	858	64	590	14.9	68.8	0.63
chr2	222469830	222470140	CpG: 24	310	24	188	15.5	60.6	0.84
chr2	222544673	222544915	CpG: 18	242	18	145	14.9	59.9	0.85
chr2	222569821	222570102	CpG: 24	281	24	175	17.1	62.3	0.89
chr2	222640437	222640653	CpG: 18	216	18	129	16.7	59.7	0.93
chr2	222776136	222776564	CpG: 41	428	41	306	19.2	71.5	0.76
chr2	222780132	222780894	CpG: 56	762	56	459	14.7	60.2	0.82
chr2	222781938	222782326	CpG: 34	388	34	251	17.5	64.7	0.84
chr2	222783281	222784319	CpG: 81	1038	81	672	15.6	64.7	0.75
chr2	222787620	222787975	CpG: 25	355	25	207	14.1	58.3	0.83
chr2	222789053	222789408	CpG: 26	355	26	223	14.6	62.8	0.74
chr2	222790886	222791540	CpG: 62	654	62	410	19.0	62.7	0.96
chr2	222796894	222797916	CpG: 74	1022	74	606	14.5	59.3	0.82
chr2	222803416	222805872	CpG: 260	2456	260	1729	21.2	70.4	0.85
chr2	222909406	222910497	CpG: 127	1091	127	778	23.3	71.3	0.92
chr2	223046204	223046424	CpG: 16	220	16	133	14.5	60.5	0.81
chr2	223140809	223141238	CpG: 37	429	37	270	17.2	62.9	0.87
chr2	223156468	223157006	CpG: 55	538	55	397	20.4	73.8	0.76
chr2	223189447	223189725	CpG: 22	278	22	170	15.8	61.2	0.86
chr2	223334811	223335076	CpG: 19	265	19	160	14.3	60.4	0.80
chr2	223346306	223347282	CpG: 130	976	130	736	26.6	75.4	0.94
chr2	223435495	223435725	CpG: 16	230	16	136	13.9	59.1	0.81
chr2	223535691	223536152	CpG: 34	461	34	296	14.8	64.2	0.72
chr2	223794109	223794348	CpG: 21	239	21	145	17.6	60.7	0.98
chr2	223899304	223899532	CpG: 17	228	17	140	14.9	61.4	0.81
chr2	224206687	224206928	CpG: 18	241	18	147	14.9	61.0	0.83
chr2	224252992	224253233	CpG: 22	241	22	149	18.3	61.8	0.97
chr2	224308226	224308470	CpG: 17	244	17	143	13.9	58.6	0.83
chr2	224320343	224321275	CpG: 106	932	106	658	22.7	70.6	0.94
chr2	224425804	224426085	CpG: 23	281	23	175	16.4	62.3	0.86
chr2	224427462	224428758	CpG: 131	1296	131	929	20.2	71.7	0.82
chr2	224440468	224441115	CpG: 65	647	65	420	20.1	64.9	0.95
chr2	224521739	224523253	CpG: 169	1514	169	1095	22.3	72.3	0.86
chr2	224847767	224848039	CpG: 23	272	23	173	16.9	63.6	0.85
chr2	224873906	224874145	CpG: 19	239	19	146	15.9	61.1	0.88
chr2	224915385	224915612	CpG: 18	227	18	140	15.9	61.7	0.89
chr2	224924438	224925770	CpG: 117	1332	117	864	17.6	64.9	0.85
chr2	225066754	225067986	CpG: 158	1232	158	934	25.6	75.8	0.92
chr2	225085903	225086294	CpG: 37	391	37	287	18.9	73.4	0.70
chr2	225137545	225137773	CpG: 21	228	21	169	18.4	74.1	0.67
chr2	225380777	225381049	CpG: 20	272	20	164	14.7	60.3	0.81
chr2	225387441	225387724	CpG: 25	283	25	175	17.7	61.8	0.94
chr2	225434830	225435066	CpG: 20	236	20	144	16.9	61.0	0.93
chr2	225442948	225443213	CpG: 23	265	23	164	17.4	61.9	0.92
chr2	225524205	225525106	CpG: 114	901	114	671	25.3	74.5	0.92
chr2	225569845	225570053	CpG: 15	208	15	122	14.4	58.7	0.85
chr2	225635840	225636114	CpG: 21	274	21	160	15.3	58.4	0.91
chr2	225696960	225697233	CpG: 22	273	22	170	16.1	62.3	0.84
chr2	225711276	225711667	CpG: 38	391	38	291	19.4	74.4	0.70
chr2	226063860	226064875	CpG: 74	1015	74	644	14.6	63.4	0.75
chr2	226226024	226226426	CpG: 41	402	41	298	20.4	74.1	0.74
chr2	226421833	226422134	CpG: 27	301	27	184	17.9	61.1	0.97
chr2	227059347	227059626	CpG: 23	279	23	172	16.5	61.6	0.88
chr2	227234147	227234417	CpG: 20	270	20	165	14.8	61.1	0.80
chr2	227274045	227274789	CpG: 74	744	74	509	19.9	68.4	0.85
chr2	227280224	227283054	CpG: 259	2830	259	1939	18.3	68.5	0.78
chr2	227318290	227319092	CpG: 90	802	90	550	22.4	68.6	0.96
chr2	227646721	227647775	CpG: 108	1054	108	774	20.5	73.4	0.77
chr2	227700863	227701076	CpG: 16	213	16	127	15.0	59.6	0.87
chr2	227759723	227759934	CpG: 16	211	16	127	15.2	60.2	0.86
chr2	227807795	227808460	CpG: 67	665	67	451	20.2	67.8	0.89
chr2	227814671	227814947	CpG: 24	276	24	170	17.4	61.6	0.93
chr2	227941986	227942216	CpG: 16	230	16	134	13.9	58.3	0.82
chr2	227954723	227955846	CpG: 136	1123	136	841	24.2	74.9	0.88
chr2	228200399	228200735	CpG: 30	336	30	219	17.9	65.2	0.84
chr2	228250515	228250731	CpG: 16	216	16	152	14.8	70.4	0.61
chr2	228329920	228330197	CpG: 24	277	24	174	17.3	62.8	0.89
chr2	228353844	228354158	CpG: 33	314	33	220	21.0	70.1	0.86
chr2	228419194	228419468	CpG: 22	274	22	169	16.1	61.7	0.86
chr2	228582117	228582384	CpG: 19	267	19	162	14.2	60.7	0.78
chr2	228663533	228664129	CpG: 45	596	45	388	15.1	65.1	0.71
chr2	228720443	228720679	CpG: 17	236	17	140	14.4	59.3	0.84
chr2	228847223	228847497	CpG: 24	274	24	171	17.5	62.4	0.91
chr2	228908200	228908425	CpG: 21	225	21	132	18.7	58.7	1.08
chr2	229050949	229051197	CpG: 22	248	22	148	17.7	59.7	1.00
chr2	229070615	229070833	CpG: 19	218	19	133	17.4	61.0	0.95
chr2	229094503	229094724	CpG: 18	221	18	133	16.3	60.2	0.91
chr2	229238313	229238673	CpG: 27	360	27	215	15.0	59.7	0.85
chr2	229376901	229377175	CpG: 25	274	25	172	18.2	62.8	0.93
chr2	229663405	229663634	CpG: 22	229	22	144	19.2	62.9	1.01
chr2	229753586	229754030	CpG: 64	444	64	349	28.8	78.6	0.94
chr2	229816613	229816832	CpG: 17	219	17	133	15.5	60.7	0.86
chr2	230185209	230185413	CpG: 16	204	16	123	15.7	60.3	0.87
chr2	230195914	230197833	CpG: 196	1919	196	1407	20.4	73.3	0.76
chr2	230245267	230245540	CpG: 24	273	24	173	17.6	63.4	0.88
chr2	230333421	230333841	CpG: 34	420	34	304	16.2	72.4	0.62
chr2	230403884	230405637	CpG: 156	1753	156	1183	17.8	67.5	0.83
chr2	230420938	230421150	CpG: 15	212	15	128	14.2	60.4	0.78
chr2	230446143	230446418	CpG: 19	275	19	162	13.8	58.9	0.80
chr2	230534641	230534876	CpG: 21	235	21	143	17.9	60.9	0.98
chr2	230550381	230551463	CpG: 107	1082	107	770	19.8	71.2	0.79
chr2	230632417	230632694	CpG: 26	277	26	172	18.8	62.1	0.98
chr2	230825259	230825476	CpG: 18	217	18	128	16.6	59.0	0.95
chr2	230943715	230944000	CpG: 25	285	25	179	17.5	62.8	0.90
chr2	231105182	231105467	CpG: 24	285	24	181	16.8	63.5	0.85
chr2	231195680	231197056	CpG: 164	1376	164	987	23.8	71.7	0.93
chr2	231311119	231311918	CpG: 81	799	81	594	20.3	74.3	0.73
chr2	231331206	231331413	CpG: 23	207	23	150	22.2	72.5	0.85
chr2	231347783	231349280	CpG: 122	1497	122	1007	16.3	67.3	0.74
chr2	231440755	231441041	CpG: 31	286	31	191	21.7	66.8	1.00
chr2	231447645	231448209	CpG: 44	564	44	403	15.6	71.5	0.61
chr2	231470398	231470707	CpG: 27	309	27	199	17.5	64.4	0.84
chr2	231473552	231474512	CpG: 100	960	100	699	20.8	72.8	0.79
chr2	231521818	231522914	CpG: 159	1096	159	869	29.0	79.3	0.94
chr2	231537082	231537657	CpG: 50	575	50	364	17.4	63.3	0.87
chr2	231541205	231541764	CpG: 60	559	60	395	21.5	70.7	0.88
chr2	231549857	231550100	CpG: 19	243	19	144	15.6	59.3	0.92
chr2	231615989	231616263	CpG: 24	274	24	172	17.5	62.8	0.90
chr2	231676147	231676387	CpG: 18	240	18	144	15.0	60.0	0.85
chr2	231682805	231683390	CpG: 73	585	73	407	25.0	69.6	1.03
chr2	231734301	231734519	CpG: 18	218	18	158	16.5	72.5	0.67
chr2	231740556	231740848	CpG: 28	292	28	189	19.2	64.7	0.92
chr2	231879839	231880873	CpG: 129	1034	129	807	25.0	78.0	0.82
chr2	231882593	231883283	CpG: 60	690	60	443	17.4	64.2	0.85
chr2	231896480	231897013	CpG: 58	533	58	402	21.8	75.4	0.77
chr2	231903366	231903596	CpG: 17	230	17	150	14.8	65.2	0.70
chr2	231904243	231904495	CpG: 20	252	20	147	15.9	58.3	0.96
chr2	231948173	231950160	CpG: 197	1987	197	1319	19.8	66.4	0.90
chr2	231967314	231968593	CpG: 94	1279	94	886	14.7	69.3	0.62
chr2	231998676	231999394	CpG: 88	718	88	489	24.5	68.1	1.07
chr2	232014491	232015211	CpG: 82	720	82	520	22.8	72.2	0.88
chr2	232088914	232089508	CpG: 57	594	57	441	19.2	74.2	0.70
chr2	232098093	232099659	CpG: 148	1566	148	1073	18.9	68.5	0.81
chr2	232146499	232147610	CpG: 122	1111	122	739	22.0	66.5	0.99
chr2	232165192	232165988	CpG: 88	796	88	608	22.1	76.4	0.76
chr2	232166367	232166598	CpG: 18	231	18	139	15.6	60.2	0.88
chr2	232190997	232195693	CpG: 502	4696	502	3212	21.4	68.4	0.91
chr2	232265174	232266366	CpG: 100	1192	100	794	16.8	66.6	0.78
chr2	232270759	232271292	CpG: 61	533	61	384	22.9	72.0	0.88
chr2	232275324	232275612	CpG: 24	288	24	180	16.7	62.5	0.87
chr2	232387163	232387408	CpG: 20	245	20	167	16.3	68.2	0.70
chr2	232411869	232413943	CpG: 195	2074	195	1429	18.8	68.9	0.79
chr2	232447996	232448755	CpG: 82	759	82	540	21.6	71.1	0.86
chr2	232449126	232449366	CpG: 18	240	18	142	15.0	59.2	0.87
chr2	232471078	232471317	CpG: 19	239	19	139	15.9	58.2	0.96
chr2	232641361	232641772	CpG: 31	411	31	248	15.1	60.3	0.83
chr2	232837696	232839572	CpG: 174	1876	174	1321	18.6	70.4	0.75
chr2	232842101	232842346	CpG: 19	245	19	147	15.5	60.0	0.86
chr2	232853074	232853465	CpG: 36	391	36	289	18.4	73.9	0.68
chr2	232866348	232866676	CpG: 28	328	28	205	17.1	62.5	0.88
chr2	232868024	232868473	CpG: 47	449	47	315	20.9	70.2	0.85
chr2	232873277	232875478	CpG: 194	2201	194	1501	17.6	68.2	0.76
chr2	232894488	232894784	CpG: 24	296	24	189	16.2	63.9	0.80
chr2	232896164	232896609	CpG: 47	445	47	310	21.1	69.7	0.87
chr2	232905479	232908041	CpG: 234	2562	234	1750	18.3	68.3	0.78
chr2	232945476	232946032	CpG: 51	556	51	386	18.3	69.4	0.76
chr2	232972373	232975069	CpG: 312	2696	312	1955	23.1	72.5	0.88
chr2	232989575	232990686	CpG: 95	1111	95	764	17.1	68.8	0.73
chr2	233008723	233011270	CpG: 206	2547	206	1806	16.2	70.9	0.64
chr2	233037041	233037885	CpG: 85	844	85	580	20.1	68.7	0.86
chr2	233051242	233051467	CpG: 18	225	18	135	16.0	60.0	0.90
chr2	233053001	233053251	CpG: 18	250	18	147	14.4	58.8	0.85
chr2	233092586	233093124	CpG: 43	538	43	315	16.0	58.6	0.94
chr2	233119877	233121778	CpG: 180	1901	180	1289	18.9	67.8	0.83
chr2	233182855	233183180	CpG: 24	325	24	187	14.8	57.5	0.90
chr2	233183875	233184599	CpG: 73	724	73	524	20.2	72.4	0.78
chr2	233191651	233191917	CpG: 20	266	20	163	15.0	61.3	0.81
chr2	233217380	233217654	CpG: 23	274	23	170	16.8	62.0	0.88
chr2	233362641	233363852	CpG: 157	1211	157	914	25.9	75.5	0.92
chr2	233369780	233370136	CpG: 25	356	25	228	14.0	64.0	0.69
chr2	233388033	233388303	CpG: 20	270	20	167	14.8	61.9	0.81
chr2	233392126	233393331	CpG: 99	1205	99	881	16.4	73.1	0.62
chr2	233413808	233415947	CpG: 243	2139	243	1585	22.7	74.1	0.83
chr2	233467897	233468171	CpG: 25	274	25	171	18.2	62.4	0.95
chr2	233547731	233547958	CpG: 18	227	18	160	15.9	70.5	0.64
chr2	233692370	233692835	CpG: 46	465	46	332	19.8	71.4	0.79
chr2	233739537	233740172	CpG: 72	635	72	453	22.7	71.3	0.89
chr2	233787514	233787770	CpG: 19	256	19	150	14.8	58.6	0.86
chr2	233842165	233843415	CpG: 170	1250	170	931	27.2	74.5	0.98
chr2	233949658	233949971	CpG: 23	313	23	214	14.7	68.4	0.63
chr2	233951925	233952216	CpG: 18	291	18	172	12.4	59.1	1.26
chr2	233965230	233965602	CpG: 26	372	26	232	14.0	62.4	0.72
chr2	234054948	234055513	CpG: 46	565	46	369	16.3	65.3	0.77
chr2	234072062	234072460	CpG: 33	398	33	238	16.6	59.8	0.93
chr2	234212752	234213729	CpG: 78	977	78	695	16.0	71.1	0.63
chr2	234232231	234232705	CpG: 42	474	42	307	17.7	64.8	0.85
chr2	234243580	234244056	CpG: 41	476	41	308	17.2	64.7	0.83
chr2	234277413	234277689	CpG: 22	276	22	170	15.9	61.6	0.85
chr2	234342622	234343705	CpG: 89	1083	89	723	16.4	66.8	0.76
chr2	234357040	234357256	CpG: 39	216	39	156	36.1	72.2	1.39
chr2	234374573	234374809	CpG: 17	236	17	139	14.4	58.9	0.85
chr2	234427944	234428154	CpG: 20	210	20	128	19.0	61.0	1.03
chr2	234556455	234556691	CpG: 19	236	19	142	16.1	60.2	0.91
chr2	234585042	234585474	CpG: 63	432	63	283	29.2	65.5	1.64
chr2	234603210	234603490	CpG: 23	280	23	174	16.4	62.1	0.86
chr2	234984994	234987033	CpG: 234	2039	234	1464	23.0	71.8	0.90
chr2	235042552	235042792	CpG: 22	240	22	146	18.3	60.8	1.01
chr2	235052632	235053445	CpG: 66	813	66	555	16.2	68.3	0.70
chr2	235377500	235377926	CpG: 36	426	36	258	16.9	60.6	0.92
chr2	235392712	235392950	CpG: 18	238	18	142	15.1	59.7	0.88
chr2	235440359	235442127	CpG: 221	1768	221	1319	25.0	74.6	0.90
chr2	235531777	235532139	CpG: 27	362	27	240	14.9	66.3	0.68
chr2	235739674	235739955	CpG: 23	281	23	173	16.4	61.6	0.88
chr2	235792167	235792561	CpG: 28	394	28	236	14.2	59.9	0.80
chr2	235874197	235874466	CpG: 22	269	22	173	16.4	64.3	0.79
chr2	235977647	235977877	CpG: 19	230	19	140	16.5	60.9	0.90
chr2	235978081	235978355	CpG: 24	274	24	170	17.5	62.0	0.92
chr2	235982650	235984797	CpG: 280	2147	280	1582	26.1	73.7	0.96
chr2	236024428	236024638	CpG: 17	210	17	122	16.2	58.1	0.96
chr2	236086929	236087618	CpG: 80	689	80	428	23.2	62.1	1.20
chr2	236158916	236160989	CpG: 306	2073	306	1605	29.5	77.4	0.99
chr2	236253904	236254595	CpG: 52	691	52	493	15.1	71.3	0.79
chr2	236355048	236355249	CpG: 20	201	20	123	19.9	61.2	1.07
chr2	236448918	236449172	CpG: 21	254	21	146	16.5	57.5	1.00
chr2	236558245	236558517	CpG: 23	272	23	168	16.9	61.8	0.89
chr2	236591291	236591523	CpG: 20	232	20	133	17.2	57.3	1.05
chr2	236609918	236610191	CpG: 25	273	25	191	18.3	70.0	0.75
chr2	236613632	236613931	CpG: 29	299	29	197	19.4	65.9	0.90
chr2	236649144	236649908	CpG: 64	764	64	534	16.8	69.9	0.69
chr2	236652877	236659846	CpG: 541	6969	541	4384	15.5	62.9	0.78
chr2	236661272	236661516	CpG: 27	244	27	156	22.1	63.9	1.11
chr2	236662394	236663478	CpG: 105	1084	105	760	19.4	70.1	0.79
chr2	236667811	236669548	CpG: 128	1737	128	1027	14.7	59.1	0.84
chr2	236701063	236701342	CpG: 21	279	21	164	15.1	58.8	0.87
chr2	236704100	236704657	CpG: 91	557	91	432	32.7	77.6	1.09
chr2	236726650	236727604	CpG: 110	954	110	693	23.1	72.6	0.89
chr2	236879570	236879865	CpG: 25	295	25	182	16.9	61.7	0.90
chr2	236997758	236998050	CpG: 41	292	41	217	28.1	74.3	1.03
chr2	237016510	237016787	CpG: 24	277	24	170	17.3	61.4	0.93
chr2	237057602	237057864	CpG: 23	262	23	161	17.6	61.5	0.94
chr2	237058198	237059150	CpG: 85	952	85	644	17.9	67.6	0.79
chr2	237125861	237126187	CpG: 23	326	23	193	14.1	59.2	0.82
chr2	237358808	237359082	CpG: 25	274	25	173	18.2	63.1	0.93
chr2	237576452	237577324	CpG: 85	872	85	546	19.5	62.6	1.01
chr2	237710664	237710922	CpG: 22	258	22	162	17.1	62.8	0.88
chr2	237862861	237863155	CpG: 22	294	22	183	15.0	62.2	0.78
chr2	237966061	237966779	CpG: 83	718	83	535	23.1	74.5	0.84
chr2	237977457	237978637	CpG: 111	1180	111	800	18.8	67.8	0.82
chr2	238116898	238118177	CpG: 163	1279	163	973	25.5	76.1	0.89
chr2	238171709	238171939	CpG: 19	230	19	140	16.5	60.9	0.90
chr2	238181213	238182786	CpG: 185	1573	185	1169	23.5	74.3	0.86
chr2	238225262	238225466	CpG: 16	204	16	137	15.7	67.2	0.70
chr2	238288308	238289603	CpG: 131	1295	131	843	20.2	65.1	0.97
chr2	238349430	238350188	CpG: 89	758	89	566	23.5	74.7	0.84
chr2	238414326	238414602	CpG: 19	276	19	158	13.8	57.2	0.85
chr2	238445819	238446580	CpG: 71	761	71	565	18.7	74.2	0.68
chr2	238456491	238457687	CpG: 158	1196	158	881	26.4	73.7	0.98
chr2	238547890	238548138	CpG: 27	248	27	191	21.8	77.0	0.74
chr2	238550295	238551274	CpG: 118	979	118	720	24.1	73.5	0.89
chr2	238590327	238590616	CpG: 26	289	26	212	18.0	73.4	0.67
chr2	238595961	238596268	CpG: 22	307	22	209	14.3	68.1	0.62
chr2	238618467	238618693	CpG: 21	226	21	167	18.6	73.9	0.70
chr2	238620638	238621428	CpG: 64	790	64	559	16.2	70.8	0.65
chr2	238629181	238629564	CpG: 36	383	36	272	18.8	71.0	0.75
chr2	238630498	238631199	CpG: 57	701	57	475	16.3	67.8	0.71
chr2	238640519	238640750	CpG: 23	231	23	160	19.9	69.3	0.83
chr2	238648311	238649128	CpG: 108	817	108	640	26.4	78.3	0.86
chr2	238653291	238654209	CpG: 124	918	124	699	27.0	76.1	0.93
chr2	238692782	238693620	CpG: 132	838	132	672	31.5	80.2	0.98
chr2	238720980	238721760	CpG: 65	780	65	481	16.7	61.7	0.88
chr2	238724143	238724722	CpG: 47	579	47	383	16.2	66.1	0.76
chr2	238728693	238730997	CpG: 274	2304	274	1721	23.8	74.7	0.86
chr2	238755704	238755938	CpG: 17	234	17	137	14.5	58.5	0.86
chr2	238778021	238779163	CpG: 157	1142	157	819	27.5	71.7	1.09
chr2	238810011	238810952	CpG: 124	941	124	727	26.4	77.3	0.90
chr2	238916657	238917759	CpG: 123	1102	123	788	22.3	71.5	0.87
chr2	238925896	238926122	CpG: 19	226	19	145	16.8	64.2	0.82
chr2	238943181	238943428	CpG: 19	247	19	155	15.4	62.8	0.82
chr2	238990860	238991305	CpG: 34	445	34	253	15.3	56.9	0.95
chr2	239004242	239004468	CpG: 17	226	17	137	15.0	60.6	0.83
chr2	239123809	239124120	CpG: 28	311	28	180	18.0	57.9	1.08
chr2	239213115	239213457	CpG: 32	342	32	246	18.7	71.9	0.72
chr2	239302819	239303093	CpG: 22	274	22	167	16.1	60.9	0.88
chr2	239337094	239340308	CpG: 320	3214	320	2253	19.9	70.1	0.81
chr2	239384592	239384844	CpG: 22	252	22	160	17.5	63.5	0.87
chr2	239458160	239458684	CpG: 35	524	35	328	13.4	62.6	0.68
chr2	239500510	239500769	CpG: 20	259	20	150	15.4	57.9	0.92
chr2	239544116	239544401	CpG: 28	285	28	192	19.6	67.4	0.87
chr2	239554596	239554939	CpG: 26	343	26	212	15.2	61.8	0.80
chr2	239558128	239558388	CpG: 22	260	22	161	16.9	61.9	0.89
chr2	239574867	239575246	CpG: 29	379	29	235	15.3	62.0	0.80
chr2	239576721	239577413	CpG: 46	692	46	364	13.3	52.6	1.02
chr2	239587103	239587367	CpG: 18	264	18	192	13.6	72.7	0.74
chr2	239598746	239599036	CpG: 23	290	23	205	15.9	70.7	0.64
chr2	239602217	239602523	CpG: 26	306	26	210	17.0	68.6	0.73
chr2	239608483	239608858	CpG: 26	375	26	233	13.9	62.1	0.72
chr2	239609122	239609493	CpG: 30	371	30	222	16.2	59.8	0.93
chr2	239615099	239616163	CpG: 98	1064	98	579	18.4	54.4	1.26
chr2	239630753	239631029	CpG: 29	276	29	184	21.0	66.7	0.95
chr2	239670129	239670356	CpG: 21	227	21	157	18.5	69.2	0.84
chr2	239671007	239671268	CpG: 20	261	20	167	15.3	64.0	0.77
chr2	239680775	239681038	CpG: 21	263	21	179	16.0	68.1	0.70
chr2	239681695	239681896	CpG: 15	201	15	121	14.9	60.2	0.83
chr2	239722734	239723017	CpG: 21	283	21	190	14.8	67.1	0.68
chr2	239765993	239766222	CpG: 17	229	17	160	14.8	69.9	0.61
chr2	239785642	239785878	CpG: 22	236	22	145	18.6	61.4	1.01
chr2	239811804	239812036	CpG: 17	232	17	136	14.7	58.6	0.87
chr2	239865022	239865296	CpG: 23	274	23	170	16.8	62.0	0.88
chr2	239890667	239892810	CpG: 283	2143	283	1592	26.4	74.3	0.96
chr2	239940090	239940836	CpG: 60	746	60	511	16.1	68.5	0.69
chr2	240018255	240019393	CpG: 105	1138	105	712	18.5	62.6	0.95
chr2	240023637	240023875	CpG: 17	238	17	143	14.3	60.1	0.84
chr2	240135633	240136168	CpG: 36	535	36	275	13.5	51.4	1.02
chr2	240143536	240143815	CpG: 22	279	22	170	15.8	60.9	0.85
chr2	240181859	240182115	CpG: 29	256	29	204	22.7	79.7	0.73
chr2	240209963	240210279	CpG: 23	316	23	212	14.6	67.1	0.65
chr2	240220571	240220778	CpG: 16	207	16	139	15.5	67.1	0.69
chr2	240309009	240309272	CpG: 23	263	23	150	17.5	57.0	1.20
chr2	240328405	240328617	CpG: 18	212	18	128	17.0	60.4	0.95
chr2	240359295	240359534	CpG: 26	239	26	171	21.8	71.5	0.89
chr2	240422026	240422338	CpG: 23	312	23	192	14.7	61.5	0.84
chr2	240431882	240432256	CpG: 30	374	30	238	16.0	63.6	0.79
chr2	240517589	240518978	CpG: 119	1389	119	910	17.1	65.5	0.80
chr2	240534697	240535161	CpG: 30	464	30	297	12.9	64.0	0.96
chr2	240596433	240596674	CpG: 20	241	20	149	16.6	61.8	0.89
chr2	240622555	240622757	CpG: 16	202	16	128	15.8	63.4	0.83
chr2	240628608	240629799	CpG: 118	1191	118	815	19.8	68.4	0.85
chr2	240650761	240651291	CpG: 36	530	36	331	13.6	62.5	0.76
chr2	240699721	240699996	CpG: 23	275	23	170	16.7	61.8	0.88
chr2	240738165	240738403	CpG: 18	238	18	155	15.1	65.1	0.72
chr2	240810823	240811069	CpG: 17	246	17	149	13.8	60.6	0.77
chr2	240816289	240816737	CpG: 33	448	33	289	14.7	64.5	0.71
chr2	240847726	240848503	CpG: 51	777	51	513	13.1	66.0	0.68
chr2	240908453	240908685	CpG: 16	232	16	142	13.8	61.2	0.75
chr2	240928686	240930596	CpG: 254	1910	254	1473	26.6	77.1	0.90
chr2	240946201	240947846	CpG: 212	1645	212	1293	25.8	78.6	0.85
chr2	240949496	240950050	CpG: 54	554	54	413	19.5	74.5	0.72
chr2	240955809	240956234	CpG: 38	425	38	295	17.9	69.4	0.74
chr2	240958198	240958402	CpG: 18	204	18	128	17.6	62.7	0.90
chr2	241013742	241014157	CpG: 41	415	41	298	19.8	71.8	0.77
chr2	241038666	241038977	CpG: 25	311	25	193	16.1	62.1	0.84
chr2	241051189	241052280	CpG: 105	1091	105	786	19.2	72.0	0.76
chr2	241054195	241055398	CpG: 144	1203	144	869	23.9	72.2	0.92
chr2	241060535	241060741	CpG: 27	206	27	165	26.2	80.1	0.82
chr2	241061965	241063235	CpG: 187	1270	187	998	29.4	78.6	0.97
chr2	241080230	241081443	CpG: 142	1213	142	854	23.4	70.4	0.94
chr2	241084574	241084957	CpG: 28	383	28	236	14.6	61.6	0.77
chr2	241090328	241090597	CpG: 20	269	20	176	14.9	65.4	0.70
chr2	241138125	241138817	CpG: 72	692	72	496	20.8	71.7	0.82
chr2	241169263	241170289	CpG: 100	1026	100	744	19.5	72.5	0.74
chr2	241197712	241198667	CpG: 89	955	89	687	18.6	71.9	0.72
chr2	241274398	241275748	CpG: 90	1350	90	836	13.3	61.9	0.84
chr2	241276820	241277056	CpG: 20	236	20	160	16.9	67.8	0.85
chr2	241278832	241279996	CpG: 95	1164	95	790	16.3	67.9	0.79
chr2	241311650	241311975	CpG: 26	325	26	211	16.0	64.9	0.81
chr2	241317687	241320329	CpG: 284	2642	284	1955	21.5	74.0	0.79
chr2	241331201	241331740	CpG: 60	539	60	406	22.3	75.3	0.79
chr2	241387533	241387790	CpG: 25	257	25	190	19.5	73.9	0.72
chr2	241414828	241415656	CpG: 73	828	73	607	17.6	73.3	0.69
chr2	241417642	241417948	CpG: 25	306	25	227	16.3	74.2	0.62
chr2	241466498	241466705	CpG: 18	207	18	147	17.4	71.0	0.69
chr2	241482671	241483037	CpG: 40	366	40	269	21.9	73.5	0.82
chr2	241497282	241498494	CpG: 161	1212	161	934	26.6	77.1	0.90
chr2	241548748	241549045	CpG: 30	297	30	203	20.2	68.4	0.89
chr2	241552172	241552395	CpG: 20	223	20	160	17.9	71.7	0.71
chr2	241563122	241563359	CpG: 22	237	22	181	18.6	76.4	0.68
chr2	241564511	241564790	CpG: 24	279	24	190	17.2	68.1	0.76
chr2	241601236	241601719	CpG: 68	483	68	347	28.2	71.8	1.09
chr2	241644041	241644311	CpG: 20	270	20	167	14.8	61.9	0.78
chr2	241648053	241650015	CpG: 211	1962	211	1383	21.5	70.5	0.87
chr2	241686173	241686447	CpG: 19	274	19	167	13.9	60.9	0.75
chr2	241700154	241700366	CpG: 19	212	19	139	17.9	65.6	0.83
chr2	241708219	241708598	CpG: 33	379	33	260	17.4	68.6	0.74
chr2	241709215	241709447	CpG: 17	232	17	157	14.7	67.7	0.65
chr2	241716391	241717734	CpG: 174	1343	174	1029	25.9	76.6	0.94
chr2	241730098	241730334	CpG: 17	236	17	142	14.4	60.2	0.80
chr2	241738848	241739082	CpG: 17	234	17	145	14.5	62.0	0.76
chr2	241770850	241772063	CpG: 133	1213	133	895	21.9	73.8	0.82
chr2	241813870	241815597	CpG: 172	1727	172	1192	19.9	69.0	0.84
chr2	241832367	241832641	CpG: 21	274	21	170	15.3	62.0	0.81
chr2	241854124	241855944	CpG: 198	1820	198	1352	21.8	74.3	0.80
chr2	241973448	241973734	CpG: 20	286	20	173	14.0	60.5	0.78
chr2	242006929	242008729	CpG: 197	1800	197	1323	21.9	73.5	0.82
chr2	242021754	242022029	CpG: 21	275	21	167	15.3	60.7	0.84
chr2	242040824	242042198	CpG: 131	1374	131	998	19.1	72.6	0.73
chr2	242058381	242059642	CpG: 164	1261	164	958	26.0	76.0	0.90
chr2	242079646	242080089	CpG: 51	443	51	291	23.0	65.7	1.13
chr2	242111000	242111370	CpG: 26	370	26	241	14.1	65.1	0.66
chr2	242113289	242113911	CpG: 62	622	62	475	19.9	76.4	0.69
chr2	242136224	242136615	CpG: 29	391	29	254	14.8	65.0	0.71
chr2	242139619	242141476	CpG: 276	1857	276	1411	29.7	76.0	1.03
chr2	242144599	242144810	CpG: 16	211	16	126	15.2	59.7	0.87
chr2	242170002	242170484	CpG: 37	482	37	307	15.4	63.7	0.76
chr2	242175649	242175878	CpG: 20	229	20	159	17.5	69.4	0.74
chr2	242180739	242181013	CpG: 23	274	23	190	16.8	69.3	0.72
chr2	242189655	242191165	CpG: 167	1510	167	1021	22.1	67.6	0.97
chr2	242205044	242207063	CpG: 222	2019	222	1472	22.0	72.9	0.83
chr2	242228156	242228481	CpG: 23	325	23	209	14.2	64.3	0.72
chr2	242228815	242229762	CpG: 88	947	88	630	18.6	66.5	0.84
chr2	242238260	242240035	CpG: 197	1775	197	1244	22.2	70.1	0.91
chr2	242273752	242274162	CpG: 39	410	39	272	19.0	66.3	0.87
chr2	242305712	242306872	CpG: 128	1160	128	811	22.1	69.9	0.90
chr2	242314978	242315284	CpG: 24	306	24	211	15.7	69.0	0.66
chr2	242316289	242316959	CpG: 56	670	56	479	16.7	71.5	0.66
chr2	242317856	242318197	CpG: 30	341	30	238	17.6	69.8	0.73
chr2	242321203	242321406	CpG: 16	203	16	130	15.8	64.0	0.80
chr2	242322401	242322672	CpG: 22	271	22	179	16.2	66.1	0.74
chr2	242325660	242326196	CpG: 44	536	44	305	16.4	56.9	1.02
chr2	242345550	242346261	CpG: 85	711	85	555	23.9	78.1	0.79
chr2	242346778	242347059	CpG: 24	281	24	195	17.1	69.4	0.71
chr2	242348426	242350516	CpG: 139	2090	139	1198	13.3	57.3	0.91
chr2	242354248	242354478	CpG: 19	230	19	148	16.5	64.3	0.81
chr2	242365148	242365430	CpG: 28	282	28	197	19.9	69.9	0.84
chr2	242367803	242368067	CpG: 22	264	22	187	16.7	70.8	0.79
chr2	242374505	242375307	CpG: 65	802	65	559	16.2	69.7	0.72
chr2	242383485	242384007	CpG: 39	522	39	363	14.9	69.5	0.67
chr2	242394362	242394592	CpG: 21	230	21	171	18.3	74.3	0.66
chr2	242407625	242407859	CpG: 20	234	20	147	17.1	62.8	0.89
chr2	242409450	242411169	CpG: 135	1719	135	1157	15.7	67.3	0.71
chr2	242440670	242440886	CpG: 18	216	18	148	16.7	68.5	0.71
chr2	242444500	242445052	CpG: 53	552	53	404	19.2	73.2	0.72
chr2	242455007	242455535	CpG: 46	528	46	324	17.4	61.4	0.94
chr2	242493347	242493956	CpG: 42	609	42	411	13.8	67.5	0.63
chr2	242495388	242495842	CpG: 36	454	36	265	15.9	58.4	1.07
chr2	242496516	242496775	CpG: 20	259	20	170	15.4	65.6	0.72
chr2	242500035	242500307	CpG: 24	272	24	169	17.6	62.1	0.92
chr2	242512021	242513906	CpG: 132	1885	132	1227	14.0	65.1	0.68
chr2	242516083	242520977	CpG: 305	4894	305	2946	12.5	60.2	0.72
chr2	242522729	242522953	CpG: 17	224	17	139	15.2	62.1	0.79
chr2	242555841	242556074	CpG: 16	233	16	150	13.7	64.4	0.73
chr2	242556905	242558196	CpG: 195	1291	195	991	30.2	76.8	1.05
chr2	242597764	242598999	CpG: 156	1235	156	908	25.3	73.5	0.94
chr2	242630222	242630443	CpG: 18	221	18	133	16.3	60.2	0.91
chr2	242692845	242694125	CpG: 243	1280	243	1015	38.0	79.3	1.24
chr3	2650	3530	CpG: 193	880	193	723	43.9	82.2	1.35
chr3	31104	31334	CpG: 20	230	20	150	17.4	65.2	0.83
chr3	178778	179039	CpG: 20	261	20	166	15.3	63.6	0.77
chr3	188527	190290	CpG: 173	1763	173	1269	19.6	72.0	0.76
chr3	300798	301031	CpG: 20	233	20	159	17.2	68.2	0.74
chr3	474527	475367	CpG: 113	840	113	628	26.9	74.8	0.99
chr3	521914	522192	CpG: 24	278	24	171	17.3	61.5	0.92
chr3	527727	528091	CpG: 42	364	42	277	23.1	76.1	0.80
chr3	801361	801672	CpG: 25	311	25	191	16.1	61.4	0.86
chr3	1010073	1010315	CpG: 24	242	24	153	19.8	63.2	1.01
chr3	1032862	1033141	CpG: 25	279	25	181	17.9	64.9	0.86
chr3	1092909	1093140	CpG: 17	231	17	142	14.7	61.5	0.79
chr3	1096191	1096463	CpG: 23	272	23	178	16.9	65.4	0.80
chr3	1096612	1096841	CpG: 19	229	19	145	16.6	63.3	0.84
chr3	1196616	1196891	CpG: 25	275	25	181	18.2	65.8	0.85
chr3	1426895	1427159	CpG: 20	264	20	167	15.2	63.3	0.78
chr3	1520361	1520638	CpG: 23	277	23	179	16.6	64.6	0.80
chr3	1618767	1619046	CpG: 25	279	25	181	17.9	64.9	0.86
chr3	1734417	1734690	CpG: 23	273	23	176	16.8	64.5	0.82
chr3	1980494	1980713	CpG: 21	219	21	138	19.2	63.0	0.99
chr3	1981320	1981609	CpG: 28	289	28	188	19.4	65.1	0.92
chr3	2043739	2044017	CpG: 25	278	25	177	18.0	63.7	0.90
chr3	2077381	2077919	CpG: 55	538	55	401	20.4	74.5	0.74
chr3	2092251	2094006	CpG: 182	1755	182	1197	20.7	68.2	0.89
chr3	2115785	2115990	CpG: 17	205	17	125	16.6	61.0	0.93
chr3	2163348	2163581	CpG: 21	233	21	152	18.0	65.2	0.87
chr3	2163930	2164203	CpG: 24	273	24	172	17.6	63.0	0.89
chr3	2232649	2232922	CpG: 24	273	24	178	17.6	65.2	0.83
chr3	2263847	2264119	CpG: 23	272	23	171	16.9	62.9	0.87
chr3	2322008	2322269	CpG: 22	261	22	166	16.9	63.6	0.85
chr3	2775746	2775975	CpG: 19	229	19	145	16.6	63.3	0.84
chr3	2834439	2834711	CpG: 23	272	23	170	16.9	62.5	0.87
chr3	2910669	2911372	CpG: 52	703	52	464	14.8	66.0	0.70
chr3	2914329	2914602	CpG: 24	273	24	173	17.6	63.4	0.88
chr3	2927157	2927387	CpG: 18	230	18	137	15.7	59.6	0.90
chr3	2955219	2955500	CpG: 22	281	22	162	15.7	57.7	0.96
chr3	2975486	2975760	CpG: 20	274	20	166	14.6	60.6	0.80
chr3	3003813	3004049	CpG: 19	236	19	145	16.1	61.4	0.88
chr3	3115957	3116158	CpG: 18	201	18	118	17.9	58.7	1.11
chr3	3120244	3121844	CpG: 140	1600	140	982	17.5	61.4	0.93
chr3	3173747	3174287	CpG: 57	540	57	381	21.1	70.6	0.85
chr3	3380198	3380471	CpG: 25	273	25	176	18.3	64.5	0.89
chr3	3454038	3454274	CpG: 21	236	21	147	17.8	62.3	0.93
chr3	3540384	3541021	CpG: 48	637	48	363	15.1	57.0	0.93
chr3	3584651	3584940	CpG: 21	289	21	174	14.5	60.2	0.83
chr3	3593328	3593598	CpG: 22	270	22	170	16.3	63.0	0.84
chr3	3625652	3625932	CpG: 24	280	24	178	17.1	63.6	0.86
chr3	3784312	3784565	CpG: 17	253	17	150	13.4	59.3	0.79
chr3	3795013	3797461	CpG: 221	2448	221	1650	18.1	67.4	0.80
chr3	3959202	3959494	CpG: 24	292	24	180	16.4	61.6	0.87
chr3	4156790	4157068	CpG: 25	278	25	175	18.0	62.9	0.92
chr3	4297070	4297407	CpG: 42	337	42	238	24.9	70.6	1.02
chr3	4435981	4436229	CpG: 22	248	22	152	17.7	61.3	0.96
chr3	4460136	4460416	CpG: 23	280	23	174	16.4	62.1	0.86
chr3	4460932	4461288	CpG: 38	356	38	251	21.3	70.5	0.86
chr3	4468237	4468511	CpG: 21	274	21	172	15.3	62.8	0.78
chr3	4486734	4487689	CpG: 64	955	64	603	13.4	63.1	0.67
chr3	4862092	4862667	CpG: 67	575	67	418	23.3	72.7	0.88
chr3	4910379	4910806	CpG: 33	427	33	259	15.5	60.7	0.84
chr3	4971973	4974320	CpG: 182	2347	182	1575	15.5	67.1	0.69
chr3	4976848	4977055	CpG: 18	207	18	124	17.4	59.9	1.01
chr3	4980503	4980997	CpG: 43	494	43	337	17.4	68.2	0.75
chr3	5020124	5020523	CpG: 36	399	36	276	18.0	69.2	0.76
chr3	5089806	5090235	CpG: 37	429	37	278	17.2	64.8	0.82
chr3	5107739	5108503	CpG: 62	764	62	514	16.2	67.3	0.72
chr3	5113687	5114348	CpG: 47	661	47	392	14.2	59.3	0.81
chr3	5116084	5116786	CpG: 83	702	83	491	23.6	69.9	0.97
chr3	5181204	5182436	CpG: 149	1232	149	922	24.2	74.8	0.87
chr3	5236635	5237300	CpG: 49	665	49	431	14.7	64.8	0.73
chr3	5243417	5243689	CpG: 26	272	26	175	19.1	64.3	0.93
chr3	5324772	5325076	CpG: 25	304	25	188	16.4	61.8	0.88
chr3	5571234	5571498	CpG: 19	264	19	160	14.4	60.6	0.79
chr3	5777255	5777468	CpG: 16	213	16	125	15.0	58.7	0.88
chr3	5814996	5815270	CpG: 23	274	23	173	16.8	63.1	0.85
chr3	5912916	5913186	CpG: 24	270	24	175	17.8	64.8	0.87
chr3	5993904	5994127	CpG: 18	223	18	137	16.1	61.4	0.87
chr3	6055151	6055437	CpG: 24	286	24	175	16.8	61.2	0.91
chr3	6062272	6062496	CpG: 17	224	17	138	15.2	61.6	0.82
chr3	6070475	6070746	CpG: 27	271	27	177	19.9	65.3	0.94
chr3	6079214	6079489	CpG: 21	275	21	168	15.3	61.1	0.83
chr3	6181404	6181678	CpG: 20	274	20	168	14.6	61.3	0.78
chr3	6208435	6208710	CpG: 22	275	22	168	16.0	61.1	0.88
chr3	6250225	6250495	CpG: 22	270	22	170	16.3	63.0	0.83
chr3	6334635	6334897	CpG: 26	262	26	164	19.8	62.6	1.02
chr3	6485537	6485754	CpG: 20	217	20	134	18.4	61.8	0.97
chr3	6502608	6502876	CpG: 25	268	25	172	18.7	64.2	0.92
chr3	6628682	6628963	CpG: 24	281	24	176	17.1	62.6	0.88
chr3	6671691	6671932	CpG: 22	241	22	152	18.3	63.1	0.94
chr3	6760302	6760625	CpG: 26	323	26	202	16.1	62.5	0.83
chr3	6766208	6766446	CpG: 19	238	19	146	16.0	61.3	0.87
chr3	6851720	6852413	CpG: 77	693	77	479	22.2	69.1	0.94
chr3	6853030	6853546	CpG: 40	516	40	333	15.5	64.5	0.75
chr3	7079343	7079672	CpG: 28	329	28	201	17.0	61.1	0.92
chr3	7262225	7262465	CpG: 19	240	19	145	15.8	60.4	0.89
chr3	7559539	7559916	CpG: 31	377	31	277	16.4	73.5	0.61
chr3	7656149	7656403	CpG: 20	254	20	152	15.7	59.8	0.89
chr3	8023298	8023573	CpG: 22	275	22	168	16.0	61.1	0.87
chr3	8217111	8217386	CpG: 19	275	19	168	13.8	61.1	0.75
chr3	8317113	8317316	CpG: 18	203	18	152	17.7	74.9	0.63
chr3	8469091	8469372	CpG: 23	281	23	174	16.4	61.9	0.87
chr3	8492659	8493037	CpG: 43	378	43	268	22.8	70.9	0.91
chr3	8707298	8707657	CpG: 29	359	29	213	16.2	59.3	0.92
chr3	8758451	8760770	CpG: 192	2319	192	1512	16.6	65.2	0.78
chr3	8861832	8862107	CpG: 21	275	21	169	15.3	61.5	0.81
chr3	8954362	8954768	CpG: 39	406	39	272	19.2	67.0	0.86
chr3	8976642	8977097	CpG: 43	455	43	318	18.9	69.9	0.79
chr3	8981743	8982005	CpG: 21	262	21	177	16.0	67.6	0.71
chr3	9127115	9127682	CpG: 56	567	56	399	19.8	70.4	0.82
chr3	9219979	9220261	CpG: 25	282	25	177	17.7	62.8	0.92
chr3	9354945	9355200	CpG: 27	255	27	171	21.2	67.1	0.97
chr3	9388199	9390011	CpG: 179	1812	179	1261	19.8	69.6	0.83
chr3	9504931	9505168	CpG: 19	237	19	138	16.0	58.2	0.96
chr3	9535130	9535367	CpG: 16	237	16	141	13.5	59.5	0.79
chr3	9544309	9544737	CpG: 47	428	47	305	22.0	71.3	0.90
chr3	9545426	9545841	CpG: 66	415	66	338	31.8	81.4	0.98
chr3	9551476	9552331	CpG: 63	855	63	587	14.7	68.7	0.63
chr3	9561552	9562127	CpG: 41	575	41	384	14.3	66.8	0.64
chr3	9583383	9584130	CpG: 55	747	55	505	14.7	67.6	0.65
chr3	9591808	9592084	CpG: 22	276	22	170	15.9	61.6	0.85
chr3	9592637	9592973	CpG: 45	336	45	255	26.8	75.9	0.93
chr3	9640531	9640761	CpG: 18	230	18	133	15.7	57.8	0.95
chr3	9641239	9641691	CpG: 43	452	43	318	19.0	70.4	0.80
chr3	9655557	9655768	CpG: 15	211	15	126	14.2	59.7	0.82
chr3	9695723	9697053	CpG: 109	1330	109	908	16.4	68.3	0.70
chr3	9723169	9724185	CpG: 107	1016	107	732	21.1	72.0	0.81
chr3	9741394	9742282	CpG: 67	888	67	565	15.1	63.6	0.77
chr3	9761737	9762007	CpG: 31	270	31	210	23.0	77.8	0.77
chr3	9768402	9768638	CpG: 18	236	18	144	15.3	61.0	0.84
chr3	9784262	9785255	CpG: 85	993	85	662	17.1	66.7	0.79
chr3	9801744	9802471	CpG: 80	727	80	542	22.0	74.6	0.79
chr3	9835418	9836103	CpG: 54	685	54	447	15.8	65.3	0.75
chr3	9854655	9855135	CpG: 42	480	42	352	17.5	73.3	0.65
chr3	9874142	9874417	CpG: 23	275	23	167	16.7	60.7	0.92
chr3	9882500	9883119	CpG: 65	619	65	438	21.0	70.8	0.84
chr3	9884050	9884313	CpG: 19	263	19	158	14.4	60.1	0.81
chr3	9907161	9908003	CpG: 104	842	104	619	24.7	73.5	0.91
chr3	9924685	9926028	CpG: 132	1343	132	940	19.7	70.0	0.80
chr3	9931895	9932547	CpG: 55	652	55	445	16.9	68.3	0.72
chr3	9938195	9939919	CpG: 169	1724	169	1221	19.6	70.8	0.78
chr3	9944030	9944436	CpG: 45	406	45	300	22.2	73.9	0.83
chr3	9978827	9979365	CpG: 42	538	42	321	15.6	59.7	0.89
chr3	10002149	10002364	CpG: 18	215	18	131	16.7	60.9	0.91
chr3	10002857	10003339	CpG: 49	482	49	350	20.3	72.6	0.77
chr3	10018212	10018579	CpG: 41	367	41	245	22.3	66.8	1.00
chr3	10061590	10062789	CpG: 95	1199	95	864	15.8	72.1	0.61
chr3	10099567	10099811	CpG: 20	244	20	153	16.4	62.7	0.86
chr3	10100286	10100602	CpG: 27	316	27	225	17.1	71.2	0.68
chr3	10107665	10108148	CpG: 43	483	43	307	17.8	63.6	0.90
chr3	10134513	10135535	CpG: 118	1022	118	676	23.1	66.1	1.06
chr3	10141238	10141512	CpG: 24	274	24	171	17.5	62.4	0.91
chr3	10157662	10158237	CpG: 66	575	66	422	23.0	73.4	0.85
chr3	10177655	10177930	CpG: 20	275	20	165	14.5	60.0	0.82
chr3	10227504	10227894	CpG: 30	390	30	251	15.4	64.4	0.74
chr3	10241489	10242207	CpG: 77	718	77	504	21.4	70.2	0.88
chr3	10242503	10242726	CpG: 18	223	18	152	16.1	68.2	0.70
chr3	10314131	10314566	CpG: 44	435	44	303	20.2	69.7	0.84
chr3	10322064	10322432	CpG: 26	368	26	212	14.1	57.6	0.91
chr3	10349102	10349382	CpG: 26	280	26	177	18.6	63.2	0.94
chr3	10352010	10352215	CpG: 19	205	19	130	18.5	63.4	0.92
chr3	10466165	10466396	CpG: 20	231	20	143	17.3	61.9	0.92
chr3	10499840	10500051	CpG: 25	211	25	158	23.7	74.9	0.85
chr3	10701859	10702585	CpG: 101	726	101	575	27.8	79.2	0.92
chr3	10733134	10733385	CpG: 19	251	19	154	15.1	61.4	0.81
chr3	10796518	10796792	CpG: 22	274	22	171	16.1	62.4	0.84
chr3	10810280	10811040	CpG: 97	760	97	570	25.5	75.0	0.91
chr3	10987038	10988180	CpG: 122	1142	122	817	21.4	71.5	0.84
chr3	11011600	11011833	CpG: 19	233	19	149	16.3	63.9	0.80
chr3	11055331	11056230	CpG: 66	899	66	622	14.7	69.2	0.61
chr3	11088453	11088784	CpG: 29	331	29	238	17.5	71.9	0.68
chr3	11104420	11104684	CpG: 21	264	21	162	15.9	61.4	0.86
chr3	11149151	11149805	CpG: 90	654	90	514	27.5	78.6	0.89
chr3	11174280	11174491	CpG: 15	211	15	125	14.2	59.2	0.85
chr3	11244991	11245374	CpG: 31	383	31	217	16.2	56.7	1.01
chr3	11266193	11266467	CpG: 24	274	24	170	17.5	62.0	0.92
chr3	11267154	11267402	CpG: 30	248	30	174	24.2	70.2	0.99
chr3	11298109	11298385	CpG: 19	276	19	170	13.8	61.6	0.73
chr3	11298513	11298771	CpG: 21	258	21	151	16.3	58.5	0.98
chr3	11435039	11435313	CpG: 24	274	24	171	17.5	62.4	0.91
chr3	11482133	11483901	CpG: 164	1768	164	1351	18.6	76.4	0.64
chr3	11563969	11564202	CpG: 22	233	22	161	18.9	69.1	0.81
chr3	11594830	11595377	CpG: 41	547	41	325	15.0	59.4	0.85
chr3	11638463	11639201	CpG: 54	738	54	435	14.6	58.9	0.85
chr3	11641056	11641337	CpG: 24	281	24	176	17.1	62.6	0.88
chr3	11660914	11661150	CpG: 17	236	17	144	14.4	61.0	0.79
chr3	11700835	11701082	CpG: 22	247	22	155	17.8	62.8	0.94
chr3	11714887	11716331	CpG: 193	1444	193	1105	26.7	76.5	0.93
chr3	11842074	11842813	CpG: 64	739	64	470	17.3	63.6	0.87
chr3	11899618	11900114	CpG: 31	496	31	296	12.5	59.7	0.78
chr3	12002135	12003096	CpG: 129	961	129	725	26.8	75.4	0.95
chr3	12048728	12049009	CpG: 24	281	24	176	17.1	62.6	0.88
chr3	12156917	12157266	CpG: 27	349	27	246	15.5	70.5	0.62
chr3	12217409	12217965	CpG: 39	556	39	318	14.0	57.2	0.87
chr3	12259624	12259857	CpG: 18	233	18	138	15.5	59.2	0.91
chr3	12269770	12270044	CpG: 20	274	20	164	14.6	59.9	0.82
chr3	12285691	12287023	CpG: 162	1332	162	1020	24.3	76.6	0.84
chr3	12482056	12482803	CpG: 70	747	70	483	18.7	64.7	0.91
chr3	12545967	12546245	CpG: 23	278	23	174	16.5	62.6	0.86
chr3	12554696	12555356	CpG: 75	660	75	465	22.7	70.5	0.94
chr3	12665076	12665903	CpG: 90	827	90	565	21.8	68.3	0.95
chr3	12669578	12669808	CpG: 22	230	22	143	19.1	62.2	1.00
chr3	12699455	12699738	CpG: 25	283	25	177	17.7	62.5	0.91
chr3	12719897	12720108	CpG: 16	211	16	125	15.2	59.2	0.88
chr3	12720235	12720509	CpG: 22	274	22	169	16.1	61.7	0.86
chr3	12797077	12797307	CpG: 18	230	18	140	15.7	60.9	0.86
chr3	12797983	12798350	CpG: 39	367	39	269	21.3	73.3	0.80
chr3	12798462	12798773	CpG: 21	311	21	222	13.5	71.4	0.66
chr3	12811504	12812067	CpG: 49	563	49	409	17.4	72.6	0.67
chr3	12816652	12816866	CpG: 19	214	19	132	17.8	61.7	0.94
chr3	12842544	12843083	CpG: 38	539	38	334	14.1	62.0	0.73
chr3	12851108	12851913	CpG: 64	805	64	556	15.9	69.1	0.67
chr3	12867939	12868178	CpG: 18	239	18	143	15.1	59.8	0.87
chr3	12877393	12878018	CpG: 52	625	52	453	16.6	72.5	0.63
chr3	12884246	12884783	CpG: 47	537	47	396	17.5	73.7	0.64
chr3	12900758	12901139	CpG: 30	381	30	257	15.7	67.5	0.69
chr3	12909703	12910029	CpG: 25	326	25	212	15.3	65.0	0.73
chr3	12936969	12938185	CpG: 87	1216	87	782	14.3	64.3	0.69
chr3	12968665	12969529	CpG: 104	864	104	659	24.1	76.3	0.83
chr3	12994870	12996707	CpG: 209	1837	209	1343	22.8	73.1	0.85
chr3	13074630	13075329	CpG: 81	699	81	502	23.2	71.8	0.90
chr3	13181407	13181632	CpG: 17	225	17	134	15.1	59.6	0.86
chr3	13204478	13205058	CpG: 51	580	51	389	17.6	67.1	0.78
chr3	13205206	13205454	CpG: 19	248	19	152	15.3	61.3	0.83
chr3	13282280	13283771	CpG: 203	1491	203	1132	27.2	75.9	0.95
chr3	13419827	13421002	CpG: 153	1175	153	898	26.0	76.4	0.90
chr3	13479871	13481221	CpG: 130	1350	130	969	19.3	71.8	0.75
chr3	13549368	13549962	CpG: 100	594	100	483	33.7	81.3	1.02
chr3	13570891	13571403	CpG: 41	512	41	348	16.0	68.0	0.69
chr3	13638047	13638316	CpG: 21	269	21	173	15.6	64.3	0.76
chr3	13650971	13651328	CpG: 38	357	38	254	21.3	71.1	0.89
chr3	13655607	13656107	CpG: 64	500	64	394	25.6	78.8	0.83
chr3	13804700	13804923	CpG: 17	223	17	131	15.2	58.7	0.90
chr3	13819572	13820020	CpG: 34	448	34	280	15.2	62.5	0.78
chr3	13855131	13855445	CpG: 25	314	25	203	15.9	64.6	0.77
chr3	13878734	13881435	CpG: 238	2701	238	1866	17.6	69.1	0.74
chr3	13895605	13896676	CpG: 98	1071	98	677	18.3	63.2	0.94
chr3	13933504	13933971	CpG: 62	467	62	333	26.6	71.3	1.05
chr3	14126162	14127444	CpG: 123	1282	123	847	19.2	66.1	0.89
chr3	14157488	14157725	CpG: 19	237	19	143	16.0	60.3	0.91
chr3	14180079	14180772	CpG: 75	693	75	456	21.6	65.8	1.00
chr3	14186338	14186615	CpG: 23	277	23	170	16.6	61.4	0.89
chr3	14295147	14295538	CpG: 36	391	36	294	18.4	75.2	0.65
chr3	14296381	14296597	CpG: 16	216	16	118	14.8	54.6	1.02
chr3	14299683	14300008	CpG: 39	325	39	250	24.0	76.9	0.81
chr3	14404621	14405561	CpG: 105	940	105	660	22.3	70.2	0.91
chr3	14506084	14506303	CpG: 16	219	16	154	14.6	70.3	0.66
chr3	14558289	14558540	CpG: 18	251	18	172	14.3	68.5	0.64
chr3	14574729	14574994	CpG: 21	265	21	163	15.8	61.5	0.85
chr3	14576254	14576845	CpG: 48	591	48	366	16.2	61.9	0.85
chr3	14604618	14605728	CpG: 143	1110	143	871	25.8	78.5	0.84
chr3	14653846	14654344	CpG: 37	498	37	276	14.9	55.4	0.99
chr3	14812675	14814050	CpG: 156	1375	156	974	22.7	70.8	0.91
chr3	14921786	14921989	CpG: 15	203	15	120	14.8	59.1	0.86
chr3	14949555	14951281	CpG: 208	1726	208	1222	24.1	70.8	0.96
chr3	15067020	15067878	CpG: 83	858	83	569	19.3	66.3	0.88
chr3	15076910	15077126	CpG: 15	216	15	135	13.9	62.5	0.75
chr3	15100941	15101796	CpG: 75	855	75	513	17.5	60.0	1.02
chr3	15121150	15121569	CpG: 45	419	45	274	21.5	65.4	1.01
chr3	15208348	15209222	CpG: 111	874	111	644	25.4	73.7	0.94
chr3	15334209	15335104	CpG: 107	895	107	651	23.9	72.7	0.92
chr3	15429837	15430337	CpG: 46	500	46	321	18.4	64.2	0.90
chr3	15603582	15604393	CpG: 70	811	70	495	17.3	61.0	0.93
chr3	15752313	15752596	CpG: 23	283	23	174	16.3	61.5	0.88
chr3	15862159	15863649	CpG: 176	1490	176	1109	23.6	74.4	0.85
chr3	15881109	15881312	CpG: 20	203	20	139	19.7	68.5	0.84
chr3	16152772	16153034	CpG: 26	262	26	166	19.8	63.4	1.00
chr3	16265855	16266705	CpG: 69	850	69	519	16.2	61.1	0.88
chr3	16513957	16515043	CpG: 112	1086	112	763	20.6	70.3	0.85
chr3	16605568	16606752	CpG: 102	1184	102	821	17.2	69.3	0.72
chr3	16709070	16709347	CpG: 26	277	26	175	18.8	63.2	0.95
chr3	16885118	16886608	CpG: 181	1490	181	1086	24.3	72.9	0.92
chr3	17257953	17258224	CpG: 19	271	19	163	14.0	60.1	0.78
chr3	17287477	17287755	CpG: 26	278	26	176	18.7	63.3	0.94
chr3	17744188	17744997	CpG: 92	809	92	571	22.7	70.6	0.91
chr3	17767452	17767716	CpG: 22	264	22	165	16.7	62.5	0.86
chr3	17820294	17820672	CpG: 30	378	30	273	15.9	72.2	0.61
chr3	17863051	17863478	CpG: 34	427	34	257	15.9	60.2	0.89
chr3	17879088	17879362	CpG: 24	274	24	171	17.5	62.4	0.91
chr3	17909167	17909445	CpG: 24	278	24	174	17.3	62.6	0.89
chr3	18118354	18118580	CpG: 20	226	20	138	17.7	61.1	0.99
chr3	18426918	18428284	CpG: 133	1366	133	932	19.5	68.2	0.87
chr3	18445731	18447675	CpG: 190	1944	190	1330	19.5	68.4	0.84
chr3	18696107	18696343	CpG: 22	236	22	139	18.6	58.9	1.07
chr3	18716544	18716818	CpG: 24	274	24	171	17.5	62.4	0.91
chr3	18967219	18967544	CpG: 25	325	25	191	15.4	58.8	0.89
chr3	18972592	18972835	CpG: 18	243	18	145	14.8	59.7	0.85
chr3	18997733	18998014	CpG: 23	281	23	175	16.4	62.3	0.86
chr3	19037680	19037905	CpG: 16	225	16	131	14.2	58.2	0.85
chr3	19039677	19039950	CpG: 23	273	23	170	16.8	62.3	0.88
chr3	19135611	19135841	CpG: 21	230	21	141	18.3	61.3	0.99
chr3	19150880	19151406	CpG: 44	526	44	352	16.7	66.9	0.75
chr3	19152322	19152734	CpG: 46	412	46	313	22.3	76.0	0.78
chr3	19174944	19175165	CpG: 16	221	16	130	14.5	58.8	0.85
chr3	19179392	19179616	CpG: 21	224	21	140	18.8	62.5	1.00
chr3	19238357	19238908	CpG: 46	551	46	392	16.7	71.1	0.66
chr3	19302787	19303017	CpG: 19	230	19	142	16.5	61.7	0.88
chr3	19423296	19423571	CpG: 24	275	24	172	17.5	62.5	0.90
chr3	19653000	19653277	CpG: 22	277	22	168	15.9	60.6	0.87
chr3	19706501	19707005	CpG: 60	504	60	382	23.8	75.8	0.83
chr3	19859270	19859504	CpG: 20	234	20	143	17.1	61.1	0.92
chr3	19899323	19899592	CpG: 20	269	20	166	14.9	61.7	0.79
chr3	19943553	19943813	CpG: 20	260	20	159	15.4	61.2	0.84
chr3	19950974	19951974	CpG: 97	1000	97	687	19.4	68.7	0.83
chr3	20044027	20045001	CpG: 124	974	124	754	25.5	77.4	0.85
chr3	20186725	20186999	CpG: 19	274	19	165	13.9	60.2	0.77
chr3	20189775	20190442	CpG: 62	667	62	411	18.6	61.6	0.98
chr3	20215515	20215751	CpG: 21	236	21	145	17.8	61.4	0.96
chr3	20320453	20320675	CpG: 20	222	20	135	18.0	60.8	1.00
chr3	20556467	20557421	CpG: 65	954	65	644	13.6	67.5	0.60
chr3	20653002	20653273	CpG: 21	271	21	167	15.5	61.6	0.82
chr3	20665248	20665488	CpG: 19	240	19	146	15.8	60.8	0.89
chr3	20697998	20698270	CpG: 21	272	21	165	15.4	60.7	0.85
chr3	21093519	21093755	CpG: 19	236	19	139	16.1	58.9	0.94
chr3	21118717	21119009	CpG: 26	292	26	181	17.8	62.0	0.94
chr3	21265791	21266034	CpG: 19	243	19	145	15.6	59.7	0.89
chr3	21416145	21416356	CpG: 16	211	16	155	15.2	73.5	0.61
chr3	21612716	21612998	CpG: 23	282	23	173	16.3	61.3	0.88
chr3	21704171	21704438	CpG: 22	267	22	166	16.5	62.2	0.89
chr3	21721336	21721576	CpG: 19	240	19	145	15.8	60.4	0.89
chr3	21998944	21999223	CpG: 23	279	23	171	16.5	61.3	0.88
chr3	22018601	22018853	CpG: 19	252	19	155	15.1	61.5	0.83
chr3	22333579	22333855	CpG: 22	276	22	168	15.9	60.9	0.87
chr3	22376817	22377690	CpG: 85	873	85	606	19.5	69.4	0.81
chr3	22460873	22461146	CpG: 19	273	19	164	13.9	60.1	0.78
chr3	22748224	22748439	CpG: 16	215	16	128	14.9	59.5	0.84
chr3	22771497	22771768	CpG: 18	271	18	163	13.3	60.1	0.74
chr3	22806367	22806591	CpG: 18	224	18	131	16.1	58.5	0.94
chr3	22950863	22951132	CpG: 23	269	23	165	17.1	61.3	0.93
chr3	23074431	23074712	CpG: 27	281	27	180	19.2	64.1	0.95
chr3	23207596	23208698	CpG: 133	1102	133	803	24.1	72.9	0.92
chr3	23768461	23768726	CpG: 20	265	20	167	15.1	63.0	0.77
chr3	23810493	23811918	CpG: 141	1425	141	1056	19.8	74.1	0.72
chr3	23815272	23815793	CpG: 68	521	68	403	26.1	77.4	0.90
chr3	23876027	23877023	CpG: 76	996	76	693	15.3	69.6	0.63
chr3	23921226	23922466	CpG: 108	1240	108	805	17.4	64.9	0.83
chr3	23949585	23951282	CpG: 208	1697	208	1249	24.5	73.6	0.92
chr3	24003466	24003667	CpG: 16	201	16	119	15.9	59.2	0.92
chr3	24099542	24099834	CpG: 25	292	25	178	17.1	61.0	0.92
chr3	24334453	24334740	CpG: 24	287	24	178	16.7	62.0	0.88
chr3	24498772	24500367	CpG: 171	1595	171	1126	21.4	70.6	0.88
chr3	24525772	24526485	CpG: 83	713	83	526	23.3	73.8	0.86
chr3	24579111	24579367	CpG: 20	256	20	155	15.6	60.5	0.88
chr3	24833278	24834729	CpG: 112	1451	112	948	15.4	65.3	0.74
chr3	25051664	25051897	CpG: 17	233	17	145	14.6	62.2	0.77
chr3	25075580	25075840	CpG: 19	260	19	157	14.6	60.4	0.81
chr3	25666912	25667926	CpG: 130	1014	130	739	25.6	72.9	0.98
chr3	25685785	25686059	CpG: 19	274	19	165	13.9	60.2	0.78
chr3	25785657	25786733	CpG: 101	1076	101	756	18.8	70.3	0.77
chr3	25792631	25792919	CpG: 38	288	38	182	26.4	63.2	1.33
chr3	25855520	25855732	CpG: 18	212	18	117	17.0	55.2	1.15
chr3	25901179	25901439	CpG: 21	260	21	160	16.2	61.5	0.88
chr3	26392916	26393343	CpG: 31	427	31	253	14.5	59.3	0.83
chr3	26406262	26406587	CpG: 25	325	25	191	15.4	58.8	0.89
chr3	26625213	26625905	CpG: 71	692	71	487	20.5	70.4	0.84
chr3	26627059	26627273	CpG: 18	214	18	151	16.8	70.6	0.74
chr3	26673643	26673917	CpG: 24	274	24	171	17.5	62.4	0.91
chr3	26695664	26695937	CpG: 23	273	23	167	16.8	61.2	0.91
chr3	26772469	26772693	CpG: 17	224	17	133	15.2	59.4	0.87
chr3	26845616	26845897	CpG: 23	281	23	175	16.4	62.3	0.86
chr3	27320018	27320251	CpG: 17	233	17	139	14.6	59.7	0.84
chr3	27371270	27371724	CpG: 37	454	37	302	16.3	66.5	0.77
chr3	27465247	27465594	CpG: 24	347	24	191	13.8	55.0	0.92
chr3	27468271	27468540	CpG: 21	269	21	164	15.6	61.0	0.84
chr3	27485540	27486786	CpG: 160	1246	160	918	25.7	73.7	0.95
chr3	27634837	27635233	CpG: 53	396	53	300	26.8	75.8	0.93
chr3	27714933	27715335	CpG: 34	402	34	229	16.9	57.0	1.05
chr3	27716808	27717018	CpG: 18	210	18	132	17.1	62.9	0.96
chr3	27717256	27717537	CpG: 27	281	27	182	19.2	64.8	0.92
chr3	27722948	27724592	CpG: 148	1644	148	1110	18.0	67.5	0.79
chr3	27725793	27726272	CpG: 40	479	40	252	16.7	52.6	1.21
chr3	27732235	27732539	CpG: 24	304	24	186	15.8	61.2	0.84
chr3	27823632	27823926	CpG: 23	294	23	176	15.6	59.9	0.88
chr3	28061691	28062002	CpG: 25	311	25	192	16.1	61.7	0.85
chr3	28202369	28202792	CpG: 45	423	45	315	21.3	74.5	0.77
chr3	28243394	28244025	CpG: 60	631	60	432	19.0	68.5	0.81
chr3	28350540	28351420	CpG: 91	880	91	584	20.7	66.4	0.96
chr3	28437470	28437703	CpG: 16	233	16	139	13.7	59.7	0.78
chr3	28455764	28456038	CpG: 23	274	23	170	16.8	62.0	0.89
chr3	28577062	28578369	CpG: 126	1307	126	908	19.3	69.5	0.80
chr3	28667449	28667673	CpG: 18	224	18	133	16.1	59.4	0.92
chr3	28727547	28727781	CpG: 18	234	18	137	15.4	58.5	0.93
chr3	28905194	28905559	CpG: 30	365	30	259	16.4	71.0	0.65
chr3	28939525	28939810	CpG: 22	285	22	176	15.4	61.8	0.83
chr3	28966049	28966250	CpG: 15	201	15	113	14.9	56.2	0.99
chr3	29016349	29016634	CpG: 24	285	24	178	16.8	62.5	0.88
chr3	29113760	29113984	CpG: 18	224	18	129	16.1	57.6	0.97
chr3	29133625	29133904	CpG: 26	279	26	176	18.6	63.1	0.95
chr3	29200417	29200696	CpG: 24	279	24	173	17.2	62.0	0.90
chr3	29475878	29476298	CpG: 33	420	33	304	15.7	72.4	0.60
chr3	29511350	29511660	CpG: 27	310	27	191	17.4	61.6	0.93
chr3	29704053	29704421	CpG: 35	368	35	268	19.0	72.8	0.72
chr3	29924638	29924919	CpG: 24	281	24	174	17.1	61.9	0.91
chr3	29932595	29932807	CpG: 16	212	16	126	15.1	59.4	0.87
chr3	30064290	30064573	CpG: 19	283	19	167	13.4	59.0	0.79
chr3	30528065	30528349	CpG: 26	284	26	183	18.3	64.4	0.89
chr3	30593883	30594149	CpG: 19	266	19	160	14.3	60.2	0.80
chr3	30609001	30609895	CpG: 98	894	98	627	21.9	70.1	0.89
chr3	30897035	30897253	CpG: 29	218	29	161	26.6	73.9	0.98
chr3	30916045	30916273	CpG: 17	228	17	135	14.9	59.2	0.87
chr3	31493940	31494176	CpG: 19	236	19	145	16.1	61.4	0.88
chr3	31529189	31529452	CpG: 24	263	24	168	18.3	63.9	0.92
chr3	31534276	31536256	CpG: 235	1980	235	1382	23.7	69.8	0.97
chr3	31555270	31555543	CpG: 23	273	23	167	16.8	61.2	0.91
chr3	31680256	31680537	CpG: 23	281	23	174	16.4	61.9	0.87
chr3	31842276	31842557	CpG: 24	281	24	174	17.1	61.9	0.91
chr3	31982992	31984838	CpG: 153	1846	153	1194	16.6	64.7	0.80
chr3	32103447	32104495	CpG: 109	1048	109	736	20.8	70.2	0.86
chr3	32166294	32167093	CpG: 62	799	62	556	15.5	69.6	0.64
chr3	32235008	32236327	CpG: 139	1319	139	948	21.1	71.9	0.82
chr3	32387562	32387821	CpG: 22	259	22	157	17.0	60.6	0.94
chr3	32388589	32389647	CpG: 119	1058	119	758	22.5	71.6	0.88
chr3	32398638	32398941	CpG: 33	303	33	218	21.8	71.9	0.84
chr3	32439176	32439400	CpG: 18	224	18	137	16.1	61.2	0.89
chr3	32464718	32464978	CpG: 26	260	26	189	20.0	72.7	0.76
chr3	32499495	32499874	CpG: 43	379	43	280	22.7	73.9	0.85
chr3	32501545	32501983	CpG: 30	438	30	260	13.7	59.4	0.79
chr3	32535366	32535605	CpG: 16	239	16	143	13.4	59.8	0.75
chr3	32567152	32568215	CpG: 121	1063	121	756	22.8	71.1	0.92
chr3	32575704	32576053	CpG: 32	349	32	255	18.3	73.1	0.69
chr3	32613176	32613402	CpG: 17	226	17	128	15.0	56.6	0.96
chr3	32622426	32622965	CpG: 47	539	47	392	17.4	72.7	0.66
chr3	32623725	32623934	CpG: 16	209	16	122	15.3	58.4	0.90
chr3	32648531	32648809	CpG: 23	278	23	169	16.5	60.8	0.90
chr3	32660543	32661272	CpG: 54	729	54	493	14.8	67.6	0.65
chr3	32673133	32673538	CpG: 34	405	34	247	16.8	61.0	0.90
chr3	32684542	32685174	CpG: 66	632	66	438	20.9	69.3	0.88
chr3	32721274	32721478	CpG: 16	204	16	117	15.7	57.4	0.97
chr3	32729294	32729568	CpG: 23	274	23	171	16.8	62.4	0.87
chr3	32778984	32780042	CpG: 93	1058	93	669	17.6	63.2	0.88
chr3	32814788	32817189	CpG: 303	2401	303	1678	25.2	69.9	1.03
chr3	32817818	32818106	CpG: 24	288	24	175	16.7	60.8	0.91
chr3	32819851	32820092	CpG: 34	241	34	188	28.2	78.0	0.93
chr3	32900809	32901199	CpG: 38	390	38	284	19.5	72.8	0.74
chr3	32932920	32933172	CpG: 20	252	20	154	15.9	61.1	0.86
chr3	33044114	33044383	CpG: 20	269	20	162	14.9	60.2	0.83
chr3	33098362	33099048	CpG: 76	686	76	491	22.2	71.6	0.87
chr3	33115479	33116393	CpG: 107	914	107	644	23.4	70.5	0.95
chr3	33220195	33221039	CpG: 103	844	103	628	24.4	74.4	0.89
chr3	33261232	33261505	CpG: 22	273	22	172	16.1	63.0	0.82
chr3	33279120	33279611	CpG: 60	491	60	375	24.4	76.4	0.85
chr3	33359348	33359616	CpG: 19	268	19	161	14.2	60.1	0.79
chr3	33441279	33442420	CpG: 140	1141	140	863	24.5	75.6	0.88
chr3	33442881	33443145	CpG: 19	264	19	152	14.4	57.6	0.87
chr3	33530549	33530831	CpG: 25	282	25	180	17.7	63.8	0.89
chr3	33571903	33572175	CpG: 22	272	22	171	16.2	62.9	0.83
chr3	33718448	33719297	CpG: 95	849	95	591	22.4	69.6	0.92
chr3	33769085	33769307	CpG: 17	222	17	134	15.3	60.4	0.86
chr3	33799236	33799911	CpG: 68	675	68	456	20.1	67.6	0.88
chr3	33800573	33800809	CpG: 18	236	18	144	15.3	61.0	0.84
chr3	33842193	33842467	CpG: 23	274	23	169	16.8	61.7	0.89
chr3	33859261	33859476	CpG: 17	215	17	130	15.8	60.5	0.88
chr3	33935648	33935923	CpG: 23	275	23	170	16.7	61.8	0.89
chr3	33975278	33975564	CpG: 23	286	23	178	16.1	62.2	0.85
chr3	34419515	34419857	CpG: 28	342	28	205	16.4	59.9	0.91
chr3	34756415	34756690	CpG: 23	275	23	170	16.7	61.8	0.88
chr3	34788938	34789175	CpG: 17	237	17	136	14.3	57.4	0.88
chr3	34854839	34855120	CpG: 24	281	24	175	17.1	62.3	0.90
chr3	34914067	34914340	CpG: 24	273	24	171	17.6	62.6	0.91
chr3	34980813	34981091	CpG: 23	278	23	173	16.5	62.2	0.86
chr3	35417175	35417456	CpG: 23	281	23	174	16.4	61.9	0.87
chr3	35491341	35491570	CpG: 21	229	21	141	18.3	61.6	0.99
chr3	35639696	35640814	CpG: 101	1118	101	764	18.1	68.3	0.79
chr3	36067559	36067837	CpG: 25	278	25	174	18.0	62.6	0.93
chr3	36366773	36366984	CpG: 17	211	17	131	16.1	62.1	0.86
chr3	36381701	36382209	CpG: 61	508	61	388	24.0	76.4	0.82
chr3	36454668	36454964	CpG: 27	296	27	220	18.2	74.3	0.66
chr3	36455495	36455700	CpG: 16	205	16	115	15.6	56.1	1.03
chr3	36495082	36495358	CpG: 23	276	23	170	16.7	61.6	0.89
chr3	36635255	36635825	CpG: 50	570	50	407	17.5	71.4	0.69
chr3	36636663	36636876	CpG: 18	213	18	123	16.9	57.7	1.05
chr3	36703924	36704191	CpG: 18	267	18	163	13.5	61.0	0.73
chr3	36765318	36766067	CpG: 97	749	97	551	25.9	73.6	0.96
chr3	36836389	36836663	CpG: 22	274	22	169	16.1	61.7	0.86
chr3	36945415	36946763	CpG: 132	1348	132	913	19.6	67.7	0.86
chr3	36994110	36995238	CpG: 93	1128	93	680	16.5	60.3	0.91
chr3	37176938	37177981	CpG: 108	1043	108	734	20.7	70.4	0.84
chr3	37202425	37202699	CpG: 20	274	20	167	14.6	60.9	0.79
chr3	37234410	37234813	CpG: 38	403	38	294	18.9	73.0	0.71
chr3	37244467	37245190	CpG: 80	723	80	479	22.1	66.3	1.01
chr3	37287568	37287849	CpG: 23	281	23	175	16.4	62.3	0.86
chr3	37363790	37364065	CpG: 23	275	23	168	16.7	61.1	0.90
chr3	37453468	37454588	CpG: 161	1120	161	866	28.8	77.3	0.96
chr3	37762220	37762501	CpG: 24	281	24	174	17.1	61.9	0.91
chr3	37864610	37866711	CpG: 213	2101	213	1544	20.3	73.5	0.78
chr3	37998389	37998688	CpG: 29	299	29	209	19.4	69.9	0.80
chr3	38002977	38003417	CpG: 44	440	44	310	20.0	70.5	0.87
chr3	38028433	38029512	CpG: 74	1079	74	729	13.7	67.6	0.63
chr3	38033084	38034288	CpG: 116	1204	116	852	19.3	70.8	0.77
chr3	38043331	38043890	CpG: 60	559	60	370	21.5	66.2	0.98
chr3	38057130	38057879	CpG: 58	749	58	520	15.5	69.4	0.64
chr3	38068700	38069447	CpG: 58	747	58	509	15.5	68.1	0.67
chr3	38142180	38142928	CpG: 68	748	68	511	18.2	68.3	0.80
chr3	38144035	38144867	CpG: 68	832	68	548	16.3	65.9	0.75
chr3	38170707	38171851	CpG: 113	1144	113	755	19.8	66.0	0.94
chr3	38352382	38353029	CpG: 83	647	83	485	25.7	75.0	0.91
chr3	38459674	38461737	CpG: 223	2063	223	1475	21.6	71.5	0.85
chr3	38502235	38502851	CpG: 53	616	53	406	17.2	65.9	0.79
chr3	38577352	38577616	CpG: 21	264	21	165	15.9	62.5	0.83
chr3	38590668	38591094	CpG: 33	426	33	256	15.5	60.1	0.86
chr3	38661122	38662226	CpG: 118	1104	118	822	21.4	74.5	0.77
chr3	38749210	38749490	CpG: 21	280	21	170	15.0	60.7	0.83
chr3	38784626	38784858	CpG: 18	232	18	137	15.5	59.1	0.91
chr3	38963316	38963742	CpG: 39	426	39	315	18.3	73.9	0.67
chr3	39064140	39064696	CpG: 57	556	57	393	20.5	70.7	0.83
chr3	39090915	39091189	CpG: 21	274	21	168	15.3	61.3	0.82
chr3	39119050	39120073	CpG: 120	1023	120	730	23.5	71.4	0.93
chr3	39157210	39157416	CpG: 17	206	17	134	16.5	65.0	0.78
chr3	39164905	39166166	CpG: 154	1261	154	926	24.4	73.4	0.92
chr3	39186644	39186880	CpG: 18	236	18	137	15.3	58.1	0.95
chr3	39190670	39191147	CpG: 34	477	34	318	14.3	66.7	0.65
chr3	39193785	39194175	CpG: 53	390	53	295	27.2	75.6	0.96
chr3	39240091	39240945	CpG: 72	854	72	594	16.9	69.6	0.70
chr3	39299272	39299554	CpG: 24	282	24	175	17.0	62.1	0.90
chr3	39396131	39397493	CpG: 126	1362	126	889	18.5	65.3	0.88
chr3	39419326	39420080	CpG: 60	754	60	472	15.9	62.6	0.81
chr3	39515207	39515784	CpG: 45	577	45	407	15.6	70.5	0.65
chr3	39792976	39793466	CpG: 40	490	40	360	16.3	73.5	0.60
chr3	39822650	39823710	CpG: 137	1060	137	789	25.8	74.4	0.94
chr3	39931341	39931606	CpG: 19	265	19	162	14.3	61.1	0.78
chr3	40091333	40091759	CpG: 35	426	35	307	16.4	72.1	0.63
chr3	40144324	40144601	CpG: 23	277	23	170	16.6	61.4	0.89
chr3	40214152	40214426	CpG: 24	274	24	173	17.5	63.1	0.89
chr3	40296514	40296771	CpG: 18	257	18	139	14.0	54.1	0.98
chr3	40320731	40321005	CpG: 23	274	23	170	16.8	62.0	0.88
chr3	40324414	40325389	CpG: 93	975	93	645	19.1	66.2	0.91
chr3	40342200	40342474	CpG: 22	274	22	166	16.1	60.6	0.89
chr3	40402174	40402593	CpG: 40	419	40	282	19.1	67.3	0.85
chr3	40467998	40468483	CpG: 34	485	34	291	14.0	60.0	0.78
chr3	40472225	40472842	CpG: 72	617	72	419	23.3	67.9	1.01
chr3	40491931	40492425	CpG: 40	494	40	304	16.2	61.5	0.86
chr3	40520980	40521217	CpG: 25	237	25	154	21.1	65.0	1.01
chr3	40539687	40540247	CpG: 54	560	54	393	19.3	70.2	0.78
chr3	40630717	40630953	CpG: 22	236	22	164	18.6	69.5	0.80
chr3	40923424	40923636	CpG: 16	212	16	124	15.1	58.5	0.89
chr3	41214070	41215539	CpG: 161	1469	161	1086	21.9	73.9	0.81
chr3	41332549	41332830	CpG: 24	281	24	175	17.1	62.3	0.89
chr3	41497001	41497275	CpG: 24	274	24	171	17.5	62.4	0.91
chr3	41549275	41549536	CpG: 18	261	18	156	13.8	59.8	0.78
chr3	41597011	41597284	CpG: 25	273	25	169	18.3	61.9	0.96
chr3	41858418	41858977	CpG: 46	559	46	412	16.5	73.7	0.61
chr3	41861707	41862027	CpG: 26	320	26	235	16.2	73.4	0.60
chr3	41931263	41931502	CpG: 18	239	18	141	15.1	59.0	0.89
chr3	41979303	41980190	CpG: 79	887	79	550	17.8	62.0	0.93
chr3	42001077	42001859	CpG: 63	782	63	554	16.1	70.8	0.65
chr3	42010098	42010527	CpG: 34	429	34	260	15.9	60.6	0.87
chr3	42031247	42032395	CpG: 153	1148	153	861	26.7	75.0	0.95
chr3	42220433	42220874	CpG: 33	441	33	289	15.0	65.5	0.70
chr3	42281451	42281818	CpG: 39	367	39	261	21.3	71.1	0.84
chr3	42282655	42284026	CpG: 95	1371	95	866	13.9	63.2	0.69
chr3	42423129	42423369	CpG: 19	240	19	146	15.8	60.8	0.87
chr3	42466894	42467180	CpG: 24	286	24	177	16.8	61.9	0.89
chr3	42468214	42468495	CpG: 25	281	25	176	17.8	62.6	0.92
chr3	42519342	42521028	CpG: 132	1686	132	1130	15.7	67.0	0.70
chr3	42554089	42554399	CpG: 28	310	28	229	18.1	73.9	0.67
chr3	42599716	42600374	CpG: 74	658	74	461	22.5	70.1	0.92
chr3	42608666	42609169	CpG: 48	503	48	329	19.1	65.4	0.91
chr3	42617407	42617681	CpG: 24	274	24	171	17.5	62.4	0.91
chr3	42618346	42619107	CpG: 82	761	82	527	21.6	69.3	0.90
chr3	42672035	42673082	CpG: 114	1047	114	788	21.8	75.3	0.77
chr3	42676599	42676862	CpG: 20	263	20	178	15.2	67.7	0.67
chr3	42682282	42682622	CpG: 34	340	34	248	20.0	72.9	0.81
chr3	42703603	42704435	CpG: 94	832	94	561	22.6	67.4	0.99
chr3	42790828	42791448	CpG: 59	620	59	402	19.0	64.8	0.91
chr3	42819536	42820516	CpG: 92	980	92	666	18.8	68.0	0.85
chr3	42837280	42837502	CpG: 16	222	16	131	14.4	59.0	0.84
chr3	42896304	42896957	CpG: 57	653	57	456	17.5	69.8	0.72
chr3	42921569	42922259	CpG: 66	690	66	499	19.1	72.3	0.74
chr3	42925110	42925806	CpG: 50	696	50	469	14.4	67.4	0.63
chr3	42951983	42952243	CpG: 24	260	24	171	18.5	65.8	0.88
chr3	42994851	42995503	CpG: 71	652	71	452	21.8	69.3	0.92
chr3	43080119	43080547	CpG: 31	428	31	256	14.5	59.8	0.81
chr3	43120754	43121566	CpG: 86	812	86	588	21.2	72.4	0.84
chr3	43240983	43241256	CpG: 22	273	22	172	16.1	63.0	0.82
chr3	43301513	43302385	CpG: 137	872	137	688	31.4	78.9	1.01
chr3	43379239	43379445	CpG: 18	206	18	145	17.5	70.4	0.71
chr3	43397548	43397822	CpG: 24	274	24	172	17.5	62.8	0.90
chr3	43500514	43500736	CpG: 17	222	17	141	15.3	63.5	0.76
chr3	43581525	43581836	CpG: 24	311	24	191	15.4	61.4	0.83
chr3	43637256	43637993	CpG: 80	737	80	539	21.7	73.1	0.82
chr3	43705709	43707231	CpG: 160	1522	160	1026	21.0	67.4	0.93
chr3	43790087	43790330	CpG: 23	243	23	151	18.9	62.1	1.00
chr3	43909825	43910249	CpG: 47	424	47	273	22.2	64.4	1.10
chr3	44010480	44015174	CpG: 355	4694	355	2929	15.1	62.4	0.78
chr3	44037394	44037917	CpG: 42	523	42	320	16.1	61.2	0.86
chr3	44237387	44237645	CpG: 21	258	21	151	16.3	58.5	0.98
chr3	44257335	44257934	CpG: 54	599	54	420	18.0	70.1	0.74
chr3	44314348	44314622	CpG: 24	274	24	170	17.5	62.0	0.92
chr3	44353898	44354676	CpG: 75	778	75	549	19.3	70.6	0.77
chr3	44382378	44382612	CpG: 17	234	17	137	14.5	58.5	0.88
chr3	44493158	44493688	CpG: 67	530	67	387	25.3	73.0	0.99
chr3	44526192	44526949	CpG: 78	757	78	508	20.6	67.1	0.92
chr3	44570732	44571271	CpG: 65	539	65	369	24.1	68.5	1.03
chr3	44594114	44594508	CpG: 27	394	27	254	13.7	64.5	0.67
chr3	44594792	44595212	CpG: 33	420	33	290	15.7	69.0	0.67
chr3	44596507	44597108	CpG: 76	601	76	431	25.3	71.7	0.99
chr3	44600555	44601024	CpG: 35	469	35	311	14.9	66.3	0.70
chr3	44640699	44641042	CpG: 38	343	38	249	22.2	72.6	0.86
chr3	44664342	44664803	CpG: 31	461	31	306	13.4	66.4	0.61
chr3	44701137	44701446	CpG: 39	309	39	225	25.2	72.8	0.99
chr3	44723368	44723593	CpG: 16	225	16	131	14.2	58.2	0.85
chr3	44728289	44728589	CpG: 30	300	30	204	20.0	68.0	0.87
chr3	44745118	44745463	CpG: 39	345	39	233	22.6	67.5	1.01
chr3	44776099	44776477	CpG: 25	378	25	220	13.2	58.2	0.79
chr3	44777048	44777807	CpG: 69	759	69	462	18.2	60.9	0.98
chr3	44877186	44878092	CpG: 108	906	108	655	23.8	72.3	0.92
chr3	44991579	44992800	CpG: 113	1221	113	778	18.5	63.7	0.92
chr3	45022176	45022449	CpG: 20	273	20	166	14.7	60.8	0.80
chr3	45051315	45051936	CpG: 58	621	58	418	18.7	67.3	0.84
chr3	45161959	45163007	CpG: 104	1048	104	717	19.8	68.4	0.86
chr3	45241348	45242994	CpG: 241	1646	241	1272	29.3	77.3	0.99
chr3	45404786	45405111	CpG: 33	325	33	223	20.3	68.6	0.86
chr3	45446873	45447104	CpG: 19	231	19	140	16.5	60.6	0.91
chr3	45452865	45453155	CpG: 25	290	25	179	17.2	61.7	0.92
chr3	45460743	45461021	CpG: 22	278	22	171	15.8	61.5	0.84
chr3	45609252	45610388	CpG: 124	1136	124	808	21.8	71.1	0.86
chr3	45704187	45704520	CpG: 26	333	26	176	15.6	52.9	1.12
chr3	45704975	45705781	CpG: 83	806	83	539	20.6	66.9	0.92
chr3	45811627	45812429	CpG: 90	802	90	551	22.4	68.7	0.95
chr3	45857369	45858008	CpG: 50	639	50	400	15.6	62.6	0.81
chr3	45994755	45995033	CpG: 23	278	23	173	16.5	62.2	0.86
chr3	46011399	46011859	CpG: 48	460	48	324	20.9	70.4	0.84
chr3	46197933	46198178	CpG: 21	245	21	152	17.1	62.0	0.90
chr3	46480508	46480763	CpG: 26	255	26	179	20.4	70.2	0.83
chr3	46524455	46524740	CpG: 25	285	25	178	17.5	62.5	0.92
chr3	46559497	46559719	CpG: 17	222	17	133	15.3	59.9	0.88
chr3	46581938	46582398	CpG: 42	460	42	310	18.3	67.4	0.82
chr3	46592906	46593268	CpG: 26	362	26	230	14.4	63.5	0.71
chr3	46709355	46710341	CpG: 96	986	96	720	19.5	73.0	0.74
chr3	46717390	46717712	CpG: 43	322	43	244	26.7	75.8	0.95
chr3	46733659	46734145	CpG: 51	486	51	358	21.0	73.7	0.77
chr3	46739406	46739642	CpG: 16	236	16	139	13.6	58.9	0.82
chr3	46766456	46767113	CpG: 54	657	54	453	16.4	68.9	0.71
chr3	46772637	46773065	CpG: 37	428	37	304	17.3	71.0	0.69
chr3	46804840	46805199	CpG: 28	359	28	212	15.6	59.1	0.89
chr3	46828335	46828746	CpG: 41	411	41	307	20.0	74.7	0.72
chr3	46849497	46850374	CpG: 64	877	64	589	14.6	67.2	0.65
chr3	46862356	46862827	CpG: 47	471	47	349	20.0	74.1	0.73
chr3	46897737	46900090	CpG: 250	2353	250	1704	21.2	72.4	0.82
chr3	46908653	46909186	CpG: 51	533	51	358	19.1	67.2	0.88
chr3	46914756	46915459	CpG: 70	703	70	499	19.9	71.0	0.82
chr3	46979962	46980768	CpG: 63	806	63	559	15.6	69.4	0.65
chr3	46992126	46993301	CpG: 94	1175	94	701	16.0	59.7	0.93
chr3	46995731	46996576	CpG: 96	845	96	626	22.7	74.1	0.83
chr3	47025360	47026482	CpG: 107	1122	107	787	19.1	70.1	0.78
chr3	47147746	47147966	CpG: 16	220	16	133	14.5	60.5	0.82
chr3	47154365	47154640	CpG: 24	275	24	174	17.5	63.3	0.88
chr3	47179675	47181213	CpG: 193	1538	193	1143	25.1	74.3	0.92
chr3	47272276	47272978	CpG: 52	702	52	484	14.8	68.9	0.62
chr3	47298446	47299540	CpG: 107	1094	107	703	19.6	64.3	0.95
chr3	47325621	47326261	CpG: 47	640	47	421	14.7	65.8	0.68
chr3	47372762	47373161	CpG: 38	399	38	271	19.0	67.9	0.83
chr3	47397013	47398110	CpG: 94	1097	94	730	17.1	66.5	0.78
chr3	47419493	47419730	CpG: 18	237	18	145	15.2	61.2	0.82
chr3	47433059	47433346	CpG: 25	287	25	180	17.4	62.7	0.90
chr3	47434581	47434994	CpG: 41	413	41	293	19.9	70.9	0.79
chr3	47491266	47491548	CpG: 24	282	24	173	17.0	61.3	0.92
chr3	47493110	47493372	CpG: 18	262	18	158	13.7	60.3	0.77
chr3	47494627	47495452	CpG: 98	825	98	595	23.8	72.1	0.91
chr3	47503869	47504094	CpG: 17	225	17	132	15.1	58.7	0.89
chr3	47531855	47533451	CpG: 123	1596	123	958	15.4	60.0	0.87
chr3	47556813	47557050	CpG: 19	237	19	142	16.0	59.9	0.92
chr3	47596700	47598719	CpG: 236	2019	236	1524	23.4	75.5	0.83
chr3	47672044	47672330	CpG: 24	286	24	179	16.8	62.6	0.87
chr3	47691349	47691581	CpG: 17	232	17	136	14.7	58.6	0.88
chr3	47699652	47699930	CpG: 23	278	23	173	16.5	62.2	0.86
chr3	47703053	47703319	CpG: 24	266	24	169	18.0	63.5	0.91
chr3	47800575	47801523	CpG: 112	948	112	681	23.6	71.8	0.93
chr3	47829954	47830988	CpG: 118	1034	118	749	22.8	72.4	0.87
chr3	47852183	47852720	CpG: 68	537	68	400	25.3	74.5	0.92
chr3	47873666	47873991	CpG: 23	325	23	215	14.2	66.2	0.65
chr3	47876970	47877385	CpG: 33	415	33	279	15.9	67.2	0.70
chr3	47930605	47930830	CpG: 18	225	18	133	16.0	59.1	0.92
chr3	47946260	47946529	CpG: 19	269	19	158	14.1	58.7	0.83
chr3	47957464	47957745	CpG: 24	281	24	175	17.1	62.3	0.90
chr3	47978775	47979622	CpG: 66	847	66	585	15.6	69.1	0.65
chr3	48015188	48015424	CpG: 17	236	17	140	14.4	59.3	0.83
chr3	48088615	48089213	CpG: 46	598	46	423	15.4	70.7	0.62
chr3	48115735	48116713	CpG: 109	978	109	719	22.3	73.5	0.83
chr3	48214759	48215967	CpG: 125	1208	125	835	20.7	69.1	0.87
chr3	48222174	48222411	CpG: 19	237	19	143	16.0	60.3	0.91
chr3	48222888	48223162	CpG: 23	274	23	168	16.8	61.3	0.90
chr3	48229264	48229666	CpG: 28	402	28	231	13.9	57.5	0.86
chr3	48266938	48267219	CpG: 23	281	23	175	16.4	62.3	0.86
chr3	48268716	48269104	CpG: 46	388	46	263	23.7	67.8	1.03
chr3	48269330	48269754	CpG: 28	424	28	246	13.2	58.0	0.79
chr3	48281298	48281578	CpG: 19	280	19	169	13.6	60.4	0.75
chr3	48328541	48329537	CpG: 85	996	85	665	17.1	66.8	0.77
chr3	48358615	48358896	CpG: 24	281	24	174	17.1	61.9	0.91
chr3	48456833	48457992	CpG: 140	1159	140	875	24.2	75.5	0.86
chr3	48468015	48468769	CpG: 62	754	62	482	16.4	63.9	0.82
chr3	48474398	48475185	CpG: 94	787	94	559	23.9	71.0	0.95
chr3	48520496	48520766	CpG: 21	270	21	165	15.6	61.1	0.84
chr3	48532830	48533589	CpG: 75	759	75	547	19.8	72.1	0.77
chr3	48585552	48586383	CpG: 62	831	62	567	14.9	68.2	0.66
chr3	48623409	48624428	CpG: 76	1019	76	683	14.9	67.0	0.67
chr3	48638148	48638932	CpG: 82	784	82	539	20.9	68.8	0.90
chr3	48644564	48644838	CpG: 23	274	23	170	16.8	62.0	0.88
chr3	48663933	48664687	CpG: 77	754	77	536	20.4	71.1	0.81
chr3	48669056	48669404	CpG: 27	348	27	236	15.5	67.8	0.68
chr3	48684645	48686295	CpG: 178	1650	178	1145	21.6	69.4	0.90
chr3	48689862	48693194	CpG: 303	3332	303	2226	18.2	66.8	0.82
chr3	48714499	48715287	CpG: 99	788	99	575	25.1	73.0	0.95
chr3	48746124	48746451	CpG: 29	327	29	219	17.7	67.0	0.79
chr3	48876042	48876945	CpG: 112	903	112	645	24.8	71.4	0.97
chr3	48927613	48928029	CpG: 43	416	43	295	20.7	70.9	0.82
chr3	48934938	48935212	CpG: 23	274	23	170	16.8	62.0	0.88
chr3	48946210	48946454	CpG: 19	244	19	147	15.6	60.2	0.88
chr3	48946841	48947142	CpG: 23	301	23	179	15.3	59.5	0.88
chr3	48947383	48948511	CpG: 137	1128	137	778	24.3	69.0	1.02
chr3	48951048	48951269	CpG: 18	221	18	134	16.3	60.6	0.89
chr3	49017735	49018975	CpG: 135	1240	135	875	21.8	70.6	0.88
chr3	49034739	49036183	CpG: 127	1444	127	963	17.6	66.7	0.82
chr3	49045821	49050593	CpG: 369	4772	369	3011	15.5	63.1	0.78
chr3	49057180	49057590	CpG: 46	410	46	277	22.4	67.6	0.99
chr3	49121312	49122480	CpG: 128	1168	128	802	21.9	68.7	0.94
chr3	49132574	49133013	CpG: 37	439	37	283	16.9	64.5	0.82
chr3	49148407	49149102	CpG: 77	695	77	494	22.2	71.1	0.88
chr3	49188427	49188703	CpG: 25	276	25	172	18.1	62.3	0.94
chr3	49193920	49194455	CpG: 60	535	60	391	22.4	73.1	0.84
chr3	49199264	49199831	CpG: 55	567	55	388	19.4	68.4	0.83
chr3	49209914	49210122	CpG: 18	208	18	121	17.3	58.2	1.04
chr3	49227205	49227966	CpG: 61	761	61	509	16.0	66.9	0.75
chr3	49303632	49303906	CpG: 20	274	20	166	14.6	60.6	0.80
chr3	49305084	49305462	CpG: 39	378	39	265	20.6	70.1	0.88
chr3	49369285	49369799	CpG: 59	514	59	360	23.0	70.0	0.97
chr3	49370769	49371003	CpG: 19	234	19	133	16.2	56.8	1.04
chr3	49383436	49383719	CpG: 22	283	22	172	15.5	60.8	0.86
chr3	49386801	49387882	CpG: 94	1081	94	700	17.4	64.8	0.83
chr3	49430150	49430355	CpG: 15	205	15	118	14.6	57.6	0.90
chr3	49440807	49441911	CpG: 133	1104	133	787	24.1	71.3	0.96
chr3	49458428	49459165	CpG: 60	737	60	447	16.3	60.7	0.90
chr3	49477821	49478383	CpG: 37	562	37	330	13.2	58.7	0.77
chr3	49499011	49499917	CpG: 122	906	122	679	26.9	74.9	0.97
chr3	49556219	49556679	CpG: 33	460	33	262	14.3	57.0	0.90
chr3	49568817	49569101	CpG: 39	284	39	214	27.5	75.4	1.01
chr3	49583143	49584099	CpG: 127	956	127	722	26.6	75.5	0.93
chr3	49617947	49618221	CpG: 22	274	22	161	16.1	58.8	0.94
chr3	49621484	49621748	CpG: 20	264	20	163	15.2	61.7	0.82
chr3	49681850	49682157	CpG: 24	307	24	204	15.6	66.4	0.71
chr3	49702813	49704130	CpG: 117	1317	117	922	17.8	70.0	0.74
chr3	49714994	49716471	CpG: 121	1477	121	981	16.4	66.4	0.75
chr3	49718538	49719192	CpG: 61	654	61	448	18.7	68.5	0.84
chr3	49747349	49749170	CpG: 155	1821	155	1193	17.0	65.5	0.80
chr3	49752716	49753748	CpG: 116	1032	116	715	22.5	69.3	0.94
chr3	49815935	49816799	CpG: 82	864	82	591	19.0	68.4	0.82
chr3	49832109	49832347	CpG: 20	238	20	145	16.8	60.9	0.93
chr3	49832546	49833635	CpG: 110	1089	110	758	20.2	69.6	0.84
chr3	49886274	49886680	CpG: 37	406	37	252	18.2	62.1	0.96
chr3	49899204	49899949	CpG: 75	745	75	521	20.1	69.9	0.83
chr3	49908291	49908512	CpG: 16	221	16	134	14.5	60.6	0.81
chr3	49932562	49932894	CpG: 23	332	23	202	13.9	60.8	0.75
chr3	49933351	49933889	CpG: 53	538	53	383	19.7	71.2	0.78
chr3	49940085	49940894	CpG: 64	809	64	509	15.8	62.9	0.81
chr3	49959621	49959972	CpG: 36	351	36	256	20.5	72.9	0.78
chr3	49968089	49968337	CpG: 20	248	20	139	16.1	56.0	1.03
chr3	49969086	49969915	CpG: 84	829	84	561	20.3	67.7	0.91
chr3	49994532	49994807	CpG: 20	275	20	168	14.5	61.1	0.78
chr3	50118135	50119087	CpG: 69	952	69	591	14.5	62.1	0.75
chr3	50183872	50185031	CpG: 162	1159	162	910	28.0	78.5	0.91
chr3	50222329	50224243	CpG: 168	1914	168	1279	17.6	66.8	0.79
chr3	50234448	50235487	CpG: 101	1039	101	750	19.4	72.2	0.75
chr3	50255590	50257007	CpG: 118	1417	118	932	16.7	65.8	0.78
chr3	50265174	50265807	CpG: 71	633	71	463	22.4	73.1	0.84
chr3	50267299	50267551	CpG: 22	252	22	174	17.5	69.0	0.75
chr3	50289343	50290000	CpG: 69	657	69	490	21.0	74.6	0.76
chr3	50302363	50306337	CpG: 283	3974	283	2587	14.2	65.1	0.67
chr3	50321324	50322041	CpG: 75	717	75	502	20.9	70.0	0.85
chr3	50328256	50328804	CpG: 51	548	51	367	18.6	67.0	0.83
chr3	50349748	50349978	CpG: 17	230	17	136	14.8	59.1	0.87
chr3	50350673	50351899	CpG: 109	1226	109	855	17.8	69.7	0.73
chr3	50352132	50352335	CpG: 16	203	16	139	15.8	68.5	0.69
chr3	50357599	50358178	CpG: 57	579	57	402	19.7	69.4	0.82
chr3	50366556	50367922	CpG: 138	1366	138	929	20.2	68.0	0.87
chr3	50370096	50370833	CpG: 84	737	84	527	22.8	71.5	0.89
chr3	50375182	50375603	CpG: 42	421	42	287	20.0	68.2	0.86
chr3	50380251	50380973	CpG: 64	722	64	467	17.7	64.7	0.85
chr3	50388639	50389467	CpG: 64	828	64	562	15.5	67.9	0.67
chr3	50394392	50395231	CpG: 86	839	86	592	20.5	70.6	0.83
chr3	50532697	50533839	CpG: 146	1142	146	879	25.6	77.0	0.86
chr3	50560333	50560539	CpG: 31	206	31	167	30.1	81.1	0.94
chr3	50597363	50597817	CpG: 44	454	44	327	19.4	72.0	0.75
chr3	50598800	50599524	CpG: 55	724	55	483	15.2	66.7	0.68
chr3	50641377	50642267	CpG: 91	890	91	622	20.4	69.9	0.85
chr3	50646794	50647638	CpG: 75	844	75	599	17.8	71.0	0.71
chr3	50704615	50705554	CpG: 137	939	137	732	29.2	78.0	0.98
chr3	50833771	50834523	CpG: 51	752	51	501	13.6	66.6	0.62
chr3	51008760	51009112	CpG: 27	352	27	205	15.3	58.2	0.91
chr3	51098683	51098957	CpG: 20	274	20	168	14.6	61.3	0.79
chr3	51278758	51280139	CpG: 113	1381	113	1019	16.4	73.8	0.60
chr3	51339221	51339900	CpG: 53	679	53	455	15.6	67.0	0.70
chr3	51414975	51416017	CpG: 97	1042	97	719	18.6	69.0	0.79
chr3	51421398	51422826	CpG: 211	1428	211	1068	29.6	74.8	1.06
chr3	51423370	51423723	CpG: 24	353	24	224	13.6	63.5	0.68
chr3	51529768	51530686	CpG: 89	918	89	606	19.4	66.0	0.90
chr3	51569017	51569695	CpG: 87	678	87	499	25.7	73.6	0.95
chr3	51639190	51640216	CpG: 80	1026	80	737	15.6	71.8	0.61
chr3	51702564	51703524	CpG: 103	960	103	689	21.5	71.8	0.83
chr3	51738234	51738907	CpG: 68	673	68	483	20.2	71.8	0.79
chr3	51748730	51749037	CpG: 23	307	23	195	15.0	63.5	0.74
chr3	51763983	51764225	CpG: 19	242	19	142	15.7	58.7	0.93
chr3	51891137	51892117	CpG: 72	980	72	677	14.7	69.1	0.62
chr3	51974515	51975408	CpG: 80	893	80	611	17.9	68.4	0.77
chr3	51988666	51989542	CpG: 117	876	117	671	26.7	76.6	0.92
chr3	52000105	52000970	CpG: 112	865	112	680	25.9	78.6	0.88
chr3	52005986	52008279	CpG: 163	2293	163	1431	14.2	62.4	0.73
chr3	52008964	52009392	CpG: 32	428	32	268	15.0	62.6	0.76
chr3	52015960	52016496	CpG: 61	536	61	391	22.8	72.9	0.86
chr3	52023483	52023836	CpG: 34	353	34	263	19.3	74.5	0.70
chr3	52028667	52028968	CpG: 34	301	34	192	22.6	63.8	1.11
chr3	52029115	52029392	CpG: 20	277	20	167	14.4	60.3	0.81
chr3	52088539	52090539	CpG: 220	2000	220	1420	22.0	71.0	0.87
chr3	52111441	52111696	CpG: 21	255	21	153	16.5	60.0	0.93
chr3	52186955	52187896	CpG: 87	941	87	611	18.5	64.9	0.88
chr3	52230806	52231405	CpG: 65	599	65	408	21.7	68.1	0.96
chr3	52254235	52254633	CpG: 35	398	35	267	17.6	67.1	0.79
chr3	52266531	52266732	CpG: 14	201	14	120	13.9	59.7	0.81
chr3	52271709	52272502	CpG: 87	793	87	571	21.9	72.0	0.85
chr3	52278302	52279010	CpG: 92	708	92	534	26.0	75.4	0.93
chr3	52310938	52312333	CpG: 137	1395	137	911	19.6	65.3	0.94
chr3	52320227	52320535	CpG: 22	308	22	173	14.3	56.2	0.92
chr3	52320642	52320937	CpG: 27	295	27	199	18.3	67.5	0.83
chr3	52321171	52321442	CpG: 19	271	19	151	14.0	55.7	0.91
chr3	52406181	52406383	CpG: 23	202	23	153	22.8	75.7	0.85
chr3	52442642	52444069	CpG: 160	1427	160	1010	22.4	70.8	0.91
chr3	52477481	52477707	CpG: 19	226	19	133	16.8	58.8	1.15
chr3	52488302	52488893	CpG: 76	591	76	435	25.7	73.6	1.03
chr3	52520562	52521500	CpG: 68	938	68	602	14.5	64.2	0.72
chr3	52532514	52532792	CpG: 25	278	25	175	18.0	62.9	0.91
chr3	52551603	52552280	CpG: 54	677	54	476	16.0	70.3	0.68
chr3	52557457	52557661	CpG: 16	204	16	126	15.7	61.8	0.95
chr3	52557860	52558178	CpG: 24	318	24	217	15.1	68.2	0.65
chr3	52565893	52567670	CpG: 206	1777	206	1317	23.2	74.1	0.85
chr3	52569246	52569726	CpG: 52	480	52	331	21.7	69.0	0.91
chr3	52708743	52709024	CpG: 25	281	25	178	17.8	63.3	0.90
chr3	52718398	52719230	CpG: 104	832	104	587	25.0	70.6	1.01
chr3	52738432	52739321	CpG: 109	889	109	636	24.5	71.5	0.97
chr3	52803450	52804019	CpG: 61	569	61	406	21.4	71.4	0.84
chr3	52930213	52930827	CpG: 80	614	80	472	26.1	76.9	0.88
chr3	52998600	52999241	CpG: 45	641	45	370	14.0	57.7	0.85
chr3	53031009	53031222	CpG: 16	213	16	128	15.0	60.1	0.84
chr3	53031670	53031973	CpG: 22	303	22	198	14.5	65.3	0.69
chr3	53045311	53045594	CpG: 22	283	22	174	15.5	61.5	0.83
chr3	53077844	53079989	CpG: 322	2145	322	1619	30.0	75.5	1.06
chr3	53163073	53163565	CpG: 38	492	38	312	15.4	63.4	0.77
chr3	53189404	53189664	CpG: 32	260	32	192	24.6	73.8	1.01
chr3	53193610	53195027	CpG: 163	1417	163	1066	23.0	75.2	0.83
chr3	53212537	53212775	CpG: 18	238	18	143	15.1	60.1	0.92
chr3	53228857	53229071	CpG: 21	214	21	154	19.6	72.0	0.76
chr3	53252170	53252479	CpG: 26	309	26	183	16.8	59.2	0.98
chr3	53288389	53289173	CpG: 99	784	99	590	25.3	75.3	0.89
chr3	53355889	53356110	CpG: 18	221	18	130	16.3	58.8	0.95
chr3	53380293	53380884	CpG: 54	591	54	395	18.3	66.8	0.82
chr3	53498978	53499262	CpG: 24	284	24	175	16.9	61.6	0.91
chr3	53527168	53529348	CpG: 222	2180	222	1489	20.4	68.3	0.87
chr3	53856604	53857166	CpG: 62	562	62	407	22.1	72.4	0.84
chr3	53878849	53880042	CpG: 145	1193	145	855	24.3	71.7	0.95
chr3	53914876	53915533	CpG: 65	657	65	464	19.8	70.6	0.80
chr3	53924651	53925387	CpG: 73	736	73	453	19.8	61.5	1.05
chr3	53960666	53960992	CpG: 24	326	24	191	14.7	58.6	0.87
chr3	54049498	54049776	CpG: 27	278	27	176	19.4	63.3	0.98
chr3	54121458	54121981	CpG: 46	523	46	371	17.6	70.9	0.70
chr3	54154579	54154818	CpG: 20	239	20	159	16.7	66.5	0.77
chr3	54155087	54156873	CpG: 223	1786	223	1345	25.0	75.3	0.89
chr3	54433742	54434034	CpG: 23	292	23	176	15.8	60.3	0.87
chr3	54660154	54660603	CpG: 33	449	33	278	14.7	61.9	0.77
chr3	54843154	54843435	CpG: 24	281	24	174	17.1	61.9	0.91
chr3	55085954	55086242	CpG: 23	288	23	174	16.0	60.4	0.88
chr3	55170651	55170977	CpG: 26	326	26	193	16.0	59.2	0.91
chr3	55275007	55275290	CpG: 26	283	26	178	18.4	62.9	0.94
chr3	55380822	55381087	CpG: 20	265	20	166	15.1	62.6	0.77
chr3	55504379	55504631	CpG: 24	252	24	164	19.0	65.1	0.90
chr3	55508514	55508897	CpG: 47	383	47	272	24.5	71.0	0.97
chr3	55515330	55515791	CpG: 34	461	34	301	14.8	65.3	0.70
chr3	55516288	55516608	CpG: 24	320	24	205	15.0	64.1	0.74
chr3	55517076	55517341	CpG: 25	265	25	155	18.9	58.5	1.11
chr3	55517836	55518117	CpG: 21	281	21	169	14.9	60.1	0.85
chr3	55519251	55519785	CpG: 43	534	43	362	16.1	67.8	0.71
chr3	55520389	55522507	CpG: 180	2118	180	1326	17.0	62.6	0.87
chr3	55522724	55523000	CpG: 21	276	21	180	15.2	65.2	0.73
chr3	55523206	55523488	CpG: 22	282	22	169	15.6	59.9	0.87
chr3	55788688	55789114	CpG: 33	426	33	256	15.5	60.1	0.86
chr3	55885519	55885789	CpG: 23	270	23	168	17.0	62.2	0.89
chr3	55982635	55982923	CpG: 24	288	24	174	16.7	60.4	0.93
chr3	56321561	56321835	CpG: 23	274	23	170	16.8	62.0	0.88
chr3	56508265	56509211	CpG: 107	946	107	694	22.6	73.4	0.84
chr3	56549985	56550224	CpG: 18	239	18	138	15.1	57.7	0.94
chr3	56575714	56575953	CpG: 18	239	18	144	15.1	60.3	0.84
chr3	56591915	56592196	CpG: 22	281	22	171	15.7	60.9	0.86
chr3	56597434	56597718	CpG: 29	284	29	180	20.4	63.4	1.02
chr3	56606181	56606444	CpG: 21	263	21	164	16.0	62.4	0.83
chr3	56624195	56624937	CpG: 68	742	68	568	18.3	76.5	0.63
chr3	56683857	56684080	CpG: 15	223	15	135	13.5	60.5	0.74
chr3	56722779	56723945	CpG: 120	1166	120	805	20.6	69.0	0.87
chr3	56732222	56732613	CpG: 35	391	35	288	17.9	73.7	0.66
chr3	56833579	56833809	CpG: 20	230	20	140	17.4	60.9	0.96
chr3	56841960	56842520	CpG: 57	560	57	400	20.4	71.4	0.80
chr3	57118839	57120180	CpG: 128	1341	128	951	19.1	70.9	0.76
chr3	57137898	57138661	CpG: 51	763	51	455	13.4	59.6	0.75
chr3	57204494	57205737	CpG: 125	1243	125	873	20.1	70.2	0.82
chr3	57210413	57210661	CpG: 24	248	24	160	19.4	64.5	0.94
chr3	57237285	57237545	CpG: 26	260	26	159	20.0	61.2	1.08
chr3	57267695	57268838	CpG: 131	1143	131	791	22.9	69.2	0.96
chr3	57291098	57291372	CpG: 24	274	24	171	17.5	62.4	0.91
chr3	57378348	57379013	CpG: 46	665	46	443	13.8	66.6	0.62
chr3	57542267	57542498	CpG: 21	231	21	141	18.2	61.0	0.99
chr3	57560281	57560580	CpG: 28	299	28	182	18.7	60.9	1.01
chr3	57596072	57596321	CpG: 19	249	19	143	15.3	57.4	0.93
chr3	57596566	57597879	CpG: 113	1313	113	818	17.2	62.3	0.89
chr3	57598909	57599151	CpG: 20	242	20	148	16.5	61.2	0.89
chr3	57637669	57638260	CpG: 60	591	60	372	20.3	62.9	1.03
chr3	57732980	57733579	CpG: 75	599	75	447	25.0	74.6	0.90
chr3	57796573	57797638	CpG: 116	1065	116	755	21.8	70.9	0.87
chr3	57802143	57802424	CpG: 24	281	24	175	17.1	62.3	0.90
chr3	57815443	57815708	CpG: 22	265	22	167	16.6	63.0	0.85
chr3	58048524	58049390	CpG: 95	866	95	609	21.9	70.3	0.89
chr3	58049607	58049904	CpG: 23	297	23	206	15.5	69.4	0.65
chr3	58163829	58164098	CpG: 24	269	24	171	17.8	63.6	0.89
chr3	58218201	58218412	CpG: 24	211	24	150	22.7	71.1	0.91
chr3	58277773	58279036	CpG: 127	1263	127	888	20.1	70.3	0.81
chr3	58346493	58347065	CpG: 65	572	65	386	22.7	67.5	1.01
chr3	58373078	58373872	CpG: 104	794	104	613	26.2	77.2	0.91
chr3	58473830	58474472	CpG: 67	642	67	451	20.9	70.2	0.85
chr3	58532136	58532924	CpG: 122	788	122	630	31.0	79.9	0.99
chr3	58627133	58627558	CpG: 48	425	48	317	22.6	74.6	0.81
chr3	58856837	58857054	CpG: 18	217	18	126	16.6	58.1	0.98
chr3	58882582	58883008	CpG: 32	426	32	256	15.0	60.1	0.84
chr3	58911026	58911307	CpG: 23	281	23	174	16.4	61.9	0.87
chr3	59090095	59090633	CpG: 57	538	57	373	21.2	69.3	0.88
chr3	59091279	59091669	CpG: 33	390	33	277	16.9	71.0	0.67
chr3	59106168	59106453	CpG: 24	285	24	174	16.8	61.1	0.92
chr3	59168481	59168755	CpG: 21	274	21	169	15.3	61.7	0.81
chr3	59179924	59180201	CpG: 24	277	24	170	17.3	61.4	0.93
chr3	59244724	59245001	CpG: 24	277	24	171	17.3	61.7	0.92
chr3	59440593	59440874	CpG: 19	281	19	170	13.5	60.5	0.76
chr3	59615137	59615407	CpG: 22	270	22	163	16.3	60.4	0.91
chr3	60155284	60155521	CpG: 18	237	18	142	15.2	59.9	0.88
chr3	60419318	60419583	CpG: 23	265	23	166	17.4	62.6	0.90
chr3	60541179	60541410	CpG: 19	231	19	139	16.5	60.2	0.92
chr3	60573043	60573321	CpG: 23	278	23	173	16.5	62.2	0.86
chr3	60575879	60576178	CpG: 25	299	25	184	16.7	61.5	0.89
chr3	60880795	60881073	CpG: 22	278	22	171	15.8	61.5	0.84
chr3	61038190	61038420	CpG: 18	230	18	140	15.7	60.9	0.87
chr3	61064464	61064738	CpG: 23	274	23	170	16.8	62.0	0.88
chr3	61080085	61080351	CpG: 19	266	19	154	14.3	57.9	0.88
chr3	61126472	61126751	CpG: 24	279	24	173	17.2	62.0	0.90
chr3	61294089	61294710	CpG: 48	621	48	407	15.5	65.5	0.72
chr3	61338183	61338468	CpG: 26	285	26	169	18.2	59.3	1.05
chr3	61532665	61532939	CpG: 23	274	23	169	16.8	61.7	0.90
chr3	61603426	61607132	CpG: 306	3706	306	2361	16.5	63.7	0.81
chr3	61607809	61608040	CpG: 26	231	26	168	22.5	72.7	0.85
chr3	61781199	61781425	CpG: 18	226	18	137	15.9	60.6	0.89
chr3	62060775	62061061	CpG: 24	286	24	172	16.8	60.1	0.94
chr3	62124356	62124592	CpG: 17	236	17	140	14.4	59.3	0.84
chr3	62246798	62247136	CpG: 25	338	25	219	14.8	64.8	0.72
chr3	62354180	62354411	CpG: 17	231	17	139	14.7	60.2	0.83
chr3	62362349	62362615	CpG: 35	266	35	181	26.3	68.0	1.14
chr3	62412130	62417614	CpG: 364	5484	364	3236	13.3	59.0	0.76
chr3	62420450	62420922	CpG: 51	472	51	331	21.6	70.1	0.88
chr3	62421858	62422157	CpG: 23	299	23	197	15.4	65.9	0.71
chr3	62637777	62638043	CpG: 23	266	23	165	17.3	62.0	0.91
chr3	62917616	62919189	CpG: 155	1573	155	1114	19.7	70.8	0.79
chr3	63180072	63180382	CpG: 23	310	23	189	14.8	61.0	0.80
chr3	63260881	63261175	CpG: 23	294	23	176	15.6	59.9	0.87
chr3	63321834	63322050	CpG: 20	216	20	144	18.5	66.7	0.83
chr3	63378639	63378870	CpG: 16	231	16	138	13.9	59.7	0.79
chr3	63384027	63384263	CpG: 20	236	20	144	16.9	61.0	0.93
chr3	63897252	63897492	CpG: 16	240	16	142	13.3	59.2	0.78
chr3	63898356	63898630	CpG: 24	274	24	170	17.5	62.0	0.92
chr3	63906997	63908289	CpG: 170	1292	170	981	26.3	75.9	0.92
chr3	63943291	63943531	CpG: 21	240	21	144	17.5	60.0	1.00
chr3	63955334	63956716	CpG: 158	1382	158	1012	22.9	73.2	0.85
chr3	64066822	64067232	CpG: 55	410	55	295	26.8	72.0	1.04
chr3	64088562	64088781	CpG: 19	219	19	134	17.4	61.2	0.96
chr3	64134467	64134695	CpG: 20	228	20	141	17.5	61.8	0.94
chr3	64311435	64311721	CpG: 24	286	24	203	16.8	71.0	0.67
chr3	64488495	64489319	CpG: 89	824	89	603	21.6	73.2	0.82
chr3	64729075	64731945	CpG: 203	2870	203	1745	14.1	60.8	0.77
chr3	64739953	64740232	CpG: 24	279	24	175	17.2	62.7	0.88
chr3	64835448	64835712	CpG: 23	264	23	161	17.4	61.0	0.95
chr3	64948292	64948567	CpG: 20	275	20	160	14.5	58.2	0.88
chr3	65146263	65146501	CpG: 19	238	19	143	16.0	60.1	0.91
chr3	65348939	65349214	CpG: 23	275	23	172	16.7	62.5	0.86
chr3	65400168	65400849	CpG: 66	681	66	457	19.4	67.1	0.86
chr3	65422908	65423227	CpG: 34	319	34	213	21.3	66.8	0.96
chr3	65553005	65553431	CpG: 31	426	31	250	14.6	58.7	0.85
chr3	65560471	65560707	CpG: 22	236	22	146	18.6	61.9	0.99
chr3	65592646	65593316	CpG: 73	670	73	482	21.8	71.9	0.86
chr3	65913013	65913242	CpG: 20	229	20	141	17.5	61.6	0.95
chr3	65934120	65934399	CpG: 22	279	22	172	15.8	61.6	0.84
chr3	66081722	66083944	CpG: 175	2222	175	1418	15.8	63.8	0.79
chr3	66149398	66149672	CpG: 24	274	24	171	17.5	62.4	0.91
chr3	66175090	66175352	CpG: 20	262	20	161	15.3	61.5	0.84
chr3	66215168	66215446	CpG: 23	278	23	173	16.5	62.2	0.86
chr3	66239057	66239328	CpG: 22	271	22	163	16.2	60.1	0.90
chr3	66248567	66248815	CpG: 21	248	21	150	16.9	60.5	0.95
chr3	66265213	66265855	CpG: 55	642	55	407	17.1	63.4	0.85
chr3	66326596	66326877	CpG: 22	281	22	174	15.7	61.9	0.83
chr3	66544434	66545964	CpG: 186	1530	186	1112	24.3	72.7	0.94
chr3	66665701	66665980	CpG: 24	279	24	174	17.2	62.4	0.89
chr3	67043027	67043845	CpG: 81	818	81	554	19.8	67.7	0.88
chr3	67613934	67614208	CpG: 23	274	23	172	16.8	62.8	0.86
chr3	67699518	67700078	CpG: 61	560	61	418	21.8	74.6	0.79
chr3	67910899	67911169	CpG: 23	270	23	168	17.0	62.2	0.89
chr3	68053000	68053392	CpG: 28	392	28	262	14.3	66.8	0.66
chr3	68276957	68277238	CpG: 24	281	24	175	17.1	62.3	0.90
chr3	68291893	68292167	CpG: 21	274	21	169	15.3	61.7	0.82
chr3	68377506	68377780	CpG: 20	274	20	168	14.6	61.3	0.79
chr3	68658865	68659139	CpG: 23	274	23	170	16.8	62.0	0.88
chr3	68968369	68970052	CpG: 130	1683	130	1047	15.4	62.2	0.80
chr3	69049775	69050806	CpG: 128	1031	128	771	24.8	74.8	0.89
chr3	69088174	69088438	CpG: 21	264	21	145	15.9	54.9	1.05
chr3	69088856	69089299	CpG: 39	443	39	266	17.6	60.0	0.98
chr3	69116699	69117289	CpG: 57	590	57	429	19.3	72.7	0.73
chr3	69121727	69122120	CpG: 35	393	35	240	17.8	61.1	0.96
chr3	69235944	69236216	CpG: 21	272	21	167	15.4	61.4	0.83
chr3	69297267	69297474	CpG: 22	207	22	151	21.3	72.9	0.80
chr3	69350797	69351071	CpG: 25	274	25	172	18.2	62.8	0.94
chr3	69422634	69423291	CpG: 62	657	62	458	18.9	69.7	0.79
chr3	69578714	69579753	CpG: 109	1039	109	745	21.0	71.7	0.83
chr3	69665049	69665334	CpG: 25	285	25	179	17.5	62.8	0.90
chr3	69697544	69697937	CpG: 39	393	39	290	19.8	73.8	0.73
chr3	69715537	69715751	CpG: 15	214	15	122	14.0	57.0	0.89
chr3	69728424	69728706	CpG: 24	282	24	170	17.0	60.3	0.95
chr3	69776230	69776955	CpG: 78	725	78	517	21.5	71.3	0.86
chr3	69885935	69886213	CpG: 24	278	24	175	17.3	62.9	0.88
chr3	69897280	69897542	CpG: 26	262	26	164	19.8	62.6	1.03
chr3	70025965	70026227	CpG: 24	262	24	164	18.3	62.6	0.94
chr3	70224376	70224653	CpG: 24	277	24	171	17.3	61.7	0.92
chr3	70327540	70327758	CpG: 20	218	20	130	18.3	59.6	1.04
chr3	70369485	70369712	CpG: 19	227	19	135	16.7	59.5	0.96
chr3	70463891	70464164	CpG: 22	273	22	167	16.1	61.2	0.87
chr3	71101246	71102171	CpG: 116	925	116	638	25.1	69.0	1.06
chr3	71201007	71201249	CpG: 18	242	18	145	14.9	59.9	0.84
chr3	71296475	71296753	CpG: 22	278	22	167	15.8	60.1	0.89
chr3	71368884	71369099	CpG: 18	215	18	121	16.7	56.3	1.08
chr3	71620697	71623341	CpG: 267	2644	267	1764	20.2	66.7	0.91
chr3	71641996	71642285	CpG: 24	289	24	179	16.6	61.9	0.88
chr3	71763949	71764994	CpG: 145	1045	145	816	27.8	78.1	0.91
chr3	71792676	71794328	CpG: 244	1652	244	1289	29.5	78.0	0.97
chr3	71804205	71804588	CpG: 27	383	27	215	14.1	56.1	0.92
chr3	71824148	71824792	CpG: 93	644	93	480	28.9	74.5	1.04
chr3	71891579	71891853	CpG: 24	274	24	171	17.5	62.4	0.91
chr3	71929130	71929356	CpG: 17	226	17	134	15.0	59.3	0.87
chr3	72371108	72371342	CpG: 20	234	20	141	17.1	60.3	0.95
chr3	72488151	72489646	CpG: 206	1495	206	1153	27.6	77.1	0.93
chr3	72697066	72697353	CpG: 24	287	24	179	16.7	62.4	0.86
chr3	72711615	72711888	CpG: 21	273	21	163	15.4	59.7	0.88
chr3	72780731	72781142	CpG: 42	411	42	273	20.4	66.4	0.93
chr3	72829741	72830413	CpG: 48	672	48	452	14.3	67.3	0.63
chr3	72889661	72890514	CpG: 83	853	83	510	19.5	59.8	1.09
chr3	72912310	72912583	CpG: 23	273	23	170	16.8	62.3	0.89
chr3	72929763	72930442	CpG: 98	679	98	516	28.9	76.0	1.01
chr3	72954975	72955212	CpG: 20	237	20	144	16.9	60.8	0.95
chr3	72970727	72971053	CpG: 39	326	39	219	23.9	67.2	1.14
chr3	73019989	73020259	CpG: 22	270	22	166	16.3	61.5	0.87
chr3	73037893	73039266	CpG: 113	1373	113	897	16.5	65.3	0.77
chr3	73132192	73132466	CpG: 22	274	22	167	16.1	60.9	0.89
chr3	73152221	73152510	CpG: 22	289	22	165	15.2	57.1	1.01
chr3	73425083	73426417	CpG: 115	1334	115	862	17.2	64.6	0.83
chr3	73665567	73666712	CpG: 152	1145	152	811	26.6	70.8	1.06
chr3	73770385	73770623	CpG: 17	238	17	141	14.3	59.2	0.84
chr3	73982178	73982452	CpG: 24	274	24	170	17.5	62.0	0.92
chr3	74106696	74106961	CpG: 22	265	22	165	16.6	62.3	0.87
chr3	74247972	74248246	CpG: 25	274	25	172	18.2	62.8	0.94
chr3	74258812	74259086	CpG: 24	274	24	170	17.5	62.0	0.92
chr3	74386483	74386762	CpG: 23	279	23	165	16.5	59.1	0.98
chr3	74395466	74395702	CpG: 20	236	20	144	16.9	61.0	0.93
chr3	74656375	74656984	CpG: 98	609	98	488	32.2	80.1	1.01
chr3	74758137	74758411	CpG: 25	274	25	172	18.2	62.8	0.94
chr3	74941013	74941261	CpG: 19	248	19	137	15.3	55.2	1.03
chr3	74941819	74942315	CpG: 44	496	44	362	17.7	73.0	0.67
chr3	74954600	74954875	CpG: 23	275	23	168	16.7	61.1	0.90
chr3	74994685	74994954	CpG: 20	269	20	163	14.9	60.6	0.82
chr3	75041774	75042048	CpG: 22	274	22	169	16.1	61.7	0.86
chr3	75107109	75107382	CpG: 24	273	24	171	17.6	62.6	0.91
chr3	75139458	75139673	CpG: 16	215	16	124	14.9	57.7	0.90
chr3	75167327	75167569	CpG: 19	242	19	142	15.7	58.7	0.91
chr3	75176559	75176799	CpG: 21	240	21	147	17.5	61.2	0.95
chr3	75330644	75331942	CpG: 105	1298	105	938	16.2	72.3	0.62
chr3	75437641	75438540	CpG: 82	899	82	631	18.2	70.2	0.74
chr3	75487015	75488502	CpG: 127	1487	127	1041	17.1	70.0	0.74
chr3	75632899	75633682	CpG: 88	783	88	580	22.5	74.1	0.83
chr3	75662829	75663091	CpG: 23	262	23	183	17.6	69.8	0.72
chr3	75671823	75673113	CpG: 109	1290	109	911	16.9	70.6	0.68
chr3	75708614	75709103	CpG: 48	489	48	356	19.6	72.8	0.75
chr3	75711666	75712241	CpG: 40	575	40	386	13.9	67.1	0.63
chr3	75722035	75725965	CpG: 266	3930	266	2476	13.5	63.0	0.68
chr3	75810001	75810241	CpG: 17	240	17	141	14.2	58.8	0.84
chr3	75838370	75838877	CpG: 48	507	48	352	18.9	69.4	0.80
chr3	75959847	75960396	CpG: 41	549	41	360	14.9	65.6	0.72
chr3	75964822	75965099	CpG: 24	277	24	171	17.3	61.7	0.92
chr3	76062681	76062930	CpG: 22	249	22	150	17.7	60.2	1.00
chr3	76100059	76100294	CpG: 21	235	21	144	17.9	61.3	0.97
chr3	76382296	76382565	CpG: 23	269	23	168	17.1	62.5	0.88
chr3	76389316	76389589	CpG: 20	273	20	168	14.7	61.5	0.78
chr3	76436027	76436296	CpG: 23	269	23	167	17.1	62.1	0.89
chr3	76672665	76672939	CpG: 25	274	25	171	18.2	62.4	0.95
chr3	76710815	76711047	CpG: 16	232	16	135	13.8	58.2	0.82
chr3	76789618	76789891	CpG: 22	273	22	171	16.1	62.6	0.83
chr3	76905107	76905388	CpG: 25	281	25	174	17.8	61.9	0.95
chr3	76923057	76923297	CpG: 22	240	22	149	18.3	62.1	0.97
chr3	76924924	76925198	CpG: 24	274	24	171	17.5	62.4	0.91
chr3	76978599	76978880	CpG: 25	281	25	176	17.8	62.6	0.92
chr3	76990444	76990718	CpG: 24	274	24	171	17.5	62.4	0.91
chr3	76994003	76994282	CpG: 22	279	22	170	15.8	60.9	0.86
chr3	76998910	76999141	CpG: 18	231	18	141	15.6	61.0	0.85
chr3	77083954	77084214	CpG: 19	260	19	159	14.6	61.2	0.80
chr3	77093322	77094103	CpG: 73	781	73	546	18.7	69.9	0.78
chr3	77151959	77152191	CpG: 20	232	20	142	17.2	61.2	0.92
chr3	77152511	77152794	CpG: 23	283	23	170	16.3	60.1	0.92
chr3	77165885	77166138	CpG: 20	253	20	157	15.8	62.1	0.83
chr3	77293980	77294363	CpG: 34	383	34	281	17.8	73.4	0.66
chr3	77483244	77483530	CpG: 22	286	22	175	15.4	61.2	0.84
chr3	77496865	77497143	CpG: 20	278	20	168	14.4	60.4	0.80
chr3	77558097	77558328	CpG: 17	231	17	135	14.7	58.4	0.87
chr3	77694977	77695258	CpG: 22	281	22	168	15.7	59.8	0.88
chr3	77710842	77711123	CpG: 23	281	23	174	16.4	61.9	0.87
chr3	77778655	77778890	CpG: 18	235	18	144	15.3	61.3	0.85
chr3	77824066	77824357	CpG: 23	291	23	176	15.8	60.5	0.87
chr3	78084633	78084902	CpG: 37	269	37	210	27.5	78.1	0.91
chr3	78226310	78226531	CpG: 18	221	18	134	16.3	60.6	0.90
chr3	78269733	78270009	CpG: 21	276	21	171	15.2	62.0	0.80
chr3	78409142	78409385	CpG: 19	243	19	147	15.6	60.5	0.88
chr3	78554935	78555365	CpG: 33	430	33	247	15.3	57.4	0.94
chr3	78741569	78741783	CpG: 16	214	16	130	15.0	60.7	0.83
chr3	78970828	78971095	CpG: 22	267	22	163	16.5	61.0	0.89
chr3	78994189	78994428	CpG: 19	239	19	143	15.9	59.8	0.91
chr3	79017380	79017619	CpG: 19	239	19	145	15.9	60.7	0.88
chr3	79018381	79018610	CpG: 19	229	19	140	16.6	61.1	0.90
chr3	79073572	79074256	CpG: 68	684	68	480	19.9	70.2	0.81
chr3	79076562	79076800	CpG: 17	238	17	144	14.3	60.5	0.80
chr3	79229119	79229337	CpG: 16	218	16	120	14.7	55.0	1.00
chr3	79338573	79338847	CpG: 25	274	25	173	18.2	63.1	0.93
chr3	79348633	79348899	CpG: 22	266	22	165	16.5	62.0	0.87
chr3	79355081	79355463	CpG: 33	382	33	281	17.3	73.6	0.64
chr3	79386719	79386994	CpG: 19	275	19	164	13.8	59.6	0.80
chr3	79500532	79500797	CpG: 23	265	23	166	17.4	62.6	0.90
chr3	79551304	79551593	CpG: 25	289	25	179	17.3	61.9	0.92
chr3	79557003	79557554	CpG: 49	551	49	398	17.8	72.2	0.68
chr3	79776866	79777083	CpG: 16	217	16	127	14.7	58.5	0.88
chr3	79781289	79781563	CpG: 25	274	25	172	18.2	62.8	0.94
chr3	79822481	79822743	CpG: 29	262	29	187	22.1	71.4	0.87
chr3	79997870	79998143	CpG: 22	273	22	170	16.1	62.3	0.85
chr3	80375360	80375641	CpG: 22	281	22	174	15.7	61.9	0.83
chr3	80658233	80658468	CpG: 18	235	18	145	15.3	61.7	0.82
chr3	80686770	80687041	CpG: 22	271	22	168	16.2	62.0	0.85
chr3	80713255	80713495	CpG: 20	240	20	145	16.7	60.4	0.93
chr3	80824841	80825207	CpG: 45	366	45	221	24.6	60.4	1.48
chr3	80920682	80920955	CpG: 20	273	20	166	14.7	60.8	0.81
chr3	80969000	80969281	CpG: 23	281	23	174	16.4	61.9	0.87
chr3	81076684	81076938	CpG: 19	254	19	146	15.0	57.5	0.92
chr3	81085585	81085826	CpG: 19	241	19	144	15.8	59.8	0.91
chr3	81110604	81110973	CpG: 28	369	28	216	15.2	58.5	0.89
chr3	81244612	81244851	CpG: 19	239	19	147	15.9	61.5	0.86
chr3	81260749	81261021	CpG: 20	272	20	157	14.7	57.7	0.89
chr3	81350380	81350654	CpG: 23	274	23	170	16.8	62.0	0.88
chr3	81468726	81468992	CpG: 22	266	22	165	16.5	62.0	0.87
chr3	81718679	81718918	CpG: 17	239	17	140	14.2	58.6	0.85
chr3	81814583	81815222	CpG: 75	639	75	461	23.5	72.1	0.91
chr3	81820783	81821226	CpG: 45	443	45	326	20.3	73.6	0.75
chr3	81866534	81866808	CpG: 24	274	24	171	17.5	62.4	0.91
chr3	82146223	82146466	CpG: 17	243	17	141	14.0	58.0	0.84
chr3	82331807	82332074	CpG: 21	267	21	165	15.7	61.8	0.83
chr3	82367178	82367452	CpG: 23	274	23	169	16.8	61.7	0.89
chr3	82390533	82390843	CpG: 26	310	26	191	16.8	61.6	0.89
chr3	82771738	82772232	CpG: 49	494	49	358	19.8	72.5	0.76
chr3	82864394	82864654	CpG: 21	260	21	171	16.2	65.8	0.76
chr3	83250542	83250823	CpG: 21	281	21	164	14.9	58.4	0.89
chr3	83273865	83274501	CpG: 53	636	53	430	16.7	67.6	0.73
chr3	83296489	83296741	CpG: 19	252	19	154	15.1	61.1	0.82
chr3	83384383	83384623	CpG: 19	240	19	147	15.8	61.2	0.87
chr3	83614955	83615191	CpG: 19	236	19	145	16.1	61.4	0.88
chr3	84299608	84299880	CpG: 22	272	22	167	16.2	61.4	0.87
chr3	84615275	84615548	CpG: 25	273	25	170	18.3	62.3	0.95
chr3	84983635	84983967	CpG: 33	332	33	243	19.9	73.2	0.74
chr3	85023925	85024702	CpG: 72	777	72	538	18.5	69.2	0.79
chr3	85096554	85096834	CpG: 23	280	23	171	16.4	61.1	0.89
chr3	85198859	85199412	CpG: 53	553	53	411	19.2	74.3	0.69
chr3	85376419	85376660	CpG: 18	241	18	142	14.9	58.9	0.89
chr3	85458904	85459105	CpG: 16	201	16	120	15.9	59.7	0.93
chr3	85513086	85513324	CpG: 18	238	18	140	15.1	58.8	0.89
chr3	85532953	85533183	CpG: 19	230	19	141	16.5	61.3	0.89
chr3	85569124	85569372	CpG: 18	248	18	141	14.5	56.9	0.92
chr3	85569709	85570100	CpG: 45	391	45	299	23.0	76.5	0.79
chr3	85592489	85592915	CpG: 33	426	33	256	15.5	60.1	0.86
chr3	85615363	85615598	CpG: 21	235	21	144	17.9	61.3	0.97
chr3	85709288	85709569	CpG: 23	281	23	174	16.4	61.9	0.87
chr3	85969062	85969343	CpG: 22	281	22	174	15.7	61.9	0.84
chr3	86084263	86084800	CpG: 50	537	50	356	18.6	66.3	0.85
chr3	86195760	86196027	CpG: 19	267	19	158	14.2	59.2	0.82
chr3	86269574	86269837	CpG: 21	263	21	157	16.0	59.7	0.91
chr3	86319879	86320287	CpG: 32	408	32	238	15.7	58.3	0.93
chr3	86327496	86327769	CpG: 21	273	21	170	15.4	62.3	0.80
chr3	86662354	86662565	CpG: 16	211	16	127	15.2	60.2	0.84
chr3	86829397	86829743	CpG: 35	346	35	258	20.2	74.6	0.73
chr3	86973281	86973514	CpG: 17	233	17	139	14.6	59.7	0.84
chr3	86985426	86985716	CpG: 21	290	21	167	14.5	57.6	0.89
chr3	87030884	87031121	CpG: 19	237	19	143	16.0	60.3	0.89
chr3	87064821	87065727	CpG: 96	906	96	647	21.2	71.4	0.83
chr3	87101992	87102270	CpG: 23	278	23	174	16.5	62.6	0.86
chr3	87126971	87127212	CpG: 25	241	25	161	20.7	66.8	0.95
chr3	87163427	87163748	CpG: 27	321	27	212	16.8	66.0	0.77
chr3	87301078	87302048	CpG: 82	970	82	610	16.9	62.9	0.86
chr3	87373637	87373917	CpG: 19	280	19	173	13.6	61.8	0.72
chr3	87612692	87612907	CpG: 17	215	17	126	15.8	58.6	0.94
chr3	87712881	87713166	CpG: 24	285	24	178	16.8	62.5	0.88
chr3	87764333	87764606	CpG: 20	273	20	164	14.7	60.1	0.82
chr3	87868556	87869323	CpG: 66	767	66	511	17.2	66.6	0.79
chr3	88091523	88091920	CpG: 37	397	37	294	18.6	74.1	0.68
chr3	88125420	88125690	CpG: 22	270	22	164	16.3	60.7	0.90
chr3	88126221	88126498	CpG: 23	277	23	175	16.6	63.2	0.84
chr3	88134241	88135417	CpG: 120	1176	120	815	20.4	69.3	0.85
chr3	88225197	88226197	CpG: 72	1000	72	595	14.4	59.5	0.81
chr3	88274503	88274772	CpG: 19	269	19	163	14.1	60.6	0.79
chr3	88342710	88342985	CpG: 23	275	23	170	16.7	61.8	0.89
chr3	88355262	88355502	CpG: 16	240	16	143	13.3	59.6	0.78
chr3	88472070	88472347	CpG: 23	277	23	176	16.6	63.5	0.83
chr3	88504962	88505192	CpG: 21	230	21	141	18.3	61.3	0.99
chr3	88706051	88706325	CpG: 25	274	25	173	18.2	63.1	0.93
chr3	88817593	88817870	CpG: 24	277	24	171	17.3	61.7	0.92
chr3	88865396	88865672	CpG: 20	276	20	169	14.5	61.2	0.79
chr3	89140497	89140744	CpG: 19	247	19	151	15.4	61.1	0.83
chr3	89190536	89191008	CpG: 41	472	41	303	17.4	64.2	0.85
chr3	89206726	89206972	CpG: 21	246	21	147	17.1	59.8	0.97
chr3	89246024	89246272	CpG: 19	248	19	148	15.3	59.7	0.89
chr3	89279530	89279774	CpG: 20	244	20	150	16.4	61.5	0.88
chr3	89295744	89295974	CpG: 19	230	19	140	16.5	60.9	0.90
chr3	89333701	89333975	CpG: 24	274	24	170	17.5	62.0	0.92
chr3	89427610	89427969	CpG: 28	359	28	213	15.6	59.3	0.89
chr3	89542782	89543208	CpG: 32	426	32	255	15.0	59.9	0.84
chr3	89553002	89553233	CpG: 19	231	19	138	16.5	59.7	0.93
chr3	89862122	89862397	CpG: 23	275	23	170	16.7	61.8	0.89
chr3	89951263	89951622	CpG: 25	359	25	210	13.9	58.5	0.81
chr3	90012413	90012694	CpG: 23	281	23	175	16.4	62.3	0.86
chr3	90045257	90045528	CpG: 20	271	20	164	14.8	60.5	0.81
chr3	90061299	90061580	CpG: 24	281	24	175	17.1	62.3	0.90
chr3	90081628	90081867	CpG: 18	239	18	143	15.1	59.8	0.86
chr3	90127492	90127766	CpG: 22	274	22	169	16.1	61.7	0.86
chr3	90251808	90252167	CpG: 26	359	26	211	14.5	58.8	0.84
chr3	90261973	90262255	CpG: 20	282	20	170	14.2	60.3	0.79
chr3	90308605	90308859	CpG: 20	254	20	155	15.7	61.0	0.86
chr3	90380361	90380635	CpG: 24	274	24	171	17.5	62.4	0.91
chr3	90410641	90411068	CpG: 29	427	29	253	13.6	59.3	0.78
chr3	90597104	90597373	CpG: 24	269	24	167	17.8	62.1	0.94
chr3	90698353	90698627	CpG: 22	274	22	168	16.1	61.3	0.86
chr3	95384864	95385081	CpG: 15	217	15	150	13.8	69.1	0.66
chr3	95387348	95388065	CpG: 53	717	53	474	14.8	66.1	0.68
chr3	95619948	95620435	CpG: 37	487	37	331	15.2	68.0	0.67
chr3	95714663	95714942	CpG: 24	279	24	174	17.2	62.4	0.89
chr3	95745307	95745619	CpG: 34	312	34	231	21.8	74.0	0.80
chr3	95749873	95750260	CpG: 36	387	36	261	18.6	67.4	0.82
chr3	96539784	96539989	CpG: 16	205	16	110	15.6	53.7	1.09
chr3	96671835	96672064	CpG: 39	229	39	182	34.1	79.5	1.08
chr3	96678047	96678717	CpG: 62	670	62	431	18.5	64.3	0.90
chr3	96742701	96743447	CpG: 61	746	61	530	16.4	71.0	0.65
chr3	96761114	96761715	CpG: 47	601	47	345	15.6	57.4	0.95
chr3	96834037	96834302	CpG: 19	265	19	159	14.3	60.0	0.81
chr3	96836757	96837001	CpG: 18	244	18	146	14.8	59.8	0.85
chr3	96891926	96892200	CpG: 23	274	23	169	16.8	61.7	0.90
chr3	97232204	97232440	CpG: 21	236	21	151	17.8	64.0	0.89
chr3	97240826	97241104	CpG: 25	278	25	173	18.0	62.2	0.94
chr3	97343658	97343939	CpG: 21	281	21	172	14.9	61.2	0.81
chr3	97624153	97624431	CpG: 23	278	23	174	16.5	62.6	0.85
chr3	97640473	97640900	CpG: 41	427	41	278	19.2	65.1	0.91
chr3	97741377	97741607	CpG: 20	230	20	141	17.4	61.3	0.94
chr3	97869037	97869311	CpG: 23	274	23	170	16.8	62.0	0.88
chr3	97965814	97966032	CpG: 16	218	16	127	14.7	58.3	0.88
chr3	98343631	98343868	CpG: 18	237	18	142	15.2	59.9	0.85
chr3	99193965	99194239	CpG: 23	274	23	169	16.8	61.7	0.89
chr3	99368535	99368809	CpG: 19	274	19	168	13.9	61.3	0.75
chr3	99480600	99480965	CpG: 49	365	49	277	26.8	75.9	0.94
chr3	99517001	99518603	CpG: 174	1602	174	1129	21.7	70.5	0.88
chr3	99602580	99602845	CpG: 22	265	22	163	16.6	61.5	0.89
chr3	100184496	100184766	CpG: 21	270	21	181	15.6	67.0	0.69
chr3	100185287	100185492	CpG: 26	205	26	158	25.4	77.1	0.86
chr3	100299749	100299983	CpG: 18	234	18	140	15.4	59.8	0.88
chr3	100345240	100345532	CpG: 22	292	22	169	15.1	57.9	0.91
chr3	100420064	100420345	CpG: 25	281	25	176	17.8	62.6	0.92
chr3	100458509	100458783	CpG: 21	274	21	162	15.3	59.1	0.88
chr3	100468074	100468552	CpG: 38	478	38	296	15.9	61.9	0.84
chr3	100525562	100526531	CpG: 104	969	104	677	21.5	69.9	0.88
chr3	100675681	100676305	CpG: 77	624	77	460	24.7	73.7	0.92
chr3	100789686	100789910	CpG: 20	224	20	138	17.9	61.6	0.98
chr3	101077029	101077266	CpG: 19	237	19	147	16.0	62.0	0.86
chr3	101146011	101146279	CpG: 21	268	21	165	15.7	61.6	0.85
chr3	101155478	101155761	CpG: 21	283	21	171	14.8	60.4	0.82
chr3	101226249	101226775	CpG: 57	526	57	389	21.7	74.0	0.81
chr3	101275074	101275357	CpG: 25	283	25	178	17.7	62.9	0.90
chr3	101296751	101297538	CpG: 82	787	82	567	20.8	72.0	0.80
chr3	101359978	101360260	CpG: 25	282	25	179	17.7	63.5	0.90
chr3	101361552	101361778	CpG: 25	226	25	167	22.1	73.9	0.86
chr3	101399917	101400146	CpG: 18	229	18	137	15.7	59.8	0.90
chr3	101440740	101441679	CpG: 101	939	101	679	21.5	72.3	0.82
chr3	101609313	101610377	CpG: 118	1064	118	770	22.2	72.4	0.86
chr3	101637658	101637932	CpG: 23	274	23	171	16.8	62.4	0.88
chr3	101685328	101685564	CpG: 18	236	18	141	15.3	59.7	0.88
chr3	101868063	101868337	CpG: 22	274	22	169	16.1	61.7	0.86
chr3	102402040	102402314	CpG: 24	274	24	171	17.5	62.4	0.91
chr3	102522810	102523220	CpG: 42	410	42	275	20.5	67.1	0.92
chr3	102581080	102581489	CpG: 59	409	59	301	28.9	73.6	1.07
chr3	102641626	102641900	CpG: 25	274	25	171	18.2	62.4	0.95
chr3	102767500	102767736	CpG: 18	236	18	139	15.3	58.9	0.90
chr3	102771876	102772106	CpG: 19	230	19	140	16.5	60.9	0.90
chr3	102926972	102927257	CpG: 24	285	24	178	16.8	62.5	0.88
chr3	102930585	102930826	CpG: 23	241	23	169	19.1	70.1	0.78
chr3	102965996	102966534	CpG: 47	538	47	329	17.5	61.2	0.94
chr3	103039952	103040458	CpG: 69	506	69	377	27.3	74.5	0.98
chr3	103106019	103107372	CpG: 101	1353	101	806	14.9	59.6	0.84
chr3	103163788	103164062	CpG: 24	274	24	171	17.5	62.4	0.91
chr3	103166422	103166703	CpG: 21	281	21	171	14.9	60.9	0.82
chr3	103184400	103184641	CpG: 19	241	19	153	15.8	63.5	0.79
chr3	103198063	103198405	CpG: 37	342	37	234	21.6	68.4	0.93
chr3	103414980	103415979	CpG: 97	999	97	678	19.4	67.9	0.87
chr3	103665043	103665317	CpG: 25	274	25	172	18.2	62.8	0.94
chr3	104218150	104218385	CpG: 18	235	18	140	15.3	59.6	0.88
chr3	104219035	104219594	CpG: 48	559	48	344	17.2	61.5	0.91
chr3	104257682	104258241	CpG: 49	559	49	411	17.5	73.5	0.65
chr3	104265901	104266136	CpG: 22	235	22	146	18.7	62.1	0.99
chr3	104267059	104267485	CpG: 32	426	32	255	15.0	59.9	0.84
chr3	104273997	104274404	CpG: 34	407	34	239	16.7	58.7	0.98
chr3	104274670	104274900	CpG: 19	230	19	142	16.5	61.7	0.89
chr3	104286654	104287381	CpG: 63	727	63	475	17.3	65.3	0.82
chr3	104388742	104389862	CpG: 117	1120	117	762	20.9	68.0	0.91
chr3	104391916	104392180	CpG: 21	264	21	164	15.9	62.1	0.84
chr3	104399130	104399509	CpG: 28	379	28	211	14.8	55.7	0.96
chr3	104401278	104401551	CpG: 20	273	20	162	14.7	59.3	0.84
chr3	104437418	104437799	CpG: 36	381	36	236	18.9	61.9	1.00
chr3	104446373	104446605	CpG: 20	232	20	140	17.2	60.3	0.97
chr3	104491776	104492594	CpG: 86	818	86	569	21.0	69.6	0.87
chr3	104561703	104562994	CpG: 160	1291	160	951	24.8	73.7	0.91
chr3	104647699	104647977	CpG: 25	278	25	175	18.0	62.9	0.92
chr3	104878977	104879210	CpG: 17	233	17	138	14.6	59.2	0.85
chr3	104882182	104882417	CpG: 18	235	18	137	15.3	58.3	0.93
chr3	104967315	104967596	CpG: 24	281	24	175	17.1	62.3	0.90
chr3	105148872	105149106	CpG: 17	234	17	131	14.5	56.0	0.94
chr3	105174095	105174328	CpG: 16	233	16	142	13.7	60.9	0.77
chr3	105238728	105238960	CpG: 20	232	20	141	17.2	60.8	0.95
chr3	105280276	105280557	CpG: 24	281	24	175	17.1	62.3	0.90
chr3	105808329	105808604	CpG: 23	275	23	170	16.7	61.8	0.89
chr3	105904241	105904478	CpG: 20	237	20	145	16.9	61.2	0.92
chr3	105937444	105937754	CpG: 25	310	25	192	16.1	61.9	0.84
chr3	105971750	105972213	CpG: 38	463	38	338	16.4	73.0	0.62
chr3	106060744	106060959	CpG: 19	215	19	133	17.7	61.9	0.95
chr3	106278957	106279384	CpG: 31	427	31	256	14.5	60.0	0.81
chr3	106451406	106451684	CpG: 24	278	24	174	17.3	62.6	0.89
chr3	106498191	106498413	CpG: 18	222	18	129	16.2	58.1	0.98
chr3	106547606	106547880	CpG: 23	274	23	171	16.8	62.4	0.87
chr3	106570822	106571053	CpG: 19	231	19	142	16.5	61.5	0.88
chr3	106903308	106903582	CpG: 24	274	24	173	17.5	63.1	0.89
chr3	107054743	107054977	CpG: 19	234	19	140	16.2	59.8	0.93
chr3	108014407	108014651	CpG: 19	244	19	146	15.6	59.8	0.87
chr3	108060686	108060953	CpG: 21	267	21	164	15.7	61.4	0.84
chr3	108071711	108072144	CpG: 33	433	33	271	15.2	62.6	0.78
chr3	108084646	108085407	CpG: 67	761	67	500	17.6	65.7	0.82
chr3	108087252	108087519	CpG: 24	267	24	161	18.0	60.3	0.99
chr3	108173220	108173451	CpG: 17	231	17	140	14.7	60.6	0.81
chr3	108239042	108239327	CpG: 25	285	25	179	17.5	62.8	0.90
chr3	108240885	108241160	CpG: 20	275	20	167	14.5	60.7	0.80
chr3	108281721	108282002	CpG: 24	281	24	176	17.1	62.6	0.89
chr3	108586737	108587676	CpG: 90	939	90	646	19.2	68.8	0.81
chr3	108598226	108598502	CpG: 22	276	22	168	15.9	60.9	0.87
chr3	108600881	108601118	CpG: 22	237	22	148	18.6	62.4	0.99
chr3	108745424	108745704	CpG: 20	280	20	172	14.3	61.4	0.78
chr3	108756638	108756853	CpG: 15	215	15	126	14.0	58.6	0.85
chr3	109085899	109086191	CpG: 21	292	21	175	14.4	59.9	0.81
chr3	109145833	109146107	CpG: 24	274	24	171	17.5	62.4	0.91
chr3	109152190	109152460	CpG: 19	270	19	162	14.1	60.0	0.79
chr3	109273455	109273668	CpG: 15	213	15	127	14.1	59.6	0.80
chr3	109363471	109363905	CpG: 34	434	34	312	15.7	71.9	0.61
chr3	109588297	109588571	CpG: 23	274	23	170	16.8	62.0	0.88
chr3	109695327	109695636	CpG: 22	309	22	182	14.2	58.9	0.83
chr3	109960246	109960762	CpG: 49	516	49	335	19.0	64.9	0.91
chr3	110092746	110093020	CpG: 21	274	21	164	15.3	59.9	0.87
chr3	110150760	110151850	CpG: 107	1090	107	766	19.6	70.3	0.80
chr3	110242784	110245268	CpG: 184	2484	184	1560	14.8	62.8	0.77
chr3	110417579	110417813	CpG: 18	234	18	138	15.4	59.0	0.88
chr3	110563793	110564073	CpG: 24	280	24	175	17.1	62.5	0.88
chr3	110632381	110632655	CpG: 24	274	24	169	17.5	61.7	0.93
chr3	110633043	110633281	CpG: 19	238	19	142	16.0	59.7	0.93
chr3	110647370	110647841	CpG: 46	471	46	300	19.5	63.7	0.96
chr3	110745944	110746599	CpG: 50	655	50	445	15.3	67.9	0.66
chr3	110810318	110811486	CpG: 144	1168	144	851	24.7	72.9	0.94
chr3	110863108	110863393	CpG: 25	285	25	179	17.5	62.8	0.90
chr3	110941870	110942443	CpG: 49	573	49	376	17.1	65.6	0.82
chr3	111309653	111310030	CpG: 38	377	38	245	20.2	65.0	0.96
chr3	111461905	111462131	CpG: 17	226	17	134	15.0	59.3	0.87
chr3	111469770	111470211	CpG: 32	441	32	263	14.5	59.6	0.82
chr3	111485226	111485453	CpG: 17	227	17	138	15.0	60.8	0.84
chr3	111622318	111622554	CpG: 18	236	18	139	15.3	58.9	0.90
chr3	111838228	111838522	CpG: 36	294	36	203	24.5	69.0	1.06
chr3	111843776	111844848	CpG: 80	1072	80	755	14.9	70.4	0.60
chr3	111920306	111920598	CpG: 25	292	25	179	17.1	61.3	0.91
chr3	111983813	111984053	CpG: 19	240	19	140	15.8	58.3	0.96
chr3	112037089	112037326	CpG: 18	237	18	138	15.2	58.2	0.92
chr3	112057232	112057466	CpG: 18	234	18	142	15.4	60.7	0.85
chr3	112061423	112061971	CpG: 42	548	42	329	15.3	60.0	0.85
chr3	112075497	112075723	CpG: 18	226	18	136	15.9	60.2	0.92
chr3	112130650	112130889	CpG: 19	239	19	142	15.9	59.4	0.92
chr3	112344900	112345176	CpG: 21	276	21	168	15.2	60.9	0.83
chr3	112359409	112359629	CpG: 19	220	19	133	17.3	60.5	0.99
chr3	112409571	112409849	CpG: 24	278	24	174	17.3	62.6	0.89
chr3	112479073	112479303	CpG: 20	230	20	141	17.4	61.3	0.94
chr3	112550891	112551127	CpG: 19	236	19	143	16.1	60.6	0.90
chr3	112788568	112788842	CpG: 25	274	25	171	18.2	62.4	0.94
chr3	112977750	112977957	CpG: 15	207	15	124	14.5	59.9	0.82
chr3	113160274	113160498	CpG: 18	224	18	134	16.1	59.8	0.90
chr3	113294063	113294337	CpG: 24	274	24	171	17.5	62.4	0.91
chr3	113458146	113458420	CpG: 23	274	23	170	16.8	62.0	0.88
chr3	113461744	113461973	CpG: 19	229	19	141	16.6	61.6	0.88
chr3	113609383	113609678	CpG: 23	295	23	180	15.6	61.0	0.84
chr3	113739162	113739589	CpG: 33	427	33	258	15.5	60.4	0.85
chr3	113791728	113792980	CpG: 136	1252	136	875	21.7	69.9	0.91
chr3	113866582	113866860	CpG: 25	278	25	174	18.0	62.6	0.93
chr3	113989062	113989336	CpG: 23	274	23	170	16.8	62.0	0.88
chr3	114222142	114222372	CpG: 18	230	18	137	15.7	59.6	0.89
chr3	114282603	114283030	CpG: 32	427	32	256	15.0	60.0	0.84
chr3	114395169	114395523	CpG: 29	354	29	229	16.4	64.7	0.82
chr3	114412931	114413167	CpG: 19	236	19	144	16.1	61.0	0.88
chr3	114551455	114551729	CpG: 24	274	24	171	17.5	62.4	0.91
chr3	114580417	114580919	CpG: 59	502	59	371	23.5	73.9	0.91
chr3	114700003	114700396	CpG: 39	393	39	255	19.8	64.9	0.95
chr3	114775852	114776072	CpG: 16	220	16	128	14.5	58.2	0.87
chr3	114807138	114807843	CpG: 68	705	68	476	19.3	67.5	0.85
chr3	114812893	114813110	CpG: 17	217	17	132	15.7	60.8	0.87
chr3	114906627	114907090	CpG: 40	463	40	333	17.3	71.9	0.67
chr3	115052528	115052820	CpG: 22	292	22	174	15.1	59.6	0.85
chr3	115053376	115053587	CpG: 16	211	16	127	15.2	60.2	0.86
chr3	115054107	115054620	CpG: 41	513	41	335	16.0	65.3	0.78
chr3	115078023	115078259	CpG: 19	236	19	139	16.1	58.9	0.95
chr3	115164818	115165084	CpG: 19	266	19	166	14.3	62.4	0.74
chr3	115188053	115188290	CpG: 18	237	18	138	15.2	58.2	0.94
chr3	115206887	115207128	CpG: 19	241	19	144	15.8	59.8	0.89
chr3	115282210	115283138	CpG: 87	928	87	608	18.8	65.5	0.87
chr3	115283813	115284090	CpG: 21	277	21	168	15.2	60.6	0.84
chr3	115292989	115293274	CpG: 24	285	24	177	16.8	62.1	0.89
chr3	115385751	115386054	CpG: 23	303	23	183	15.2	60.4	0.84
chr3	115455699	115455929	CpG: 19	230	19	139	16.5	60.4	0.92
chr3	115590281	115590555	CpG: 22	274	22	169	16.1	61.7	0.86
chr3	115666740	115666974	CpG: 18	234	18	137	15.4	58.5	0.90
chr3	115711781	115712385	CpG: 60	604	60	386	19.9	63.9	0.97
chr3	115740353	115740762	CpG: 47	409	47	298	23.0	72.9	0.87
chr3	115932554	115933739	CpG: 132	1185	132	816	22.3	68.9	0.94
chr3	116162595	116162937	CpG: 32	342	32	203	18.7	59.4	1.07
chr3	116179462	116180072	CpG: 43	610	43	396	14.1	64.9	0.67
chr3	116215538	116215812	CpG: 24	274	24	171	17.5	62.4	0.91
chr3	116235979	116236778	CpG: 59	799	59	488	14.8	61.1	0.79
chr3	116254011	116254602	CpG: 55	591	55	399	18.6	67.5	0.84
chr3	116299339	116299552	CpG: 17	213	17	126	16.0	59.2	0.93
chr3	116417258	116418087	CpG: 93	829	93	624	22.4	75.3	0.79
chr3	116466791	116467513	CpG: 79	722	79	506	21.9	70.1	0.95
chr3	116559903	116560132	CpG: 36	229	36	171	31.4	74.7	1.19
chr3	116578592	116578807	CpG: 15	215	15	129	14.0	60.0	0.78
chr3	116606224	116606607	CpG: 34	383	34	273	17.8	71.3	0.70
chr3	116668776	116669807	CpG: 130	1031	130	775	25.2	75.2	0.89
chr3	116777575	116778010	CpG: 35	435	35	265	16.1	60.9	0.88
chr3	116824556	116824834	CpG: 25	278	25	173	18.0	62.2	0.93
chr3	116858704	116858986	CpG: 21	282	21	166	14.9	58.9	0.87
chr3	116873758	116873961	CpG: 21	203	21	142	20.7	70.0	0.85
chr3	116958160	116958375	CpG: 17	215	17	122	15.8	56.7	1.02
chr3	116991513	116991787	CpG: 24	274	24	171	17.5	62.4	0.91
chr3	116997909	116998115	CpG: 18	206	18	120	17.5	58.3	1.04
chr3	117071677	117072610	CpG: 82	933	82	590	17.6	63.2	0.88
chr3	117376071	117376352	CpG: 22	281	22	173	15.7	61.6	0.84
chr3	117533138	117533613	CpG: 44	475	44	351	18.5	73.9	0.68
chr3	117604428	117604706	CpG: 26	278	26	174	18.7	62.6	0.97
chr3	117867066	117868754	CpG: 137	1688	137	1096	16.2	64.9	0.78
chr3	117905504	117905710	CpG: 16	206	16	145	15.5	70.4	0.63
chr3	118248996	118249270	CpG: 25	274	25	172	18.2	62.8	0.94
chr3	118378579	118379099	CpG: 48	520	48	347	18.5	66.7	0.84
chr3	118495187	118495416	CpG: 17	229	17	137	14.8	59.8	0.85
chr3	118504078	118504934	CpG: 85	856	85	577	19.9	67.4	0.88
chr3	118511768	118512349	CpG: 50	581	50	393	17.2	67.6	0.76
chr3	118675204	118675416	CpG: 17	212	17	124	16.0	58.5	0.95
chr3	118833642	118833908	CpG: 20	266	20	164	15.0	61.7	0.80
chr3	118914662	118914888	CpG: 18	226	18	137	15.9	60.6	0.88
chr3	118941071	118941278	CpG: 15	207	15	125	14.5	60.4	0.81
chr3	119077088	119077324	CpG: 18	236	18	142	15.3	60.2	0.87
chr3	119080385	119080677	CpG: 25	292	25	177	17.1	60.6	0.93
chr3	119147361	119147642	CpG: 22	281	22	173	15.7	61.6	0.84
chr3	119165058	119165364	CpG: 25	306	25	191	16.3	62.4	0.84
chr3	119238996	119239589	CpG: 45	593	45	397	15.2	66.9	0.68
chr3	119384302	119384537	CpG: 19	235	19	139	16.2	59.1	0.94
chr3	119470755	119470990	CpG: 16	235	16	140	13.6	59.6	0.78
chr3	119523782	119524065	CpG: 23	283	23	174	16.3	61.5	0.88
chr3	119770092	119770786	CpG: 55	694	55	471	15.9	67.9	0.69
chr3	119797814	119798092	CpG: 23	278	23	173	16.5	62.2	0.86
chr3	120029819	120030100	CpG: 24	281	24	174	17.1	61.9	0.91
chr3	120216182	120216437	CpG: 21	255	21	154	16.5	60.4	0.92
chr3	120345830	120346080	CpG: 18	250	18	143	14.4	57.2	0.89
chr3	120356503	120356721	CpG: 16	218	16	127	14.7	58.3	0.89
chr3	120633620	120633896	CpG: 21	276	21	164	15.2	59.4	0.88
chr3	120672221	120672457	CpG: 19	236	19	143	16.1	60.6	0.90
chr3	120716552	120717546	CpG: 75	994	75	615	15.1	61.9	0.84
chr3	120924398	120924664	CpG: 21	266	21	162	15.8	60.9	0.86
chr3	120989308	120989556	CpG: 23	248	23	181	18.5	73.0	0.70
chr3	121172999	121173280	CpG: 23	281	23	174	16.4	61.9	0.87
chr3	121532958	121533178	CpG: 17	220	17	133	15.5	60.5	0.87
chr3	121574580	121574854	CpG: 22	274	22	169	16.1	61.7	0.85
chr3	121634006	121634365	CpG: 29	359	29	217	16.2	60.4	0.89
chr3	121726852	121727094	CpG: 22	242	22	150	18.2	62.0	0.95
chr3	121753984	121754853	CpG: 97	869	97	633	22.3	72.8	0.85
chr3	121764991	121765247	CpG: 23	256	23	155	18.0	60.5	0.99
chr3	121922819	121923048	CpG: 17	229	17	134	14.8	58.5	0.87
chr3	121960201	121960796	CpG: 75	595	75	442	25.2	74.3	0.92
chr3	121961721	121962651	CpG: 72	930	72	657	15.5	70.6	0.62
chr3	122013750	122014583	CpG: 67	833	67	546	16.1	65.5	0.75
chr3	122042246	122043119	CpG: 86	873	86	637	19.7	73.0	0.75
chr3	122101468	122101692	CpG: 18	224	18	135	16.1	60.3	0.90
chr3	122121711	122122002	CpG: 24	291	24	180	16.5	61.9	0.89
chr3	122188611	122189172	CpG: 53	561	53	389	18.9	69.3	0.79
chr3	122218179	122218627	CpG: 39	448	39	277	17.4	61.8	0.91
chr3	122299162	122299861	CpG: 70	699	70	456	20.0	65.2	0.94
chr3	122332265	122332497	CpG: 17	232	17	135	14.7	58.2	0.88
chr3	122364974	122365261	CpG: 23	287	23	178	16.0	62.0	0.84
chr3	122396811	122397225	CpG: 39	414	39	260	18.8	62.8	0.96
chr3	122422661	122423192	CpG: 50	531	50	362	18.8	68.2	0.81
chr3	122433775	122434053	CpG: 21	278	21	166	15.1	59.7	0.86
chr3	122529801	122530040	CpG: 28	239	28	167	23.4	69.9	0.99
chr3	122540469	122540704	CpG: 20	235	20	143	17.0	60.9	0.95
chr3	122691306	122691580	CpG: 23	274	23	170	16.8	62.0	0.88
chr3	122796223	122796500	CpG: 24	277	24	171	17.3	61.7	0.92
chr3	122813610	122815484	CpG: 180	1874	180	1259	19.2	67.2	0.85
chr3	122859931	122860349	CpG: 45	418	45	318	21.5	76.1	0.75
chr3	123004549	123005150	CpG: 75	601	75	448	25.0	74.5	0.90
chr3	123026086	123026933	CpG: 75	847	75	579	17.7	68.4	0.77
chr3	123046810	123047087	CpG: 22	277	22	168	15.9	60.6	0.87
chr3	123068206	123069238	CpG: 118	1032	118	733	22.9	71.0	0.91
chr3	123097846	123098135	CpG: 21	289	21	168	14.5	58.1	0.87
chr3	123133499	123134007	CpG: 36	508	36	334	14.2	65.7	0.66
chr3	123169932	123171249	CpG: 133	1317	133	951	20.2	72.2	0.78
chr3	123313744	123314021	CpG: 23	277	23	169	16.6	61.0	0.91
chr3	123315671	123316203	CpG: 49	532	49	325	18.4	61.1	0.99
chr3	123319701	123319975	CpG: 24	274	24	171	17.5	62.4	0.91
chr3	123627899	123628659	CpG: 83	760	83	543	21.8	71.4	0.87
chr3	123879513	123879794	CpG: 22	281	22	172	15.7	61.2	0.85
chr3	124032980	124034388	CpG: 113	1408	113	1024	16.1	72.7	0.61
chr3	124221305	124221582	CpG: 23	277	23	172	16.6	62.1	0.87
chr3	124242257	124242541	CpG: 23	284	23	176	16.2	62.0	0.86
chr3	124265554	124266028	CpG: 41	474	41	309	17.3	65.2	0.82
chr3	124394742	124395024	CpG: 24	282	24	174	17.0	61.7	0.91
chr3	124408202	124409031	CpG: 60	829	60	572	14.5	69.0	0.61
chr3	124469135	124469621	CpG: 42	486	42	325	17.3	66.9	0.78
chr3	124512360	124512613	CpG: 21	253	21	153	16.6	60.5	0.92
chr3	124554973	124555383	CpG: 42	410	42	259	20.5	63.2	1.07
chr3	124560038	124560353	CpG: 24	315	24	175	15.2	55.6	1.01
chr3	124713170	124713418	CpG: 19	248	19	176	15.3	71.0	0.62
chr3	124742106	124742395	CpG: 33	289	33	217	22.8	75.1	0.88
chr3	124742673	124742905	CpG: 18	232	18	138	15.5	59.5	0.89
chr3	124767482	124767908	CpG: 30	426	30	251	14.1	58.9	0.82
chr3	124903485	124904388	CpG: 81	903	81	626	17.9	69.3	0.78
chr3	124921203	124921511	CpG: 27	308	27	225	17.5	73.1	0.66
chr3	124949842	124950059	CpG: 17	217	17	136	15.7	62.7	0.80
chr3	125103556	125103903	CpG: 41	347	41	251	23.6	72.3	0.90
chr3	125135393	125135792	CpG: 29	399	29	220	14.5	55.1	0.97
chr3	125211153	125211431	CpG: 25	278	25	173	18.0	62.2	0.94
chr3	125233359	125234398	CpG: 124	1039	124	740	23.9	71.2	0.98
chr3	125248764	125249008	CpG: 18	244	18	148	14.8	60.7	0.82
chr3	125260237	125260452	CpG: 18	215	18	133	16.7	61.9	0.89
chr3	125283401	125283993	CpG: 52	592	52	416	17.6	70.3	0.71
chr3	125297005	125297259	CpG: 27	254	27	183	21.3	72.0	0.83
chr3	125400057	125400592	CpG: 55	535	55	374	20.6	69.9	0.86
chr3	125499357	125500639	CpG: 108	1282	108	941	16.8	73.4	0.63
chr3	125512827	125513140	CpG: 28	313	28	198	17.9	63.3	0.90
chr3	125514068	125514819	CpG: 84	751	84	557	22.4	74.2	0.81
chr3	125561395	125561669	CpG: 23	274	23	169	16.8	61.7	0.89
chr3	125632066	125633198	CpG: 105	1132	105	809	18.6	71.5	0.73
chr3	125641016	125641698	CpG: 65	682	65	485	19.1	71.1	0.75
chr3	125746412	125748215	CpG: 174	1803	174	1277	19.3	70.8	0.77
chr3	125786963	125787899	CpG: 85	936	85	671	18.2	71.7	0.71
chr3	125921919	125922330	CpG: 46	411	46	290	22.4	70.6	0.90
chr3	126128023	126128297	CpG: 24	274	24	171	17.5	62.4	0.91
chr3	126167948	126170858	CpG: 346	2910	346	2156	23.8	74.1	0.87
chr3	126261905	126262135	CpG: 18	230	18	139	15.7	60.4	0.87
chr3	126304623	126305502	CpG: 97	879	97	640	22.1	72.8	0.85
chr3	126591974	126592450	CpG: 36	476	36	283	15.1	59.5	0.86
chr3	126609870	126610832	CpG: 97	962	97	676	20.2	70.3	0.82
chr3	126686993	126687759	CpG: 65	766	65	472	17.0	61.6	0.89
chr3	126717965	126718393	CpG: 41	428	41	305	19.2	71.3	0.75
chr3	126753503	126753765	CpG: 24	262	24	164	18.3	62.6	0.94
chr3	126758937	126760482	CpG: 160	1545	160	1151	20.7	74.5	0.75
chr3	126995057	126995277	CpG: 16	220	16	141	14.5	64.1	0.71
chr3	127310496	127311059	CpG: 51	563	51	382	18.1	67.9	0.84
chr3	127382139	127382402	CpG: 19	263	19	160	14.4	60.8	0.80
chr3	127447498	127447727	CpG: 17	229	17	135	14.8	59.0	0.87
chr3	127456142	127456425	CpG: 31	283	31	186	21.9	65.7	1.05
chr3	127611628	127613298	CpG: 187	1670	187	1232	22.4	73.8	0.82
chr3	127713118	127713390	CpG: 19	272	19	165	14.0	60.7	0.77
chr3	127732525	127732806	CpG: 25	281	25	177	17.8	63.0	0.91
chr3	127781061	127781935	CpG: 128	874	128	704	29.3	80.5	0.91
chr3	127856584	127856850	CpG: 23	266	23	166	17.3	62.4	0.90
chr3	127870040	127870537	CpG: 55	497	55	352	22.1	70.8	0.89
chr3	127908912	127909193	CpG: 24	281	24	175	17.1	62.3	0.90
chr3	127939922	127940508	CpG: 60	586	60	448	20.5	76.5	0.71
chr3	128067430	128067706	CpG: 21	276	21	168	15.2	60.9	0.83
chr3	128083724	128084295	CpG: 52	571	52	395	18.2	69.2	0.78
chr3	128101477	128102174	CpG: 70	697	70	507	20.1	72.7	0.80
chr3	128185179	128185418	CpG: 17	239	17	145	14.2	60.7	0.80
chr3	128216873	128217121	CpG: 21	248	21	154	16.9	62.1	0.90
chr3	128246271	128246976	CpG: 63	705	63	510	17.9	72.3	0.74
chr3	128321764	128322796	CpG: 91	1032	91	694	17.6	67.2	0.78
chr3	128464948	128465293	CpG: 32	345	32	229	18.6	66.4	0.85
chr3	128485281	128485557	CpG: 24	276	24	202	17.4	73.2	0.65
chr3	128492928	128493565	CpG: 69	637	69	470	21.7	73.8	0.81
chr3	128499101	128499843	CpG: 81	742	81	543	21.8	73.2	0.82
chr3	128647874	128649525	CpG: 137	1651	137	1141	16.6	69.1	0.74
chr3	128690439	128691173	CpG: 89	734	89	546	24.3	74.4	0.88
chr3	128701444	128701859	CpG: 40	415	40	296	19.3	71.3	0.76
chr3	128722582	128722968	CpG: 36	386	36	256	18.7	66.3	0.85
chr3	128816025	128816836	CpG: 90	811	90	623	22.2	76.8	0.76
chr3	128912183	128913089	CpG: 75	906	75	616	16.6	68.0	0.72
chr3	128945245	128946045	CpG: 89	800	89	573	22.2	71.6	0.87
chr3	128999581	129000243	CpG: 60	662	60	442	18.1	66.8	0.82
chr3	129020239	129020453	CpG: 21	214	21	134	19.6	62.6	1.01
chr3	129020820	129021023	CpG: 16	203	16	135	15.8	66.5	0.73
chr3	129075948	129076480	CpG: 45	532	45	347	16.9	65.2	0.80
chr3	129088447	129090529	CpG: 220	2082	220	1474	21.1	70.8	0.84
chr3	129119832	129120106	CpG: 25	274	25	172	18.2	62.8	0.94
chr3	129121689	129122158	CpG: 56	469	56	326	23.9	69.5	1.01
chr3	129127220	129127640	CpG: 48	420	48	313	22.9	74.5	0.83
chr3	129148722	129149125	CpG: 45	403	45	286	22.3	71.0	0.89
chr3	129195652	129195870	CpG: 17	218	17	131	15.6	60.1	0.88
chr3	129206641	129206911	CpG: 23	270	23	164	17.0	60.7	0.93
chr3	129207395	129209127	CpG: 219	1732	219	1257	25.3	72.6	0.97
chr3	129256248	129256913	CpG: 70	665	70	494	21.1	74.3	0.76
chr3	129274427	129275536	CpG: 138	1109	138	794	24.9	71.6	0.99
chr3	129387050	129387750	CpG: 100	700	100	527	28.6	75.3	1.01
chr3	129411686	129411975	CpG: 25	289	25	188	17.3	65.1	0.82
chr3	129436505	129437554	CpG: 93	1049	93	714	17.7	68.1	0.77
chr3	129566231	129566510	CpG: 25	279	25	175	17.9	62.7	0.92
chr3	129681641	129681865	CpG: 23	224	23	157	20.5	70.1	0.89
chr3	129714709	129716621	CpG: 249	1912	249	1493	26.0	78.1	0.86
chr3	129720955	129721818	CpG: 60	863	60	539	13.9	62.5	0.71
chr3	129746305	129747009	CpG: 66	704	66	499	18.8	70.9	0.75
chr3	129750476	129750696	CpG: 16	220	16	142	14.5	64.5	0.70
chr3	129761997	129762228	CpG: 22	231	22	159	19.0	68.8	0.81
chr3	129766132	129766358	CpG: 19	226	19	160	16.8	70.8	0.67
chr3	129776907	129777144	CpG: 21	237	21	144	17.7	60.8	0.98
chr3	129778864	129779122	CpG: 22	258	22	188	17.1	72.9	0.65
chr3	129867784	129868526	CpG: 58	742	58	481	15.6	64.8	0.76
chr3	129910199	129910462	CpG: 20	263	20	160	15.2	60.8	0.83
chr3	130013123	130013369	CpG: 22	246	22	152	17.9	61.8	0.96
chr3	130028095	130028298	CpG: 16	203	16	143	15.8	70.4	0.64
chr3	130031100	130031385	CpG: 22	285	22	173	15.4	60.7	0.85
chr3	130043623	130043882	CpG: 26	259	26	200	20.1	77.2	0.68
chr3	130072613	130073138	CpG: 52	525	52	384	19.8	73.1	0.76
chr3	130190199	130190768	CpG: 59	569	59	428	20.7	75.2	0.73
chr3	130191829	130192123	CpG: 26	294	26	207	17.7	70.4	0.72
chr3	130282529	130282897	CpG: 33	368	33	274	17.9	74.5	0.65
chr3	130324390	130325954	CpG: 163	1564	163	1099	20.8	70.3	0.85
chr3	130326972	130327351	CpG: 33	379	33	219	17.4	57.8	1.05
chr3	130332750	130333354	CpG: 65	604	65	423	21.5	70.0	0.88
chr3	130339280	130339861	CpG: 43	581	43	383	14.8	65.9	0.70
chr3	130346382	130346657	CpG: 25	275	25	172	18.2	62.5	0.94
chr3	130363501	130364678	CpG: 161	1177	161	882	27.4	74.9	1.00
chr3	130406829	130408252	CpG: 165	1423	165	1054	23.2	74.1	0.84
chr3	130557002	130558144	CpG: 129	1142	129	812	22.6	71.1	0.89
chr3	130649737	130650411	CpG: 67	674	67	474	19.9	70.3	0.80
chr3	130786476	130787359	CpG: 111	883	111	639	25.1	72.4	0.96
chr3	130800371	130800613	CpG: 18	242	18	135	14.9	55.8	0.99
chr3	130810101	130811868	CpG: 165	1767	165	1242	18.7	70.3	0.75
chr3	130824826	130825048	CpG: 16	222	16	133	14.4	59.9	0.83
chr3	130858038	130858627	CpG: 49	589	49	389	16.6	66.0	0.77
chr3	130859623	130859874	CpG: 20	251	20	151	15.9	60.2	0.90
chr3	130888030	130888281	CpG: 18	251	18	143	14.3	57.0	0.93
chr3	130894972	130895638	CpG: 92	666	92	485	27.6	72.8	1.05
chr3	131167899	131168492	CpG: 59	593	59	430	19.9	72.5	0.76
chr3	131173929	131174156	CpG: 18	227	18	157	15.9	69.2	0.79
chr3	131174419	131174943	CpG: 61	524	61	408	23.3	77.9	0.78
chr3	131223351	131223554	CpG: 16	203	16	133	15.8	65.5	0.75
chr3	131228213	131234990	CpG: 538	6777	538	4466	15.9	65.9	0.73
chr3	131237931	131239624	CpG: 150	1693	150	1122	17.7	66.3	0.81
chr3	131296658	131297518	CpG: 80	860	80	625	18.6	72.7	0.71
chr3	131301974	131302252	CpG: 20	278	20	169	14.4	60.8	0.79
chr3	131350058	131350628	CpG: 59	570	59	407	20.7	71.4	0.81
chr3	131359530	131360237	CpG: 58	707	58	460	16.4	65.1	0.78
chr3	131392056	131393305	CpG: 119	1249	119	842	19.1	67.4	0.84
chr3	131395203	131395789	CpG: 54	586	54	440	18.4	75.1	0.65
chr3	131420660	131421000	CpG: 27	340	27	197	15.9	57.9	0.95
chr3	131425167	131425953	CpG: 72	786	72	523	18.3	66.5	0.83
chr3	131442465	131443611	CpG: 83	1146	83	747	14.5	65.2	0.71
chr3	131470713	131471463	CpG: 83	750	83	546	22.1	72.8	0.84
chr3	131509534	131509857	CpG: 30	323	30	213	18.6	65.9	0.94
chr3	131517382	131518183	CpG: 59	801	59	557	14.7	69.5	0.61
chr3	131540444	131540723	CpG: 22	279	22	175	15.8	62.7	0.81
chr3	131590646	131590882	CpG: 19	236	19	171	16.1	72.5	0.64
chr3	131597786	131598021	CpG: 17	235	17	143	14.5	60.9	0.80
chr3	131624053	131624580	CpG: 55	527	55	352	20.9	66.8	0.94
chr3	131738442	131739096	CpG: 59	654	59	455	18.0	69.6	0.76
chr3	131745903	131747283	CpG: 162	1380	162	996	23.5	72.2	0.91
chr3	131748321	131749074	CpG: 72	753	72	517	19.1	68.7	0.83
chr3	131771930	131772366	CpG: 46	436	46	318	21.1	72.9	0.79
chr3	131790571	131792086	CpG: 143	1515	143	1082	18.9	71.4	0.74
chr3	131813416	131813677	CpG: 29	261	29	196	22.2	75.1	0.79
chr3	131865994	131867427	CpG: 145	1433	145	1066	20.2	74.4	0.81
chr3	131905781	131906510	CpG: 59	729	59	432	16.2	59.3	0.92
chr3	131913722	131913963	CpG: 17	241	17	141	14.1	58.5	0.84
chr3	131927906	131929030	CpG: 121	1124	121	765	21.5	68.1	0.95
chr3	131951589	131951790	CpG: 16	201	16	120	15.9	59.7	0.92
chr3	131994299	131994501	CpG: 25	202	25	136	24.8	67.3	1.10
chr3	132023338	132024259	CpG: 103	921	103	675	22.4	73.3	0.88
chr3	132059495	132061601	CpG: 219	2106	219	1443	20.8	68.5	0.89
chr3	132088635	132089081	CpG: 34	446	34	316	15.2	70.9	0.62
chr3	132118348	132118585	CpG: 17	237	17	142	14.3	59.9	0.82
chr3	132173212	132173600	CpG: 37	388	37	241	19.1	62.1	0.99
chr3	132184555	132185460	CpG: 84	905	84	600	18.6	66.3	0.85
chr3	132349508	132351798	CpG: 302	2290	302	1699	26.4	74.2	0.96
chr3	132371260	132372114	CpG: 67	854	67	596	15.7	69.8	0.64
chr3	132372974	132373247	CpG: 23	273	23	169	16.8	61.9	0.89
chr3	132375163	132375447	CpG: 23	284	23	166	16.2	58.5	0.96
chr3	132384903	132385173	CpG: 20	270	20	164	14.8	60.7	0.81
chr3	132505482	132505759	CpG: 24	277	24	175	17.3	63.2	0.89
chr3	132637326	132638290	CpG: 116	964	116	707	24.1	73.3	0.90
chr3	132718081	132719799	CpG: 157	1718	157	1122	18.3	65.3	0.86
chr3	132746340	132747103	CpG: 87	763	87	569	22.8	74.6	0.83
chr3	132774866	132775145	CpG: 27	279	27	181	19.4	64.9	0.92
chr3	132854970	132856425	CpG: 119	1455	119	1024	16.4	70.4	0.71
chr3	132941217	132941458	CpG: 19	241	19	145	15.8	60.2	0.89
chr3	132963268	132963541	CpG: 22	273	22	172	16.1	63.0	0.82
chr3	133007886	133008229	CpG: 31	343	31	232	18.1	67.6	0.79
chr3	133089738	133089985	CpG: 30	247	30	171	24.3	69.2	1.02
chr3	133109319	133109551	CpG: 21	232	21	138	18.1	59.5	1.04
chr3	133260897	133261213	CpG: 41	316	41	235	25.9	74.4	0.94
chr3	133305484	133305765	CpG: 23	281	23	174	16.4	61.9	0.87
chr3	133489588	133489863	CpG: 20	275	20	164	14.5	59.6	0.82
chr3	133490478	133490700	CpG: 21	222	21	144	18.9	64.9	0.91
chr3	133491154	133491880	CpG: 52	726	52	423	14.3	58.3	0.85
chr3	133637262	133638462	CpG: 113	1200	113	817	18.8	68.1	0.81
chr3	133770293	133770745	CpG: 40	452	40	293	17.7	64.8	0.84
chr3	133912133	133912411	CpG: 24	278	24	174	17.3	62.6	0.89
chr3	134018393	134018678	CpG: 23	285	23	177	16.1	62.1	0.85
chr3	134105523	134106136	CpG: 53	613	53	420	17.3	68.5	0.74
chr3	134125289	134126099	CpG: 76	810	76	564	18.8	69.6	0.78
chr3	134246508	134246792	CpG: 35	284	35	190	24.6	66.9	1.12
chr3	134270596	134270896	CpG: 27	300	27	217	18.0	72.3	0.70
chr3	134340016	134340294	CpG: 25	278	25	174	18.0	62.6	0.93
chr3	134379525	134379755	CpG: 20	230	20	141	17.4	61.3	0.94
chr3	134394153	134394381	CpG: 22	228	22	144	19.3	63.2	1.01
chr3	134472326	134472537	CpG: 16	211	16	127	15.2	60.2	0.85
chr3	134558447	134558721	CpG: 24	274	24	171	17.5	62.4	0.91
chr3	134620163	134620378	CpG: 15	215	15	129	14.0	60.0	0.79
chr3	134695481	134696479	CpG: 73	998	73	693	14.6	69.4	0.61
chr3	134702667	134703072	CpG: 33	405	33	233	16.3	57.5	1.00
chr3	134767943	134768217	CpG: 22	274	22	169	16.1	61.7	0.86
chr3	134779465	134779724	CpG: 25	259	25	172	19.3	66.4	0.88
chr3	134881459	134881698	CpG: 19	239	19	145	15.9	60.7	0.86
chr3	134886204	134886490	CpG: 23	286	23	173	16.1	60.5	0.89
chr3	135021763	135022048	CpG: 24	285	24	178	16.8	62.5	0.88
chr3	135121292	135121602	CpG: 27	310	27	195	17.4	62.9	0.88
chr3	135161604	135162250	CpG: 63	646	63	445	19.5	68.9	0.85
chr3	135390499	135390707	CpG: 18	208	18	127	17.3	61.1	0.95
chr3	135404207	135404421	CpG: 18	214	18	140	16.8	65.4	0.79
chr3	135404732	135405292	CpG: 57	560	57	389	20.4	69.5	0.88
chr3	135466372	135467602	CpG: 138	1230	138	900	22.4	73.2	0.88
chr3	135581510	135581748	CpG: 20	238	20	142	16.8	59.7	0.97
chr3	135695993	135696420	CpG: 33	427	33	257	15.5	60.2	0.86
chr3	135782549	135783459	CpG: 83	910	83	624	18.2	68.6	0.78
chr3	136054457	136054731	CpG: 22	274	22	168	16.1	61.3	0.86
chr3	136318504	136319743	CpG: 160	1239	160	927	25.8	74.8	0.93
chr3	136406777	136407308	CpG: 52	531	52	362	19.6	68.2	0.84
chr3	136419439	136419978	CpG: 47	539	47	373	17.4	69.2	0.74
chr3	136491297	136491768	CpG: 45	471	45	314	19.1	66.7	0.86
chr3	136496455	136496684	CpG: 21	229	21	138	18.3	60.3	1.02
chr3	136528915	136529317	CpG: 35	402	35	284	17.4	70.6	0.70
chr3	136550923	136551554	CpG: 53	631	53	414	16.8	65.6	0.78
chr3	136639891	136641499	CpG: 146	1608	146	1134	18.2	70.5	0.73
chr3	136672409	136673027	CpG: 70	618	70	437	22.7	70.7	0.91
chr3	136774210	136775303	CpG: 113	1093	113	734	20.7	67.2	0.92
chr3	136815388	136815764	CpG: 30	376	30	269	16.0	71.5	0.63
chr3	136995331	136996306	CpG: 137	975	137	751	28.1	77.0	0.95
chr3	137003470	137003719	CpG: 19	249	19	147	15.3	59.0	0.90
chr3	137057924	137058853	CpG: 80	929	80	644	17.2	69.3	0.74
chr3	137106703	137106909	CpG: 20	206	20	144	19.4	69.9	0.84
chr3	137109173	137109514	CpG: 37	341	37	247	21.7	72.4	0.83
chr3	137118570	137120054	CpG: 134	1484	134	991	18.1	66.8	0.83
chr3	137151806	137152190	CpG: 42	384	42	273	21.9	71.1	0.87
chr3	137181447	137181677	CpG: 19	230	19	140	16.5	60.9	0.92
chr3	137229274	137229559	CpG: 21	285	21	171	14.7	60.0	0.83
chr3	137230849	137231798	CpG: 90	949	90	629	19.0	66.3	0.86
chr3	137327005	137327283	CpG: 25	278	25	176	18.0	63.3	0.91
chr3	137395975	137396753	CpG: 79	778	79	544	20.3	69.9	0.83
chr3	137505481	137505718	CpG: 20	237	20	146	16.9	61.6	0.92
chr3	137540614	137542509	CpG: 178	1895	178	1277	18.8	67.4	0.83
chr3	137751066	137751309	CpG: 19	243	19	145	15.6	59.7	0.88
chr3	137776360	137776578	CpG: 17	218	17	129	15.6	59.2	0.89
chr3	137784881	137785267	CpG: 31	386	31	275	16.1	71.2	0.63
chr3	137918497	137918771	CpG: 24	274	24	171	17.5	62.4	0.91
chr3	138229931	138230168	CpG: 19	237	19	142	16.0	59.9	0.92
chr3	138330638	138330875	CpG: 20	237	20	138	16.9	58.2	1.00
chr3	138404421	138404747	CpG: 27	326	27	195	16.6	59.8	0.93
chr3	138434193	138434467	CpG: 24	274	24	171	17.5	62.4	0.91
chr3	138711202	138712296	CpG: 123	1094	123	798	22.5	72.9	0.86
chr3	138883368	138883634	CpG: 19	266	19	160	14.3	60.2	0.80
chr3	138905191	138905468	CpG: 20	277	20	164	14.4	59.2	0.84
chr3	138940532	138943053	CpG: 246	2521	246	1639	19.5	65.0	0.94
chr3	138996011	138996536	CpG: 60	525	60	352	22.9	67.0	1.02
chr3	139025509	139025782	CpG: 20	273	20	164	14.7	60.1	0.82
chr3	139117811	139118069	CpG: 18	258	18	158	14.0	61.2	0.76
chr3	139225351	139225644	CpG: 23	293	23	178	15.7	60.8	0.85
chr3	139492305	139493795	CpG: 185	1490	185	1055	24.8	70.8	0.99
chr3	139536858	139537131	CpG: 21	273	21	169	15.4	61.9	0.81
chr3	139559400	139561043	CpG: 134	1643	134	1020	16.3	62.1	0.85
chr3	139602686	139603510	CpG: 85	824	85	571	20.6	69.3	0.86
chr3	139604500	139604725	CpG: 19	225	19	137	16.9	60.9	0.92
chr3	139709940	139710351	CpG: 32	411	32	247	15.6	60.1	0.87
chr3	139728183	139728609	CpG: 38	426	38	315	17.8	73.9	0.65
chr3	139773152	139773494	CpG: 23	342	23	193	13.5	56.4	0.85
chr3	139792303	139792543	CpG: 16	240	16	138	13.3	57.5	0.83
chr3	139866882	139867144	CpG: 22	262	22	162	16.8	61.8	0.89
chr3	139939048	139939819	CpG: 58	771	58	530	15.0	68.7	0.64
chr3	140201303	140201629	CpG: 25	326	25	192	15.3	58.9	0.89
chr3	140379950	140380344	CpG: 29	394	29	237	14.7	60.2	0.82
chr3	140499735	140500009	CpG: 24	274	24	171	17.5	62.4	0.91
chr3	140501708	140501960	CpG: 19	252	19	155	15.1	61.5	0.81
chr3	140502320	140502720	CpG: 31	400	31	249	15.5	62.2	0.80
chr3	140504727	140506217	CpG: 110	1490	110	977	14.8	65.6	0.70
chr3	140509191	140509783	CpG: 48	592	48	374	16.2	63.2	0.81
chr3	140510813	140511171	CpG: 26	358	26	228	14.5	63.7	0.72
chr3	140511356	140512766	CpG: 104	1410	104	847	14.8	60.1	0.82
chr3	140547593	140547867	CpG: 23	274	23	169	16.8	61.7	0.89
chr3	140642924	140643186	CpG: 23	262	23	163	17.6	62.2	0.92
chr3	140750812	140751024	CpG: 17	212	17	141	16.0	66.5	0.73
chr3	140759018	140759292	CpG: 23	274	23	170	16.8	62.0	0.88
chr3	140855593	140856337	CpG: 78	744	78	521	21.0	70.0	0.87
chr3	140915158	140915556	CpG: 36	398	36	253	18.1	63.6	0.91
chr3	140927784	140928610	CpG: 73	826	73	546	17.7	66.1	0.81
chr3	140996998	140997273	CpG: 23	275	23	166	16.7	60.4	0.93
chr3	141069904	141070489	CpG: 56	585	56	384	19.1	65.6	0.90
chr3	141088379	141089650	CpG: 146	1271	146	866	23.0	68.1	1.01
chr3	141174980	141176328	CpG: 132	1348	132	923	19.6	68.5	0.84
chr3	141192234	141192771	CpG: 45	537	45	359	16.8	66.9	0.76
chr3	141334734	141335096	CpG: 39	362	39	254	21.5	70.2	0.88
chr3	141349256	141349976	CpG: 92	720	92	529	25.6	73.5	0.95
chr3	141352881	141353093	CpG: 18	212	18	129	17.0	60.8	0.93
chr3	141568930	141569152	CpG: 19	222	19	131	17.1	59.0	0.99
chr3	141573263	141573502	CpG: 17	239	17	142	14.2	59.4	0.82
chr3	141575032	141575951	CpG: 113	919	113	671	24.6	73.0	0.95
chr3	141588218	141589266	CpG: 70	1048	70	588	13.4	56.1	0.85
chr3	141609724	141609961	CpG: 18	237	18	140	15.2	59.1	0.90
chr3	141656509	141657235	CpG: 61	726	61	510	16.8	70.2	0.68
chr3	141661623	141661838	CpG: 16	215	16	128	14.9	59.5	0.85
chr3	141669822	141670245	CpG: 36	423	36	267	17.0	63.1	0.86
chr3	141676976	141681245	CpG: 263	4269	263	2583	12.3	60.5	0.68
chr3	141685868	141688557	CpG: 291	2689	291	1885	21.6	70.1	0.88
chr3	141690796	141691484	CpG: 68	688	68	465	19.8	67.6	0.87
chr3	141701418	141701753	CpG: 37	335	37	239	22.1	71.3	0.89
chr3	141708375	141708649	CpG: 19	274	19	163	13.9	59.5	0.79
chr3	141746486	141747607	CpG: 105	1121	105	762	18.7	68.0	0.83
chr3	141756889	141757166	CpG: 24	277	24	174	17.3	62.8	0.89
chr3	141760881	141762083	CpG: 113	1202	113	809	18.8	67.3	0.84
chr3	141762801	141763073	CpG: 21	272	21	165	15.4	60.7	0.85
chr3	141784861	141786282	CpG: 126	1421	126	935	17.7	65.8	0.83
chr3	141889465	141889690	CpG: 18	225	18	133	16.0	59.1	0.92
chr3	142067251	142067543	CpG: 25	292	25	179	17.1	61.3	0.91
chr3	142091631	142091857	CpG: 24	226	24	144	21.2	63.7	1.05
chr3	142136966	142137702	CpG: 58	736	58	460	15.8	62.5	0.81
chr3	142286299	142286536	CpG: 18	237	18	142	15.2	59.9	0.86
chr3	142286739	142287709	CpG: 87	970	87	613	17.9	63.2	0.91
chr3	142338540	142338832	CpG: 27	292	27	178	18.5	61.0	1.00
chr3	142424932	142425562	CpG: 61	630	61	451	19.4	71.6	0.76
chr3	142681942	142683627	CpG: 147	1685	147	1164	17.4	69.1	0.73
chr3	143418873	143419127	CpG: 21	254	21	149	16.5	58.7	0.98
chr3	143429925	143430452	CpG: 37	527	37	316	14.0	60.0	0.82
chr3	143688945	143690213	CpG: 123	1268	123	872	19.4	68.8	0.84
chr3	143760775	143761042	CpG: 23	267	23	165	17.2	61.8	0.91
chr3	143798560	143799782	CpG: 134	1222	134	865	21.9	70.8	0.88
chr3	143813481	143814153	CpG: 71	672	71	484	21.1	72.0	0.81
chr3	143842599	143842820	CpG: 17	221	17	143	15.4	64.7	0.78
chr3	143859895	143860169	CpG: 24	274	24	171	17.5	62.4	0.91
chr3	143978627	143980167	CpG: 161	1540	161	1113	20.9	72.3	0.80
chr3	144059249	144059555	CpG: 29	306	29	190	19.0	62.1	0.98
chr3	144149785	144150480	CpG: 93	695	93	540	26.8	77.7	0.90
chr3	144222389	144222608	CpG: 16	219	16	131	14.6	59.8	0.84
chr3	144234392	144235613	CpG: 147	1221	147	919	24.1	75.3	0.91
chr3	144407416	144407969	CpG: 56	553	56	391	20.3	70.7	0.81
chr3	144485255	144485967	CpG: 77	712	77	511	21.6	71.8	0.84
chr3	144509905	144510227	CpG: 25	322	25	198	15.5	61.5	0.82
chr3	144524566	144524811	CpG: 18	245	18	136	14.7	55.5	0.96
chr3	144525544	144525878	CpG: 27	334	27	230	16.2	68.9	0.68
chr3	144544441	144545025	CpG: 43	584	43	371	14.7	63.5	0.73
chr3	144622942	144624744	CpG: 200	1802	200	1231	22.2	68.3	0.95
chr3	144690943	144691169	CpG: 20	226	20	138	17.7	61.1	0.99
chr3	144778093	144778378	CpG: 27	285	27	178	18.9	62.5	0.98
chr3	144861187	144861462	CpG: 23	275	23	165	16.7	60.0	0.94
chr3	144862650	144862916	CpG: 20	266	20	160	15.0	60.2	0.84
chr3	144896419	144897070	CpG: 80	651	80	478	24.6	73.4	0.92
chr3	144960151	144960428	CpG: 21	277	21	173	15.2	62.5	0.79
chr3	144972398	144973346	CpG: 101	948	101	646	21.3	68.1	0.93
chr3	144989109	144989345	CpG: 23	236	23	146	19.5	61.9	1.05
chr3	145194644	145195468	CpG: 71	824	71	519	17.2	63.0	0.87
chr3	145201748	145202026	CpG: 22	278	22	176	15.8	63.3	0.80
chr3	145307908	145308140	CpG: 16	232	16	135	13.8	58.2	0.83
chr3	145319324	145319645	CpG: 22	321	22	181	13.7	56.4	0.87
chr3	145325646	145326276	CpG: 56	630	56	419	17.8	66.5	0.80
chr3	145343589	145343985	CpG: 42	396	42	270	21.2	68.2	0.94
chr3	145346619	145346885	CpG: 20	266	20	163	15.0	61.3	0.82
chr3	145348196	145348472	CpG: 20	276	20	167	14.5	60.5	0.80
chr3	145471099	145472375	CpG: 111	1276	111	870	17.4	68.2	0.75
chr3	145635596	145636630	CpG: 103	1034	103	714	19.9	69.1	0.83
chr3	145637406	145637669	CpG: 23	263	23	159	17.5	60.5	0.97
chr3	145642763	145642999	CpG: 17	236	17	138	14.4	58.5	0.86
chr3	145694503	145694945	CpG: 41	442	41	312	18.6	70.6	0.77
chr3	145709537	145711668	CpG: 233	2131	233	1445	21.9	67.8	0.96
chr3	145742955	145743166	CpG: 15	211	15	125	14.2	59.2	0.82
chr3	145748636	145749159	CpG: 47	523	47	319	18.0	61.0	0.97
chr3	145866441	145869394	CpG: 327	2953	327	2055	22.1	69.6	0.92
chr3	146495288	146495569	CpG: 23	281	23	173	16.4	61.6	0.88
chr3	146532460	146532733	CpG: 23	273	23	167	16.8	61.2	0.91
chr3	146642131	146642365	CpG: 20	234	20	141	17.1	60.3	0.98
chr3	146689924	146690148	CpG: 19	224	19	141	17.0	62.9	0.89
chr3	146717522	146720068	CpG: 243	2546	243	1673	19.1	65.7	0.89
chr3	146733068	146733309	CpG: 20	241	20	149	16.6	61.8	0.89
chr3	147232207	147232522	CpG: 26	315	26	185	16.5	58.7	0.97
chr3	147241264	147241519	CpG: 20	255	20	157	15.7	61.6	0.85
chr3	147715077	147715307	CpG: 21	230	21	142	18.3	61.7	0.97
chr3	147762120	147762350	CpG: 18	230	18	139	15.7	60.4	0.87
chr3	147797312	147797586	CpG: 22	274	22	169	16.1	61.7	0.85
chr3	147882301	147882563	CpG: 20	262	20	155	15.3	59.2	0.88
chr3	147919475	147919706	CpG: 17	231	17	137	14.7	59.3	0.85
chr3	148088169	148088695	CpG: 44	526	44	383	16.7	72.8	0.63
chr3	148420018	148420293	CpG: 22	275	22	169	16.0	61.5	0.86
chr3	148616271	148616483	CpG: 16	212	16	124	15.1	58.5	0.89
chr3	148763643	148764026	CpG: 32	383	32	220	16.7	57.4	1.02
chr3	148916194	148917051	CpG: 97	857	97	618	22.6	72.1	0.88
chr3	149005695	149006369	CpG: 72	674	72	462	21.4	68.5	0.91
chr3	149116701	149116972	CpG: 23	271	23	164	17.0	60.5	0.93
chr3	149218372	149218612	CpG: 18	240	18	143	15.0	59.6	0.85
chr3	149224486	149225088	CpG: 44	602	44	399	14.6	66.3	0.68
chr3	149299504	149299883	CpG: 36	379	36	253	19.0	66.8	0.87
chr3	149513655	149513923	CpG: 21	268	21	167	15.7	62.3	0.81
chr3	149546834	149547077	CpG: 21	243	21	151	17.3	62.1	0.91
chr3	149547898	149548120	CpG: 16	222	16	133	14.4	59.9	0.82
chr3	149836368	149836650	CpG: 24	282	24	174	17.0	61.7	0.91
chr3	150000931	150001422	CpG: 43	491	43	352	17.5	71.7	0.68
chr3	150004417	150004698	CpG: 24	281	24	175	17.1	62.3	0.89
chr3	150114604	150115161	CpG: 39	557	39	320	14.0	57.5	0.85
chr3	150145976	150149168	CpG: 210	3192	210	1886	13.2	59.1	0.75
chr3	150151074	150151945	CpG: 71	871	71	563	16.3	64.6	0.79
chr3	150153230	150153887	CpG: 43	657	43	399	13.1	60.7	0.71
chr3	150164454	150166465	CpG: 192	2011	192	1287	19.1	64.0	0.93
chr3	150167808	150168043	CpG: 23	235	23	146	19.6	62.1	1.01
chr3	150168532	150168799	CpG: 25	267	25	163	18.7	61.0	1.16
chr3	150174369	150174794	CpG: 37	425	37	279	17.4	65.6	0.82
chr3	150176382	150177030	CpG: 59	648	59	432	18.2	66.7	0.82
chr3	150179647	150179857	CpG: 18	210	18	146	17.1	69.5	0.71
chr3	150326484	150326758	CpG: 24	274	24	170	17.5	62.0	0.92
chr3	150364847	150365083	CpG: 17	236	17	141	14.4	59.7	0.82
chr3	150605533	150605811	CpG: 25	278	25	175	18.0	62.9	0.92
chr3	150666097	150666378	CpG: 23	281	23	173	16.4	61.6	0.88
chr3	150727755	150728029	CpG: 23	274	23	170	16.8	62.0	0.88
chr3	150744575	150744838	CpG: 21	263	21	189	16.0	71.9	0.63
chr3	151035758	151036108	CpG: 37	350	37	264	21.1	75.4	0.74
chr3	151243739	151244013	CpG: 23	274	23	170	16.8	62.0	0.88
chr3	151448688	151449178	CpG: 57	490	57	344	23.3	70.2	0.95
chr3	151483792	151484071	CpG: 22	279	22	173	15.8	62.0	0.83
chr3	151505459	151505697	CpG: 16	238	16	138	13.4	58.0	0.82
chr3	151742008	151743001	CpG: 121	993	121	752	24.4	75.7	0.85
chr3	151807546	151807819	CpG: 22	273	22	174	16.1	63.7	0.80
chr3	151836834	151837487	CpG: 59	653	59	417	18.1	63.9	0.89
chr3	151877337	151877611	CpG: 24	274	24	170	17.5	62.0	0.92
chr3	151880148	151880918	CpG: 81	770	81	523	21.0	67.9	0.92
chr3	152035790	152036057	CpG: 18	267	18	144	13.5	53.9	0.93
chr3	152195994	152196429	CpG: 34	435	34	308	15.6	70.8	0.62
chr3	152393750	152393988	CpG: 17	238	17	141	14.3	59.2	0.83
chr3	152408053	152409781	CpG: 138	1728	138	1111	16.0	64.3	0.78
chr3	152503375	152503854	CpG: 45	479	45	299	18.8	62.4	1.00
chr3	152563773	152564714	CpG: 76	941	76	602	16.2	64.0	0.79
chr3	152620586	152620861	CpG: 20	275	20	167	14.5	60.7	0.80
chr3	152721464	152723124	CpG: 205	1660	205	1207	24.7	72.7	0.94
chr3	152734493	152734740	CpG: 32	247	32	173	25.9	70.0	1.06
chr3	152802046	152802261	CpG: 23	215	23	140	21.4	65.1	1.02
chr3	152932276	152932648	CpG: 27	372	27	223	14.5	59.9	0.82
chr3	153074243	153074636	CpG: 37	393	37	294	18.8	74.8	0.67
chr3	153119746	153120031	CpG: 26	285	26	180	18.2	63.2	0.93
chr3	153159481	153162198	CpG: 271	2717	271	1891	19.9	69.6	0.83
chr3	153297077	153298075	CpG: 123	998	123	687	24.6	68.8	1.05
chr3	153354451	153355240	CpG: 71	789	71	504	18.0	63.9	0.88
chr3	153362902	153363173	CpG: 28	271	28	199	20.7	73.4	0.80
chr3	153395774	153396052	CpG: 23	278	23	172	16.5	61.9	0.87
chr3	153453535	153453809	CpG: 21	274	21	165	15.3	60.2	0.86
chr3	153454643	153455339	CpG: 52	696	52	454	14.9	65.2	0.71
chr3	153513141	153515295	CpG: 213	2154	213	1437	19.8	66.7	0.90
chr3	153530206	153530840	CpG: 48	634	48	437	15.1	68.9	0.64
chr3	153638921	153639190	CpG: 19	269	19	162	14.1	60.2	0.79
chr3	153699301	153699575	CpG: 25	274	25	171	18.2	62.4	0.95
chr3	153728833	153729077	CpG: 18	244	18	144	14.8	59.0	0.88
chr3	153835183	153835462	CpG: 22	279	22	170	15.8	60.9	0.86
chr3	153836267	153838439	CpG: 227	2172	227	1538	20.9	70.8	0.83
chr3	153992873	153993205	CpG: 25	332	25	198	15.1	59.6	0.85
chr3	154104841	154105115	CpG: 23	274	23	169	16.8	61.7	0.89
chr3	154187400	154187726	CpG: 27	326	27	194	16.6	59.5	0.94
chr3	154217871	154218232	CpG: 31	361	31	244	17.2	67.6	0.76
chr3	154224637	154224901	CpG: 20	264	20	162	15.2	61.4	0.81
chr3	154410655	154410937	CpG: 21	282	21	165	14.9	58.5	0.88
chr3	154461748	154461973	CpG: 17	225	17	133	15.1	59.1	0.89
chr3	154588371	154588650	CpG: 24	279	24	172	17.2	61.6	0.91
chr3	154696020	154696412	CpG: 42	392	42	295	21.4	75.3	0.76
chr3	154752316	154752555	CpG: 18	239	18	146	15.1	61.1	0.82
chr3	154831912	154832183	CpG: 20	271	20	166	14.8	61.3	0.79
chr3	154903750	154904031	CpG: 19	281	19	168	13.5	59.8	0.77
chr3	154920293	154920686	CpG: 34	393	34	290	17.3	73.8	0.64
chr3	154962073	154962326	CpG: 20	253	20	141	15.8	55.7	1.04
chr3	155036438	155037436	CpG: 101	998	101	663	20.2	66.4	0.92
chr3	155079803	155080083	CpG: 25	280	25	174	17.9	62.1	0.94
chr3	155201368	155201646	CpG: 23	278	23	172	16.5	61.9	0.87
chr3	155296186	155296467	CpG: 22	281	22	174	15.7	61.9	0.83
chr3	155547050	155547611	CpG: 41	561	41	325	14.6	57.9	0.90
chr3	155567659	155567898	CpG: 19	239	19	143	15.9	59.8	0.90
chr3	155605202	155606312	CpG: 120	1110	120	769	21.6	69.3	0.90
chr3	155726740	155727014	CpG: 25	274	25	171	18.2	62.4	0.95
chr3	155871985	155872222	CpG: 18	237	18	145	15.2	61.2	0.84
chr3	155925523	155925731	CpG: 18	208	18	119	17.3	57.2	1.08
chr3	155926303	155926665	CpG: 34	362	34	270	18.8	74.6	0.68
chr3	155931048	155933866	CpG: 242	2818	242	1778	17.2	63.1	0.86
chr3	155955371	155955582	CpG: 15	211	15	126	14.2	59.7	0.82
chr3	156011909	156012320	CpG: 31	411	31	245	15.1	59.6	0.85
chr3	156039102	156039703	CpG: 53	601	53	440	17.6	73.2	0.66
chr3	156088952	156089228	CpG: 20	276	20	164	14.5	59.4	0.83
chr3	156138628	156138902	CpG: 24	274	24	170	17.5	62.0	0.92
chr3	156311749	156311983	CpG: 17	234	17	139	14.5	59.4	0.85
chr3	156509828	156510068	CpG: 18	240	18	145	15.0	60.4	0.85
chr3	156859072	156859343	CpG: 21	271	21	195	15.5	72.0	0.60
chr3	156860234	156860482	CpG: 17	248	17	137	13.7	55.2	0.92
chr3	156892011	156893604	CpG: 147	1593	147	1043	18.5	65.5	0.86
chr3	157009080	157009302	CpG: 16	222	16	129	14.4	58.1	0.86
chr3	157065138	157065413	CpG: 24	275	24	170	17.5	61.8	0.92
chr3	157070519	157070749	CpG: 17	230	17	138	14.8	60.0	0.83
chr3	157098473	157098845	CpG: 33	372	33	246	17.7	66.1	0.84
chr3	157173978	157174220	CpG: 20	242	20	149	16.5	61.6	0.89
chr3	157202520	157203138	CpG: 49	618	49	390	15.9	63.1	0.80
chr3	157272994	157273256	CpG: 20	262	20	158	15.3	60.3	0.85
chr3	157286093	157286369	CpG: 24	276	24	171	17.4	62.0	0.92
chr3	157428959	157429233	CpG: 24	274	24	169	17.5	61.7	0.93
chr3	157630815	157631089	CpG: 23	274	23	170	16.8	62.0	0.88
chr3	157663176	157663731	CpG: 50	555	50	406	18.0	73.2	0.67
chr3	157679490	157679762	CpG: 20	272	20	167	14.7	61.4	0.79
chr3	157704562	157704836	CpG: 23	274	23	170	16.8	62.0	0.88
chr3	157845833	157846118	CpG: 22	285	22	178	15.4	62.5	0.81
chr3	157853566	157854159	CpG: 60	593	60	433	20.2	73.0	0.78
chr3	157899021	157899245	CpG: 20	224	20	134	17.9	59.8	1.00
chr3	158083693	158083898	CpG: 21	205	21	148	20.5	72.2	0.82
chr3	158296942	158297214	CpG: 22	272	22	164	16.2	60.3	0.90
chr3	158315985	158316206	CpG: 18	221	18	133	16.3	60.2	0.90
chr3	158467047	158467328	CpG: 24	281	24	174	17.1	61.9	0.91
chr3	158518001	158518645	CpG: 56	644	56	419	17.4	65.1	0.82
chr3	158579834	158580268	CpG: 53	434	53	321	24.4	74.0	0.91
chr3	158590761	158591035	CpG: 21	274	21	171	15.3	62.4	0.79
chr3	158629196	158629442	CpG: 25	246	25	159	20.3	64.6	1.01
chr3	158630035	158630409	CpG: 25	374	25	214	13.4	57.2	0.82
chr3	158633329	158633601	CpG: 22	272	22	168	16.2	61.8	0.86
chr3	158644857	158646451	CpG: 176	1594	176	1170	22.1	73.4	0.82
chr3	158716802	158717032	CpG: 17	230	17	134	14.8	58.3	0.89
chr3	158725391	158725645	CpG: 21	254	21	160	16.5	63.0	0.84
chr3	158809020	158809577	CpG: 39	557	39	322	14.0	57.8	0.84
chr3	158874098	158874476	CpG: 31	378	31	276	16.4	73.0	0.62
chr3	158874986	158875235	CpG: 17	249	17	140	13.7	56.2	0.91
chr3	158939609	158939884	CpG: 24	275	24	171	17.5	62.2	0.91
chr3	158952034	158952297	CpG: 20	263	20	158	15.2	60.1	0.85
chr3	159059249	159059491	CpG: 20	242	20	144	16.5	59.5	0.93
chr3	159065837	159066166	CpG: 29	329	29	218	17.6	66.3	0.81
chr3	159169917	159170191	CpG: 23	274	23	170	16.8	62.0	0.88
chr3	159172974	159173243	CpG: 20	269	20	164	14.9	61.0	0.80
chr3	159329502	159329965	CpG: 49	463	49	315	21.2	68.0	0.91
chr3	159448705	159450502	CpG: 201	1797	201	1226	22.4	68.2	0.96
chr3	159515255	159515571	CpG: 31	316	31	231	19.6	73.1	0.74
chr3	159559290	159559570	CpG: 24	280	24	170	17.1	60.7	0.93
chr3	159590759	159592051	CpG: 139	1292	139	882	21.5	68.3	0.92
chr3	159600815	159601329	CpG: 56	514	56	359	21.8	69.8	0.91
chr3	159780576	159780857	CpG: 24	281	24	174	17.1	61.9	0.91
chr3	159781474	159781714	CpG: 20	240	20	145	16.7	60.4	0.93
chr3	159863437	159863818	CpG: 41	381	41	274	21.5	71.9	0.84
chr3	159894720	159895177	CpG: 48	457	48	323	21.0	70.7	0.84
chr3	159933928	159935117	CpG: 128	1189	128	786	21.5	66.1	0.99
chr3	159949307	159949789	CpG: 52	482	52	308	21.6	63.9	1.06
chr3	160079710	160079985	CpG: 24	275	24	171	17.5	62.2	0.91
chr3	160087513	160087735	CpG: 20	222	20	137	18.0	61.7	0.96
chr3	160212046	160212605	CpG: 67	559	67	398	24.0	71.2	0.96
chr3	160317229	160318057	CpG: 58	828	58	525	14.0	63.4	0.72
chr3	160482823	160483096	CpG: 23	273	23	168	16.8	61.5	0.90
chr3	160558046	160558332	CpG: 23	286	23	175	16.1	61.2	0.86
chr3	160625001	160625233	CpG: 17	232	17	136	14.7	58.6	0.88
chr3	160794540	160794764	CpG: 21	224	21	135	18.8	60.3	1.03
chr3	160814345	160814631	CpG: 23	286	23	177	16.1	61.9	0.85
chr3	160846386	160846626	CpG: 22	240	22	149	18.3	62.1	0.97
chr3	160868986	160869697	CpG: 63	711	63	477	17.7	67.1	0.79
chr3	160872530	160873044	CpG: 54	514	54	345	21.0	67.1	0.99
chr3	160877422	160877698	CpG: 19	276	19	164	13.8	59.4	0.79
chr3	160878181	160878553	CpG: 35	372	35	240	18.8	64.5	0.92
chr3	160879765	160880785	CpG: 92	1020	92	688	18.0	67.5	0.84
chr3	160881050	160881284	CpG: 19	234	19	131	16.2	56.0	1.04
chr3	160884731	160885168	CpG: 44	437	44	284	20.1	65.0	0.96
chr3	161091592	161091864	CpG: 23	272	23	171	16.9	62.9	0.86
chr3	161174289	161174565	CpG: 24	276	24	171	17.4	62.0	0.92
chr3	161340559	161340788	CpG: 20	229	20	142	17.5	62.0	0.92
chr3	161346125	161346596	CpG: 44	471	44	283	18.7	60.1	1.04
chr3	161408462	161408821	CpG: 27	359	27	212	15.0	59.1	0.86
chr3	161418312	161418610	CpG: 30	298	30	187	20.1	62.8	1.04
chr3	161505937	161506739	CpG: 98	802	98	595	24.4	74.2	0.89
chr3	161575646	161576466	CpG: 70	820	70	526	17.1	64.1	0.83
chr3	161874749	161875041	CpG: 25	292	25	178	17.1	61.0	0.92
chr3	162002301	162002588	CpG: 24	287	24	179	16.7	62.4	0.87
chr3	162537728	162539805	CpG: 189	2077	189	1439	18.2	69.3	0.76
chr3	162653104	162653378	CpG: 23	274	23	169	16.8	61.7	0.89
chr3	162763418	162763939	CpG: 52	521	52	357	20.0	68.5	0.85
chr3	162813474	162813839	CpG: 35	365	35	255	19.2	69.9	0.79
chr3	162952866	162953622	CpG: 58	756	58	538	15.3	71.2	0.61
chr3	162999726	163001241	CpG: 185	1515	185	1092	24.4	72.1	0.94
chr3	163173836	163175702	CpG: 159	1866	159	1105	17.0	59.2	0.98
chr3	163183648	163183873	CpG: 18	225	18	134	16.0	59.6	0.91
chr3	163224010	163225026	CpG: 85	1016	85	666	16.7	65.6	0.78
chr3	163260188	163260463	CpG: 20	275	20	165	14.5	60.0	0.81
chr3	163292796	163293040	CpG: 22	244	22	150	18.0	61.5	0.97
chr3	163294120	163294406	CpG: 21	286	21	176	14.7	61.5	0.80
chr3	163297088	163297363	CpG: 21	275	21	168	15.3	61.1	0.83
chr3	163339332	163340701	CpG: 161	1369	161	982	23.5	71.7	0.92
chr3	163529143	163531319	CpG: 206	2176	206	1417	18.9	65.1	0.89
chr3	163812680	163812955	CpG: 26	275	26	173	18.9	62.9	0.96
chr3	163879446	163880212	CpG: 91	766	91	555	23.8	72.5	0.91
chr3	163934329	163934570	CpG: 23	241	23	147	19.1	61.0	1.06
chr3	163936480	163936703	CpG: 19	223	19	150	17.0	67.3	0.76
chr3	163995944	163996477	CpG: 62	533	62	375	23.3	70.4	0.94
chr3	164106986	164107259	CpG: 24	273	24	168	17.6	61.5	0.94
chr3	164143213	164143487	CpG: 24	274	24	171	17.5	62.4	0.91
chr3	164146615	164147638	CpG: 77	1023	77	653	15.1	63.8	0.74
chr3	164728953	164729227	CpG: 24	274	24	171	17.5	62.4	0.91
chr3	165186329	165186568	CpG: 19	239	19	142	15.9	59.4	0.90
chr3	165342353	165342591	CpG: 18	238	18	143	15.1	60.1	0.86
chr3	165465353	165465631	CpG: 25	278	25	175	18.0	62.9	0.92
chr3	165987545	165987824	CpG: 25	279	25	173	17.9	62.0	0.94
chr3	166011740	166012114	CpG: 29	374	29	223	15.5	59.6	0.87
chr3	166086236	166086521	CpG: 23	285	23	179	16.1	62.8	0.83
chr3	166161982	166162385	CpG: 35	403	35	293	17.4	72.7	0.66
chr3	166282563	166282917	CpG: 35	354	35	263	19.8	74.3	0.72
chr3	166335842	166336237	CpG: 40	395	40	293	20.3	74.2	0.74
chr3	166428916	166429197	CpG: 23	281	23	172	16.4	61.2	0.89
chr3	166787334	166787714	CpG: 29	380	29	245	15.3	64.5	0.73
chr3	167184709	167185102	CpG: 33	393	33	284	16.8	72.3	0.65
chr3	167651881	167652117	CpG: 20	236	20	145	16.9	61.4	0.92
chr3	167676541	167676818	CpG: 23	277	23	174	16.6	62.8	0.86
chr3	167979225	167979729	CpG: 44	504	44	307	17.5	60.9	0.94
chr3	168084739	168085013	CpG: 24	274	24	171	17.5	62.4	0.91
chr3	168355502	168355729	CpG: 18	227	18	134	15.9	59.0	0.91
chr3	168432297	168432695	CpG: 33	398	33	292	16.6	73.4	0.62
chr3	168687790	168688052	CpG: 22	262	22	163	16.8	62.2	0.88
chr3	168701504	168701897	CpG: 38	393	38	287	19.3	73.0	0.73
chr3	168707543	168707757	CpG: 19	214	19	154	17.8	72.0	0.69
chr3	168763004	168763274	CpG: 23	270	23	166	17.0	61.5	0.91
chr3	169041573	169042118	CpG: 50	545	50	395	18.3	72.5	0.70
chr3	169093294	169093524	CpG: 19	230	19	137	16.5	59.6	0.95
chr3	169218206	169218442	CpG: 18	236	18	145	15.3	61.4	0.83
chr3	169242804	169243066	CpG: 26	262	26	166	19.8	63.4	1.00
chr3	169320940	169321221	CpG: 26	281	26	177	18.5	63.0	0.94
chr3	169460791	169461064	CpG: 24	273	24	168	17.6	61.5	0.94
chr3	169644564	169644796	CpG: 20	232	20	139	17.2	59.9	0.98
chr3	169715970	169716244	CpG: 23	274	23	166	16.8	60.6	0.93
chr3	169759755	169760108	CpG: 34	353	34	260	19.3	73.7	0.71
chr3	169933677	169933916	CpG: 19	239	19	147	15.9	61.5	0.86
chr3	170164017	170164288	CpG: 23	271	23	178	17.0	65.7	0.82
chr3	170242981	170243255	CpG: 23	274	23	171	16.8	62.4	0.87
chr3	170447755	170448029	CpG: 23	274	23	170	16.8	62.0	0.88
chr3	170518478	170518932	CpG: 37	454	37	287	16.3	63.2	0.83
chr3	170817214	170817452	CpG: 20	238	20	145	16.8	60.9	0.93
chr3	170859205	170859437	CpG: 18	232	18	139	15.5	59.9	0.87
chr3	170878928	170880201	CpG: 124	1273	124	875	19.5	68.7	0.83
chr3	170904062	170904301	CpG: 20	239	20	146	16.7	61.1	0.92
chr3	170977682	170977925	CpG: 20	243	20	149	16.5	61.3	0.90
chr3	171033353	171034237	CpG: 98	884	98	646	22.2	73.1	0.83
chr3	171097312	171097552	CpG: 22	240	22	148	18.3	61.7	0.99
chr3	171930199	171930618	CpG: 39	419	39	259	18.6	61.8	0.99
chr3	171933380	171933582	CpG: 24	202	24	138	23.8	68.3	1.02
chr3	172096347	172096587	CpG: 19	240	19	144	15.8	60.0	0.89
chr3	172291658	172291923	CpG: 21	265	21	165	15.8	62.3	0.83
chr3	172334811	172335041	CpG: 20	230	20	141	17.4	61.3	0.94
chr3	172445612	172447231	CpG: 145	1619	145	1122	17.9	69.3	0.77
chr3	172452431	172453350	CpG: 80	919	80	571	17.4	62.1	0.90
chr3	172463574	172463884	CpG: 28	310	28	195	18.1	62.9	0.92
chr3	172525384	172525654	CpG: 20	270	20	166	14.8	61.5	0.79
chr3	172529214	172529495	CpG: 23	281	23	172	16.4	61.2	0.88
chr3	172548502	172549216	CpG: 75	714	75	470	21.0	65.8	0.97
chr3	172552539	172552789	CpG: 22	250	22	151	17.6	60.4	0.99
chr3	172553458	172553835	CpG: 41	377	41	265	21.8	70.3	0.88
chr3	172557271	172557643	CpG: 36	372	36	259	19.4	69.6	0.80
chr3	172596313	172596873	CpG: 58	560	58	405	20.7	72.3	0.81
chr3	172611547	172611824	CpG: 21	277	21	172	15.2	62.1	0.80
chr3	172682365	172682606	CpG: 18	241	18	150	14.9	62.2	0.78
chr3	172711600	172711875	CpG: 21	275	21	170	15.3	61.8	0.81
chr3	172737324	172737596	CpG: 21	272	21	166	15.4	61.0	0.85
chr3	172750892	172751504	CpG: 58	612	58	426	19.0	69.6	0.81
chr3	172822473	172823710	CpG: 118	1237	118	842	19.1	68.1	0.82
chr3	172826029	172826248	CpG: 18	219	18	138	16.4	63.0	0.85
chr3	172962849	172963115	CpG: 27	266	27	169	20.3	63.5	1.02
chr3	172965842	172966522	CpG: 63	680	63	472	18.5	69.4	0.77
chr3	173007023	173007644	CpG: 64	621	64	456	20.6	73.4	0.81
chr3	173047541	173047806	CpG: 21	265	21	161	15.8	60.8	0.87
chr3	173141369	173142981	CpG: 214	1612	214	1254	26.6	77.8	0.89
chr3	173154594	173154835	CpG: 20	241	20	146	16.6	60.6	0.93
chr3	173172296	173172552	CpG: 21	256	21	145	16.4	56.6	1.04
chr3	173202798	173204442	CpG: 143	1644	143	1074	17.4	65.3	0.82
chr3	173361669	173361950	CpG: 23	281	23	175	16.4	62.3	0.86
chr3	173369585	173370309	CpG: 79	724	79	523	21.8	72.2	0.84
chr3	173438339	173438611	CpG: 21	272	21	164	15.4	60.3	0.85
chr3	173621286	173621563	CpG: 20	277	20	170	14.4	61.4	0.78
chr3	173654482	173654816	CpG: 37	334	37	208	22.2	62.3	1.15
chr3	173692381	173693391	CpG: 92	1010	92	691	18.2	68.4	0.80
chr3	173753857	173754128	CpG: 19	271	19	167	14.0	61.6	0.75
chr3	173812593	173812813	CpG: 20	220	20	129	18.2	58.6	1.06
chr3	173915418	173915648	CpG: 22	230	22	143	19.1	62.2	1.00
chr3	174243928	174245478	CpG: 114	1550	114	956	14.7	61.7	0.77
chr3	174254684	174254954	CpG: 21	270	21	164	15.6	60.7	0.86
chr3	174334130	174334367	CpG: 21	237	21	145	17.7	61.2	0.97
chr3	174494242	174494642	CpG: 27	400	27	230	13.5	57.5	0.82
chr3	174504465	174504727	CpG: 20	262	20	156	15.3	59.5	0.87
chr3	174530086	174530349	CpG: 25	263	25	195	19.0	74.1	0.70
chr3	174557897	174558171	CpG: 21	274	21	170	15.3	62.0	0.81
chr3	174593961	174594802	CpG: 87	841	87	606	20.7	72.1	0.80
chr3	174697325	174697583	CpG: 19	258	19	162	14.7	62.8	0.76
chr3	174730640	174730919	CpG: 24	279	24	174	17.2	62.4	0.89
chr3	174753050	174753280	CpG: 20	230	20	141	17.4	61.3	0.94
chr3	174768486	174768702	CpG: 16	216	16	124	14.8	57.4	0.92
chr3	174782917	174783303	CpG: 33	386	33	280	17.1	72.5	0.65
chr3	174823545	174824984	CpG: 161	1439	161	1049	22.4	72.9	0.85
chr3	174877427	174877638	CpG: 17	211	17	126	16.1	59.7	0.92
chr3	174984291	174984563	CpG: 23	272	23	171	16.9	62.9	0.86
chr3	175123838	175124115	CpG: 19	277	19	162	13.7	58.5	0.81
chr3	175232662	175234028	CpG: 108	1366	108	876	15.8	64.1	0.78
chr3	175234816	175235156	CpG: 26	340	26	208	15.3	61.2	0.86
chr3	175396448	175396718	CpG: 22	270	22	168	16.3	62.2	0.85
chr3	175413295	175413567	CpG: 22	272	22	166	16.2	61.0	0.88
chr3	175496377	175496911	CpG: 40	534	40	317	15.0	59.4	0.85
chr3	175521417	175521647	CpG: 21	230	21	142	18.3	61.7	0.97
chr3	175536338	175536811	CpG: 41	473	41	293	17.3	61.9	0.91
chr3	175652547	175652948	CpG: 37	401	37	297	18.5	74.1	0.67
chr3	175653482	175653704	CpG: 20	222	20	127	18.0	57.2	1.15
chr3	175764732	175764968	CpG: 18	236	18	141	15.3	59.7	0.87
chr3	175854627	175854838	CpG: 17	211	17	127	16.1	60.2	0.91
chr3	176181247	176181907	CpG: 68	660	68	450	20.6	68.2	0.90
chr3	176183381	176183752	CpG: 49	371	49	275	26.4	74.1	0.97
chr3	176230750	176231027	CpG: 26	277	26	174	18.8	62.8	0.96
chr3	176487777	176488055	CpG: 24	278	24	174	17.3	62.6	0.89
chr3	176637953	176638223	CpG: 23	270	23	167	17.0	61.9	0.90
chr3	176648134	176648364	CpG: 21	230	21	140	18.3	60.9	1.00
chr3	176903462	176903703	CpG: 18	241	18	141	14.9	58.5	0.89
chr3	176998926	176999317	CpG: 33	391	33	286	16.9	73.1	0.63
chr3	177028666	177028914	CpG: 19	248	19	153	15.3	61.7	0.83
chr3	177052306	177052540	CpG: 22	234	22	140	18.8	59.8	1.05
chr3	177087886	177088160	CpG: 23	274	23	168	16.8	61.3	0.90
chr3	177164133	177164410	CpG: 29	277	29	180	20.9	65.0	0.99
chr3	177192299	177192564	CpG: 21	265	21	166	15.8	62.6	0.82
chr3	177227744	177228497	CpG: 107	753	107	536	28.4	71.2	1.12
chr3	177288110	177288342	CpG: 19	232	19	139	16.4	59.9	0.93
chr3	177294689	177294975	CpG: 25	286	25	179	17.5	62.6	0.91
chr3	177310033	177310250	CpG: 17	217	17	131	15.7	60.4	0.87
chr3	177485868	177486104	CpG: 19	236	19	142	16.1	60.2	0.91
chr3	177492788	177493061	CpG: 22	273	22	167	16.1	61.2	0.87
chr3	177685228	177685506	CpG: 25	278	25	175	18.0	62.9	0.92
chr3	177774691	177774961	CpG: 24	270	24	169	17.8	62.6	0.92
chr3	177867509	177867745	CpG: 20	236	20	144	16.9	61.0	0.92
chr3	177978233	177978463	CpG: 17	230	17	139	14.8	60.4	0.83
chr3	178314682	178314963	CpG: 22	281	22	172	15.7	61.2	0.85
chr3	178394922	178395200	CpG: 25	278	25	174	18.0	62.6	0.93
chr3	178582350	178582701	CpG: 30	351	30	210	17.1	59.8	0.96
chr3	178671918	178672191	CpG: 19	273	19	163	13.9	59.7	0.80
chr3	178686544	178686780	CpG: 18	236	18	140	15.3	59.3	0.89
chr3	178732539	178732745	CpG: 15	206	15	143	14.6	69.4	0.63
chr3	178927892	178928169	CpG: 25	277	25	172	18.1	62.1	0.94
chr3	178981943	178982171	CpG: 20	228	20	139	17.5	61.0	0.96
chr3	179008717	179009120	CpG: 38	403	38	300	18.9	74.4	0.68
chr3	179164263	179164835	CpG: 48	572	48	414	16.8	72.4	0.64
chr3	179186764	179187000	CpG: 22	236	22	147	18.6	62.3	0.99
chr3	179221796	179222075	CpG: 25	279	25	176	17.9	63.1	0.91
chr3	179227500	179227774	CpG: 24	274	24	170	17.5	62.0	0.92
chr3	179485190	179485426	CpG: 17	236	17	142	14.4	60.2	0.82
chr3	179529494	179529769	CpG: 24	275	24	170	17.5	61.8	0.92
chr3	179626615	179626851	CpG: 21	236	21	146	17.8	61.9	0.96
chr3	179795373	179795602	CpG: 20	229	20	140	17.5	61.1	0.94
chr3	179999578	180001196	CpG: 189	1618	189	1183	23.4	73.1	0.88
chr3	180021743	180021994	CpG: 21	251	21	159	16.7	63.3	0.84
chr3	180050629	180050930	CpG: 21	301	21	159	14.0	52.8	1.00
chr3	180073904	180074125	CpG: 16	221	16	122	14.5	55.2	0.98
chr3	180074907	180075259	CpG: 33	352	33	262	18.8	74.4	0.68
chr3	180113450	180113721	CpG: 22	271	22	168	16.2	62.0	0.86
chr3	180197516	180197910	CpG: 29	394	29	237	14.7	60.2	0.82
chr3	180337634	180337865	CpG: 19	231	19	143	16.5	61.9	0.87
chr3	180364249	180364530	CpG: 23	281	23	174	16.4	61.9	0.87
chr3	180511855	180512082	CpG: 17	227	17	137	15.0	60.4	0.84
chr3	180694536	180695357	CpG: 58	821	58	558	14.1	68.0	0.61
chr3	180917855	180918095	CpG: 23	240	23	150	19.2	62.5	1.00
chr3	181182253	181182511	CpG: 21	258	21	156	16.3	60.5	0.91
chr3	181565725	181565983	CpG: 18	258	18	151	14.0	58.5	0.82
chr3	181663939	181664233	CpG: 25	294	25	182	17.0	61.9	0.89
chr3	181835927	181836838	CpG: 63	911	63	613	13.8	67.3	0.61
chr3	181875318	181875840	CpG: 70	522	70	385	26.8	73.8	0.99
chr3	181876436	181876711	CpG: 21	275	21	168	15.3	61.1	0.83
chr3	181908382	181908659	CpG: 24	277	24	173	17.3	62.5	0.90
chr3	181952108	181952948	CpG: 106	840	106	627	25.2	74.6	0.91
chr3	182064997	182065413	CpG: 62	416	62	329	29.8	79.1	0.95
chr3	182067109	182067343	CpG: 23	234	23	171	19.7	73.1	0.74
chr3	182094706	182095426	CpG: 58	720	58	496	16.1	68.9	0.68
chr3	182117117	182117392	CpG: 19	275	19	167	13.8	60.7	0.75
chr3	182126519	182127685	CpG: 137	1166	137	855	23.5	73.3	0.88
chr3	182148398	182148673	CpG: 21	275	21	163	15.3	59.3	0.89
chr3	182150669	182150941	CpG: 21	272	21	160	15.4	58.8	0.91
chr3	182151612	182152031	CpG: 48	419	48	293	22.9	69.9	0.97
chr3	182198276	182198554	CpG: 25	278	25	176	18.0	63.3	0.91
chr3	182254782	182255650	CpG: 123	868	123	638	28.3	73.5	1.05
chr3	182284747	182284987	CpG: 19	240	19	146	15.8	60.8	0.88
chr3	182356348	182356625	CpG: 21	277	21	166	15.2	59.9	0.86
chr3	182361047	182361263	CpG: 20	216	20	135	18.5	62.5	0.98
chr3	182366413	182367514	CpG: 95	1101	95	746	17.3	67.8	0.75
chr3	182408398	182408840	CpG: 34	442	34	262	15.4	59.3	0.88
chr3	182416375	182416623	CpG: 19	248	19	146	15.3	58.9	0.90
chr3	182456494	182457601	CpG: 127	1107	127	775	22.9	70.0	0.95
chr3	182457772	182458049	CpG: 22	277	22	166	15.9	59.9	0.90
chr3	182531410	182532398	CpG: 78	988	78	703	15.8	71.2	0.62
chr3	182562086	182562322	CpG: 19	236	19	143	16.1	60.6	0.91
chr3	182617216	182617497	CpG: 23	281	23	175	16.4	62.3	0.86
chr3	182789561	182789797	CpG: 21	236	21	144	17.8	61.0	0.98
chr3	182839844	182840613	CpG: 100	769	100	536	26.0	69.7	1.07
chr3	182937038	182937249	CpG: 17	211	17	127	16.1	60.2	0.91
chr3	183096610	183096883	CpG: 23	273	23	167	16.8	61.2	0.91
chr3	183224640	183224851	CpG: 18	211	18	130	17.1	61.6	0.91
chr3	183232124	183232398	CpG: 24	274	24	171	17.5	62.4	0.91
chr3	183369246	183369523	CpG: 24	277	24	171	17.3	61.7	0.91
chr3	183403897	183404467	CpG: 55	570	55	373	19.3	65.4	0.90
chr3	183481189	183481962	CpG: 54	773	54	452	14.0	58.5	0.82
chr3	183586873	183587147	CpG: 23	274	23	170	16.8	62.0	0.88
chr3	183630255	183631000	CpG: 53	745	53	501	14.2	67.2	0.63
chr3	183692016	183692281	CpG: 22	265	22	164	16.6	61.9	0.88
chr3	183714130	183714974	CpG: 64	844	64	546	15.2	64.7	0.73
chr3	183791260	183791621	CpG: 30	361	30	230	16.6	63.7	0.82
chr3	184045821	184046063	CpG: 19	242	19	143	15.7	59.1	0.93
chr3	184296386	184296671	CpG: 25	285	25	179	17.5	62.8	0.90
chr3	184350220	184350456	CpG: 18	236	18	141	15.3	59.7	0.87
chr3	184486907	184487189	CpG: 24	282	24	175	17.0	62.1	0.90
chr3	184489973	184490207	CpG: 17	234	17	139	14.5	59.4	0.84
chr3	184499789	184500797	CpG: 100	1008	100	651	19.8	64.6	0.95
chr3	184516789	184517864	CpG: 111	1075	111	735	20.7	68.4	0.89
chr3	184523944	184524238	CpG: 33	294	33	208	22.4	70.7	0.90
chr3	184531178	184531768	CpG: 47	590	47	332	15.9	56.3	1.01
chr3	184577284	184577558	CpG: 24	274	24	171	17.5	62.4	0.91
chr3	184594854	184595058	CpG: 15	204	15	124	14.7	60.8	0.81
chr3	184615766	184616005	CpG: 17	239	17	144	14.2	60.3	0.80
chr3	184671213	184671449	CpG: 19	236	19	143	16.1	60.6	0.90
chr3	184672517	184672760	CpG: 19	243	19	148	15.6	60.9	0.86
chr3	184701935	184702169	CpG: 18	234	18	142	15.4	60.7	0.86
chr3	184730402	184731072	CpG: 54	670	54	462	16.1	69.0	0.68
chr3	184802453	184802726	CpG: 23	273	23	167	16.8	61.2	0.91
chr3	184826098	184826356	CpG: 18	258	18	159	14.0	61.6	0.75
chr3	185183303	185183567	CpG: 22	264	22	163	16.7	61.7	0.88
chr3	185286185	185286466	CpG: 21	281	21	173	14.9	61.6	0.81
chr3	185471291	185471530	CpG: 19	239	19	148	15.9	61.9	0.85
chr3	185487170	185487932	CpG: 70	762	70	492	18.4	64.6	0.88
chr3	185525446	185525679	CpG: 19	233	19	139	16.3	59.7	0.93
chr3	185567438	185567715	CpG: 21	277	21	167	15.2	60.3	0.85
chr3	185597386	185597637	CpG: 19	251	19	150	15.1	59.8	0.86
chr3	185598179	185599600	CpG: 159	1421	159	989	22.4	69.6	0.93
chr3	185624239	185624473	CpG: 19	234	19	139	16.2	59.4	0.93
chr3	185688772	185689046	CpG: 23	274	23	170	16.8	62.0	0.88
chr3	185785053	185786035	CpG: 127	982	127	772	25.9	78.6	0.84
chr3	185870584	185871002	CpG: 42	418	42	300	20.1	71.8	0.78
chr3	185905142	185905860	CpG: 62	718	62	469	17.3	65.3	0.82
chr3	185907282	185907488	CpG: 21	206	21	149	20.4	72.3	0.81
chr3	185909922	185910310	CpG: 43	388	43	295	22.2	76.0	0.77
chr3	185968686	185970042	CpG: 111	1356	111	856	16.4	63.1	0.83
chr3	185985090	185985375	CpG: 21	285	21	175	14.7	61.4	0.79
chr3	185985699	185986496	CpG: 76	797	76	545	19.1	68.4	0.82
chr3	186060025	186061738	CpG: 191	1713	191	1199	22.3	70.0	0.91
chr3	186235055	186236418	CpG: 126	1363	126	924	18.5	67.8	0.81
chr3	186254867	186255296	CpG: 40	429	40	274	18.6	63.9	0.94
chr3	186290218	186290452	CpG: 16	234	16	139	13.7	59.4	0.81
chr3	186300037	186300313	CpG: 28	276	28	186	20.3	67.4	0.89
chr3	186379614	186379889	CpG: 20	275	20	166	14.5	60.4	0.81
chr3	186444921	186446503	CpG: 157	1582	157	1085	19.8	68.6	0.85
chr3	186507145	186507761	CpG: 87	616	87	484	28.2	78.6	0.92
chr3	186525500	186525736	CpG: 19	236	19	140	16.1	59.3	0.94
chr3	186579618	186579836	CpG: 16	218	16	126	14.7	57.8	0.90
chr3	186634201	186635509	CpG: 157	1308	157	959	24.0	73.3	0.89
chr3	186694369	186694915	CpG: 50	546	50	364	18.3	66.7	0.84
chr3	186826702	186827815	CpG: 98	1113	98	741	17.6	66.6	0.80
chr3	186828256	186828500	CpG: 22	244	22	148	18.0	60.7	1.01
chr3	186850672	186850896	CpG: 16	224	16	134	14.3	59.8	0.81
chr3	186944539	186945147	CpG: 55	608	55	388	18.1	63.8	0.89
chr3	186964140	186964401	CpG: 22	261	22	153	16.9	58.6	1.01
chr3	186964662	186965449	CpG: 108	787	108	582	27.4	74.0	1.01
chr3	186978969	186979632	CpG: 57	663	57	477	17.2	71.9	0.67
chr3	186983603	186984332	CpG: 71	729	71	501	19.5	68.7	0.83
chr3	186994536	186995646	CpG: 93	1110	93	720	16.8	64.9	0.80
chr3	187038206	187039967	CpG: 206	1761	206	1321	23.4	75.0	0.83
chr3	187050557	187051243	CpG: 55	686	55	489	16.0	71.3	0.63
chr3	187057190	187057435	CpG: 19	245	19	145	15.5	59.2	0.91
chr3	187058072	187059301	CpG: 89	1229	89	742	14.5	60.4	0.80
chr3	187069062	187072149	CpG: 302	3087	302	2152	19.6	69.7	0.81
chr3	187085200	187085838	CpG: 63	638	63	480	19.7	75.2	0.72
chr3	187108070	187108909	CpG: 93	839	93	577	22.2	68.8	0.94
chr3	187123654	187124730	CpG: 125	1076	125	813	23.2	75.6	0.81
chr3	187136488	187136708	CpG: 21	220	21	147	19.1	66.8	0.91
chr3	187145037	187145735	CpG: 74	698	74	517	21.2	74.1	0.78
chr3	187147891	187148143	CpG: 34	252	34	187	27.0	74.2	1.00
chr3	187170695	187172766	CpG: 174	2071	174	1446	16.8	69.8	0.70
chr3	187174957	187175239	CpG: 24	282	24	175	17.0	62.1	0.89
chr3	187188983	187191049	CpG: 207	2066	207	1508	20.0	73.0	0.75
chr3	187195776	187195987	CpG: 22	211	22	159	20.9	75.4	0.73
chr3	187278932	187279139	CpG: 16	207	16	122	15.5	58.9	0.91
chr3	187305430	187305679	CpG: 23	249	23	178	18.5	71.5	0.72
chr3	187306963	187307217	CpG: 20	254	20	151	15.7	59.4	0.91
chr3	187328327	187328950	CpG: 56	623	56	422	18.0	67.7	0.78
chr3	187335393	187335674	CpG: 20	281	20	169	14.2	60.1	0.80
chr3	187340116	187340937	CpG: 69	821	69	570	16.8	69.4	0.71
chr3	187376893	187378420	CpG: 162	1527	162	1112	21.2	72.8	0.80
chr3	187384215	187384509	CpG: 22	294	22	190	15.0	64.6	0.80
chr3	187384638	187385032	CpG: 47	394	47	300	23.9	76.1	0.84
chr3	187388296	187388586	CpG: 21	290	21	184	14.5	63.4	0.73
chr3	187398820	187399837	CpG: 100	1017	100	730	19.7	71.8	0.77
chr3	187417079	187417921	CpG: 71	842	71	588	16.9	69.8	0.69
chr3	187419486	187420103	CpG: 61	617	61	456	19.8	73.9	0.73
chr3	187526768	187527309	CpG: 59	541	59	394	21.8	72.8	0.82
chr3	187627826	187628269	CpG: 48	443	48	300	21.7	67.7	1.01
chr3	187819672	187820462	CpG: 61	790	61	544	15.4	68.9	0.65
chr3	187968405	187969745	CpG: 169	1340	169	980	25.2	73.1	0.96
chr3	188033811	188034091	CpG: 24	280	24	172	17.1	61.4	0.92
chr3	188069385	188069746	CpG: 43	361	43	250	23.8	69.3	1.00
chr3	188098302	188098641	CpG: 33	339	33	217	19.5	64.0	1.02
chr3	188115111	188115392	CpG: 24	281	24	176	17.1	62.6	0.89
chr3	188210937	188211211	CpG: 25	274	25	172	18.2	62.8	0.94
chr3	188314284	188315105	CpG: 82	821	82	559	20.0	68.1	0.88
chr3	188342673	188342939	CpG: 20	266	20	161	15.0	60.5	0.84
chr3	188369411	188369676	CpG: 21	265	21	165	15.8	62.3	0.82
chr3	188370439	188370719	CpG: 26	280	26	178	18.6	63.6	0.94
chr3	188401838	188402513	CpG: 62	675	62	438	18.4	64.9	0.89
chr3	188403834	188404296	CpG: 36	462	36	267	15.6	57.8	0.95
chr3	188505598	188505876	CpG: 23	278	23	173	16.5	62.2	0.86
chr3	188638973	188642071	CpG: 351	3098	351	2255	22.7	72.8	0.87
chr3	188649900	188650130	CpG: 18	230	18	138	15.7	60.0	0.88
chr3	188652658	188652890	CpG: 18	232	18	139	15.5	59.9	0.88
chr3	188711017	188711257	CpG: 19	240	19	149	15.8	62.1	0.85
chr3	188724303	188724582	CpG: 22	279	22	170	15.8	60.9	0.86
chr3	188753057	188754030	CpG: 93	973	93	621	19.1	63.8	0.98
chr3	188754280	188754521	CpG: 18	241	18	142	14.9	58.9	0.88
chr3	188779322	188779554	CpG: 18	232	18	134	15.5	57.8	0.96
chr3	188843382	188843596	CpG: 16	214	16	129	15.0	60.3	0.85
chr3	188923452	188924993	CpG: 140	1541	140	1025	18.2	66.5	0.86
chr3	189009168	189010052	CpG: 75	884	75	578	17.0	65.4	0.79
chr3	189049105	189049372	CpG: 20	267	20	151	15.0	56.6	0.94
chr3	189127457	189127738	CpG: 24	281	24	175	17.1	62.3	0.90
chr3	189176657	189178208	CpG: 113	1551	113	986	14.6	63.6	0.72
chr3	189251052	189251826	CpG: 58	774	58	518	15.0	66.9	0.67
chr3	189301231	189301461	CpG: 21	230	21	142	18.3	61.7	0.97
chr3	189382742	189383262	CpG: 65	520	65	366	25.0	70.4	1.02
chr3	189386181	189386571	CpG: 40	390	40	259	20.5	66.4	0.93
chr3	189470078	189470504	CpG: 32	426	32	255	15.0	59.9	0.84
chr3	189594467	189595054	CpG: 43	587	43	368	14.7	62.7	0.78
chr3	189604979	189606289	CpG: 116	1310	116	772	17.7	58.9	1.02
chr3	189628341	189628940	CpG: 60	599	60	381	20.0	63.6	0.99
chr3	189649159	189649714	CpG: 69	555	69	413	24.9	74.4	0.90
chr3	189691192	189692100	CpG: 67	908	67	633	14.8	69.7	0.61
chr3	189702632	189703206	CpG: 44	574	44	393	15.3	68.5	0.66
chr3	189730812	189731093	CpG: 25	281	25	175	17.8	62.3	0.92
chr3	189747931	189749141	CpG: 107	1210	107	807	17.7	66.7	0.80
chr3	189956256	189957303	CpG: 88	1047	88	655	16.8	62.6	0.86
chr3	190001722	190001933	CpG: 16	211	16	129	15.2	61.1	0.82
chr3	190017045	190017390	CpG: 35	345	35	238	20.3	69.0	0.85
chr3	190041790	190042064	CpG: 23	274	23	170	16.8	62.0	0.88
chr3	190229696	190230006	CpG: 25	310	25	190	16.1	61.3	0.86
chr3	190487577	190487839	CpG: 25	262	25	175	19.1	66.8	0.86
chr3	190516166	190516381	CpG: 23	215	23	147	21.4	68.4	0.92
chr3	190555047	190555560	CpG: 41	513	41	301	16.0	58.7	0.94
chr3	190555967	190556297	CpG: 27	330	27	203	16.4	61.5	0.87
chr3	190557448	190557665	CpG: 32	217	32	150	29.5	69.1	1.24
chr3	190561189	190562446	CpG: 83	1257	83	727	13.2	57.8	0.81
chr3	190583531	190583812	CpG: 24	281	24	174	17.1	61.9	0.91
chr3	190680122	190680365	CpG: 23	243	23	150	18.9	61.7	0.99
chr3	190707745	190708035	CpG: 24	290	24	175	16.6	60.3	0.92
chr3	190971213	190972089	CpG: 89	876	89	631	20.3	72.0	0.78
chr3	191136320	191136594	CpG: 26	274	26	171	19.0	62.4	0.98
chr3	191303056	191303330	CpG: 24	274	24	170	17.5	62.0	0.92
chr3	191453423	191453640	CpG: 19	217	19	129	17.5	59.4	0.99
chr3	191660086	191660318	CpG: 19	232	19	147	16.4	63.4	0.84
chr3	191764095	191764372	CpG: 25	277	25	167	18.1	60.3	0.99
chr3	191839428	191839866	CpG: 33	438	33	265	15.1	60.5	0.83
chr3	191890898	191891133	CpG: 18	235	18	136	15.3	57.9	0.92
chr3	192181478	192181764	CpG: 25	286	25	178	17.5	62.2	0.92
chr3	192412860	192413245	CpG: 32	385	32	279	16.6	72.5	0.63
chr3	192674773	192675046	CpG: 23	273	23	173	16.8	63.4	0.85
chr3	192820765	192821050	CpG: 25	285	25	180	17.5	63.2	0.89
chr3	192912024	192912262	CpG: 17	238	17	142	14.3	59.7	0.82
chr3	192930163	192930402	CpG: 22	239	22	148	18.4	61.9	0.99
chr3	192930571	192930804	CpG: 18	233	18	141	15.5	60.5	0.86
chr3	192936657	192937456	CpG: 105	799	105	595	26.3	74.5	0.95
chr3	192993343	192993729	CpG: 32	386	32	283	16.6	73.3	0.62
chr3	193011730	193011934	CpG: 15	204	15	119	14.7	58.3	0.88
chr3	193017863	193018131	CpG: 22	268	22	164	16.4	61.2	0.90
chr3	193053949	193054223	CpG: 24	274	24	172	17.5	62.8	0.90
chr3	193138316	193138964	CpG: 64	648	64	446	19.8	68.8	0.84
chr3	193216642	193216912	CpG: 19	270	19	157	14.1	58.1	0.84
chr3	193255223	193255488	CpG: 27	265	27	172	20.4	64.9	0.99
chr3	193257105	193257342	CpG: 19	237	19	142	16.0	59.9	0.92
chr3	193329855	193330969	CpG: 96	1114	96	707	17.2	63.5	0.86
chr3	193370090	193370365	CpG: 25	275	25	173	18.2	62.9	0.93
chr3	193389216	193389446	CpG: 21	230	21	141	18.3	61.3	0.98
chr3	193393167	193393429	CpG: 26	262	26	169	19.8	64.5	0.97
chr3	193451076	193451354	CpG: 20	278	20	169	14.4	60.8	0.78
chr3	193569705	193569941	CpG: 18	236	18	146	15.3	61.9	0.81
chr3	193679042	193679437	CpG: 51	395	51	296	25.8	74.9	0.92
chr3	193781007	193781464	CpG: 34	457	34	275	14.9	60.2	0.82
chr3	193794628	193794853	CpG: 20	225	20	140	17.8	62.2	0.93
chr3	193940634	193941327	CpG: 53	693	53	466	15.3	67.2	0.68
chr3	193952482	193952996	CpG: 35	514	35	288	13.6	56.0	0.87
chr3	193987524	193987808	CpG: 23	284	23	178	16.2	62.7	0.84
chr3	194056943	194057181	CpG: 20	238	20	136	16.8	57.1	1.04
chr3	194097419	194097692	CpG: 23	273	23	170	16.8	62.3	0.88
chr3	194117585	194117816	CpG: 17	231	17	139	14.7	60.2	0.83
chr3	194132999	194133239	CpG: 20	240	20	174	16.7	72.5	0.64
chr3	194145210	194145972	CpG: 81	762	81	540	21.3	70.9	0.85
chr3	194312937	194313223	CpG: 24	286	24	174	16.8	60.8	0.92
chr3	194315054	194315331	CpG: 21	277	21	169	15.2	61.0	0.82
chr3	194483869	194484141	CpG: 22	272	22	166	16.2	61.0	0.88
chr3	194833264	194833542	CpG: 21	278	21	170	15.1	61.2	0.83
chr3	194850759	194851069	CpG: 26	310	26	195	16.8	62.9	0.85
chr3	194886388	194886654	CpG: 22	266	22	166	16.5	62.4	0.86
chr3	195041287	195041561	CpG: 25	274	25	173	18.2	63.1	0.93
chr3	195103907	195106080	CpG: 195	2173	195	1452	17.9	66.8	0.81
chr3	195210168	195211233	CpG: 98	1065	98	712	18.4	66.9	0.83
chr3	195410479	195410753	CpG: 26	274	26	169	19.0	61.7	1.01
chr3	195440727	195441130	CpG: 31	403	31	246	15.4	61.0	0.83
chr3	195484827	195485370	CpG: 55	543	55	406	20.3	74.8	0.73
chr3	195524602	195524833	CpG: 16	231	16	135	13.9	58.4	0.83
chr3	195568229	195568465	CpG: 21	236	21	143	17.8	60.6	1.00
chr3	195612485	195614143	CpG: 126	1658	126	1035	15.2	62.4	0.78
chr3	195718780	195719054	CpG: 23	274	23	170	16.8	62.0	0.88
chr3	195836454	195836729	CpG: 23	275	23	174	16.7	63.3	0.84
chr3	195933161	195933431	CpG: 22	270	22	165	16.3	61.1	0.88
chr3	195936305	195936969	CpG: 91	664	91	488	27.4	73.5	1.03
chr3	196113210	196113488	CpG: 23	278	23	173	16.5	62.2	0.86
chr3	196132169	196132449	CpG: 26	280	26	180	18.6	64.3	0.91
chr3	196178874	196179110	CpG: 18	236	18	141	15.3	59.7	0.88
chr3	196236317	196236583	CpG: 22	266	22	165	16.5	62.0	0.87
chr3	196288634	196288998	CpG: 39	364	39	248	21.4	68.1	0.93
chr3	196457768	196458051	CpG: 21	283	21	175	14.8	61.8	0.78
chr3	196566194	196566731	CpG: 50	537	50	372	18.6	69.3	0.78
chr3	196617085	196617347	CpG: 26	262	26	166	19.8	63.4	1.01
chr3	196699818	196700156	CpG: 36	338	36	231	21.3	68.3	0.91
chr3	196754881	196755220	CpG: 31	339	31	225	18.3	66.4	0.84
chr3	196767359	196768144	CpG: 93	785	93	592	23.7	75.4	0.84
chr3	196830581	196832000	CpG: 169	1419	169	1060	23.8	74.7	0.85
chr3	196833457	196834897	CpG: 115	1440	115	936	16.0	65.0	0.76
chr3	196837472	196838599	CpG: 127	1127	127	838	22.5	74.4	0.81
chr3	196872537	196872849	CpG: 26	312	26	190	16.7	60.9	0.91
chr3	196900818	196901344	CpG: 64	526	64	373	24.3	70.9	0.97
chr3	196966380	196966713	CpG: 25	333	25	229	15.0	68.8	0.64
chr3	196994525	196995233	CpG: 62	708	62	477	17.5	67.4	0.79
chr3	197013442	197013747	CpG: 38	305	38	223	24.9	73.1	0.93
chr3	197031979	197032645	CpG: 75	666	75	448	22.5	67.3	1.00
chr3	197095237	197096678	CpG: 116	1441	116	941	16.1	65.3	0.76
chr3	197131771	197132056	CpG: 22	285	22	176	15.4	61.8	0.83
chr3	197184841	197186569	CpG: 185	1728	185	1203	21.4	69.6	0.89
chr3	197282176	197282923	CpG: 73	747	73	474	19.5	63.5	0.97
chr3	197328227	197329870	CpG: 105	1643	105	953	12.8	58.0	0.76
chr3	197331652	197332392	CpG: 106	740	106	559	28.6	75.5	1.00
chr3	197342708	197342993	CpG: 22	285	22	177	15.4	62.1	0.82
chr3	197370289	197370859	CpG: 50	570	50	314	17.5	55.1	1.16
chr3	197382279	197384894	CpG: 255	2615	255	1760	19.5	67.3	0.86
chr3	197487721	197487997	CpG: 23	276	23	173	16.7	62.7	0.86
chr3	197526292	197526592	CpG: 23	300	23	183	15.3	61.0	0.83
chr3	197625541	197625833	CpG: 26	292	26	164	17.8	56.2	1.20
chr3	197682335	197682682	CpG: 25	347	25	233	14.4	67.1	0.64
chr3	197762899	197763471	CpG: 39	572	39	388	13.6	67.8	0.70
chr3	197785374	197785770	CpG: 30	396	30	240	15.2	60.6	0.83
chr3	197957484	197958427	CpG: 106	943	106	693	22.5	73.5	0.84
chr3	197968139	197969630	CpG: 151	1491	151	1033	20.3	69.3	0.84
chr3	198026678	198026894	CpG: 17	216	17	130	15.7	60.2	0.89
chr3	198118295	198118526	CpG: 16	231	16	134	13.9	58.0	0.85
chr3	198140049	198141277	CpG: 143	1228	143	879	23.3	71.6	0.91
chr3	198171346	198171582	CpG: 18	236	18	139	15.3	58.9	0.90
chr3	198249734	198250930	CpG: 125	1196	125	786	20.9	65.7	0.97
chr3	198306810	198307453	CpG: 52	643	52	435	16.2	67.7	0.71
chr3	198331568	198332051	CpG: 46	483	46	348	19.0	72.0	0.73
chr3	198338399	198338645	CpG: 19	246	19	167	15.4	67.9	0.70
chr3	198340902	198342537	CpG: 149	1635	149	1097	18.2	67.1	0.83
chr3	198367184	198368421	CpG: 144	1237	144	907	23.3	73.3	0.87
chr3	198402468	198404104	CpG: 152	1636	152	1103	18.6	67.4	0.84
chr3	198431071	198431345	CpG: 24	274	24	171	17.5	62.4	0.91
chr3	198448004	198449553	CpG: 183	1549	183	1216	23.6	78.5	0.82
chr3	198461878	198462724	CpG: 90	846	90	637	21.3	75.3	0.79
chr3	198463287	198463565	CpG: 22	278	22	177	15.8	63.7	0.83
chr3	198470005	198470304	CpG: 35	299	35	184	23.4	61.5	1.41
chr3	198470946	198471324	CpG: 26	378	26	248	13.8	65.6	0.64
chr3	198481990	198484010	CpG: 151	2020	151	1376	15.0	68.1	0.65
chr3	198484856	198485224	CpG: 31	368	31	253	16.8	68.8	0.72
chr3	198488307	198488558	CpG: 19	251	19	174	15.1	69.3	0.66
chr3	198488786	198489444	CpG: 55	658	55	481	16.7	73.1	0.64
chr3	198506481	198506767	CpG: 23	286	23	151	16.1	52.8	1.16
chr3	198507887	198508145	CpG: 32	258	32	192	24.8	74.4	0.91
chr3	198519730	198519938	CpG: 21	208	21	134	20.2	64.4	1.01
chr3	198525606	198525991	CpG: 31	385	31	221	16.1	57.4	0.99
chr3	198531495	198532026	CpG: 41	531	41	327	15.4	61.6	0.82
chr3	198545445	198545675	CpG: 19	230	19	154	16.5	67.0	0.74
chr3	198594268	198594692	CpG: 38	424	38	276	17.9	65.1	0.90
chr3	198602882	198604488	CpG: 167	1606	167	1190	20.8	74.1	0.76
chr3	198615757	198615999	CpG: 21	242	21	151	17.4	62.4	0.89
chr3	198618726	198618943	CpG: 25	217	25	172	23.0	79.3	0.75
chr3	198708747	198709977	CpG: 142	1230	142	900	23.1	73.2	0.87
chr3	198764916	198765507	CpG: 47	591	47	366	15.9	61.9	0.83
chr3	198801757	198802698	CpG: 108	941	108	675	23.0	71.7	0.89
chr3	198830824	198831060	CpG: 20	236	20	144	16.9	61.0	0.94
chr3	198874813	198875049	CpG: 18	236	18	143	15.3	60.6	0.85
chr3	198896608	198896818	CpG: 17	210	17	127	16.2	60.5	0.90
chr3	198911257	198911531	CpG: 25	274	25	176	18.2	64.2	0.89
chr3	198926905	198927867	CpG: 91	962	91	678	18.9	70.5	0.82
chr3	198963153	198964011	CpG: 70	858	70	589	16.3	68.6	0.69
chr3	199006865	199007721	CpG: 77	856	77	560	18.0	65.4	0.86
chr3	199008045	199008307	CpG: 20	262	20	159	15.3	60.7	0.83
chr3	199037104	199038064	CpG: 108	960	108	680	22.5	70.8	0.90
chr3	199062028	199062300	CpG: 23	272	23	170	16.9	62.5	0.88
chr3	199063514	199063851	CpG: 23	337	23	188	13.6	55.8	0.89
chr3	199136378	199136611	CpG: 21	233	21	144	18.0	61.8	0.97
chr3	199151070	199152070	CpG: 93	1000	93	678	18.6	67.8	0.81
chr3	199158074	199158338	CpG: 22	264	22	163	16.7	61.7	0.88
chr3	199219912	199220192	CpG: 25	280	25	177	17.9	63.2	0.90
chr3	199222118	199223091	CpG: 94	973	94	596	19.3	61.3	1.03
chr3	199247891	199248409	CpG: 52	518	52	358	20.1	69.1	0.84
chr3	199262413	199262855	CpG: 40	442	40	320	18.1	72.4	0.69
chr3	199287754	199288703	CpG: 120	949	120	700	25.3	73.8	0.93
chr3	199318295	199318683	CpG: 37	388	37	287	19.1	74.0	0.70
chr3	199322511	199322743	CpG: 19	232	19	141	16.4	60.8	0.90
chr3	199351626	199352104	CpG: 43	478	43	326	18.0	68.2	0.79
chr3	199358870	199359395	CpG: 58	525	58	366	22.1	69.7	0.91
chr3	199368831	199369104	CpG: 21	273	21	168	15.4	61.5	0.82
chr3	199379261	199379971	CpG: 57	710	57	455	16.1	64.1	0.79
chr3	199394574	199395291	CpG: 54	717	54	416	15.1	58.0	0.89
chr3	199431395	199432255	CpG: 113	860	113	652	26.3	75.8	0.92
chr3	199459091	199459859	CpG: 87	768	87	570	22.7	74.2	0.84
chr3	199462011	199462294	CpG: 24	283	24	174	17.0	61.5	0.90
chr3	199481129	199482018	CpG: 69	889	69	620	15.5	69.7	0.64
chr3	199559670	199559947	CpG: 26	277	26	178	18.8	64.3	0.92
chr3	199593407	199594317	CpG: 112	910	112	663	24.6	72.9	0.93
chr3	199599947	199600222	CpG: 23	275	23	170	16.7	61.8	0.88
chr3	199667874	199669234	CpG: 128	1360	128	894	18.8	65.7	0.87
chr3	199693107	199693542	CpG: 32	435	32	288	14.7	66.2	0.71
chr3	199694661	199696407	CpG: 250	1746	250	1365	28.6	78.2	0.94
chr3	199699415	199700107	CpG: 59	692	59	478	17.1	69.1	0.72
chr3	199721155	199721399	CpG: 23	244	23	142	18.9	58.2	1.36
chr3	199728270	199730196	CpG: 214	1926	214	1439	22.2	74.7	0.80
chr3	199753944	199754149	CpG: 20	205	20	150	19.5	73.2	0.73
chr3	199754995	199756802	CpG: 161	1807	161	1303	17.8	72.1	0.69
chr3	199766300	199766515	CpG: 16	215	16	126	14.9	58.6	0.88
chr3	199784926	199785143	CpG: 16	217	16	132	14.7	60.8	0.80
chr3	199857574	199857848	CpG: 23	274	23	170	16.8	62.0	0.88
chr3	199916604	199916874	CpG: 24	270	24	174	17.8	64.4	0.87
chr3	200018821	200019900	CpG: 121	1079	121	786	22.4	72.8	0.85
chr3	200020246	200020499	CpG: 25	253	25	162	19.8	64.0	0.98
chr3	200029482	200029720	CpG: 17	238	17	142	14.3	59.7	0.83
chr3	200183342	200183662	CpG: 33	320	33	222	20.6	69.4	0.87
chr3	200192009	200192236	CpG: 15	227	15	141	13.2	62.1	1.54
chr3	200231401	200231920	CpG: 58	519	58	376	22.4	72.4	0.86
chr3	200287378	200288901	CpG: 152	1523	152	1074	20.0	70.5	0.80
chr3	200334887	200335652	CpG: 64	765	64	527	16.7	68.9	0.71
chr3	200359798	200361028	CpG: 138	1230	138	892	22.4	72.5	0.86
chr3	200386375	200388015	CpG: 148	1640	148	1099	18.0	67.0	0.83
chr3	200390272	200390518	CpG: 19	246	19	167	15.4	67.9	0.70
chr3	200397254	200397997	CpG: 61	743	61	516	16.4	69.4	0.68
chr3	200468838	200469647	CpG: 95	809	95	579	23.5	71.6	0.95
chr3	200481767	200483061	CpG: 160	1294	160	906	24.7	70.0	1.03
chr3	200503887	200504124	CpG: 20	237	20	145	16.9	61.2	0.93
chr3	200523494	200524293	CpG: 87	799	87	566	21.8	70.8	0.88
chr3	200611827	200612072	CpG: 22	245	22	154	18.0	62.9	0.94
chr3	200612427	200612701	CpG: 25	274	25	173	18.2	63.1	0.93
chr3	200678610	200678884	CpG: 20	274	20	170	14.6	62.0	0.77
chr3	200692503	200692918	CpG: 51	415	51	291	24.6	70.1	1.00
chr3	200789139	200789418	CpG: 26	279	26	178	18.6	63.8	0.93
chr3	200812542	200814246	CpG: 160	1704	160	1242	18.8	72.9	0.71
chr3	200830278	200830507	CpG: 20	229	20	144	17.5	62.9	0.90
chr3	200831246	200831600	CpG: 24	354	24	197	13.6	55.6	1.06
chr3	200843246	200843568	CpG: 48	322	48	240	29.8	74.5	1.07
chr3	200886781	200887244	CpG: 45	463	45	289	19.4	62.4	1.00
chr3	201057858	201058131	CpG: 31	273	31	190	22.7	69.6	0.95
chr3	201080008	201081010	CpG: 111	1002	111	732	22.2	73.1	0.85
chr3	201100428	201101329	CpG: 148	901	148	691	32.9	76.7	1.13
chr4	3368	4852	CpG: 267	1484	267	1141	36.0	76.9	1.24
chr4	52736	53521	CpG: 66	785	66	505	16.8	64.3	0.81
chr4	106686	107439	CpG: 98	753	98	585	26.0	77.7	0.86
chr4	123890	124426	CpG: 39	536	39	347	14.6	64.7	0.70
chr4	205928	206443	CpG: 49	515	49	349	19.0	67.8	0.83
chr4	263533	263764	CpG: 21	231	21	143	18.2	61.9	0.96
chr4	298298	298868	CpG: 52	570	52	379	18.2	66.5	0.83
chr4	329763	331996	CpG: 191	2233	191	1485	17.1	66.5	0.77
chr4	379503	380318	CpG: 56	815	56	518	13.7	63.6	0.68
chr4	400653	400939	CpG: 23	286	23	177	16.1	61.9	0.85
chr4	467065	467433	CpG: 33	368	33	247	17.9	67.1	0.80
chr4	490117	490385	CpG: 21	268	21	163	15.7	60.8	0.85
chr4	491134	491370	CpG: 21	236	21	150	17.8	63.6	0.90
chr4	492165	492971	CpG: 87	806	87	517	21.6	64.1	1.06
chr4	528759	529149	CpG: 31	390	31	264	15.9	67.7	0.70
chr4	529441	529642	CpG: 16	201	16	130	15.9	64.7	0.76
chr4	529890	530193	CpG: 25	303	25	188	16.5	62.0	0.86
chr4	543752	544705	CpG: 68	953	68	640	14.3	67.2	0.63
chr4	554178	554416	CpG: 17	238	17	143	14.3	60.1	0.81
chr4	554722	554951	CpG: 21	229	21	142	18.3	62.0	0.97
chr4	574069	577323	CpG: 368	3254	368	2405	22.6	73.9	0.83
chr4	587728	588192	CpG: 35	464	35	275	15.1	59.3	0.87
chr4	604399	604791	CpG: 26	392	26	234	13.3	59.7	0.75
chr4	623572	623835	CpG: 19	263	19	170	14.4	64.6	0.71
chr4	625005	625404	CpG: 36	399	36	270	18.0	67.7	0.79
chr4	634043	634886	CpG: 63	843	63	564	14.9	66.9	0.70
chr4	644598	644872	CpG: 24	274	24	171	17.5	62.4	0.91
chr4	645857	646114	CpG: 28	257	28	164	21.8	63.8	1.16
chr4	650295	650591	CpG: 23	296	23	209	15.5	70.6	0.69
chr4	650727	651070	CpG: 25	343	25	227	14.6	66.2	0.69
chr4	652713	652969	CpG: 21	256	21	163	16.4	63.7	0.81
chr4	658185	658428	CpG: 18	243	18	151	14.8	62.1	0.77
chr4	662802	663971	CpG: 95	1169	95	812	16.3	69.5	0.68
chr4	673158	674611	CpG: 147	1453	147	1020	20.2	70.2	0.82
chr4	680728	681936	CpG: 120	1208	120	896	19.9	74.2	0.73
chr4	685892	686211	CpG: 24	319	24	225	15.0	70.5	0.61
chr4	687158	687359	CpG: 15	201	15	136	14.9	67.7	0.66
chr4	688569	688924	CpG: 47	355	47	276	26.5	77.7	0.88
chr4	704139	704529	CpG: 38	390	38	279	19.5	71.5	0.82
chr4	705036	705788	CpG: 88	752	88	567	23.4	75.4	0.86
chr4	711098	711383	CpG: 24	285	24	178	16.8	62.5	0.88
chr4	720066	720276	CpG: 18	210	18	147	17.1	70.0	0.73
chr4	720479	720719	CpG: 36	240	36	174	30.0	72.5	1.24
chr4	722420	723116	CpG: 110	696	110	490	31.6	70.4	1.40
chr4	730474	732210	CpG: 129	1736	129	1213	14.9	69.9	0.62
chr4	736422	737094	CpG: 59	672	59	475	17.6	70.7	0.74
chr4	744513	745160	CpG: 70	647	70	475	21.6	73.4	0.90
chr4	755662	757848	CpG: 234	2186	234	1480	21.4	67.7	1.10
chr4	779066	779958	CpG: 78	892	78	636	17.5	71.3	0.70
chr4	782654	784561	CpG: 175	1907	175	1287	18.4	67.5	0.82
chr4	790086	790309	CpG: 26	223	26	168	23.3	75.3	0.86
chr4	792793	793705	CpG: 82	912	82	646	18.0	70.8	0.72
chr4	795409	795642	CpG: 17	233	17	140	14.6	60.1	0.82
chr4	800987	801431	CpG: 35	444	35	252	15.8	56.8	0.98
chr4	802500	802946	CpG: 48	446	48	311	21.5	69.7	0.90
chr4	816348	816608	CpG: 23	260	23	166	17.7	63.8	0.87
chr4	822563	825041	CpG: 281	2478	281	1906	22.7	76.9	0.79
chr4	832106	832318	CpG: 17	212	17	148	16.0	69.8	0.66
chr4	833661	834291	CpG: 47	630	47	390	14.9	61.9	0.78
chr4	844759	845125	CpG: 30	366	30	224	16.4	61.2	0.88
chr4	845615	845835	CpG: 25	220	25	151	22.7	68.6	1.00
chr4	847282	847900	CpG: 50	618	50	429	16.2	69.4	0.68
chr4	870180	870426	CpG: 22	246	22	171	17.9	69.5	0.75
chr4	874779	875053	CpG: 20	274	20	185	14.6	67.5	0.64
chr4	875360	875606	CpG: 18	246	18	159	14.6	64.6	0.70
chr4	879580	879980	CpG: 34	400	34	277	17.0	69.2	0.71
chr4	880539	880824	CpG: 21	285	21	197	14.7	69.1	0.62
chr4	882798	883057	CpG: 22	259	22	133	17.0	51.4	1.29
chr4	884985	885602	CpG: 55	617	55	367	17.8	59.5	1.09
chr4	891311	892283	CpG: 63	972	63	639	13.0	65.7	0.62
chr4	898027	898302	CpG: 24	275	24	186	17.5	67.6	0.76
chr4	901002	901216	CpG: 16	214	16	147	15.0	68.7	0.63
chr4	902156	902568	CpG: 31	412	31	271	15.0	65.8	0.70
chr4	903244	903491	CpG: 30	247	30	176	24.3	71.3	1.08
chr4	903810	904021	CpG: 18	211	18	126	17.1	59.7	0.96
chr4	911689	912097	CpG: 27	408	27	295	13.2	72.3	0.64
chr4	912772	913073	CpG: 22	301	22	208	14.6	69.1	0.77
chr4	924556	925921	CpG: 120	1365	120	1041	17.6	76.3	0.84
chr4	929864	930772	CpG: 114	908	114	651	25.1	71.7	1.00
chr4	944926	945369	CpG: 46	443	46	318	20.8	71.8	0.81
chr4	953633	954012	CpG: 27	379	27	257	14.2	67.8	0.63
chr4	955931	956569	CpG: 51	638	51	438	16.0	68.7	0.68
chr4	965667	966475	CpG: 81	808	81	584	20.0	72.3	0.78
chr4	968125	968436	CpG: 23	311	23	213	14.8	68.5	0.63
chr4	971053	972458	CpG: 176	1405	176	1079	25.1	76.8	0.85
chr4	973615	974479	CpG: 62	864	62	586	14.4	67.8	0.63
chr4	975177	975382	CpG: 15	205	15	133	14.6	64.9	0.71
chr4	979071	979346	CpG: 20	275	20	182	14.5	66.2	0.70
chr4	995236	995970	CpG: 84	734	84	561	22.9	76.4	0.79
chr4	999741	1001800	CpG: 226	2059	226	1540	22.0	74.8	0.79
chr4	1007365	1010736	CpG: 392	3371	392	2555	23.3	75.8	0.81
chr4	1011295	1011546	CpG: 21	251	21	173	16.7	68.9	0.71
chr4	1021781	1023195	CpG: 129	1414	129	1003	18.2	70.9	0.73
chr4	1025363	1025595	CpG: 20	232	20	164	17.2	70.7	0.69
chr4	1026543	1026924	CpG: 29	381	29	265	15.2	69.6	0.65
chr4	1031937	1032277	CpG: 25	340	25	228	14.7	67.1	0.66
chr4	1033463	1033891	CpG: 33	428	33	303	15.4	70.8	0.62
chr4	1043914	1046736	CpG: 195	2822	195	2004	13.8	71.0	0.69
chr4	1047507	1047784	CpG: 20	277	20	178	14.4	64.3	0.70
chr4	1049004	1049262	CpG: 20	258	20	173	15.5	67.1	0.70
chr4	1050051	1050490	CpG: 36	439	36	283	16.4	64.5	0.79
chr4	1054749	1055020	CpG: 22	271	22	179	16.2	66.1	0.75
chr4	1068821	1069039	CpG: 18	218	18	130	16.5	59.6	1.01
chr4	1094985	1095247	CpG: 19	262	19	169	14.5	64.5	0.77
chr4	1111302	1111503	CpG: 15	201	15	148	14.9	73.6	0.65
chr4	1111622	1112663	CpG: 98	1041	98	771	18.8	74.1	0.71
chr4	1142933	1144711	CpG: 125	1778	125	976	14.1	54.9	1.01
chr4	1145532	1145826	CpG: 21	294	21	154	14.3	52.4	1.18
chr4	1166011	1166566	CpG: 47	555	47	365	16.9	65.8	0.78
chr4	1169399	1171466	CpG: 204	2067	204	1474	19.7	71.3	0.78
chr4	1192509	1194458	CpG: 149	1949	149	1397	15.3	71.7	0.60
chr4	1206660	1206905	CpG: 23	245	23	158	18.8	64.5	0.93
chr4	1207841	1208607	CpG: 53	766	53	452	13.8	59.0	0.81
chr4	1211192	1211578	CpG: 29	386	29	269	15.0	69.7	0.62
chr4	1215140	1215568	CpG: 35	428	35	281	16.4	65.7	0.76
chr4	1223048	1223337	CpG: 20	289	20	188	13.8	65.1	0.66
chr4	1224317	1225092	CpG: 67	775	67	531	17.3	68.5	0.74
chr4	1227211	1227424	CpG: 16	213	16	129	15.0	60.6	0.82
chr4	1229824	1230101	CpG: 26	277	26	164	18.8	59.2	1.08
chr4	1234389	1234911	CpG: 36	522	36	307	13.8	58.8	0.82
chr4	1237154	1237570	CpG: 32	416	32	285	15.4	68.5	0.66
chr4	1239213	1239541	CpG: 33	328	33	235	20.1	71.6	0.82
chr4	1246532	1249250	CpG: 354	2718	354	2022	26.0	74.4	0.94
chr4	1277418	1277946	CpG: 42	528	42	366	15.9	69.3	0.82
chr4	1288010	1289091	CpG: 118	1081	118	769	21.8	71.1	0.86
chr4	1308257	1308602	CpG: 26	345	26	225	15.1	65.2	0.71
chr4	1309535	1309880	CpG: 30	345	30	235	17.4	68.1	0.78
chr4	1313970	1314183	CpG: 23	213	23	141	21.6	66.2	1.00
chr4	1324936	1325139	CpG: 16	203	16	121	15.8	59.6	0.91
chr4	1327232	1327713	CpG: 34	481	34	326	14.1	67.8	0.62
chr4	1337169	1338504	CpG: 95	1335	95	764	14.2	57.2	0.88
chr4	1338757	1338968	CpG: 19	211	19	146	18.0	69.2	0.75
chr4	1344856	1346299	CpG: 178	1443	178	1084	24.7	75.1	0.88
chr4	1368974	1369177	CpG: 16	203	16	141	15.8	69.5	0.65
chr4	1371290	1371539	CpG: 22	249	22	170	17.7	68.3	0.95
chr4	1373760	1374117	CpG: 27	357	27	234	15.1	65.5	0.71
chr4	1393469	1393826	CpG: 31	357	31	245	17.4	68.6	0.75
chr4	1400777	1406216	CpG: 600	5439	600	3764	22.1	69.2	0.92
chr4	1406683	1406921	CpG: 18	238	18	160	15.1	67.2	0.68
chr4	1408525	1409004	CpG: 40	479	40	328	16.7	68.5	0.72
chr4	1411932	1413710	CpG: 191	1778	191	1266	21.5	71.2	0.87
chr4	1421836	1422095	CpG: 18	259	18	161	13.9	62.2	0.73
chr4	1469422	1470473	CpG: 107	1051	107	749	20.4	71.3	0.81
chr4	1488172	1488373	CpG: 18	201	18	150	17.9	74.6	0.65
chr4	1490836	1491047	CpG: 20	211	20	134	19.0	63.5	0.94
chr4	1501547	1501853	CpG: 29	306	29	239	19.0	78.1	0.66
chr4	1509518	1509725	CpG: 17	207	17	150	16.4	72.5	0.63
chr4	1510477	1511482	CpG: 92	1005	92	746	18.3	74.2	0.67
chr4	1517960	1519743	CpG: 170	1783	170	1330	19.1	74.6	0.71
chr4	1531095	1531540	CpG: 31	445	31	291	13.9	65.4	0.65
chr4	1533536	1533820	CpG: 25	284	25	169	17.6	59.5	1.18
chr4	1535329	1535589	CpG: 26	260	26	172	20.0	66.2	1.01
chr4	1538143	1538420	CpG: 23	277	23	173	16.6	62.5	0.85
chr4	1538796	1539207	CpG: 27	411	27	261	13.1	63.5	0.65
chr4	1542745	1542965	CpG: 17	220	17	152	15.5	69.1	0.67
chr4	1550188	1550401	CpG: 19	213	19	152	17.8	71.4	0.70
chr4	1553284	1553572	CpG: 22	288	22	187	15.3	64.9	0.72
chr4	1565426	1566449	CpG: 76	1023	76	719	14.9	70.3	0.62
chr4	1575580	1575960	CpG: 31	380	31	260	16.3	68.4	0.70
chr4	1576178	1577854	CpG: 142	1676	142	1135	16.9	67.7	0.75
chr4	1589511	1590685	CpG: 96	1174	96	865	16.4	73.7	0.60
chr4	1590806	1591052	CpG: 19	246	19	140	15.4	56.9	0.96
chr4	1596223	1596574	CpG: 31	351	31	253	17.7	72.1	0.68
chr4	1620628	1621005	CpG: 40	377	40	264	21.2	70.0	0.87
chr4	1622149	1623065	CpG: 62	916	62	617	13.5	67.4	0.60
chr4	1641397	1641835	CpG: 40	438	40	285	18.3	65.1	0.87
chr4	1652246	1652826	CpG: 63	580	63	425	21.7	73.3	0.81
chr4	1656329	1656680	CpG: 24	351	24	231	13.7	65.8	0.64
chr4	1681555	1682893	CpG: 183	1338	183	998	27.4	74.6	0.98
chr4	1685771	1685983	CpG: 15	212	15	125	14.2	59.0	0.82
chr4	1707506	1707737	CpG: 17	231	17	137	14.7	59.3	0.87
chr4	1709370	1711083	CpG: 207	1713	207	1228	24.2	71.7	0.94
chr4	1718280	1719952	CpG: 202	1672	202	1241	24.2	74.2	0.88
chr4	1758692	1758900	CpG: 18	208	18	150	17.3	72.1	0.67
chr4	1759460	1760091	CpG: 66	631	66	492	20.9	78.0	1.05
chr4	1761775	1762356	CpG: 56	581	56	412	19.3	70.9	0.77
chr4	1765333	1766544	CpG: 130	1211	130	935	21.5	77.2	0.74
chr4	1768758	1769017	CpG: 32	259	32	198	24.7	76.4	0.85
chr4	1791194	1793933	CpG: 357	2739	357	2090	26.1	76.3	0.90
chr4	1796896	1797103	CpG: 19	207	19	138	18.4	66.7	0.88
chr4	1797873	1798079	CpG: 16	206	16	143	15.5	69.4	0.65
chr4	1799828	1802424	CpG: 194	2596	194	1776	14.9	68.4	0.64
chr4	1803240	1803448	CpG: 16	208	16	142	15.4	68.3	0.68
chr4	1803869	1804339	CpG: 39	470	39	321	16.6	68.3	0.72
chr4	1804553	1804811	CpG: 20	258	20	164	15.5	63.6	0.77
chr4	1825334	1825581	CpG: 20	247	20	160	16.2	64.8	0.79
chr4	1839826	1840098	CpG: 21	272	21	171	15.4	62.9	0.78
chr4	1853812	1855634	CpG: 218	1822	218	1336	23.9	73.3	0.89
chr4	1860932	1861161	CpG: 26	229	26	174	22.7	76.0	0.81
chr4	1868897	1870734	CpG: 285	1837	285	1481	31.0	80.6	0.96
chr4	1977362	1977616	CpG: 24	254	24	182	18.9	71.7	0.75
chr4	1984282	1985050	CpG: 54	768	54	521	14.1	67.8	0.61
chr4	1991454	1991883	CpG: 37	429	37	263	17.2	61.3	0.92
chr4	2006505	2008219	CpG: 178	1714	178	1195	20.8	69.7	0.88
chr4	2017936	2018185	CpG: 18	249	18	156	14.5	62.7	0.76
chr4	2038870	2041341	CpG: 271	2471	271	1841	21.9	74.5	0.79
chr4	2045489	2045904	CpG: 50	415	50	312	24.1	75.2	0.86
chr4	2056679	2059932	CpG: 396	3253	396	2492	24.3	76.6	0.83
chr4	2062293	2063149	CpG: 77	856	77	595	18.0	69.5	0.75
chr4	2240299	2241118	CpG: 85	819	85	578	20.8	70.6	0.83
chr4	2260005	2261714	CpG: 231	1709	231	1282	27.0	75.0	0.97
chr4	2274493	2274955	CpG: 36	462	36	283	15.6	61.3	0.83
chr4	2289810	2290040	CpG: 17	230	17	140	14.8	60.9	0.80
chr4	2303943	2304573	CpG: 46	630	46	427	14.6	67.8	0.64
chr4	2311852	2312117	CpG: 20	265	20	161	15.1	60.8	0.83
chr4	2338848	2339224	CpG: 31	376	31	252	16.5	67.0	0.73
chr4	2364041	2364712	CpG: 75	671	75	495	22.4	73.8	0.86
chr4	2415337	2417921	CpG: 283	2584	283	1866	21.9	72.2	0.85
chr4	2428825	2429355	CpG: 44	530	44	267	16.6	50.4	1.31
chr4	2438922	2439200	CpG: 24	278	24	174	17.3	62.6	0.89
chr4	2460938	2461728	CpG: 109	790	109	614	27.6	77.7	0.91
chr4	2467250	2468759	CpG: 153	1509	153	999	20.3	66.2	0.94
chr4	2520866	2521147	CpG: 23	281	23	174	16.4	61.9	0.87
chr4	2531403	2531665	CpG: 18	262	18	158	13.7	60.3	0.77
chr4	2534116	2536439	CpG: 285	2323	285	1719	24.5	74.0	0.90
chr4	2536965	2537238	CpG: 19	273	19	165	13.9	60.4	0.76
chr4	2548162	2548436	CpG: 22	274	22	169	16.1	61.7	0.86
chr4	2724684	2724898	CpG: 17	214	17	127	15.9	59.3	0.91
chr4	2730689	2731052	CpG: 28	363	28	234	15.4	64.5	0.74
chr4	2754685	2755321	CpG: 90	636	90	508	28.3	79.9	0.94
chr4	2761863	2763182	CpG: 108	1319	108	885	16.4	67.1	0.73
chr4	2791534	2792506	CpG: 118	972	118	738	24.3	75.9	0.85
chr4	2816255	2817185	CpG: 112	930	112	714	24.1	76.8	0.82
chr4	2841759	2842986	CpG: 138	1227	138	899	22.5	73.3	0.85
chr4	2845339	2845571	CpG: 18	232	18	138	15.5	59.5	0.91
chr4	2924789	2925007	CpG: 16	218	16	138	14.7	63.3	0.74
chr4	2930380	2930615	CpG: 18	235	18	164	15.3	69.8	0.65
chr4	2932197	2933751	CpG: 170	1554	170	1161	21.9	74.7	0.80
chr4	2953442	2954061	CpG: 54	619	54	439	17.4	70.9	0.86
chr4	2961408	2962963	CpG: 179	1555	179	1082	23.0	69.6	0.95
chr4	3040010	3040539	CpG: 40	529	40	358	15.1	67.7	0.68
chr4	3072483	3073949	CpG: 152	1466	152	1094	20.7	74.6	0.78
chr4	3093238	3093727	CpG: 49	489	49	382	20.0	78.1	0.66
chr4	3215502	3215738	CpG: 20	236	20	144	16.9	61.0	0.93
chr4	3247658	3248478	CpG: 74	820	74	533	18.0	65.0	0.86
chr4	3251988	3252206	CpG: 20	218	20	142	18.3	65.1	0.90
chr4	3254455	3254836	CpG: 32	381	32	270	16.8	70.9	0.68
chr4	3260133	3260393	CpG: 20	260	20	162	15.4	62.3	0.79
chr4	3265204	3265484	CpG: 23	280	23	172	16.4	61.4	0.89
chr4	3290736	3292356	CpG: 210	1620	210	1239	25.9	76.5	0.89
chr4	3307136	3307366	CpG: 20	230	20	138	17.4	60.0	0.99
chr4	3316027	3316578	CpG: 43	551	43	340	15.6	61.7	0.82
chr4	3332281	3332518	CpG: 17	237	17	142	14.3	59.9	0.82
chr4	3339229	3339467	CpG: 17	238	17	153	14.3	64.3	0.69
chr4	3363183	3363404	CpG: 22	221	22	152	19.9	68.8	0.88
chr4	3373833	3374147	CpG: 22	314	22	207	14.0	65.9	0.65
chr4	3412632	3413304	CpG: 57	672	57	450	17.0	67.0	0.76
chr4	3414640	3414899	CpG: 25	259	25	176	19.3	68.0	1.34
chr4	3447707	3448052	CpG: 24	345	24	233	13.9	67.5	0.61
chr4	3462856	3463497	CpG: 81	641	81	496	25.3	77.4	0.86
chr4	3473117	3473524	CpG: 33	407	33	285	16.2	70.0	0.67
chr4	3475927	3476292	CpG: 28	365	28	254	15.3	69.6	0.69
chr4	3483934	3484352	CpG: 35	418	35	290	16.7	69.4	0.70
chr4	3485048	3485421	CpG: 28	373	28	256	15.0	68.6	0.64
chr4	3508972	3509581	CpG: 65	609	65	382	21.3	62.7	1.09
chr4	3511430	3511776	CpG: 31	346	31	236	17.9	68.2	0.78
chr4	3512468	3512777	CpG: 21	309	21	199	13.6	64.4	0.66
chr4	3514374	3514771	CpG: 33	397	33	260	16.6	65.5	0.78
chr4	3517483	3518114	CpG: 46	631	46	409	14.6	64.8	0.70
chr4	3524562	3524800	CpG: 16	238	16	140	13.4	58.8	0.78
chr4	3531571	3532716	CpG: 118	1145	118	819	20.6	71.5	0.81
chr4	3563184	3564434	CpG: 97	1250	97	780	15.5	62.4	0.80
chr4	3640651	3641166	CpG: 66	515	66	346	25.6	67.2	1.15
chr4	3668041	3668416	CpG: 27	375	27	233	14.4	62.1	0.75
chr4	3682106	3682423	CpG: 24	317	24	214	15.1	67.5	0.70
chr4	3723587	3723814	CpG: 18	227	18	153	15.9	67.4	0.71
chr4	3726282	3726518	CpG: 22	236	22	147	18.6	62.3	0.99
chr4	3739032	3739298	CpG: 23	266	23	168	17.3	63.2	0.88
chr4	3745154	3745801	CpG: 49	647	49	341	15.1	52.7	1.09
chr4	3764243	3766960	CpG: 393	2717	393	2051	28.9	75.5	1.02
chr4	3771043	3771254	CpG: 17	211	17	136	16.1	64.5	0.79
chr4	3807995	3808317	CpG: 34	322	34	224	21.1	69.6	0.95
chr4	3870751	3871670	CpG: 91	919	91	651	19.8	70.8	0.80
chr4	3875737	3875940	CpG: 14	203	14	137	13.8	67.5	0.61
chr4	3954349	3955961	CpG: 134	1612	134	1120	16.6	69.5	0.74
chr4	4106637	4107416	CpG: 92	779	92	580	23.6	74.5	0.86
chr4	4114503	4114765	CpG: 24	262	24	162	18.3	61.8	0.97
chr4	4130201	4130409	CpG: 16	208	16	112	15.4	53.8	1.06
chr4	4195802	4197540	CpG: 157	1738	157	1218	18.1	70.1	0.74
chr4	4217460	4217964	CpG: 55	504	55	324	21.8	64.3	1.06
chr4	4222009	4222241	CpG: 19	232	19	139	16.4	59.9	0.94
chr4	4232176	4232417	CpG: 17	241	17	142	14.1	58.9	0.83
chr4	4259510	4260232	CpG: 71	722	71	498	19.7	69.0	0.83
chr4	4355330	4357656	CpG: 234	2326	234	1665	20.1	71.6	0.79
chr4	4371849	4372080	CpG: 19	231	19	138	16.5	59.7	0.93
chr4	4416762	4417038	CpG: 26	276	26	172	18.8	62.3	0.98
chr4	4511284	4511951	CpG: 72	667	72	462	21.6	69.3	0.90
chr4	4513185	4513397	CpG: 15	212	15	126	14.2	59.4	0.82
chr4	4544947	4545434	CpG: 66	487	66	357	27.1	73.3	1.01
chr4	4609983	4610257	CpG: 21	274	21	165	15.3	60.2	0.85
chr4	4643488	4643727	CpG: 20	239	20	141	16.7	59.0	0.98
chr4	4734530	4734808	CpG: 27	278	27	177	19.4	63.7	0.97
chr4	4822501	4823098	CpG: 41	597	41	364	13.7	61.0	0.75
chr4	4826285	4826796	CpG: 53	511	53	341	20.7	66.7	0.95
chr4	4827541	4828100	CpG: 41	559	41	336	14.7	60.1	0.83
chr4	4829125	4830128	CpG: 114	1003	114	762	22.7	76.0	0.79
chr4	4832337	4832715	CpG: 40	378	40	253	21.2	66.9	0.95
chr4	4834320	4837393	CpG: 210	3073	210	1875	13.7	61.0	0.74
chr4	4840931	4841587	CpG: 48	656	48	425	14.6	64.8	0.70
chr4	4841843	4842055	CpG: 17	212	17	126	16.0	59.4	0.94
chr4	4988923	4989249	CpG: 27	326	27	238	16.6	73.0	0.63
chr4	5012472	5012753	CpG: 24	281	24	175	17.1	62.3	0.90
chr4	5020854	5022010	CpG: 120	1156	120	790	20.8	68.3	0.89
chr4	5537831	5538047	CpG: 18	216	18	152	16.7	70.4	0.68
chr4	5662056	5662337	CpG: 24	281	24	175	17.1	62.3	0.90
chr4	5679606	5680607	CpG: 86	1001	86	676	17.2	67.5	0.75
chr4	5682731	5683378	CpG: 80	647	80	494	24.7	76.4	0.86
chr4	5804797	5805071	CpG: 24	274	24	171	17.5	62.4	0.91
chr4	5859220	5860662	CpG: 145	1442	145	1045	20.1	72.5	0.77
chr4	5861998	5862784	CpG: 57	786	57	520	14.5	66.2	0.66
chr4	5864104	5865149	CpG: 164	1045	164	828	31.4	79.2	1.00
chr4	5981032	5981449	CpG: 54	417	54	321	25.9	77.0	0.88
chr4	6079160	6079758	CpG: 68	598	68	417	22.7	69.7	0.94
chr4	6086535	6086738	CpG: 18	203	18	132	17.7	65.0	0.89
chr4	6173072	6175051	CpG: 204	1979	204	1429	20.6	72.2	0.80
chr4	6195823	6196481	CpG: 84	658	84	510	25.5	77.5	0.85
chr4	6219482	6220163	CpG: 59	681	59	472	17.3	69.3	0.72
chr4	6243575	6244471	CpG: 112	896	112	676	25.0	75.4	0.88
chr4	6275838	6276515	CpG: 59	677	59	434	17.4	64.1	0.85
chr4	6283041	6283674	CpG: 69	633	69	483	21.8	76.3	0.75
chr4	6352623	6352949	CpG: 24	326	24	204	14.7	62.6	0.75
chr4	6395974	6396182	CpG: 15	208	15	125	14.4	60.1	0.81
chr4	6444920	6447279	CpG: 238	2359	238	1689	20.2	71.6	0.79
chr4	6539396	6540860	CpG: 192	1464	192	1104	26.2	75.4	0.93
chr4	6551377	6551879	CpG: 51	502	51	369	20.3	73.5	0.76
chr4	6616484	6617955	CpG: 145	1471	145	893	19.7	60.7	1.09
chr4	6632605	6633140	CpG: 51	535	51	346	19.1	64.7	0.93
chr4	6633706	6634151	CpG: 55	445	55	335	24.7	75.3	0.90
chr4	6639007	6639988	CpG: 87	981	87	650	17.7	66.3	0.81
chr4	6640703	6641006	CpG: 23	303	23	180	15.2	59.4	0.87
chr4	6641602	6641832	CpG: 19	230	19	139	16.5	60.4	0.93
chr4	6647802	6648199	CpG: 32	397	32	288	16.1	72.5	0.61
chr4	6648938	6649751	CpG: 109	813	109	598	26.8	73.6	1.02
chr4	6653136	6653422	CpG: 23	286	23	178	16.1	62.2	0.85
chr4	6684277	6685122	CpG: 72	845	72	491	17.0	58.1	1.05
chr4	6691045	6691879	CpG: 112	834	112	593	26.9	71.1	1.08
chr4	6702188	6702477	CpG: 21	289	21	193	14.5	66.8	0.65
chr4	6757134	6758865	CpG: 221	1731	221	1347	25.5	77.8	0.85
chr4	6812051	6812764	CpG: 58	713	58	495	16.3	69.4	0.68
chr4	6881125	6882520	CpG: 180	1395	180	1036	25.8	74.3	0.93
chr4	6895424	6895804	CpG: 33	380	33	243	17.4	63.9	0.87
chr4	6925242	6925527	CpG: 22	285	22	171	15.4	60.0	0.87
chr4	6925764	6926193	CpG: 31	429	31	289	14.5	67.4	0.64
chr4	6949217	6950076	CpG: 70	859	70	592	16.3	68.9	0.69
chr4	6958472	6959540	CpG: 102	1068	102	691	19.1	64.7	0.91
chr4	6985666	6985938	CpG: 22	272	22	164	16.2	60.3	0.91
chr4	6996874	6997277	CpG: 27	403	27	251	13.4	62.3	0.70
chr4	7011508	7011725	CpG: 19	217	19	130	17.5	59.9	0.99
chr4	7013916	7016134	CpG: 253	2218	253	1604	22.8	72.3	0.87
chr4	7022424	7022720	CpG: 26	296	26	198	17.6	66.9	0.79
chr4	7026130	7026691	CpG: 44	561	44	313	15.7	55.8	1.03
chr4	7039208	7040512	CpG: 134	1304	134	883	20.6	67.7	0.90
chr4	7086433	7086648	CpG: 17	215	17	128	15.8	59.5	0.90
chr4	7145856	7146126	CpG: 19	270	19	162	14.1	60.0	0.79
chr4	7164953	7166293	CpG: 170	1340	170	998	25.4	74.5	0.92
chr4	7187679	7188106	CpG: 35	427	35	308	16.4	72.1	0.63
chr4	7277407	7277611	CpG: 15	204	15	123	14.7	60.3	0.81
chr4	7453838	7454657	CpG: 52	819	52	514	12.7	62.8	0.71
chr4	7482347	7482987	CpG: 50	640	50	430	15.6	67.2	0.69
chr4	7499261	7499486	CpG: 16	225	16	151	14.2	67.1	0.67
chr4	7563820	7564037	CpG: 19	217	19	140	17.5	64.5	0.84
chr4	7574309	7575118	CpG: 60	809	60	559	14.8	69.1	0.62
chr4	7576512	7576768	CpG: 19	256	19	158	14.8	61.7	0.79
chr4	7617826	7618031	CpG: 17	205	17	134	16.6	65.4	0.78
chr4	7636051	7636379	CpG: 24	328	24	181	14.6	55.2	0.96
chr4	7708858	7709211	CpG: 24	353	24	233	13.6	66.0	0.63
chr4	7744750	7745024	CpG: 20	274	20	180	14.6	65.7	0.72
chr4	7772353	7772602	CpG: 19	249	19	143	15.3	57.4	0.93
chr4	7917381	7918671	CpG: 166	1290	166	973	25.7	75.4	0.91
chr4	8001745	8001948	CpG: 17	203	17	132	16.7	65.0	0.84
chr4	8063874	8064154	CpG: 22	280	22	204	15.7	72.9	0.61
chr4	8075525	8075774	CpG: 22	249	22	168	17.7	67.5	0.78
chr4	8130596	8131062	CpG: 34	466	34	290	14.6	62.2	0.75
chr4	8136385	8137915	CpG: 165	1530	165	1100	21.6	71.9	0.84
chr4	8178946	8179157	CpG: 19	211	19	135	18.0	64.0	0.88
chr4	8248264	8249141	CpG: 113	877	113	673	25.8	76.7	0.88
chr4	8285961	8286301	CpG: 27	340	27	228	15.9	67.1	0.71
chr4	8317594	8317871	CpG: 25	277	25	173	18.1	62.5	0.93
chr4	8325651	8326064	CpG: 38	413	38	276	18.4	66.8	0.84
chr4	8353181	8353482	CpG: 22	301	22	181	14.6	60.1	0.94
chr4	8354876	8355153	CpG: 29	277	29	193	20.9	69.7	0.87
chr4	8362667	8362891	CpG: 19	224	19	137	17.0	61.2	0.92
chr4	8366573	8366849	CpG: 24	276	24	172	17.4	62.3	0.91
chr4	8407947	8408459	CpG: 59	512	59	367	23.0	71.7	0.93
chr4	8420452	8421132	CpG: 64	680	64	474	18.8	69.7	0.78
chr4	8560170	8561498	CpG: 124	1328	124	918	18.7	69.1	0.79
chr4	8566850	8567086	CpG: 21	236	21	157	17.8	66.5	0.81
chr4	8572546	8572911	CpG: 40	365	40	265	21.9	72.6	0.85
chr4	8605005	8605353	CpG: 26	348	26	212	14.9	60.9	0.82
chr4	8616276	8616624	CpG: 26	348	26	213	14.9	61.2	0.81
chr4	8621915	8622263	CpG: 25	348	25	211	14.4	60.6	0.80
chr4	8629673	8629904	CpG: 18	231	18	161	15.6	69.7	0.64
chr4	8673796	8674015	CpG: 23	219	23	151	21.0	68.9	0.89
chr4	8676694	8676959	CpG: 20	265	20	164	15.1	61.9	0.79
chr4	8733120	8733511	CpG: 28	391	28	249	14.3	63.7	0.71
chr4	8800789	8801010	CpG: 19	221	19	133	17.2	60.2	0.96
chr4	8824116	8829054	CpG: 397	4938	397	3304	16.1	66.9	0.72
chr4	8832234	8832461	CpG: 18	227	18	153	15.9	67.4	0.70
chr4	8834224	8835247	CpG: 119	1023	119	757	23.3	74.0	0.85
chr4	8837977	8841614	CpG: 326	3637	326	2433	17.9	66.9	0.80
chr4	8858546	8861443	CpG: 266	2897	266	1984	18.4	68.5	0.79
chr4	8930297	8931391	CpG: 98	1094	98	772	17.9	70.6	0.72
chr4	8967388	8968136	CpG: 84	748	84	547	22.5	73.1	0.85
chr4	9020718	9020997	CpG: 22	279	22	166	15.8	59.5	0.91
chr4	9119023	9120570	CpG: 135	1547	135	1086	17.5	70.2	0.75
chr4	9401524	9401931	CpG: 35	407	35	293	17.2	72.0	0.67
chr4	9489926	9490127	CpG: 15	201	15	134	14.9	66.7	0.67
chr4	9493846	9494938	CpG: 103	1092	103	772	18.9	70.7	0.76
chr4	9528391	9529145	CpG: 85	754	85	554	22.5	73.5	0.84
chr4	9581723	9581962	CpG: 22	239	22	144	18.4	60.3	1.04
chr4	9687786	9688444	CpG: 54	658	54	464	16.4	70.5	0.72
chr4	9758156	9758664	CpG: 42	508	42	346	16.5	68.1	0.72
chr4	9781184	9783109	CpG: 155	1925	155	1263	16.1	65.6	0.75
chr4	9845245	9845520	CpG: 25	275	25	171	18.2	62.2	0.95
chr4	10018425	10018970	CpG: 49	545	49	366	18.0	67.2	0.81
chr4	10077297	10077517	CpG: 22	220	22	147	20.0	66.8	0.90
chr4	10115529	10116906	CpG: 160	1377	160	985	23.2	71.5	0.91
chr4	10432477	10433701	CpG: 161	1224	161	894	26.3	73.0	0.99
chr4	10437179	10438036	CpG: 83	857	83	561	19.4	65.5	0.90
chr4	10451198	10451434	CpG: 17	236	17	138	14.4	58.5	0.87
chr4	10482801	10483073	CpG: 19	272	19	164	14.0	60.3	0.77
chr4	10586074	10586341	CpG: 26	267	26	170	19.5	63.7	0.97
chr4	10600303	10600563	CpG: 21	260	21	158	16.2	60.8	0.90
chr4	10838140	10838421	CpG: 21	281	21	172	14.9	61.2	0.81
chr4	10873674	10874025	CpG: 29	351	29	209	16.5	59.5	0.93
chr4	11125364	11125599	CpG: 20	235	20	144	17.0	61.3	0.91
chr4	11236889	11237163	CpG: 25	274	25	168	18.2	61.3	0.98
chr4	11344664	11345321	CpG: 81	657	81	460	24.7	70.0	1.03
chr4	11360453	11360778	CpG: 25	325	25	195	15.4	60.0	0.86
chr4	11364050	11364335	CpG: 24	285	24	176	16.8	61.8	0.90
chr4	11375231	11376100	CpG: 71	869	71	551	16.3	63.4	0.82
chr4	11403851	11404070	CpG: 19	219	19	146	17.4	66.7	0.78
chr4	11404670	11405691	CpG: 91	1021	91	699	17.8	68.5	0.76
chr4	11516874	11517159	CpG: 24	285	24	178	16.8	62.5	0.88
chr4	11637966	11638240	CpG: 21	274	21	169	15.3	61.7	0.82
chr4	11696222	11696496	CpG: 22	274	22	169	16.1	61.7	0.86
chr4	12273165	12273407	CpG: 18	242	18	145	14.9	59.9	0.84
chr4	12588053	12588310	CpG: 28	257	28	189	21.8	73.5	0.81
chr4	12743296	12743578	CpG: 21	282	21	172	14.9	61.0	0.81
chr4	12782997	12783283	CpG: 26	286	26	178	18.2	62.2	0.95
chr4	13053493	13053725	CpG: 17	232	17	134	14.7	57.8	0.88
chr4	13226797	13227030	CpG: 20	233	20	141	17.2	60.5	0.95
chr4	13378174	13378414	CpG: 18	240	18	143	15.0	59.6	0.87
chr4	13463581	13464592	CpG: 97	1011	97	690	19.2	68.2	0.83
chr4	13502126	13504147	CpG: 132	2021	132	1261	13.1	62.4	0.67
chr4	13504617	13504834	CpG: 21	217	21	134	19.4	61.8	1.02
chr4	13507318	13507929	CpG: 51	611	51	403	16.7	66.0	0.77
chr4	13508911	13509308	CpG: 30	397	30	224	15.1	56.4	0.95
chr4	13515706	13516033	CpG: 27	327	27	201	16.5	61.5	0.88
chr4	13521592	13524657	CpG: 265	3065	265	2054	17.3	67.0	0.77
chr4	13526638	13528024	CpG: 132	1386	132	938	19.0	67.7	0.83
chr4	13606990	13607734	CpG: 88	744	88	532	23.7	71.5	0.94
chr4	13609809	13610048	CpG: 17	239	17	142	14.2	59.4	0.83
chr4	13712772	13713040	CpG: 19	268	19	163	14.2	60.8	0.78
chr4	13994813	13995047	CpG: 19	234	19	142	16.2	60.7	0.88
chr4	14491251	14491478	CpG: 18	227	18	137	15.9	60.4	0.91
chr4	14735192	14735502	CpG: 23	310	23	188	14.8	60.6	0.81
chr4	14842786	14843079	CpG: 31	293	31	210	21.2	71.7	0.82
chr4	14926606	14926884	CpG: 25	278	25	173	18.0	62.2	0.94
chr4	14983215	14986917	CpG: 424	3702	424	2673	22.9	72.2	0.88
chr4	15192961	15193170	CpG: 17	209	17	125	16.3	59.8	0.92
chr4	15422362	15422575	CpG: 18	213	18	126	16.9	59.2	0.97
chr4	15511915	15512149	CpG: 20	234	20	140	17.1	59.8	0.98
chr4	15596811	15597055	CpG: 21	244	21	177	17.2	72.5	0.66
chr4	15621056	15621288	CpG: 16	232	16	128	13.8	55.2	0.92
chr4	15636917	15638292	CpG: 151	1375	151	976	22.0	71.0	0.87
chr4	15663457	15664137	CpG: 59	680	59	448	17.4	65.9	0.80
chr4	15683815	15684049	CpG: 20	234	20	142	17.1	60.7	0.94
chr4	15685081	15685532	CpG: 46	451	46	302	20.4	67.0	0.92
chr4	15750691	15750954	CpG: 21	263	21	159	16.0	60.5	0.89
chr4	15760532	15761263	CpG: 71	731	71	499	19.4	68.3	0.83
chr4	15769159	15769410	CpG: 22	251	22	182	17.5	72.5	0.67
chr4	15772420	15773481	CpG: 87	1061	87	760	16.4	71.6	0.64
chr4	15823136	15823584	CpG: 34	448	34	270	15.2	60.3	0.84
chr4	15854465	15854738	CpG: 25	273	25	169	18.3	61.9	0.96
chr4	16064298	16065838	CpG: 134	1540	134	1026	17.4	66.6	0.79
chr4	16081617	16081854	CpG: 22	237	22	144	18.6	60.8	1.02
chr4	16207773	16209393	CpG: 208	1620	208	1192	25.7	73.6	0.95
chr4	16238228	16238508	CpG: 25	280	25	161	17.9	57.5	1.09
chr4	16342728	16343078	CpG: 28	350	28	202	16.0	57.7	1.00
chr4	16375049	16376048	CpG: 76	999	76	707	15.2	70.8	0.61
chr4	16596505	16596783	CpG: 25	278	25	175	18.0	62.9	0.92
chr4	16626981	16627263	CpG: 24	282	24	176	17.0	62.4	0.89
chr4	16637634	16637857	CpG: 16	223	16	134	14.3	60.1	0.81
chr4	16780700	16780944	CpG: 18	244	18	144	14.8	59.0	0.87
chr4	16782485	16782764	CpG: 21	279	21	175	15.1	62.7	0.79
chr4	16803044	16803328	CpG: 20	284	20	169	14.1	59.5	0.81
chr4	16845370	16845610	CpG: 21	240	21	142	17.5	59.2	1.02
chr4	16899281	16899502	CpG: 17	221	17	133	15.4	60.2	0.88
chr4	16902418	16902657	CpG: 16	239	16	136	13.4	56.9	0.86
chr4	16924395	16924821	CpG: 32	426	32	255	15.0	59.9	0.84
chr4	16993144	16993508	CpG: 25	364	25	207	13.7	56.9	0.86
chr4	17017559	17018134	CpG: 43	575	43	345	15.0	60.0	0.85
chr4	17130917	17131226	CpG: 24	309	24	174	15.5	56.3	0.99
chr4	17396030	17396432	CpG: 42	402	42	307	20.9	76.4	0.72
chr4	17418343	17418906	CpG: 44	563	44	399	15.6	70.9	0.62
chr4	17493436	17494118	CpG: 80	682	80	499	23.5	73.2	0.89
chr4	17523661	17524124	CpG: 36	463	36	271	15.6	58.5	0.92
chr4	17531665	17531887	CpG: 20	222	20	136	18.0	61.3	0.97
chr4	17559125	17560080	CpG: 124	955	124	666	26.0	69.7	1.07
chr4	17595500	17596062	CpG: 39	562	39	325	13.9	57.8	0.84
chr4	17596860	17597343	CpG: 35	483	35	276	14.5	57.1	0.89
chr4	17597840	17598114	CpG: 20	274	20	162	14.6	59.1	0.85
chr4	17619238	17619584	CpG: 24	346	24	209	13.9	60.4	0.76
chr4	17691404	17691759	CpG: 24	355	24	236	13.5	66.5	0.62
chr4	17729982	17730248	CpG: 21	266	21	164	15.8	61.7	0.85
chr4	17763365	17764347	CpG: 94	982	94	669	19.1	68.1	0.83
chr4	17792679	17793952	CpG: 117	1273	117	821	18.4	64.5	0.89
chr4	18003165	18005003	CpG: 197	1838	197	1254	21.4	68.2	0.93
chr4	18141607	18141997	CpG: 38	390	38	290	19.5	74.4	0.71
chr4	18399890	18400129	CpG: 20	239	20	132	16.7	55.2	1.15
chr4	18400683	18401073	CpG: 42	390	42	287	21.5	73.6	0.80
chr4	19066032	19066459	CpG: 31	427	31	253	14.5	59.3	0.83
chr4	19221511	19221772	CpG: 20	261	20	153	15.3	58.6	0.90
chr4	19280974	19281210	CpG: 20	236	20	144	16.9	61.0	0.93
chr4	19624156	19624431	CpG: 23	275	23	170	16.7	61.8	0.88
chr4	19986651	19987045	CpG: 41	394	41	296	20.8	75.1	0.74
chr4	19987381	19987635	CpG: 19	254	19	147	15.0	57.9	0.92
chr4	20234345	20237937	CpG: 300	3592	300	2371	16.7	66.0	0.77
chr4	20500359	20500597	CpG: 21	238	21	148	17.6	62.2	0.93
chr4	20681871	20682390	CpG: 53	519	53	344	20.4	66.3	0.93
chr4	20969309	20969577	CpG: 20	268	20	161	14.9	60.1	0.84
chr4	20990133	20990412	CpG: 22	279	22	171	15.8	61.3	0.85
chr4	21030573	21030847	CpG: 25	274	25	172	18.2	62.8	0.94
chr4	21141014	21141440	CpG: 33	426	33	256	15.5	60.1	0.86
chr4	21930321	21931101	CpG: 95	780	95	578	24.4	74.1	0.90
chr4	22014323	22014554	CpG: 18	231	18	141	15.6	61.0	0.85
chr4	22030659	22030941	CpG: 23	282	23	175	16.3	62.1	0.86
chr4	22099374	22099650	CpG: 19	276	19	165	13.8	59.8	0.78
chr4	22299265	22299545	CpG: 22	280	22	174	15.7	62.1	0.82
chr4	22457249	22457523	CpG: 20	274	20	165	14.6	60.2	0.81
chr4	22491531	22491805	CpG: 25	274	25	172	18.2	62.8	0.93
chr4	22497037	22498229	CpG: 150	1192	150	875	25.2	73.4	0.94
chr4	22616324	22616862	CpG: 67	538	67	399	24.9	74.2	0.91
chr4	22760399	22760729	CpG: 28	330	28	245	17.0	74.2	0.62
chr4	22854063	22854325	CpG: 22	262	22	158	16.8	60.3	0.94
chr4	23264793	23265067	CpG: 21	274	21	167	15.3	60.9	0.83
chr4	23596477	23596830	CpG: 27	353	27	210	15.3	59.5	0.86
chr4	23701797	23702078	CpG: 25	281	25	175	17.8	62.3	0.93
chr4	24194866	24195106	CpG: 20	240	20	147	16.7	61.2	0.91
chr4	24403032	24403298	CpG: 21	266	21	162	15.8	60.9	0.87
chr4	24451783	24455222	CpG: 318	3439	318	2256	18.5	65.6	0.86
chr4	24497114	24497414	CpG: 25	300	25	174	16.7	58.0	1.00
chr4	24512825	24513099	CpG: 20	274	20	166	14.6	60.6	0.80
chr4	24565510	24566377	CpG: 89	867	89	607	20.5	70.0	0.86
chr4	24566665	24566925	CpG: 21	260	21	155	16.2	59.6	0.92
chr4	24781419	24782212	CpG: 108	793	108	591	27.2	74.5	0.98
chr4	24894531	24895175	CpG: 95	644	95	511	29.5	79.3	0.95
chr4	25012327	25013019	CpG: 94	692	94	544	27.2	78.6	0.89
chr4	25070399	25070803	CpG: 34	404	34	251	16.8	62.1	0.87
chr4	25077957	25078212	CpG: 20	255	20	159	15.7	62.4	0.81
chr4	25138343	25138587	CpG: 18	244	18	147	14.8	60.2	0.83
chr4	25139479	25139764	CpG: 21	285	21	172	14.7	60.4	0.82
chr4	25142082	25142591	CpG: 52	509	52	316	20.4	62.1	1.06
chr4	25215757	25216545	CpG: 103	788	103	602	26.1	76.4	0.90
chr4	25231146	25231902	CpG: 59	756	59	538	15.6	71.2	0.62
chr4	25294422	25294763	CpG: 32	341	32	237	18.8	69.5	0.79
chr4	25306804	25307045	CpG: 18	241	18	146	14.9	60.6	0.82
chr4	25358657	25359458	CpG: 77	801	77	579	19.2	72.3	0.74
chr4	25477359	25477595	CpG: 23	236	23	147	19.5	62.3	1.03
chr4	25486850	25488357	CpG: 135	1507	135	964	17.9	64.0	0.88
chr4	25548878	25549151	CpG: 19	273	19	169	13.9	61.9	0.73
chr4	25637467	25637895	CpG: 58	428	58	315	27.1	73.6	1.01
chr4	25658157	25658531	CpG: 32	374	32	235	17.1	62.8	0.88
chr4	25788042	25788277	CpG: 18	235	18	141	15.3	60.0	0.86
chr4	25844216	25845832	CpG: 167	1616	167	1172	20.7	72.5	0.79
chr4	25895821	25896465	CpG: 61	644	61	417	18.9	64.8	0.90
chr4	26010981	26011253	CpG: 25	272	25	198	18.4	72.8	0.70
chr4	26046178	26046527	CpG: 35	349	35	263	20.1	75.4	0.71
chr4	26238373	26238603	CpG: 21	230	21	140	18.3	60.9	1.00
chr4	26240168	26240442	CpG: 21	274	21	171	15.3	62.4	0.80
chr4	26303715	26303946	CpG: 19	231	19	134	16.5	58.0	1.01
chr4	26304138	26306519	CpG: 230	2381	230	1586	19.3	66.6	0.87
chr4	26314594	26314832	CpG: 18	238	18	141	15.1	59.2	0.89
chr4	26344551	26344790	CpG: 30	239	30	181	25.1	75.7	0.88
chr4	26422057	26422294	CpG: 21	237	21	145	17.7	61.2	0.97
chr4	26569019	26569254	CpG: 24	235	24	159	20.4	67.7	0.90
chr4	26630906	26631180	CpG: 23	274	23	171	16.8	62.4	0.87
chr4	26713853	26714129	CpG: 21	276	21	161	15.2	58.3	0.91
chr4	26842363	26842899	CpG: 58	536	58	371	21.6	69.2	0.90
chr4	26845521	26846727	CpG: 156	1206	156	866	25.9	71.8	1.00
chr4	26875735	26875965	CpG: 18	230	18	139	15.7	60.4	0.87
chr4	27061135	27061377	CpG: 20	242	20	146	16.5	60.3	0.91
chr4	27366793	27367220	CpG: 33	427	33	255	15.5	59.7	0.87
chr4	27506079	27506312	CpG: 18	233	18	140	15.5	60.1	0.87
chr4	27739233	27739507	CpG: 22	274	22	168	16.1	61.3	0.86
chr4	28102614	28103217	CpG: 63	603	63	449	20.9	74.5	0.75
chr4	28548320	28548556	CpG: 22	236	22	146	18.6	61.9	1.00
chr4	28732537	28732756	CpG: 18	219	18	131	16.4	59.8	0.94
chr4	28855594	28855827	CpG: 17	233	17	138	14.6	59.2	0.87
chr4	28954403	28954680	CpG: 19	277	19	167	13.7	60.3	0.77
chr4	29021772	29022000	CpG: 19	228	19	138	16.7	60.5	0.94
chr4	29103700	29104090	CpG: 36	390	36	283	18.5	72.6	0.70
chr4	29329985	29330259	CpG: 24	274	24	171	17.5	62.4	0.91
chr4	29375751	29375981	CpG: 17	230	17	136	14.8	59.1	0.86
chr4	29407655	29407940	CpG: 24	285	24	178	16.8	62.5	0.88
chr4	29709353	29709627	CpG: 23	274	23	169	16.8	61.7	0.89
chr4	29719577	29719847	CpG: 19	270	19	163	14.1	60.4	0.78
chr4	29831099	29831340	CpG: 17	241	17	147	14.1	61.0	0.77
chr4	30079193	30079580	CpG: 30	387	30	270	15.5	69.8	0.64
chr4	30108699	30108942	CpG: 20	243	20	147	16.5	60.5	0.92
chr4	30173895	30174175	CpG: 25	280	25	176	17.9	62.9	0.92
chr4	30212767	30213043	CpG: 22	276	22	169	15.9	61.2	0.86
chr4	30453264	30453538	CpG: 24	274	24	171	17.5	62.4	0.91
chr4	30706210	30707204	CpG: 75	994	75	623	15.1	62.7	0.77
chr4	30708561	30712199	CpG: 337	3638	337	2354	18.5	64.7	0.89
chr4	30725537	30725812	CpG: 25	275	25	172	18.2	62.5	0.94
chr4	30887629	30887862	CpG: 17	233	17	137	14.6	58.8	0.85
chr4	31350298	31350577	CpG: 25	279	25	173	17.9	62.0	0.94
chr4	31393526	31393804	CpG: 25	278	25	176	18.0	63.3	0.91
chr4	31412340	31412565	CpG: 18	225	18	137	16.0	60.9	0.87
chr4	31427125	31427331	CpG: 17	206	17	148	16.5	71.8	0.64
chr4	31658699	31658984	CpG: 24	285	24	180	16.8	63.2	0.86
chr4	31722046	31722277	CpG: 21	231	21	141	18.2	61.0	1.00
chr4	31971289	31971759	CpG: 47	470	47	344	20.0	73.2	0.75
chr4	32171231	32171451	CpG: 16	220	16	130	14.5	59.1	0.86
chr4	32451044	32451321	CpG: 19	277	19	170	13.7	61.4	0.73
chr4	32513953	32514227	CpG: 24	274	24	171	17.5	62.4	0.91
chr4	32607496	32607814	CpG: 25	318	25	176	15.7	55.3	1.03
chr4	32654770	32655030	CpG: 23	260	23	161	17.7	61.9	0.93
chr4	32691175	32691566	CpG: 39	391	39	292	19.9	74.7	0.72
chr4	32713941	32714205	CpG: 23	264	23	162	17.4	61.4	0.95
chr4	32717699	32717980	CpG: 24	281	24	175	17.1	62.3	0.90
chr4	33220132	33220377	CpG: 22	245	22	150	18.0	61.2	0.99
chr4	33247836	33248071	CpG: 20	235	20	144	17.0	61.3	0.93
chr4	33440861	33441135	CpG: 24	274	24	171	17.5	62.4	0.91
chr4	33493369	33493648	CpG: 22	279	22	175	15.8	62.7	0.82
chr4	33537752	33538030	CpG: 24	278	24	172	17.3	61.9	0.91
chr4	33642739	33642975	CpG: 17	236	17	143	14.4	60.6	0.81
chr4	33813525	33813799	CpG: 21	274	21	168	15.3	61.3	0.82
chr4	34170056	34170334	CpG: 25	278	25	175	18.0	62.9	0.92
chr4	34190434	34190719	CpG: 23	285	23	176	16.1	61.8	0.86
chr4	34200947	34201221	CpG: 19	274	19	164	13.9	59.9	0.79
chr4	34304098	34304304	CpG: 17	206	17	122	16.5	59.2	0.96
chr4	34304743	34305129	CpG: 30	386	30	274	15.5	71.0	0.62
chr4	34322858	34323132	CpG: 22	274	22	169	16.1	61.7	0.86
chr4	34595481	34595704	CpG: 19	223	19	133	17.0	59.6	0.99
chr4	34719810	34720087	CpG: 22	277	22	166	15.9	59.9	0.89
chr4	34738073	34738324	CpG: 21	251	21	156	16.7	62.2	0.88
chr4	34821037	34821307	CpG: 20	270	20	165	14.8	61.1	0.80
chr4	35099546	35099748	CpG: 17	202	17	123	16.8	60.9	0.93
chr4	35450705	35450990	CpG: 23	285	23	177	16.1	62.1	0.85
chr4	35553702	35553936	CpG: 19	234	19	141	16.2	60.3	0.91
chr4	35623970	35624242	CpG: 23	272	23	168	16.9	61.8	0.90
chr4	35650120	35650394	CpG: 24	274	24	172	17.5	62.8	0.90
chr4	35971079	35971364	CpG: 24	285	24	178	16.8	62.5	0.88
chr4	36212992	36213750	CpG: 100	758	100	569	26.4	75.1	0.94
chr4	36287635	36287873	CpG: 19	238	19	147	16.0	61.8	0.85
chr4	36343926	36344385	CpG: 37	459	37	332	16.1	72.3	0.62
chr4	36427078	36427312	CpG: 21	234	21	142	17.9	60.7	0.99
chr4	36437276	36437519	CpG: 22	243	22	150	18.1	61.7	0.98
chr4	36747936	36748213	CpG: 25	277	25	173	18.1	62.5	0.94
chr4	36863010	36863230	CpG: 18	220	18	127	16.4	57.7	0.98
chr4	36875037	36875303	CpG: 23	266	23	166	17.3	62.4	0.90
chr4	36974149	36974435	CpG: 24	286	24	180	16.8	62.9	0.87
chr4	37191505	37191790	CpG: 25	285	25	180	17.5	63.2	0.90
chr4	37198196	37198470	CpG: 20	274	20	167	14.6	60.9	0.80
chr4	37211966	37213695	CpG: 171	1729	171	1165	19.8	67.4	0.87
chr4	37422396	37422874	CpG: 63	478	63	343	26.4	71.8	1.02
chr4	37478310	37478592	CpG: 23	282	23	177	16.3	62.8	0.83
chr4	37538763	37539052	CpG: 21	289	21	168	14.5	58.1	0.88
chr4	37540850	37541128	CpG: 22	278	22	168	15.8	60.4	0.87
chr4	37654978	37656190	CpG: 135	1212	135	887	22.3	73.2	0.85
chr4	37668040	37668320	CpG: 19	280	19	172	13.6	61.4	0.74
chr4	37733753	37734034	CpG: 23	281	23	175	16.4	62.3	0.86
chr4	37789416	37789773	CpG: 30	357	30	267	16.8	74.8	0.61
chr4	37795582	37796383	CpG: 80	801	80	554	20.0	69.2	0.84
chr4	37859112	37860770	CpG: 143	1658	143	1144	17.2	69.0	0.73
chr4	37868918	37869193	CpG: 27	275	27	177	19.6	64.4	0.96
chr4	37888914	37889160	CpG: 17	246	17	148	13.8	60.2	0.78
chr4	37946153	37947046	CpG: 116	893	116	676	26.0	75.7	0.91
chr4	37970013	37970217	CpG: 14	204	14	120	13.7	58.8	0.81
chr4	37983608	37983896	CpG: 33	288	33	198	22.9	68.8	0.97
chr4	38145691	38145924	CpG: 17	233	17	141	14.6	60.5	0.80
chr4	38175896	38176125	CpG: 19	229	19	144	16.6	62.9	0.86
chr4	38231620	38231846	CpG: 17	226	17	132	15.0	58.4	0.90
chr4	38513013	38513277	CpG: 20	264	20	159	15.2	60.2	0.84
chr4	38632128	38634144	CpG: 246	2016	246	1520	24.4	75.4	0.86
chr4	38657792	38658089	CpG: 21	297	21	187	14.1	63.0	0.73
chr4	38685037	38685316	CpG: 22	279	22	171	15.8	61.3	0.85
chr4	38777370	38778244	CpG: 65	874	65	604	14.9	69.1	0.62
chr4	38825075	38825352	CpG: 21	277	21	168	15.2	60.6	0.83
chr4	38837671	38838287	CpG: 71	616	71	464	23.1	75.3	0.81
chr4	38852105	38852386	CpG: 22	281	22	173	15.7	61.6	0.84
chr4	39014254	39015115	CpG: 119	861	119	681	27.6	79.1	0.90
chr4	39140244	39140524	CpG: 28	280	28	156	20.0	55.7	1.69
chr4	39140760	39141035	CpG: 20	275	20	165	14.5	60.0	0.81
chr4	39151841	39152590	CpG: 61	749	61	442	16.3	59.0	0.95
chr4	39335670	39336235	CpG: 48	565	48	374	17.0	66.2	0.78
chr4	39366310	39366540	CpG: 19	230	19	141	16.5	61.3	0.90
chr4	39416210	39417080	CpG: 78	870	78	571	17.9	65.6	0.83
chr4	39428119	39428843	CpG: 55	724	55	435	15.2	60.1	0.84
chr4	39450010	39450225	CpG: 23	215	23	152	21.4	70.7	0.88
chr4	39496769	39497764	CpG: 98	995	98	703	19.7	70.7	0.79
chr4	39608214	39608981	CpG: 76	767	76	514	19.8	67.0	0.89
chr4	39654645	39654865	CpG: 17	220	17	130	15.5	59.1	0.90
chr4	39667505	39668360	CpG: 97	855	97	597	22.7	69.8	0.94
chr4	39739700	39739965	CpG: 23	265	23	166	17.4	62.6	0.90
chr4	39740831	39741330	CpG: 50	499	50	336	20.0	67.3	0.89
chr4	39743282	39743514	CpG: 20	232	20	141	17.2	60.8	0.95
chr4	39943796	39944072	CpG: 21	276	21	169	15.2	61.2	0.82
chr4	39946410	39948136	CpG: 205	1726	205	1244	23.8	72.1	0.93
chr4	39949319	39949561	CpG: 17	242	17	140	14.0	57.9	0.85
chr4	39969407	39969688	CpG: 22	281	22	169	15.7	60.1	0.87
chr4	40013281	40013494	CpG: 15	213	15	131	14.1	61.5	0.75
chr4	40013994	40014216	CpG: 21	222	21	140	18.9	63.1	0.95
chr4	40025967	40027524	CpG: 179	1557	179	1116	23.0	71.7	0.90
chr4	40111267	40112060	CpG: 60	793	60	546	15.1	68.9	0.64
chr4	40153458	40153733	CpG: 21	275	21	167	15.3	60.7	0.84
chr4	40173161	40173373	CpG: 17	212	17	127	16.0	59.9	0.91
chr4	40221128	40221371	CpG: 18	243	18	143	14.8	58.8	0.88
chr4	40249441	40249663	CpG: 17	222	17	135	15.3	60.8	0.84
chr4	40411423	40412507	CpG: 118	1084	118	714	21.8	65.9	1.00
chr4	40566639	40566863	CpG: 17	224	17	131	15.2	58.5	0.89
chr4	40573981	40574255	CpG: 20	274	20	169	14.6	61.7	0.79
chr4	40589754	40589978	CpG: 17	224	17	137	15.2	61.2	0.82
chr4	40603359	40604206	CpG: 70	847	70	545	16.5	64.3	0.81
chr4	40665281	40665482	CpG: 16	201	16	120	15.9	59.7	0.90
chr4	40723693	40724343	CpG: 74	650	74	465	22.8	71.5	0.90
chr4	40724541	40724746	CpG: 15	205	15	109	14.6	53.2	1.04
chr4	40766407	40766655	CpG: 21	248	21	155	16.9	62.5	0.88
chr4	40830805	40831228	CpG: 49	423	49	308	23.2	72.8	0.89
chr4	40867931	40868167	CpG: 18	236	18	140	15.3	59.3	0.88
chr4	41006631	41006904	CpG: 25	273	25	169	18.3	61.9	0.96
chr4	41022640	41023410	CpG: 66	770	66	545	17.1	70.8	0.68
chr4	41074991	41075276	CpG: 25	285	25	178	17.5	62.5	0.91
chr4	41187649	41188591	CpG: 95	942	95	685	20.2	72.7	0.76
chr4	41190092	41190552	CpG: 50	460	50	332	21.7	72.2	0.84
chr4	41228702	41228986	CpG: 23	284	23	176	16.2	62.0	0.86
chr4	41230530	41231638	CpG: 123	1108	123	799	22.2	72.1	0.85
chr4	41254322	41254583	CpG: 21	261	21	158	16.1	60.5	0.90
chr4	41334018	41335405	CpG: 149	1387	149	988	21.5	71.2	0.85
chr4	41399819	41400098	CpG: 24	279	24	174	17.2	62.4	0.89
chr4	41501301	41501576	CpG: 22	275	22	169	16.0	61.5	0.86
chr4	41618033	41618323	CpG: 32	290	32	202	22.1	69.7	0.91
chr4	41719264	41721567	CpG: 170	2303	170	1403	14.8	60.9	0.80
chr4	41724036	41724258	CpG: 17	222	17	134	15.3	60.4	0.85
chr4	41725425	41725703	CpG: 28	278	28	206	20.1	74.1	0.73
chr4	41757304	41757547	CpG: 18	243	18	140	14.8	57.6	0.92
chr4	41839150	41839351	CpG: 20	201	20	134	19.9	66.7	0.93
chr4	41840939	41841224	CpG: 34	285	34	213	23.9	74.7	0.86
chr4	41847236	41847585	CpG: 31	349	31	232	17.8	66.5	0.80
chr4	41852016	41852292	CpG: 25	276	25	189	18.1	68.5	0.77
chr4	41852969	41853210	CpG: 21	241	21	161	17.4	66.8	0.78
chr4	41854242	41854756	CpG: 34	514	34	292	13.2	56.8	0.82
chr4	41855284	41856362	CpG: 111	1078	111	748	20.6	69.4	0.86
chr4	41908892	41909418	CpG: 45	526	45	337	17.1	64.1	0.83
chr4	41937285	41937559	CpG: 24	274	24	171	17.5	62.4	0.91
chr4	41954444	41955040	CpG: 40	596	40	338	13.4	56.7	0.83
chr4	41955724	41955985	CpG: 21	261	21	141	16.1	54.0	1.12
chr4	41964287	41964935	CpG: 61	648	61	422	18.8	65.1	0.89
chr4	42059647	42059921	CpG: 24	274	24	170	17.5	62.0	0.92
chr4	42080217	42080437	CpG: 17	220	17	132	15.5	60.0	0.89
chr4	42124685	42126903	CpG: 246	2218	246	1515	22.2	68.3	0.97
chr4	42206925	42207167	CpG: 18	242	18	145	14.9	59.9	0.85
chr4	42230711	42230990	CpG: 21	279	21	168	15.1	60.2	0.84
chr4	42289246	42289511	CpG: 23	265	23	193	17.4	72.8	0.66
chr4	42343452	42343722	CpG: 26	270	26	192	19.3	71.1	0.77
chr4	42370996	42372646	CpG: 154	1650	154	1120	18.7	67.9	0.82
chr4	42372709	42372927	CpG: 15	218	15	115	13.8	52.8	1.04
chr4	42630131	42631525	CpG: 133	1394	133	944	19.1	67.7	0.84
chr4	42705616	42705850	CpG: 18	234	18	140	15.4	59.8	0.89
chr4	42743421	42743699	CpG: 26	278	26	176	18.7	63.3	0.94
chr4	42957578	42957808	CpG: 19	230	19	140	16.5	60.9	0.90
chr4	43296156	43296433	CpG: 23	277	23	170	16.6	61.4	0.89
chr4	43363958	43364248	CpG: 24	290	24	184	16.6	63.4	0.83
chr4	43365428	43365709	CpG: 23	281	23	175	16.4	62.3	0.86
chr4	43564099	43564377	CpG: 21	278	21	167	15.1	60.1	0.85
chr4	43607213	43607491	CpG: 22	278	22	171	15.8	61.5	0.85
chr4	44134564	44134858	CpG: 26	294	26	221	17.7	75.2	0.63
chr4	44283905	44284191	CpG: 24	286	24	179	16.8	62.6	0.87
chr4	44302524	44302798	CpG: 22	274	22	169	16.1	61.7	0.86
chr4	44415093	44416840	CpG: 199	1747	199	1191	22.8	68.2	0.98
chr4	44541352	44541626	CpG: 20	274	20	167	14.6	60.9	0.79
chr4	44645249	44645647	CpG: 44	398	44	263	22.1	66.1	1.01
chr4	44692940	44693626	CpG: 65	686	65	447	19.0	65.2	0.89
chr4	44811866	44812091	CpG: 16	225	16	127	14.2	56.4	0.91
chr4	44858537	44858765	CpG: 17	228	17	138	14.9	60.5	0.84
chr4	44864272	44864534	CpG: 21	262	21	163	16.0	62.2	0.84
chr4	45421007	45421245	CpG: 18	238	18	138	15.1	58.0	0.91
chr4	45668648	45668921	CpG: 23	273	23	173	16.8	63.4	0.85
chr4	45948482	45948718	CpG: 18	236	18	141	15.3	59.7	0.88
chr4	45960673	45960942	CpG: 21	269	21	163	15.6	60.6	0.86
chr4	46256799	46257062	CpG: 22	263	22	162	16.7	61.6	0.89
chr4	46357065	46357734	CpG: 66	669	66	481	19.7	71.9	0.78
chr4	46578217	46578502	CpG: 25	285	25	175	17.5	61.4	0.94
chr4	46588615	46588823	CpG: 16	208	16	122	15.4	58.7	0.90
chr4	46603276	46603512	CpG: 22	236	22	144	18.6	61.0	1.03
chr4	46960466	46961210	CpG: 59	744	59	472	15.9	63.4	0.80
chr4	46972485	46972704	CpG: 15	219	15	129	13.7	58.9	0.80
chr4	46999812	47000325	CpG: 44	513	44	334	17.2	65.1	0.81
chr4	47092993	47093267	CpG: 21	274	21	168	15.3	61.3	0.82
chr4	47343712	47343988	CpG: 21	276	21	168	15.2	60.9	0.83
chr4	47345371	47345768	CpG: 35	397	35	288	17.6	72.5	0.67
chr4	47365956	47366302	CpG: 25	346	25	203	14.5	58.7	0.85
chr4	47393034	47393247	CpG: 21	213	21	141	19.7	66.2	0.91
chr4	47430843	47431152	CpG: 37	309	37	219	23.9	70.9	0.97
chr4	47532343	47532589	CpG: 21	246	21	151	17.1	61.4	0.93
chr4	47543290	47543520	CpG: 21	230	21	141	18.3	61.3	0.99
chr4	47673772	47674041	CpG: 18	269	18	154	13.4	57.2	0.82
chr4	47796213	47796448	CpG: 18	235	18	139	15.3	59.1	0.90
chr4	47803919	47805261	CpG: 95	1342	95	876	14.2	65.3	0.66
chr4	47881145	47882164	CpG: 85	1019	85	661	16.7	64.9	0.80
chr4	47983546	47984495	CpG: 81	949	81	636	17.1	67.0	0.77
chr4	48024725	48025034	CpG: 22	309	22	180	14.2	58.3	0.84
chr4	48064848	48065078	CpG: 18	230	18	141	15.7	61.3	0.84
chr4	48066971	48067237	CpG: 26	266	26	166	19.5	62.4	1.02
chr4	48152917	48153836	CpG: 69	919	69	648	15.0	70.5	0.60
chr4	48203215	48203489	CpG: 22	274	22	165	16.1	60.2	0.90
chr4	48236288	48237223	CpG: 93	935	93	648	19.9	69.3	0.83
chr4	48245531	48245807	CpG: 24	276	24	171	17.4	62.0	0.91
chr4	48286507	48286740	CpG: 19	233	19	141	16.3	60.5	0.90
chr4	48308074	48309314	CpG: 145	1240	145	905	23.4	73.0	0.88
chr4	48343703	48343931	CpG: 20	228	20	141	17.5	61.8	0.95
chr4	48450309	48451494	CpG: 143	1185	143	857	24.1	72.3	0.92
chr4	48457134	48458583	CpG: 186	1449	186	1077	25.7	74.3	0.94
chr4	48641912	48642144	CpG: 21	232	21	167	18.1	72.0	0.70
chr4	48745883	48746891	CpG: 129	1008	129	730	25.6	72.4	0.98
chr4	48797377	48798139	CpG: 57	762	57	481	15.0	63.1	0.75
chr4	48872869	48873427	CpG: 53	558	53	404	19.0	72.4	0.73
chr4	48952378	48953396	CpG: 94	1018	94	694	18.5	68.2	0.80
chr4	49120258	49120557	CpG: 24	299	24	203	16.1	67.9	0.71
chr4	49146029	49146288	CpG: 20	259	20	157	15.4	60.6	0.85
chr4	49233985	49234372	CpG: 35	387	35	265	18.1	68.5	0.77
chr4	49293963	49294350	CpG: 35	387	35	265	18.1	68.5	0.77
chr4	49453086	49453573	CpG: 46	487	46	337	18.9	69.2	0.80
chr4	55180260	55180686	CpG: 32	426	32	255	15.0	59.9	0.84
chr4	55323346	55323608	CpG: 26	262	26	166	19.8	63.4	1.00
chr4	55328560	55330918	CpG: 199	2358	199	1620	16.9	68.7	0.79
chr4	55514296	55514569	CpG: 24	273	24	167	17.6	61.2	0.95
chr4	55523824	55524685	CpG: 86	861	86	624	20.0	72.5	0.78
chr4	55537162	55538054	CpG: 80	892	80	580	17.9	65.0	0.85
chr4	55562748	55563018	CpG: 23	270	23	176	17.0	65.2	0.81
chr4	56025499	56025786	CpG: 21	287	21	172	14.6	59.9	0.82
chr4	56096835	56097108	CpG: 25	273	25	169	18.3	61.9	0.96
chr4	56145686	56146955	CpG: 161	1269	161	937	25.4	73.8	0.94
chr4	56199086	56199966	CpG: 93	880	93	617	21.1	70.1	0.86
chr4	56208917	56209463	CpG: 46	546	46	369	16.8	67.6	0.74
chr4	56237840	56238560	CpG: 71	720	71	498	19.7	69.2	0.83
chr4	56295061	56295339	CpG: 24	278	24	175	17.3	62.9	0.88
chr4	56303353	56303780	CpG: 32	427	32	257	15.0	60.2	0.83
chr4	56348749	56349712	CpG: 116	963	116	699	24.1	72.6	0.92
chr4	56625949	56626583	CpG: 46	634	46	434	14.5	68.5	0.62
chr4	56734848	56735131	CpG: 24	283	24	175	17.0	61.8	0.90
chr4	56825845	56826123	CpG: 20	278	20	171	14.4	61.5	0.77
chr4	56850800	56851026	CpG: 22	226	22	140	19.5	61.9	1.05
chr4	56852783	56853395	CpG: 43	612	43	375	14.1	61.3	0.75
chr4	56864717	56865472	CpG: 88	755	88	530	23.3	70.2	0.95
chr4	56907160	56907382	CpG: 19	222	19	135	17.1	60.8	0.95
chr4	57551320	57552156	CpG: 110	836	110	608	26.3	72.7	1.00
chr4	57579056	57579619	CpG: 45	563	45	344	16.0	61.1	0.86
chr4	57587247	57589147	CpG: 151	1900	151	1205	15.9	63.4	0.79
chr4	57596463	57597278	CpG: 56	815	56	497	13.7	61.0	0.75
chr4	57604274	57604511	CpG: 20	237	20	147	16.9	62.0	0.90
chr4	57611792	57612024	CpG: 17	232	17	136	14.7	58.6	0.87
chr4	57636523	57636988	CpG: 51	465	51	350	21.9	75.3	0.78
chr4	57642497	57642885	CpG: 30	388	30	278	15.5	71.6	0.60
chr4	57669103	57669379	CpG: 22	276	22	171	15.9	62.0	0.84
chr4	57715547	57715828	CpG: 26	281	26	185	18.5	65.8	0.85
chr4	57716907	57717179	CpG: 24	272	24	175	17.6	64.3	0.85
chr4	57718625	57722917	CpG: 346	4292	346	2773	16.1	64.6	0.78
chr4	57975858	57976143	CpG: 24	285	24	178	16.8	62.5	0.88
chr4	58029093	58029371	CpG: 25	278	25	175	18.0	62.9	0.92
chr4	58105039	58105316	CpG: 24	277	24	175	17.3	63.2	0.87
chr4	58121284	58121576	CpG: 24	292	24	214	16.4	73.3	0.62
chr4	58145983	58147871	CpG: 184	1888	184	1280	19.5	67.8	0.85
chr4	58244480	58244750	CpG: 22	270	22	162	16.3	60.0	0.91
chr4	58379520	58379731	CpG: 18	211	18	129	17.1	61.1	0.93
chr4	58511101	58511331	CpG: 19	230	19	141	16.5	61.3	0.89
chr4	58613211	58614476	CpG: 98	1265	98	810	15.5	64.0	0.76
chr4	58645728	58646044	CpG: 32	316	32	230	20.3	72.8	0.78
chr4	58834255	58835024	CpG: 96	769	96	564	25.0	73.3	0.93
chr4	58883674	58884700	CpG: 123	1026	123	747	24.0	72.8	0.92
chr4	59033954	59035318	CpG: 159	1364	159	993	23.3	72.8	0.90
chr4	59091769	59092005	CpG: 20	236	20	144	16.9	61.0	0.92
chr4	59107352	59107779	CpG: 33	427	33	259	15.5	60.7	0.84
chr4	59123917	59124670	CpG: 77	753	77	531	20.5	70.5	0.82
chr4	59188732	59189021	CpG: 25	289	25	174	17.3	60.2	0.96
chr4	59216517	59216801	CpG: 24	284	24	179	16.9	63.0	0.86
chr4	59261957	59262231	CpG: 20	274	20	164	14.6	59.9	0.82
chr4	59281605	59282123	CpG: 44	518	44	360	17.0	69.5	0.70
chr4	59341683	59342207	CpG: 51	524	51	339	19.5	64.7	0.94
chr4	59436762	59437537	CpG: 87	775	87	544	22.5	70.2	0.92
chr4	59535665	59535881	CpG: 16	216	16	127	14.8	58.8	0.86
chr4	59537143	59537924	CpG: 109	781	109	607	27.9	77.7	0.92
chr4	59558305	59558572	CpG: 22	267	22	164	16.5	61.4	0.90
chr4	59559843	59560118	CpG: 23	275	23	171	16.7	62.2	0.88
chr4	59704722	59705003	CpG: 23	281	23	174	16.4	61.9	0.87
chr4	59802028	59803968	CpG: 138	1940	138	1253	14.2	64.6	0.70
chr4	59864764	59865038	CpG: 22	274	22	169	16.1	61.7	0.85
chr4	59874512	59874793	CpG: 24	281	24	175	17.1	62.3	0.90
chr4	59875304	59875581	CpG: 33	277	33	176	23.8	63.5	1.20
chr4	59896528	59896753	CpG: 20	225	20	141	17.8	62.7	0.91
chr4	59923164	59924494	CpG: 128	1330	128	887	19.2	66.7	0.87
chr4	59924846	59925175	CpG: 26	329	26	183	15.8	55.6	1.10
chr4	59955301	59956035	CpG: 62	734	62	463	16.9	63.1	0.85
chr4	59993422	59993862	CpG: 48	440	48	292	21.8	66.4	0.99
chr4	60018279	60019111	CpG: 66	832	66	533	15.9	64.1	0.77
chr4	60032651	60033062	CpG: 32	411	32	271	15.6	65.9	0.72
chr4	60080484	60080877	CpG: 46	393	46	296	23.4	75.3	0.84
chr4	60143321	60144357	CpG: 105	1036	105	731	20.3	70.6	0.83
chr4	60181329	60182066	CpG: 60	737	60	521	16.3	70.7	0.65
chr4	60224701	60224978	CpG: 25	277	25	174	18.1	62.8	0.92
chr4	60239872	60240134	CpG: 20	262	20	155	15.3	59.2	0.89
chr4	60309356	60309777	CpG: 51	421	51	303	24.2	72.0	0.95
chr4	60338969	60339242	CpG: 23	273	23	173	16.8	63.4	0.85
chr4	60376923	60377198	CpG: 20	275	20	164	14.5	59.6	0.84
chr4	60399119	60400860	CpG: 207	1741	207	1276	23.8	73.3	0.89
chr4	60467916	60470484	CpG: 195	2568	195	1531	15.2	59.6	0.86
chr4	60601081	60602137	CpG: 132	1056	132	782	25.0	74.1	0.91
chr4	60626816	60627110	CpG: 23	294	23	180	15.6	61.2	0.85
chr4	60655036	60655721	CpG: 58	685	58	435	16.9	63.5	0.84
chr4	60664021	60664890	CpG: 66	869	66	600	15.2	69.0	0.64
chr4	60685847	60686323	CpG: 38	476	38	298	16.0	62.6	0.81
chr4	60686951	60687315	CpG: 34	364	34	236	18.7	64.8	0.89
chr4	60714887	60715573	CpG: 56	686	56	475	16.3	69.2	0.68
chr4	61208257	61208523	CpG: 19	266	19	162	14.3	60.9	0.78
chr4	61283154	61283393	CpG: 18	239	18	143	15.1	59.8	0.87
chr4	61663379	61663594	CpG: 15	215	15	123	14.0	57.2	0.87
chr4	61709931	61710201	CpG: 22	270	22	169	16.3	62.6	0.84
chr4	61819257	61819530	CpG: 25	273	25	170	18.3	62.3	0.96
chr4	61987584	61987794	CpG: 18	210	18	128	17.1	61.0	0.92
chr4	62233049	62233323	CpG: 23	274	23	171	16.8	62.4	0.87
chr4	62358921	62359160	CpG: 21	239	21	146	17.6	61.1	0.96
chr4	62425679	62425901	CpG: 16	222	16	129	14.4	58.1	0.89
chr4	62668988	62669241	CpG: 19	253	19	152	15.0	60.1	0.84
chr4	62769232	62769510	CpG: 23	278	23	163	16.5	58.6	0.97
chr4	62779605	62779883	CpG: 22	278	22	170	15.8	61.2	0.85
chr4	62908780	62909020	CpG: 18	240	18	144	15.0	60.0	0.86
chr4	62920116	62920354	CpG: 19	238	19	147	16.0	61.8	0.85
chr4	63239425	63239657	CpG: 18	232	18	139	15.5	59.9	0.87
chr4	63613818	63614104	CpG: 23	286	23	172	16.1	60.1	0.90
chr4	63725148	63725426	CpG: 23	278	23	170	16.5	61.2	0.90
chr4	64065125	64065347	CpG: 21	222	21	137	18.9	61.7	1.01
chr4	64099533	64099803	CpG: 22	270	22	165	16.3	61.1	0.88
chr4	64399889	64400174	CpG: 25	285	25	179	17.5	62.8	0.90
chr4	64638016	64641021	CpG: 252	3005	252	1947	16.8	64.8	0.80
chr4	64653552	64653787	CpG: 19	235	19	142	16.2	60.4	0.90
chr4	64697090	64697325	CpG: 17	235	17	138	14.5	58.7	0.87
chr4	64955118	64955353	CpG: 17	235	17	155	14.5	66.0	0.67
chr4	65187808	65188085	CpG: 25	277	25	175	18.1	63.2	0.91
chr4	65213262	65213579	CpG: 25	317	25	192	15.8	60.6	0.88
chr4	65300524	65300798	CpG: 23	274	23	169	16.8	61.7	0.89
chr4	65312113	65312394	CpG: 23	281	23	173	16.4	61.6	0.88
chr4	65382878	65383204	CpG: 25	326	25	192	15.3	58.9	0.89
chr4	65723374	65723636	CpG: 22	262	22	162	16.8	61.8	0.89
chr4	65922960	65923197	CpG: 19	237	19	143	16.0	60.3	0.89
chr4	65928610	65928855	CpG: 17	245	17	141	13.9	57.6	0.85
chr4	65929398	65929789	CpG: 38	391	38	289	19.4	73.9	0.71
chr4	66010004	66010275	CpG: 20	271	20	163	14.8	60.1	0.82
chr4	66039820	66040130	CpG: 23	310	23	178	14.8	57.4	0.90
chr4	66169807	66170133	CpG: 26	326	26	194	16.0	59.5	0.90
chr4	66246198	66246437	CpG: 17	239	17	146	14.2	61.1	0.79
chr4	66785820	66786557	CpG: 61	737	61	520	16.6	70.6	0.67
chr4	67013547	67013828	CpG: 23	281	23	173	16.4	61.6	0.88
chr4	67134148	67134422	CpG: 25	274	25	173	18.2	63.1	0.93
chr4	67164943	67165219	CpG: 20	276	20	168	14.5	60.9	0.79
chr4	67187991	67188224	CpG: 16	233	16	136	13.7	58.4	0.81
chr4	67380046	67380376	CpG: 33	330	33	248	20.0	75.2	0.71
chr4	67651760	67652043	CpG: 23	283	23	174	16.3	61.5	0.87
chr4	67671245	67671511	CpG: 24	266	24	168	18.0	63.2	0.92
chr4	67770743	67771027	CpG: 23	284	23	175	16.2	61.6	0.87
chr4	67891474	67891684	CpG: 17	210	17	127	16.2	60.5	0.91
chr4	68301853	68302279	CpG: 32	426	32	259	15.0	60.8	0.82
chr4	68730818	68731044	CpG: 17	226	17	133	15.0	58.8	0.87
chr4	68967845	68968126	CpG: 24	281	24	175	17.1	62.3	0.90
chr4	69064186	69064418	CpG: 21	232	21	137	18.1	59.1	1.06
chr4	69107830	69109314	CpG: 103	1484	103	902	13.9	60.8	0.75
chr4	69115508	69115782	CpG: 21	274	21	168	15.3	61.3	0.83
chr4	69305669	69305909	CpG: 20	240	20	148	16.7	61.7	0.93
chr4	69327775	69328005	CpG: 18	230	18	139	15.7	60.4	0.87
chr4	69423917	69424147	CpG: 20	230	20	141	17.4	61.3	0.94
chr4	69543477	69543745	CpG: 22	268	22	163	16.4	60.8	0.91
chr4	69623914	69624176	CpG: 20	262	20	156	15.3	59.5	0.87
chr4	69684436	69684714	CpG: 26	278	26	177	18.7	63.7	0.93
chr4	69814685	69814953	CpG: 21	268	21	162	15.7	60.4	0.86
chr4	69838811	69839096	CpG: 25	285	25	178	17.5	62.5	0.92
chr4	69914732	69914969	CpG: 21	237	21	144	17.7	60.8	0.98
chr4	70004132	70004507	CpG: 34	375	34	272	18.1	72.5	0.69
chr4	70114872	70115146	CpG: 25	274	25	172	18.2	62.8	0.94
chr4	70152434	70152705	CpG: 20	271	20	167	14.8	61.6	0.78
chr4	70442736	70442972	CpG: 18	236	18	145	15.3	61.4	0.82
chr4	70541084	70541316	CpG: 19	232	19	145	16.4	62.5	0.85
chr4	70595078	70595463	CpG: 34	385	34	277	17.7	71.9	0.68
chr4	70620371	70620595	CpG: 20	224	20	135	17.9	60.3	0.98
chr4	70847165	70847445	CpG: 22	280	22	160	15.7	57.1	0.97
chr4	70988373	70988872	CpG: 47	499	47	332	18.8	66.5	0.88
chr4	71143995	71144468	CpG: 45	473	45	334	19.0	70.6	0.76
chr4	71235259	71235540	CpG: 23	281	23	175	16.4	62.3	0.86
chr4	71260078	71260348	CpG: 23	270	23	164	17.0	60.7	0.94
chr4	71522268	71522554	CpG: 25	286	25	180	17.5	62.9	0.90
chr4	71563933	71564211	CpG: 25	278	25	175	18.0	62.9	0.92
chr4	71625517	71625892	CpG: 27	375	27	240	14.4	64.0	0.71
chr4	71790654	71791271	CpG: 67	617	67	413	21.7	66.9	1.00
chr4	72968761	72969031	CpG: 23	270	23	167	17.0	61.9	0.90
chr4	72998976	72999202	CpG: 16	226	16	129	14.2	57.1	0.87
chr4	73086325	73086562	CpG: 19	237	19	140	16.0	59.1	0.96
chr4	73371830	73372049	CpG: 19	219	19	140	17.4	63.9	0.85
chr4	73440016	73440240	CpG: 17	224	17	130	15.2	58.0	0.92
chr4	73472256	73472531	CpG: 22	275	22	167	16.0	60.7	0.87
chr4	73494700	73494942	CpG: 19	242	19	147	15.7	60.7	0.87
chr4	73724933	73725200	CpG: 24	267	24	167	18.0	62.5	0.93
chr4	73751290	73751578	CpG: 22	288	22	179	15.3	62.2	0.80
chr4	74030605	74031224	CpG: 55	619	55	367	17.8	59.3	1.02
chr4	74046896	74048375	CpG: 173	1479	173	1089	23.4	73.6	0.87
chr4	74180352	74180680	CpG: 25	328	25	194	15.2	59.1	0.87
chr4	74181416	74182488	CpG: 122	1072	122	778	22.8	72.6	0.87
chr4	74244514	74245384	CpG: 87	870	87	609	20.0	70.0	0.83
chr4	74278361	74278601	CpG: 19	240	19	146	15.8	60.8	0.87
chr4	74307954	74308228	CpG: 21	274	21	171	15.3	62.4	0.80
chr4	74335878	74336604	CpG: 74	726	74	509	20.4	70.1	0.83
chr4	74363510	74363791	CpG: 22	281	22	175	15.7	62.3	0.82
chr4	74384960	74385236	CpG: 25	276	25	171	18.1	62.0	0.95
chr4	74401857	74402152	CpG: 22	295	22	178	14.9	60.3	0.82
chr4	74528784	74530010	CpG: 146	1226	146	886	23.8	72.3	0.91
chr4	74535435	74535705	CpG: 19	270	19	165	14.1	61.1	0.76
chr4	74674744	74675010	CpG: 25	266	25	167	18.8	62.8	0.96
chr4	75030723	75030945	CpG: 18	222	18	132	16.2	59.5	0.94
chr4	75262361	75262627	CpG: 27	266	27	170	20.3	63.9	1.00
chr4	75373876	75374276	CpG: 30	400	30	260	15.0	65.0	0.73
chr4	75380990	75381380	CpG: 28	390	28	230	14.4	59.0	0.84
chr4	75469368	75469642	CpG: 25	274	25	174	18.2	63.5	0.92
chr4	75551005	75551233	CpG: 20	228	20	138	17.5	60.5	0.97
chr4	75877605	75877821	CpG: 17	216	17	127	15.7	58.8	0.93
chr4	75911405	75911911	CpG: 34	506	34	314	13.4	62.1	0.71
chr4	75912476	75912942	CpG: 51	466	51	339	21.9	72.7	0.85
chr4	76283283	76283513	CpG: 17	230	17	133	14.8	57.8	0.90
chr4	76367256	76367530	CpG: 25	274	25	171	18.2	62.4	0.95
chr4	76394957	76395176	CpG: 21	219	21	135	19.2	61.6	1.02
chr4	76412842	76413548	CpG: 71	706	71	470	20.1	66.6	0.91
chr4	76601941	76603059	CpG: 122	1118	122	777	21.8	69.5	0.91
chr4	76612937	76613194	CpG: 22	257	22	162	17.1	63.0	0.88
chr4	76648488	76648713	CpG: 19	225	19	139	16.9	61.8	0.92
chr4	76745659	76745868	CpG: 17	209	17	127	16.3	60.8	0.91
chr4	76785007	76785283	CpG: 21	276	21	168	15.2	60.9	0.83
chr4	77180349	77180556	CpG: 23	207	23	152	22.2	73.4	0.85
chr4	77197035	77197287	CpG: 18	252	18	167	14.3	66.3	0.65
chr4	77212838	77213464	CpG: 54	626	54	434	17.3	69.3	0.74
chr4	77265546	77265827	CpG: 25	281	25	175	17.8	62.3	0.93
chr4	77287815	77288035	CpG: 28	220	28	170	25.5	77.3	0.87
chr4	77325459	77325761	CpG: 22	302	22	198	14.6	65.6	0.68
chr4	77342031	77342247	CpG: 26	216	26	153	24.1	70.8	0.96
chr4	77381844	77382480	CpG: 62	636	62	439	19.5	69.0	0.84
chr4	77442540	77443163	CpG: 62	623	62	431	19.9	69.2	0.84
chr4	77501455	77502078	CpG: 75	623	75	459	24.1	73.7	0.89
chr4	77707157	77707433	CpG: 25	276	25	170	18.1	61.6	0.96
chr4	77788628	77789082	CpG: 55	454	55	319	24.2	70.3	0.99
chr4	77962913	77963148	CpG: 20	235	20	142	17.0	60.4	0.95
chr4	78088360	78088584	CpG: 16	224	16	135	14.3	60.3	0.81
chr4	78133992	78134631	CpG: 49	639	49	436	15.3	68.2	0.68
chr4	78273152	78274855	CpG: 130	1703	130	1030	15.3	60.5	0.84
chr4	78276650	78276894	CpG: 18	244	18	142	14.8	58.2	0.90
chr4	78359859	78360144	CpG: 24	285	24	177	16.8	62.1	0.88
chr4	78399350	78399576	CpG: 17	226	17	130	15.0	57.5	0.94
chr4	78809235	78809516	CpG: 24	281	24	174	17.1	61.9	0.91
chr4	78854389	78854957	CpG: 56	568	56	375	19.7	66.0	0.91
chr4	78901103	78901345	CpG: 23	242	23	148	19.0	61.2	1.05
chr4	78920868	78921138	CpG: 22	270	22	166	16.3	61.5	0.87
chr4	78929447	78929725	CpG: 24	278	24	174	17.3	62.6	0.89
chr4	78943139	78943421	CpG: 22	282	22	174	15.6	61.7	0.84
chr4	78947997	78948353	CpG: 28	356	28	204	15.7	57.3	0.98
chr4	78968300	78968536	CpG: 19	236	19	139	16.1	58.9	0.95
chr4	78970309	78971022	CpG: 56	713	56	463	15.7	64.9	0.75
chr4	79012578	79013863	CpG: 126	1285	126	819	19.6	63.7	1.00
chr4	79034587	79034801	CpG: 21	214	21	139	19.6	65.0	0.96
chr4	79064482	79065401	CpG: 76	919	76	607	16.5	66.1	0.76
chr4	79066130	79066364	CpG: 17	234	17	139	14.5	59.4	0.83
chr4	79193249	79193462	CpG: 15	213	15	122	14.1	57.3	0.86
chr4	79199538	79199758	CpG: 19	220	19	131	17.3	59.5	1.00
chr4	79201755	79202029	CpG: 24	274	24	171	17.5	62.4	0.91
chr4	79227825	79228052	CpG: 17	227	17	136	15.0	59.9	0.85
chr4	79280424	79281761	CpG: 132	1337	132	925	19.7	69.2	0.83
chr4	79331189	79331598	CpG: 32	409	32	234	15.6	57.2	0.96
chr4	79419461	79419740	CpG: 21	279	21	169	15.1	60.6	0.83
chr4	79470250	79470524	CpG: 20	274	20	163	14.6	59.5	0.84
chr4	79488585	79489191	CpG: 54	606	54	403	17.8	66.5	0.81
chr4	79554081	79554892	CpG: 100	811	100	590	24.7	72.7	0.93
chr4	79575711	79575986	CpG: 20	275	20	164	14.5	59.6	0.83
chr4	79592113	79592586	CpG: 55	473	55	325	23.3	68.7	0.99
chr4	79646800	79648047	CpG: 110	1247	110	869	17.6	69.7	0.73
chr4	79761584	79762281	CpG: 78	697	78	503	22.4	72.2	0.87
chr4	79763608	79764448	CpG: 63	840	63	583	15.0	69.4	0.62
chr4	79926664	79926926	CpG: 23	262	23	162	17.6	61.8	0.92
chr4	79974075	79974338	CpG: 21	263	21	161	16.0	61.2	0.87
chr4	80029873	80030577	CpG: 92	704	92	514	26.1	73.0	0.99
chr4	80081000	80082635	CpG: 148	1635	148	1128	18.1	69.0	0.76
chr4	80142635	80142967	CpG: 27	332	27	204	16.3	61.4	0.88
chr4	80237624	80239209	CpG: 156	1585	156	1136	19.7	71.7	0.77
chr4	80289097	80291782	CpG: 233	2685	233	1810	17.4	67.4	0.77
chr4	80416059	80417209	CpG: 122	1150	122	787	21.2	68.4	0.93
chr4	80453954	80454216	CpG: 26	262	26	191	19.8	72.9	0.75
chr4	80497636	80499232	CpG: 151	1596	151	1096	18.9	68.7	0.81
chr4	80533376	80533612	CpG: 17	236	17	139	14.4	58.9	0.84
chr4	80649267	80649525	CpG: 20	258	20	158	15.5	61.2	0.86
chr4	80762170	80762444	CpG: 24	274	24	171	17.5	62.4	0.91
chr4	80958450	80958692	CpG: 18	242	18	144	14.9	59.5	0.86
chr4	81004209	81004490	CpG: 24	281	24	175	17.1	62.3	0.90
chr4	81119522	81119761	CpG: 19	239	19	142	15.9	59.4	0.93
chr4	81159317	81161187	CpG: 224	1870	224	1363	24.0	72.9	0.90
chr4	81203412	81203682	CpG: 20	270	20	142	14.8	52.6	1.10
chr4	81398027	81398944	CpG: 83	917	83	595	18.1	64.9	0.86
chr4	81399704	81400072	CpG: 35	368	35	265	19.0	72.0	0.74
chr4	81446557	81446866	CpG: 24	309	24	182	15.5	58.9	0.90
chr4	81522550	81522911	CpG: 34	361	34	231	18.8	64.0	0.92
chr4	81575097	81575327	CpG: 18	230	18	138	15.7	60.0	0.88
chr4	81579185	81579456	CpG: 24	271	24	168	17.7	62.0	0.93
chr4	81773277	81773563	CpG: 23	286	23	178	16.1	62.2	0.85
chr4	81887217	81887588	CpG: 46	371	46	274	24.8	73.9	0.91
chr4	82014275	82014556	CpG: 22	281	22	174	15.7	61.9	0.83
chr4	82111144	82112408	CpG: 151	1264	151	927	23.9	73.3	0.89
chr4	82274677	82275209	CpG: 68	532	68	398	25.6	74.8	0.91
chr4	82490698	82490950	CpG: 21	252	21	159	16.7	63.1	0.85
chr4	82580431	82580708	CpG: 22	277	22	177	15.9	63.9	0.78
chr4	82620385	82620668	CpG: 23	283	23	174	16.3	61.5	0.87
chr4	82768631	82768912	CpG: 23	281	23	174	16.4	61.9	0.87
chr4	82874247	82874477	CpG: 19	230	19	137	16.5	59.6	0.94
chr4	83040260	83040569	CpG: 25	309	25	184	16.2	59.5	0.92
chr4	83113029	83113264	CpG: 20	235	20	142	17.0	60.4	0.96
chr4	83274134	83274560	CpG: 33	426	33	256	15.5	60.1	0.86
chr4	83301079	83301539	CpG: 48	460	48	285	20.9	62.0	1.09
chr4	83315452	83315668	CpG: 16	216	16	130	14.8	60.2	0.83
chr4	83402516	83403551	CpG: 86	1035	86	717	16.6	69.3	0.69
chr4	83433606	83433842	CpG: 21	236	21	145	17.8	61.4	0.96
chr4	83513978	83514744	CpG: 69	766	69	553	18.0	72.2	0.70
chr4	83519122	83519695	CpG: 46	573	46	374	16.1	65.3	0.75
chr4	83527393	83527859	CpG: 37	466	37	296	15.9	63.5	0.79
chr4	83528351	83528647	CpG: 33	296	33	202	22.3	68.2	0.98
chr4	83532385	83534100	CpG: 183	1715	183	1202	21.3	70.1	0.87
chr4	83537492	83537954	CpG: 38	462	38	305	16.5	66.0	0.76
chr4	83596716	83597135	CpG: 43	419	43	286	20.5	68.3	0.89
chr4	83666311	83666541	CpG: 33	230	33	164	28.7	71.3	1.14
chr4	83716424	83716906	CpG: 41	482	41	322	17.0	66.8	0.77
chr4	83744135	83744405	CpG: 22	270	22	166	16.3	61.5	0.87
chr4	83777240	83777476	CpG: 22	236	22	146	18.6	61.9	0.99
chr4	83921208	83921438	CpG: 19	230	19	140	16.5	60.9	0.90
chr4	84212431	84212661	CpG: 20	230	20	139	17.4	60.4	0.97
chr4	84360766	84361687	CpG: 97	921	97	628	21.1	68.2	0.91
chr4	84483609	84483830	CpG: 19	221	19	131	17.2	59.3	0.98
chr4	84484598	84484876	CpG: 23	278	23	171	16.5	61.5	0.88
chr4	84544436	84545083	CpG: 76	647	76	461	23.5	71.3	0.93
chr4	84759297	84759622	CpG: 25	325	25	205	15.4	63.1	0.82
chr4	84801161	84801973	CpG: 89	812	89	566	21.9	69.7	0.91
chr4	85035649	85035885	CpG: 20	236	20	145	16.9	61.4	0.93
chr4	85373643	85374369	CpG: 81	726	81	530	22.3	73.0	0.84
chr4	85406893	85407401	CpG: 33	508	33	331	13.0	65.2	0.62
chr4	85539406	85539684	CpG: 21	278	21	168	15.1	60.4	0.83
chr4	85614114	85614628	CpG: 57	514	57	368	22.2	71.6	0.89
chr4	85702739	85703914	CpG: 138	1175	138	803	23.5	68.3	1.04
chr4	85706291	85706514	CpG: 16	223	16	130	14.3	58.3	0.86
chr4	85725344	85725585	CpG: 20	241	20	150	16.6	62.2	0.88
chr4	85736355	85736630	CpG: 18	275	18	165	13.1	60.0	0.74
chr4	85736838	85737074	CpG: 17	236	17	139	14.4	58.9	0.84
chr4	85740685	85740914	CpG: 18	229	18	138	15.7	60.3	0.89
chr4	85748838	85749112	CpG: 24	274	24	171	17.5	62.4	0.91
chr4	85758508	85760916	CpG: 255	2408	255	1630	21.2	67.7	0.93
chr4	85776331	85776619	CpG: 24	288	24	179	16.7	62.2	0.88
chr4	85778389	85778663	CpG: 24	274	24	170	17.5	62.0	0.92
chr4	85890758	85891513	CpG: 98	755	98	589	26.0	78.0	0.86
chr4	85900505	85900740	CpG: 19	235	19	139	16.2	59.1	0.95
chr4	86127077	86128308	CpG: 131	1231	131	880	21.3	71.5	0.84
chr4	86220030	86220780	CpG: 80	750	80	509	21.3	67.9	0.93
chr4	86229754	86230352	CpG: 63	598	63	386	21.1	64.5	1.02
chr4	86319731	86319989	CpG: 19	258	19	155	14.7	60.1	0.83
chr4	86339734	86340286	CpG: 54	552	54	380	19.6	68.8	0.85
chr4	86341424	86342462	CpG: 114	1038	114	732	22.0	70.5	0.89
chr4	86345507	86345786	CpG: 21	279	21	161	15.1	57.7	0.92
chr4	86361551	86361782	CpG: 20	231	20	141	17.3	61.0	0.94
chr4	86363638	86363880	CpG: 21	242	21	149	17.4	61.6	0.93
chr4	86437486	86437701	CpG: 17	215	17	127	15.8	59.1	0.91
chr4	86438660	86439339	CpG: 64	679	64	473	18.9	69.7	0.78
chr4	86459497	86459735	CpG: 17	238	17	141	14.3	59.2	0.83
chr4	86614324	86614963	CpG: 72	639	72	453	22.5	70.9	0.90
chr4	86630674	86630905	CpG: 19	231	19	140	16.5	60.6	0.91
chr4	86642508	86642783	CpG: 19	275	19	167	13.8	60.7	0.76
chr4	86664671	86665344	CpG: 58	673	58	462	17.2	68.6	0.74
chr4	86785580	86786151	CpG: 45	571	45	339	15.8	59.4	0.90
chr4	86814603	86815428	CpG: 91	825	91	566	22.1	68.6	0.95
chr4	86866061	86867041	CpG: 85	980	85	646	17.3	65.9	0.80
chr4	86904982	86905262	CpG: 23	280	23	176	16.4	62.9	0.84
chr4	87165633	87165864	CpG: 19	231	19	138	16.5	59.7	0.93
chr4	87223991	87224227	CpG: 18	236	18	142	15.3	60.2	0.85
chr4	87271916	87272191	CpG: 20	275	20	169	14.5	61.5	0.79
chr4	87456777	87457077	CpG: 23	300	23	174	15.3	58.0	0.92
chr4	87811591	87813352	CpG: 126	1761	126	1058	14.3	60.1	0.79
chr4	87813814	87814080	CpG: 20	266	20	159	15.0	59.8	0.86
chr4	87822840	87823717	CpG: 84	877	84	578	19.2	65.9	0.88
chr4	87826502	87829642	CpG: 254	3140	254	2066	16.2	65.8	0.75
chr4	87831772	87832033	CpG: 22	261	22	171	16.9	65.5	0.79
chr4	87912390	87913737	CpG: 138	1347	138	952	20.5	70.7	0.82
chr4	88074558	88074832	CpG: 24	274	24	172	17.5	62.8	0.90
chr4	88127616	88127842	CpG: 20	226	20	137	17.7	60.6	0.99
chr4	88295673	88296642	CpG: 125	969	125	746	25.8	77.0	0.87
chr4	88528182	88528460	CpG: 25	278	25	174	18.0	62.6	0.93
chr4	88716470	88716691	CpG: 19	221	19	136	17.2	61.5	0.92
chr4	88742298	88742533	CpG: 19	235	19	140	16.2	59.6	0.93
chr4	88805193	88805419	CpG: 27	226	27	171	23.9	75.7	1.05
chr4	88870775	88871049	CpG: 23	274	23	169	16.8	61.7	0.89
chr4	88905769	88905995	CpG: 18	226	18	134	15.9	59.3	0.92
chr4	88972806	88973087	CpG: 22	281	22	174	15.7	61.9	0.83
chr4	88992904	88993178	CpG: 25	274	25	176	18.2	64.2	0.90
chr4	89164803	89165037	CpG: 18	234	18	140	15.4	59.8	0.90
chr4	89210066	89210297	CpG: 19	231	19	142	16.5	61.5	0.89
chr4	89351047	89351435	CpG: 31	388	31	280	16.0	72.2	0.62
chr4	89405489	89405731	CpG: 20	242	20	146	16.5	60.3	0.91
chr4	89586279	89586481	CpG: 18	202	18	119	17.8	58.9	1.05
chr4	89633893	89634171	CpG: 22	278	22	171	15.8	61.5	0.85
chr4	89876821	89877059	CpG: 20	238	20	170	16.8	71.4	0.66
chr4	89905965	89906217	CpG: 18	252	18	150	14.3	59.5	0.82
chr4	89923515	89924304	CpG: 78	789	78	555	19.8	70.3	0.80
chr4	90141524	90141798	CpG: 24	274	24	170	17.5	62.0	0.92
chr4	90221417	90221963	CpG: 72	546	72	416	26.4	76.2	0.91
chr4	90223379	90223606	CpG: 17	227	17	137	15.0	60.4	0.83
chr4	90233502	90233856	CpG: 40	354	40	256	22.6	72.3	0.87
chr4	90264130	90265461	CpG: 133	1331	133	900	20.0	67.6	0.88
chr4	90298996	90299269	CpG: 22	273	22	170	16.1	62.3	0.85
chr4	90324805	90325537	CpG: 55	732	55	501	15.0	68.4	0.64
chr4	90336137	90336876	CpG: 79	739	79	505	21.4	68.3	0.92
chr4	90548718	90549821	CpG: 109	1103	109	786	19.8	71.3	0.78
chr4	90649448	90649723	CpG: 21	275	21	165	15.3	60.0	0.86
chr4	90657782	90658012	CpG: 21	230	21	140	18.3	60.9	1.00
chr4	90681740	90682166	CpG: 33	426	33	256	15.5	60.1	0.86
chr4	90699814	90700088	CpG: 25	274	25	171	18.2	62.4	0.95
chr4	90719281	90719490	CpG: 16	209	16	123	15.3	58.9	0.89
chr4	90724205	90724450	CpG: 18	245	18	138	14.7	56.3	0.96
chr4	90751569	90752051	CpG: 44	482	44	300	18.3	62.2	0.95
chr4	90753328	90753597	CpG: 21	269	21	155	15.6	57.6	0.95
chr4	90803819	90804055	CpG: 21	236	21	145	17.8	61.4	0.96
chr4	90904299	90904544	CpG: 20	245	20	149	16.3	60.8	0.91
chr4	90987643	90987917	CpG: 23	274	23	173	16.8	63.1	0.85
chr4	91036939	91037165	CpG: 21	226	21	138	18.6	61.1	1.00
chr4	91190132	91190515	CpG: 36	383	36	291	18.8	76.0	0.65
chr4	91333816	91334995	CpG: 167	1179	167	903	28.3	76.6	0.97
chr4	91484799	91485497	CpG: 77	698	77	486	22.1	69.6	0.91
chr4	91517567	91517849	CpG: 25	282	25	178	17.7	63.1	0.90
chr4	91530641	91530917	CpG: 20	276	20	167	14.5	60.5	0.80
chr4	91614778	91615895	CpG: 108	1117	108	732	19.3	65.5	0.90
chr4	91658328	91658613	CpG: 24	285	24	177	16.8	62.1	0.89
chr4	91709810	91710249	CpG: 44	439	44	324	20.0	73.8	0.77
chr4	91787998	91789457	CpG: 142	1459	142	959	19.5	65.7	0.90
chr4	91811444	91811718	CpG: 21	274	21	163	15.3	59.5	0.88
chr4	91854797	91855549	CpG: 80	752	80	514	21.3	68.4	0.91
chr4	91921919	91922192	CpG: 20	273	20	166	14.7	60.8	0.80
chr4	91923515	91924968	CpG: 160	1453	160	1001	22.0	68.9	0.93
chr4	91933416	91933690	CpG: 24	274	24	170	17.5	62.0	0.92
chr4	92029251	92029541	CpG: 31	290	31	202	21.4	69.7	0.89
chr4	92169865	92170085	CpG: 18	220	18	135	16.4	61.4	0.89
chr4	92318905	92319125	CpG: 17	220	17	134	15.5	60.9	0.85
chr4	92356605	92356890	CpG: 24	285	24	178	16.8	62.5	0.88
chr4	92441767	92442925	CpG: 130	1158	130	806	22.5	69.6	0.94
chr4	92638729	92639305	CpG: 65	576	65	421	22.6	73.1	0.85
chr4	92677617	92677890	CpG: 24	273	24	167	17.6	61.2	0.95
chr4	92772490	92772764	CpG: 23	274	23	170	16.8	62.0	0.88
chr4	92821330	92821630	CpG: 27	300	27	222	18.0	74.0	0.66
chr4	92822375	92822582	CpG: 17	207	17	115	16.4	55.6	1.08
chr4	92834789	92835059	CpG: 20	270	20	161	14.8	59.6	0.84
chr4	92954538	92954780	CpG: 21	242	21	144	17.4	59.5	0.99
chr4	93168105	93168968	CpG: 74	863	74	581	17.1	67.3	0.76
chr4	93336558	93336788	CpG: 20	230	20	141	17.4	61.3	0.94
chr4	93458507	93459776	CpG: 129	1269	129	882	20.3	69.5	0.84
chr4	93683318	93683542	CpG: 19	224	19	137	17.0	61.2	0.92
chr4	93734845	93735119	CpG: 21	274	21	168	15.3	61.3	0.82
chr4	93791672	93791949	CpG: 23	277	23	170	16.6	61.4	0.89
chr4	93792715	93792996	CpG: 25	281	25	176	17.8	62.6	0.92
chr4	93905949	93906235	CpG: 21	286	21	176	14.7	61.5	0.79
chr4	94136352	94136589	CpG: 19	237	19	141	16.0	59.5	0.91
chr4	94164372	94164600	CpG: 22	228	22	123	19.3	53.9	1.33
chr4	94441217	94441455	CpG: 21	238	21	144	17.6	60.5	0.98
chr4	94750280	94750562	CpG: 24	282	24	175	17.0	62.1	0.90
chr4	94757205	94757441	CpG: 17	236	17	140	14.4	59.3	0.86
chr4	94808368	94808646	CpG: 23	278	23	173	16.5	62.2	0.87
chr4	95117823	95118222	CpG: 30	399	30	240	15.0	60.2	0.83
chr4	95304799	95305023	CpG: 19	224	19	134	17.0	59.8	0.95
chr4	95434237	95434515	CpG: 25	278	25	174	18.0	62.6	0.93
chr4	95508983	95509319	CpG: 26	336	26	207	15.5	61.6	0.82
chr4	95631744	95632403	CpG: 68	659	68	422	20.6	64.0	1.01
chr4	95668233	95668448	CpG: 16	215	16	126	14.9	58.6	0.88
chr4	95767954	95768395	CpG: 34	441	34	246	15.4	55.8	1.01
chr4	96031713	96031952	CpG: 18	239	18	136	15.1	56.9	0.94
chr4	96306974	96307228	CpG: 20	254	20	152	15.7	59.8	0.89
chr4	96521962	96522236	CpG: 23	274	23	170	16.8	62.0	0.88
chr4	96935364	96935588	CpG: 18	224	18	133	16.1	59.4	0.91
chr4	96947039	96947275	CpG: 19	236	19	143	16.1	60.6	0.92
chr4	96971899	96972180	CpG: 24	281	24	174	17.1	61.9	0.91
chr4	97099162	97099436	CpG: 23	274	23	170	16.8	62.0	0.88
chr4	97143715	97145218	CpG: 119	1503	119	951	15.8	63.3	0.79
chr4	97150006	97150530	CpG: 39	524	39	349	14.9	66.6	0.68
chr4	97473361	97473775	CpG: 38	414	38	307	18.4	74.2	0.67
chr4	97522978	97523610	CpG: 55	632	55	369	17.4	58.4	1.03
chr4	97597630	97597915	CpG: 26	285	26	177	18.2	62.1	0.95
chr4	97656045	97656280	CpG: 18	235	18	137	15.3	58.3	0.92
chr4	97755956	97756192	CpG: 18	236	18	139	15.3	58.9	0.90
chr4	97767156	97767890	CpG: 88	734	88	539	24.0	73.4	0.90
chr4	98052645	98052921	CpG: 20	276	20	169	14.5	61.2	0.79
chr4	98072773	98073786	CpG: 139	1013	139	758	27.4	74.8	1.02
chr4	98357681	98357966	CpG: 24	285	24	178	16.8	62.5	0.88
chr4	98573832	98574119	CpG: 24	287	24	179	16.7	62.4	0.87
chr4	98583065	98583291	CpG: 21	226	21	139	18.6	61.5	1.01
chr4	98586305	98586581	CpG: 24	276	24	172	17.4	62.3	0.90
chr4	98863442	98863653	CpG: 20	211	20	129	19.0	61.1	1.02
chr4	98863845	98864980	CpG: 95	1135	95	759	16.7	66.9	0.75
chr4	98928089	98928332	CpG: 17	243	17	145	14.0	59.7	0.81
chr4	99119881	99120135	CpG: 19	254	19	157	15.0	61.8	0.80
chr4	99229197	99229478	CpG: 22	281	22	173	15.7	61.6	0.84
chr4	99245800	99246066	CpG: 24	266	24	166	18.0	62.4	0.94
chr4	99257041	99257269	CpG: 19	228	19	137	16.7	60.1	0.93
chr4	99290759	99290995	CpG: 18	236	18	141	15.3	59.7	0.87
chr4	99444288	99444569	CpG: 24	281	24	175	17.1	62.3	0.90
chr4	99476491	99476714	CpG: 19	223	19	137	17.0	61.4	0.92
chr4	99486011	99486286	CpG: 21	275	21	166	15.3	60.4	0.85
chr4	99848100	99848328	CpG: 19	228	19	139	16.7	61.0	0.92
chr4	100040928	100041157	CpG: 21	229	21	139	18.3	60.7	1.00
chr4	100278511	100278744	CpG: 18	233	18	141	15.5	60.5	0.85
chr4	100290434	100290664	CpG: 17	230	17	138	14.8	60.0	0.83
chr4	100290955	100291192	CpG: 21	237	21	145	17.7	61.2	0.97
chr4	100374241	100374514	CpG: 21	273	21	165	15.4	60.4	0.85
chr4	100504326	100504600	CpG: 22	274	22	169	16.1	61.7	0.86
chr4	100527078	100527352	CpG: 24	274	24	171	17.5	62.4	0.91
chr4	100549734	100550008	CpG: 23	274	23	170	16.8	62.0	0.88
chr4	100574956	100575230	CpG: 24	274	24	171	17.5	62.4	0.91
chr4	100769045	100769329	CpG: 23	284	23	175	16.2	61.6	0.87
chr4	100948305	100948510	CpG: 20	205	20	123	19.5	60.0	1.09
chr4	100984180	100984465	CpG: 24	285	24	178	16.8	62.5	0.88
chr4	101402591	101402827	CpG: 17	236	17	141	14.4	59.7	0.82
chr4	101458427	101458630	CpG: 19	203	19	144	18.7	70.9	0.75
chr4	101575313	101577003	CpG: 170	1690	170	1175	20.1	69.5	0.84
chr4	101645249	101645645	CpG: 35	396	35	275	17.7	69.4	0.73
chr4	101912970	101913397	CpG: 30	427	30	254	14.1	59.5	0.80
chr4	101972945	101973963	CpG: 131	1018	131	715	25.7	70.2	1.04
chr4	102089699	102089937	CpG: 19	238	19	141	16.0	59.2	0.94
chr4	102243109	102244356	CpG: 102	1247	102	784	16.4	62.9	0.84
chr4	102272595	102272878	CpG: 23	283	23	174	16.3	61.5	0.87
chr4	102308632	102308877	CpG: 23	245	23	179	18.8	73.1	0.72
chr4	102310156	102311352	CpG: 144	1196	144	902	24.1	75.4	0.85
chr4	102401563	102401795	CpG: 17	232	17	140	14.7	60.3	0.83
chr4	102403485	102403878	CpG: 43	393	43	265	21.9	67.4	0.97
chr4	102416798	102417083	CpG: 25	285	25	179	17.5	62.8	0.90
chr4	102617475	102617721	CpG: 21	246	21	146	17.1	59.3	0.99
chr4	102619202	102619475	CpG: 22	273	22	167	16.1	61.2	0.87
chr4	102875778	102876036	CpG: 19	258	19	149	14.7	57.8	0.90
chr4	102878339	102878896	CpG: 40	557	40	336	14.4	60.3	0.79
chr4	102891185	102891459	CpG: 24	274	24	171	17.5	62.4	0.91
chr4	102967338	102967857	CpG: 43	519	43	337	16.6	64.9	0.79
chr4	102968682	102968933	CpG: 20	251	20	159	15.9	63.3	0.81
chr4	102976863	102977067	CpG: 16	204	16	122	15.7	59.8	0.89
chr4	103261655	103262489	CpG: 95	834	95	621	22.8	74.5	0.83
chr4	103264704	103266321	CpG: 165	1617	165	1020	20.4	63.1	1.04
chr4	103450648	103450884	CpG: 21	236	21	145	17.8	61.4	0.96
chr4	103505622	103506447	CpG: 61	825	61	532	14.8	64.5	0.72
chr4	103512138	103512529	CpG: 32	391	32	283	16.4	72.4	0.63
chr4	103519712	103519974	CpG: 20	262	20	159	15.3	60.7	0.84
chr4	103924061	103924378	CpG: 28	317	28	232	17.7	73.2	0.66
chr4	104146102	104146384	CpG: 24	282	24	173	17.0	61.3	0.92
chr4	104208765	104209049	CpG: 21	284	21	171	14.8	60.2	0.82
chr4	104563639	104563912	CpG: 21	273	21	167	15.4	61.2	0.84
chr4	104609720	104610006	CpG: 24	286	24	179	16.8	62.6	0.87
chr4	104660630	104663155	CpG: 248	2525	248	1730	19.6	68.5	0.84
chr4	105043612	105043886	CpG: 19	274	19	160	13.9	58.4	0.83
chr4	105104919	105105289	CpG: 35	370	35	265	18.9	71.6	0.74
chr4	105117965	105118240	CpG: 24	275	24	170	17.5	61.8	0.92
chr4	105154227	105154493	CpG: 23	266	23	167	17.3	62.8	0.89
chr4	105380487	105380710	CpG: 16	223	16	131	14.3	58.7	0.85
chr4	105392200	105392477	CpG: 24	277	24	171	17.3	61.7	0.92
chr4	105658689	105659847	CpG: 102	1158	102	743	17.6	64.2	0.86
chr4	105744837	105745122	CpG: 25	285	25	178	17.5	62.5	0.92
chr4	105765417	105765628	CpG: 16	211	16	125	15.2	59.2	0.89
chr4	105814860	105815998	CpG: 144	1138	144	846	25.3	74.3	0.92
chr4	105829058	105829332	CpG: 24	274	24	171	17.5	62.4	0.91
chr4	105978291	105978506	CpG: 18	215	18	131	16.7	60.9	0.91
chr4	106074581	106075093	CpG: 54	512	54	361	21.1	70.5	0.85
chr4	106140499	106142263	CpG: 141	1764	141	1117	16.0	63.3	0.80
chr4	106183164	106183680	CpG: 60	516	60	368	23.3	71.3	0.92
chr4	106331397	106331680	CpG: 34	283	34	192	24.0	67.8	1.06
chr4	106387942	106388741	CpG: 92	799	92	553	23.0	69.2	0.96
chr4	106509988	106510367	CpG: 38	379	38	257	20.1	67.8	0.88
chr4	106567684	106568111	CpG: 31	427	31	253	14.5	59.3	0.84
chr4	106747960	106748243	CpG: 24	283	24	172	17.0	60.8	0.93
chr4	106858120	106858353	CpG: 16	233	16	136	13.7	58.4	0.83
chr4	107031339	107031577	CpG: 19	238	19	169	16.0	71.0	0.64
chr4	107035157	107035409	CpG: 22	252	22	189	17.5	75.0	0.62
chr4	107146355	107146616	CpG: 21	261	21	161	16.1	61.7	0.86
chr4	107149388	107149657	CpG: 25	269	25	168	18.6	62.5	0.96
chr4	107306338	107306644	CpG: 23	306	23	180	15.0	58.8	0.88
chr4	107802442	107802992	CpG: 71	550	71	415	25.8	75.5	0.91
chr4	107806277	107806609	CpG: 28	332	28	206	16.9	62.0	0.89
chr4	107892968	107893356	CpG: 33	388	33	283	17.0	72.9	0.64
chr4	108003419	108003713	CpG: 22	294	22	175	15.0	59.5	0.85
chr4	108011331	108011561	CpG: 19	230	19	140	16.5	60.9	0.90
chr4	108013347	108013621	CpG: 22	274	22	169	16.1	61.7	0.85
chr4	108036401	108036631	CpG: 19	230	19	139	16.5	60.4	0.93
chr4	108164628	108164904	CpG: 21	276	21	168	15.2	60.9	0.83
chr4	108174392	108174677	CpG: 25	285	25	179	17.5	62.8	0.90
chr4	108215400	108215678	CpG: 24	278	24	174	17.3	62.6	0.89
chr4	108434269	108434543	CpG: 25	274	25	172	18.2	62.8	0.94
chr4	108456971	108457743	CpG: 88	772	88	568	22.8	73.6	0.85
chr4	108759823	108760096	CpG: 24	273	24	171	17.6	62.6	0.91
chr4	108784265	108785036	CpG: 82	771	82	539	21.3	69.9	0.87
chr4	108792536	108792775	CpG: 18	239	18	140	15.1	58.6	0.91
chr4	108897065	108897346	CpG: 22	281	22	175	15.7	62.3	0.82
chr4	109019559	109020198	CpG: 57	639	57	406	17.8	63.5	0.88
chr4	109079232	109079463	CpG: 17	231	17	135	14.7	58.4	0.88
chr4	109206384	109207738	CpG: 136	1354	136	944	20.1	69.7	0.83
chr4	109323794	109324030	CpG: 21	236	21	145	17.8	61.4	0.96
chr4	109431171	109431413	CpG: 20	242	20	143	16.5	59.1	0.95
chr4	109515872	109516153	CpG: 25	281	25	175	17.8	62.3	0.94
chr4	109631964	109632757	CpG: 65	793	65	544	16.4	68.6	0.70
chr4	109809471	109809745	CpG: 24	274	24	171	17.5	62.4	0.91
chr4	109834559	109834807	CpG: 19	248	19	142	15.3	57.3	0.96
chr4	109835401	109835734	CpG: 33	333	33	245	19.8	73.6	0.73
chr4	109886622	109886914	CpG: 24	292	24	177	16.4	60.6	0.90
chr4	109937797	109938025	CpG: 16	228	16	131	14.0	57.5	0.88
chr4	110332859	110333122	CpG: 20	263	20	157	15.2	59.7	0.87
chr4	110340476	110341374	CpG: 62	898	62	536	13.8	59.7	0.78
chr4	110428770	110429045	CpG: 19	275	19	166	13.8	60.4	0.77
chr4	110449546	110449820	CpG: 24	274	24	171	17.5	62.4	0.91
chr4	110671298	110671569	CpG: 20	271	20	163	14.8	60.1	0.82
chr4	110778714	110778992	CpG: 25	278	25	175	18.0	62.9	0.92
chr4	111021992	111022983	CpG: 109	991	109	684	22.0	69.0	0.93
chr4	111126973	111127679	CpG: 80	706	80	507	22.7	71.8	0.91
chr4	111233625	111234517	CpG: 100	892	100	649	22.4	72.8	0.85
chr4	111291948	111292548	CpG: 73	600	73	430	24.3	71.7	0.96
chr4	111379683	111380055	CpG: 33	372	33	283	17.7	76.1	0.61
chr4	111451502	111451776	CpG: 24	274	24	175	17.5	63.9	0.88
chr4	111468915	111471575	CpG: 234	2660	234	1692	17.6	63.6	0.87
chr4	111473746	111474007	CpG: 21	261	21	154	16.1	59.0	0.94
chr4	111474206	111475714	CpG: 144	1508	144	1013	19.1	67.2	0.84
chr4	111488881	111489143	CpG: 26	262	26	167	19.8	63.7	0.99
chr4	111504945	111505206	CpG: 20	261	20	161	15.3	61.7	0.81
chr4	111692424	111692668	CpG: 22	244	22	152	18.0	62.3	0.95
chr4	111953440	111953786	CpG: 30	346	30	218	17.3	63.0	0.88
chr4	111984814	111985078	CpG: 19	264	19	161	14.4	61.0	0.79
chr4	112065524	112066157	CpG: 61	633	61	436	19.3	68.9	0.82
chr4	112097803	112098034	CpG: 20	231	20	143	17.3	61.9	0.93
chr4	112173302	112173530	CpG: 18	228	18	137	15.8	60.1	0.90
chr4	112286431	112286733	CpG: 29	302	29	223	19.2	73.8	0.70
chr4	112314575	112314811	CpG: 23	236	23	176	19.5	74.6	0.70
chr4	112333276	112333513	CpG: 20	237	20	140	16.9	59.1	0.98
chr4	112385601	112385878	CpG: 20	277	20	165	14.4	59.6	0.82
chr4	112603934	112605221	CpG: 112	1287	112	819	17.4	63.6	0.86
chr4	112658804	112659102	CpG: 22	298	22	170	14.8	57.0	0.92
chr4	112695476	112695750	CpG: 22	274	22	170	16.1	62.0	0.84
chr4	112735439	112736573	CpG: 141	1134	141	856	24.9	75.5	0.87
chr4	112769180	112769454	CpG: 25	274	25	172	18.2	62.8	0.94
chr4	112778992	112779266	CpG: 22	274	22	169	16.1	61.7	0.85
chr4	112861821	112863054	CpG: 117	1233	117	838	19.0	68.0	0.83
chr4	113004744	113005616	CpG: 83	872	83	597	19.0	68.5	0.82
chr4	113031455	113032158	CpG: 84	703	84	517	23.9	73.5	0.89
chr4	113117775	113118393	CpG: 44	618	44	376	14.2	60.8	0.87
chr4	113228465	113228759	CpG: 22	294	22	175	15.0	59.5	0.85
chr4	113246297	113246527	CpG: 20	230	20	139	17.4	60.4	0.96
chr4	113498602	113499530	CpG: 96	928	96	682	20.7	73.5	0.77
chr4	113500327	113501221	CpG: 61	894	61	515	13.6	57.6	0.83
chr4	113713390	113713784	CpG: 30	394	30	233	15.2	59.1	0.88
chr4	113778580	113779111	CpG: 34	531	34	333	12.8	62.7	0.65
chr4	113886461	113886688	CpG: 19	227	19	139	16.7	61.2	0.91
chr4	113889797	113890187	CpG: 29	390	29	254	14.9	65.1	0.70
chr4	113913353	113914097	CpG: 59	744	59	474	15.9	63.7	0.79
chr4	113919933	113920188	CpG: 24	255	24	163	18.8	63.9	0.93
chr4	113920611	113920832	CpG: 16	221	16	145	14.5	65.6	0.71
chr4	113922767	113925167	CpG: 196	2400	196	1531	16.3	63.8	0.80
chr4	113930582	113930906	CpG: 22	324	22	182	13.6	56.2	0.89
chr4	113933781	113934912	CpG: 100	1131	100	743	17.7	65.7	0.82
chr4	113935667	113936206	CpG: 47	539	47	362	17.4	67.2	0.78
chr4	113938638	113939147	CpG: 49	509	49	347	19.3	68.2	0.83
chr4	113941265	113941510	CpG: 18	245	18	154	14.7	62.9	0.74
chr4	114143063	114143301	CpG: 20	238	20	143	16.8	60.1	0.96
chr4	114178355	114178598	CpG: 22	243	22	149	18.1	61.3	0.97
chr4	114425914	114426146	CpG: 21	232	21	141	18.1	60.8	1.01
chr4	114638656	114638885	CpG: 19	229	19	138	16.6	60.3	0.91
chr4	114956909	114957181	CpG: 21	272	21	167	15.4	61.4	0.83
chr4	115009831	115010257	CpG: 32	426	32	255	15.0	59.9	0.84
chr4	115085383	115085658	CpG: 24	275	24	171	17.5	62.2	0.91
chr4	115203293	115203520	CpG: 20	227	20	138	17.6	60.8	0.95
chr4	115394977	115395193	CpG: 20	216	20	126	18.5	58.3	1.09
chr4	115453675	115454584	CpG: 120	909	120	674	26.4	74.1	0.97
chr4	115475179	115475453	CpG: 24	274	24	171	17.5	62.4	0.91
chr4	115530659	115530902	CpG: 28	243	28	181	23.0	74.5	0.83
chr4	115535764	115536049	CpG: 24	285	24	178	16.8	62.5	0.88
chr4	115539708	115540852	CpG: 106	1144	106	774	18.5	67.7	0.82
chr4	115594019	115594465	CpG: 50	446	50	318	22.4	71.3	0.89
chr4	115687740	115687957	CpG: 24	217	24	149	22.1	68.7	0.94
chr4	115720128	115720510	CpG: 29	382	29	246	15.2	64.4	0.75
chr4	115802106	115802344	CpG: 21	238	21	145	17.6	60.9	0.97
chr4	115819003	115819774	CpG: 55	771	55	481	14.3	62.4	0.73
chr4	115823076	115825180	CpG: 209	2104	209	1403	19.9	66.7	0.89
chr4	115831359	115831567	CpG: 24	208	24	144	23.1	69.2	0.97
chr4	115832200	115832528	CpG: 35	328	35	239	21.3	72.9	0.82
chr4	115857171	115857445	CpG: 24	274	24	170	17.5	62.0	0.92
chr4	115933643	115933920	CpG: 23	277	23	168	16.6	60.6	0.91
chr4	115945215	115945864	CpG: 59	649	59	374	18.2	57.6	1.11
chr4	115993085	115993330	CpG: 18	245	18	148	14.7	60.4	0.82
chr4	116013941	116014709	CpG: 91	768	91	559	23.7	72.8	0.89
chr4	116022057	116022290	CpG: 17	233	17	140	14.6	60.1	0.82
chr4	116092751	116093000	CpG: 19	249	19	155	15.3	62.2	0.82
chr4	116171934	116172170	CpG: 20	236	20	146	16.9	61.9	0.91
chr4	116187006	116187270	CpG: 20	264	20	155	15.2	58.7	0.89
chr4	116259150	116259428	CpG: 25	278	25	175	18.0	62.9	0.91
chr4	116265939	116266839	CpG: 72	900	72	627	16.0	69.7	0.66
chr4	116323276	116323512	CpG: 19	236	19	145	16.1	61.4	0.88
chr4	116405522	116405795	CpG: 22	273	22	171	16.1	62.6	0.83
chr4	116485851	116486094	CpG: 19	243	19	149	15.6	61.3	0.84
chr4	116541879	116542154	CpG: 24	275	24	170	17.5	61.8	0.92
chr4	116613780	116614058	CpG: 25	278	25	175	18.0	62.9	0.92
chr4	116803538	116803773	CpG: 19	235	19	140	16.2	59.6	0.92
chr4	117069644	117070985	CpG: 121	1341	121	911	18.0	67.9	0.78
chr4	117081074	117081291	CpG: 18	217	18	155	16.6	71.4	0.65
chr4	117200940	117201221	CpG: 23	281	23	174	16.4	61.9	0.87
chr4	117213176	117213411	CpG: 16	235	16	137	13.6	58.3	0.81
chr4	117287866	117288321	CpG: 41	455	41	292	18.0	64.2	0.88
chr4	117313421	117313623	CpG: 15	202	15	112	14.9	55.4	1.00
chr4	117511952	117512226	CpG: 24	274	24	172	17.5	62.8	0.90
chr4	117901308	117902801	CpG: 125	1493	125	967	16.7	64.8	0.82
chr4	117931767	117932048	CpG: 24	281	24	174	17.1	61.9	0.91
chr4	117943362	117943636	CpG: 23	274	23	170	16.8	62.0	0.88
chr4	117978763	117979037	CpG: 22	274	22	169	16.1	61.7	0.85
chr4	118134066	118134347	CpG: 24	281	24	175	17.1	62.3	0.90
chr4	118150093	118150371	CpG: 25	278	25	176	18.0	63.3	0.91
chr4	118212388	118212672	CpG: 23	284	23	176	16.2	62.0	0.86
chr4	118482382	118482765	CpG: 35	383	35	287	18.3	74.9	0.65
chr4	118486249	118486523	CpG: 23	274	23	170	16.8	62.0	0.88
chr4	118539750	118539980	CpG: 18	230	18	141	15.7	61.3	0.84
chr4	118579948	118580178	CpG: 20	230	20	141	17.4	61.3	0.94
chr4	118599706	118599980	CpG: 24	274	24	171	17.5	62.4	0.91
chr4	118937495	118937773	CpG: 25	278	25	175	18.0	62.9	0.92
chr4	118981197	118981724	CpG: 50	527	50	387	19.0	73.4	0.70
chr4	119012333	119012606	CpG: 23	273	23	170	16.8	62.3	0.88
chr4	119802202	119802432	CpG: 21	230	21	142	18.3	61.7	0.97
chr4	119901991	119902280	CpG: 21	289	21	180	14.5	62.3	0.76
chr4	120008054	120008608	CpG: 43	554	43	368	15.5	66.4	0.71
chr4	120017852	120018127	CpG: 25	275	25	170	18.2	61.8	0.97
chr4	120082439	120082656	CpG: 16	217	16	125	14.7	57.6	0.89
chr4	120227683	120228118	CpG: 48	435	48	317	22.1	72.9	0.84
chr4	120361249	120361527	CpG: 21	278	21	167	15.1	60.1	0.85
chr4	120387084	120387405	CpG: 35	321	35	217	21.8	67.6	0.96
chr4	120765488	120765724	CpG: 18	236	18	142	15.3	60.2	0.87
chr4	120807693	120807963	CpG: 22	270	22	163	16.3	60.4	0.90
chr4	121337176	121337405	CpG: 16	229	16	135	14.0	59.0	0.81
chr4	121338146	121338943	CpG: 99	797	99	597	24.8	74.9	0.89
chr4	121570388	121570956	CpG: 61	568	61	424	21.5	74.6	0.77
chr4	121583322	121584014	CpG: 60	692	60	404	17.3	58.4	1.03
chr4	121657130	121658283	CpG: 130	1153	130	851	22.5	73.8	0.83
chr4	121680218	121680496	CpG: 24	278	24	173	17.3	62.2	0.91
chr4	121990629	121990962	CpG: 28	333	28	194	16.8	58.3	1.02
chr4	122097017	122097678	CpG: 54	661	54	453	16.3	68.5	0.70
chr4	122098531	122098809	CpG: 24	278	24	174	17.3	62.6	0.89
chr4	122141162	122142004	CpG: 86	842	86	530	20.4	62.9	1.05
chr4	122302308	122302582	CpG: 23	274	23	170	16.8	62.0	0.88
chr4	122356539	122356819	CpG: 25	280	25	175	17.9	62.5	0.92
chr4	122398043	122398336	CpG: 24	293	24	182	16.4	62.1	0.86
chr4	122435085	122435296	CpG: 17	211	17	124	16.1	58.8	0.95
chr4	122517480	122518205	CpG: 68	725	68	485	18.8	66.9	0.84
chr4	122532455	122532684	CpG: 19	229	19	140	16.6	61.1	0.90
chr4	122584902	122585178	CpG: 22	276	22	164	15.9	59.4	0.91
chr4	122605577	122605958	CpG: 40	381	40	236	21.0	61.9	1.12
chr4	122628528	122628804	CpG: 24	276	24	173	17.4	62.7	0.90
chr4	122759709	122760326	CpG: 75	617	75	436	24.3	70.7	0.97
chr4	122932193	122934243	CpG: 175	2050	175	1347	17.1	65.7	0.79
chr4	122980145	122980408	CpG: 21	263	21	161	16.0	61.2	0.88
chr4	122991282	122991567	CpG: 23	285	23	179	16.1	62.8	0.83
chr4	123072220	123072494	CpG: 23	274	23	170	16.8	62.0	0.88
chr4	123147427	123147717	CpG: 22	290	22	175	15.2	60.3	0.84
chr4	123258414	123258841	CpG: 30	427	30	253	14.1	59.3	0.80
chr4	123370559	123371098	CpG: 54	539	54	346	20.0	64.2	0.98
chr4	123414108	123414340	CpG: 17	232	17	137	14.7	59.1	0.86
chr4	123566038	123566300	CpG: 25	262	25	165	19.1	63.0	0.98
chr4	123790665	123790939	CpG: 22	274	22	170	16.1	62.0	0.84
chr4	123890312	123890597	CpG: 24	285	24	177	16.8	62.1	0.89
chr4	123952304	123952663	CpG: 28	359	28	212	15.6	59.1	0.90
chr4	123965704	123965936	CpG: 19	232	19	138	16.4	59.5	0.95
chr4	124192018	124192296	CpG: 25	278	25	174	18.0	62.6	0.93
chr4	124226197	124227242	CpG: 127	1045	127	756	24.3	72.3	0.93
chr4	124375143	124377267	CpG: 171	2124	171	1347	16.1	63.4	0.80
chr4	124527192	124527424	CpG: 17	232	17	138	14.7	59.5	0.86
chr4	124548715	124548988	CpG: 19	273	19	159	13.9	58.2	0.83
chr4	124684667	124685390	CpG: 68	723	68	482	18.8	66.7	0.85
chr4	124726561	124726848	CpG: 19	287	19	175	13.2	61.0	0.73
chr4	124831160	124831434	CpG: 24	274	24	172	17.5	62.8	0.90
chr4	124936447	124936649	CpG: 18	202	18	125	17.8	61.9	0.94
chr4	125000334	125001495	CpG: 112	1161	112	783	19.3	67.4	0.85
chr4	125068732	125069437	CpG: 84	705	84	497	23.8	70.5	0.96
chr4	125105232	125105655	CpG: 41	423	41	260	19.4	61.5	1.03
chr4	125127454	125128164	CpG: 75	710	75	473	21.1	66.6	0.95
chr4	125174093	125174728	CpG: 50	635	50	412	15.7	64.9	0.75
chr4	125225279	125225553	CpG: 25	274	25	171	18.2	62.4	0.95
chr4	125236437	125237052	CpG: 55	615	55	391	17.9	63.6	0.89
chr4	125254295	125256065	CpG: 176	1770	176	1197	19.9	67.6	0.88
chr4	125394577	125394817	CpG: 21	240	21	147	17.5	61.2	0.95
chr4	125425413	125425649	CpG: 22	236	22	147	18.6	62.3	0.97
chr4	125456305	125456687	CpG: 43	382	43	287	22.5	75.1	0.80
chr4	125497949	125498223	CpG: 23	274	23	168	16.8	61.3	0.90
chr4	125682153	125682427	CpG: 24	274	24	171	17.5	62.4	0.91
chr4	125683398	125683796	CpG: 45	398	45	273	22.6	68.6	0.98
chr4	126036529	126036944	CpG: 29	415	29	256	14.0	61.7	0.78
chr4	126038457	126038662	CpG: 17	205	17	117	16.6	57.1	1.03
chr4	126099654	126099893	CpG: 19	239	19	144	15.9	60.3	0.89
chr4	126105199	126105473	CpG: 22	274	22	170	16.1	62.0	0.84
chr4	126130684	126131924	CpG: 152	1240	152	901	24.5	72.7	0.93
chr4	126170191	126170464	CpG: 22	273	22	167	16.1	61.2	0.87
chr4	126226326	126226759	CpG: 49	433	49	296	22.6	68.4	0.98
chr4	126227117	126227402	CpG: 21	285	21	165	14.7	57.9	0.88
chr4	126419226	126419490	CpG: 21	264	21	187	15.9	70.8	0.64
chr4	126427719	126427964	CpG: 21	245	21	146	17.1	59.6	0.98
chr4	126488637	126488911	CpG: 23	274	23	170	16.8	62.0	0.88
chr4	126696300	126696520	CpG: 18	220	18	133	16.4	60.5	0.90
chr4	126701251	126703430	CpG: 209	2179	209	1408	19.2	64.6	0.92
chr4	126718236	126718489	CpG: 18	253	18	154	14.2	60.9	0.77
chr4	126809695	126810072	CpG: 44	377	44	252	23.3	66.8	1.05
chr4	126812693	126812900	CpG: 17	207	17	136	16.4	65.7	0.79
chr4	126841993	126842203	CpG: 25	210	25	160	23.8	76.2	0.82
chr4	126844402	126844676	CpG: 23	274	23	169	16.8	61.7	0.89
chr4	126988471	126989152	CpG: 46	681	46	456	13.5	67.0	0.60
chr4	126990968	126991207	CpG: 20	239	20	145	16.7	60.7	0.93
chr4	127420083	127420297	CpG: 17	214	17	126	15.9	58.9	0.95
chr4	127541581	127541859	CpG: 24	278	24	174	17.3	62.6	0.89
chr4	127587117	127587357	CpG: 19	240	19	141	15.8	58.8	0.93
chr4	127593702	127593982	CpG: 23	280	23	174	16.4	62.1	0.86
chr4	127641486	127641751	CpG: 28	265	28	198	21.1	74.7	0.76
chr4	127798411	127798648	CpG: 18	237	18	138	15.2	58.2	0.91
chr4	127953058	127953456	CpG: 35	398	35	290	17.6	72.9	0.68
chr4	128014724	128015609	CpG: 100	885	100	663	22.6	74.9	0.83
chr4	128040391	128040666	CpG: 24	275	24	171	17.5	62.2	0.91
chr4	128053422	128053703	CpG: 23	281	23	173	16.4	61.6	0.88
chr4	128298855	128299130	CpG: 22	275	22	166	16.0	60.4	0.89
chr4	128531864	128532263	CpG: 36	399	36	290	18.0	72.7	0.69
chr4	128583252	128583672	CpG: 33	420	33	300	15.7	71.4	0.62
chr4	128617038	128620073	CpG: 231	3035	231	1860	15.2	61.3	0.81
chr4	128855814	128856087	CpG: 25	273	25	171	18.3	62.6	0.94
chr4	128924601	128924875	CpG: 24	274	24	169	17.5	61.7	0.93
chr4	129008700	129008973	CpG: 23	273	23	171	16.8	62.6	0.87
chr4	129056840	129057114	CpG: 25	274	25	172	18.2	62.8	0.94
chr4	129096258	129096532	CpG: 24	274	24	171	17.5	62.4	0.91
chr4	129117870	129118136	CpG: 21	266	21	165	15.8	62.0	0.84
chr4	129154002	129154290	CpG: 23	288	23	172	16.0	59.7	0.90
chr4	129384535	129384815	CpG: 21	280	21	170	15.0	60.7	0.83
chr4	129502880	129503104	CpG: 18	224	18	130	16.1	58.0	0.99
chr4	129503610	129504080	CpG: 42	470	42	347	17.9	73.8	0.66
chr4	129949139	129949379	CpG: 23	240	23	146	19.2	60.8	1.05
chr4	130012458	130012698	CpG: 19	240	19	147	15.8	61.2	0.86
chr4	130022274	130022552	CpG: 24	278	24	174	17.3	62.6	0.89
chr4	130074135	130074536	CpG: 33	401	33	288	16.5	71.8	0.64
chr4	130231418	130231728	CpG: 24	310	24	189	15.5	61.0	0.83
chr4	130323723	130324017	CpG: 22	294	22	177	15.0	60.2	0.83
chr4	130371222	130371465	CpG: 20	243	20	142	16.5	58.4	0.96
chr4	130910553	130910781	CpG: 20	228	20	148	17.5	64.9	0.84
chr4	130925843	130926715	CpG: 87	872	87	617	20.0	70.8	0.80
chr4	131033289	131033847	CpG: 59	558	59	354	21.1	63.4	1.05
chr4	131034452	131034673	CpG: 17	221	17	129	15.4	58.4	0.90
chr4	131038932	131039162	CpG: 20	230	20	140	17.4	60.9	0.95
chr4	131084682	131086067	CpG: 135	1385	135	899	19.5	64.9	0.93
chr4	131183743	131184553	CpG: 73	810	73	532	18.0	65.7	0.84
chr4	131268213	131269858	CpG: 138	1645	138	1122	16.8	68.2	0.72
chr4	131270670	131270876	CpG: 15	206	15	111	14.6	53.9	1.02
chr4	131271977	131272240	CpG: 23	263	23	164	17.5	62.4	0.93
chr4	131351570	131351958	CpG: 38	388	38	290	19.6	74.7	0.70
chr4	131364693	131366361	CpG: 210	1668	210	1249	25.2	74.9	0.90
chr4	131367187	131367424	CpG: 19	237	19	145	16.0	61.2	0.88
chr4	131372004	131372232	CpG: 17	228	17	139	14.9	61.0	0.83
chr4	131414518	131414752	CpG: 20	234	20	141	17.1	60.3	0.95
chr4	131498406	131498708	CpG: 21	302	21	174	13.9	57.6	0.84
chr4	131517918	131518261	CpG: 27	343	27	204	15.7	59.5	0.89
chr4	131591241	131592724	CpG: 153	1483	153	1035	20.6	69.8	0.85
chr4	131816692	131816916	CpG: 17	224	17	135	15.2	60.3	0.85
chr4	132004332	132004568	CpG: 17	236	17	138	14.4	58.5	0.86
chr4	132082571	132082974	CpG: 28	403	28	238	13.9	59.1	0.82
chr4	132113677	132117017	CpG: 312	3340	312	2114	18.7	63.3	0.94
chr4	132264804	132265085	CpG: 23	281	23	174	16.4	61.9	0.87
chr4	132397364	132397914	CpG: 56	550	56	362	20.4	65.8	0.94
chr4	132553951	132554181	CpG: 18	230	18	139	15.7	60.4	0.87
chr4	133006134	133006371	CpG: 22	237	22	146	18.6	61.6	1.01
chr4	133099067	133099348	CpG: 22	281	22	172	15.7	61.2	0.85
chr4	133157797	133158091	CpG: 22	294	22	174	15.0	59.2	0.86
chr4	133317239	133317629	CpG: 33	390	33	283	16.9	72.6	0.65
chr4	133394918	133395126	CpG: 20	208	20	153	19.2	73.6	0.72
chr4	133729295	133729584	CpG: 25	289	25	179	17.3	61.9	0.92
chr4	134568891	134569165	CpG: 24	274	24	172	17.5	62.8	0.90
chr4	134683004	134683257	CpG: 29	253	29	195	22.9	77.1	0.77
chr4	135027004	135027380	CpG: 29	376	29	243	15.4	64.6	0.74
chr4	135027977	135088857	CpG: 4082	60880	4082	38720	13.4	63.6	0.66
chr4	135289341	135289571	CpG: 21	230	21	142	18.3	61.7	0.97
chr4	135292191	135292415	CpG: 16	224	16	132	14.3	58.9	0.85
chr4	135299010	135300786	CpG: 141	1776	141	1153	15.9	64.9	0.76
chr4	135301405	135301945	CpG: 35	540	35	331	13.0	61.3	0.69
chr4	135362117	135362395	CpG: 21	278	21	168	15.1	60.4	0.85
chr4	135495729	135495969	CpG: 19	240	19	144	15.8	60.0	0.91
chr4	135502616	135502897	CpG: 24	281	24	176	17.1	62.6	0.89
chr4	135520102	135520375	CpG: 24	273	24	167	17.6	61.2	0.95
chr4	135978595	135978868	CpG: 24	273	24	168	17.6	61.5	0.94
chr4	136095012	136095285	CpG: 24	273	24	169	17.6	61.9	0.93
chr4	136221660	136221934	CpG: 25	274	25	172	18.2	62.8	0.94
chr4	136267654	136267963	CpG: 24	309	24	184	15.5	59.5	0.88
chr4	136310651	136310925	CpG: 24	274	24	170	17.5	62.0	0.92
chr4	136471248	136472528	CpG: 90	1280	90	733	14.1	57.3	0.86
chr4	136473748	136475714	CpG: 168	1966	168	1250	17.1	63.6	0.85
chr4	136523102	136523331	CpG: 16	229	16	135	14.0	59.0	0.83
chr4	136550449	136550727	CpG: 22	278	22	173	15.8	62.2	0.83
chr4	136562665	136563052	CpG: 32	387	32	278	16.5	71.8	0.64
chr4	136578675	136578891	CpG: 19	216	19	134	17.6	62.0	0.92
chr4	136696739	136696975	CpG: 21	236	21	145	17.8	61.4	0.97
chr4	136783281	136783494	CpG: 18	213	18	127	16.9	59.6	0.96
chr4	136809766	136810002	CpG: 19	236	19	143	16.1	60.6	0.90
chr4	137486454	137486724	CpG: 22	270	22	166	16.3	61.5	0.87
chr4	137523903	137524245	CpG: 48	342	48	258	28.1	75.4	1.00
chr4	137550449	137550722	CpG: 23	273	23	169	16.8	61.9	0.89
chr4	137868241	137868477	CpG: 21	236	21	145	17.8	61.4	0.96
chr4	138267032	138267237	CpG: 21	205	21	125	20.5	61.0	1.10
chr4	138353202	138353423	CpG: 16	221	16	131	14.5	59.3	0.84
chr4	138729264	138729510	CpG: 18	246	18	172	14.6	69.9	0.60
chr4	138840580	138840850	CpG: 21	270	21	168	15.6	62.2	0.81
chr4	139037138	139037360	CpG: 16	222	16	137	14.4	61.7	0.77
chr4	139205762	139206032	CpG: 22	270	22	166	16.3	61.5	0.87
chr4	139246375	139246578	CpG: 14	203	14	120	13.8	59.1	0.84
chr4	139260858	139261132	CpG: 22	274	22	168	16.1	61.3	0.86
chr4	139263994	139264268	CpG: 23	274	23	166	16.8	60.6	0.93
chr4	139310299	139310564	CpG: 19	265	19	156	14.3	58.9	0.84
chr4	139621687	139622113	CpG: 32	426	32	255	15.0	59.9	0.84
chr4	139664788	139665104	CpG: 26	316	26	201	16.5	63.6	0.82
chr4	139678667	139678944	CpG: 24	277	24	185	17.3	66.8	0.79
chr4	139717857	139718392	CpG: 48	535	48	393	17.9	73.5	0.67
chr4	140134886	140135994	CpG: 72	1108	72	721	13.0	65.1	0.61
chr4	140192147	140192394	CpG: 22	247	22	153	17.8	61.9	0.94
chr4	140345479	140345747	CpG: 24	268	24	166	17.9	61.9	0.95
chr4	140373856	140374131	CpG: 20	275	20	166	14.5	60.4	0.81
chr4	140700931	140701204	CpG: 21	273	21	169	15.4	61.9	0.81
chr4	140744258	140744804	CpG: 53	546	53	406	19.4	74.4	0.70
chr4	140749697	140749928	CpG: 22	231	22	140	19.0	60.6	1.04
chr4	140819689	140820048	CpG: 29	359	29	213	16.2	59.3	0.92
chr4	140886379	140886585	CpG: 17	206	17	115	16.5	55.8	1.06
chr4	140948393	140948627	CpG: 18	234	18	138	15.4	59.0	0.90
chr4	140972446	140972727	CpG: 24	281	24	176	17.1	62.6	0.89
chr4	141056372	141056610	CpG: 18	238	18	142	15.1	59.7	0.86
chr4	141057201	141057411	CpG: 21	210	21	153	20.0	72.9	0.76
chr4	141092923	141093132	CpG: 14	209	14	124	13.4	59.3	0.77
chr4	141176980	141177223	CpG: 29	243	29	185	23.9	76.1	0.82
chr4	141217005	141217276	CpG: 22	271	22	168	16.2	62.0	0.85
chr4	141376565	141376812	CpG: 22	247	22	182	17.8	73.7	0.68
chr4	141390443	141390716	CpG: 23	273	23	173	16.8	63.4	0.85
chr4	141412049	141412730	CpG: 69	681	69	499	20.3	73.3	0.76
chr4	141573340	141573568	CpG: 16	228	16	136	14.0	59.6	0.80
chr4	141589881	141590113	CpG: 17	232	17	136	14.7	58.6	0.88
chr4	141627570	141627807	CpG: 19	237	19	143	16.0	60.3	0.91
chr4	141872500	141872864	CpG: 33	364	33	268	18.1	73.6	0.67
chr4	141879920	141880182	CpG: 21	262	21	167	16.0	63.7	0.79
chr4	141880714	141881441	CpG: 53	727	53	437	14.6	60.1	0.81
chr4	141928047	141928332	CpG: 24	285	24	174	16.8	61.1	0.92
chr4	142058276	142058938	CpG: 52	662	52	462	15.7	69.8	0.65
chr4	142074779	142075005	CpG: 20	226	20	143	17.7	63.3	0.89
chr4	142137642	142137868	CpG: 20	226	20	140	17.7	61.9	0.93
chr4	142176144	142176420	CpG: 24	276	24	168	17.4	60.9	0.95
chr4	142318563	142318830	CpG: 21	267	21	162	15.7	60.7	0.87
chr4	142335204	142336189	CpG: 112	985	112	673	22.7	68.3	0.98
chr4	142370544	142370922	CpG: 26	378	26	214	13.8	56.6	0.86
chr4	142402510	142402761	CpG: 18	251	18	150	14.3	59.8	0.89
chr4	142403159	142404253	CpG: 108	1094	108	742	19.7	67.8	0.86
chr4	142412618	142412884	CpG: 20	266	20	161	15.0	60.5	0.83
chr4	142434751	142435163	CpG: 53	412	53	317	25.7	76.9	0.87
chr4	142495707	142498291	CpG: 266	2584	266	1775	20.6	68.7	0.89
chr4	142511853	142512128	CpG: 21	275	21	167	15.3	60.7	0.84
chr4	142556206	142556438	CpG: 19	232	19	139	16.4	59.9	0.93
chr4	142599506	142599891	CpG: 41	385	41	275	21.3	71.4	0.85
chr4	142614052	142614287	CpG: 18	235	18	138	15.3	58.7	0.91
chr4	142615168	142615519	CpG: 34	351	34	244	19.4	69.5	0.82
chr4	142620867	142621776	CpG: 84	909	84	596	18.5	65.6	0.86
chr4	142629768	142630042	CpG: 21	274	21	168	15.3	61.3	0.82
chr4	142667384	142667669	CpG: 26	285	26	180	18.2	63.2	0.93
chr4	142755859	142756107	CpG: 22	248	22	172	17.7	69.4	0.75
chr4	142772939	142774189	CpG: 120	1250	120	839	19.2	67.1	0.85
chr4	142874834	142877081	CpG: 216	2247	216	1503	19.2	66.9	0.86
chr4	142982768	142982985	CpG: 17	217	17	129	15.7	59.4	0.90
chr4	143017996	143018229	CpG: 18	233	18	138	15.5	59.2	0.88
chr4	143054433	143055606	CpG: 104	1173	104	781	17.7	66.6	0.80
chr4	143091602	143091839	CpG: 17	237	17	142	14.3	59.9	0.82
chr4	143179528	143179955	CpG: 35	427	35	249	16.4	58.3	0.97
chr4	143331071	143331356	CpG: 25	285	25	179	17.5	62.8	0.90
chr4	143439711	143439985	CpG: 23	274	23	171	16.8	62.4	0.87
chr4	143442267	143442541	CpG: 24	274	24	171	17.5	62.4	0.91
chr4	143456764	143457038	CpG: 23	274	23	166	16.8	60.6	0.93
chr4	143470129	143470426	CpG: 20	297	20	172	13.5	57.9	0.81
chr4	143470556	143474292	CpG: 299	3736	299	2339	16.0	62.6	0.82
chr4	143540600	143540830	CpG: 20	230	20	143	17.4	62.2	0.91
chr4	143544467	143544731	CpG: 23	264	23	163	17.4	61.7	0.92
chr4	143572440	143573173	CpG: 78	733	78	538	21.3	73.4	0.79
chr4	143615331	143615687	CpG: 27	356	27	220	15.2	61.8	0.80
chr4	143693290	143693898	CpG: 55	608	55	416	18.1	68.4	0.79
chr4	143724971	143725248	CpG: 22	277	22	171	15.9	61.7	0.84
chr4	143733238	143733549	CpG: 23	311	23	186	14.8	59.8	0.83
chr4	143746652	143747567	CpG: 87	915	87	631	19.0	69.0	0.80
chr4	143817563	143818198	CpG: 65	635	65	439	20.5	69.1	0.86
chr4	143843655	143844254	CpG: 67	599	67	421	22.4	70.3	0.91
chr4	143888509	143888925	CpG: 53	416	53	304	25.5	73.1	0.96
chr4	144075479	144076730	CpG: 144	1251	144	898	23.0	71.8	0.89
chr4	144325504	144325779	CpG: 24	275	24	170	17.5	61.8	0.92
chr4	144402300	144402530	CpG: 20	230	20	141	17.4	61.3	0.94
chr4	144451874	144453153	CpG: 138	1279	138	906	21.6	70.8	0.86
chr4	144540521	144540909	CpG: 42	388	42	264	21.6	68.0	0.94
chr4	144602412	144602638	CpG: 18	226	18	144	15.9	63.7	0.80
chr4	144612661	144612938	CpG: 22	277	22	166	15.9	59.9	0.89
chr4	144650408	144650949	CpG: 56	541	56	412	20.7	76.2	0.72
chr4	144684074	144684348	CpG: 19	274	19	164	13.9	59.9	0.79
chr4	144750415	144750650	CpG: 17	235	17	138	14.5	58.7	0.87
chr4	144953591	144954526	CpG: 69	935	69	616	14.8	65.9	0.68
chr4	144983474	144983690	CpG: 18	216	18	141	16.7	65.3	0.78
chr4	145007378	145007587	CpG: 19	209	19	148	18.2	70.8	0.74
chr4	145233361	145233617	CpG: 22	256	22	145	17.2	56.6	1.09
chr4	145569408	145569682	CpG: 25	274	25	172	18.2	62.8	0.94
chr4	145570675	145570910	CpG: 19	235	19	140	16.2	59.6	0.91
chr4	145715400	145715633	CpG: 17	233	17	140	14.6	60.1	0.83
chr4	146162939	146164471	CpG: 131	1532	131	1022	17.1	66.7	0.77
chr4	146214720	146215103	CpG: 31	383	31	271	16.2	70.8	0.65
chr4	146417591	146417885	CpG: 24	294	24	178	16.3	60.5	0.89
chr4	146501725	146502856	CpG: 105	1131	105	775	18.6	68.5	0.79
chr4	146652515	146652759	CpG: 21	244	21	143	17.2	58.6	1.01
chr4	146652995	146654595	CpG: 171	1600	171	1107	21.4	69.2	0.89
chr4	146654930	146655155	CpG: 18	225	18	128	16.0	56.9	1.05
chr4	146682167	146682403	CpG: 17	236	17	139	14.4	58.9	0.85
chr4	146830309	146831403	CpG: 107	1094	107	709	19.6	64.8	0.93
chr4	146876584	146876990	CpG: 47	406	47	272	23.2	67.0	1.04
chr4	146969428	146969709	CpG: 23	281	23	175	16.4	62.3	0.86
chr4	147016921	147018317	CpG: 123	1396	123	959	17.6	68.7	0.75
chr4	147229333	147229731	CpG: 54	398	54	286	27.1	71.9	1.08
chr4	147253407	147253681	CpG: 24	274	24	171	17.5	62.4	0.91
chr4	147962464	147963653	CpG: 103	1189	103	798	17.3	67.1	0.77
chr4	148001695	148001952	CpG: 20	257	20	139	15.6	54.1	1.10
chr4	148073856	148074092	CpG: 18	236	18	144	15.3	61.0	0.86
chr4	148197215	148197456	CpG: 19	241	19	149	15.8	61.8	0.85
chr4	148256257	148256531	CpG: 20	274	20	167	14.6	60.9	0.80
chr4	148415403	148416066	CpG: 59	663	59	403	17.8	60.8	0.96
chr4	148497000	148498301	CpG: 172	1301	172	950	26.4	73.0	0.99
chr4	148663624	148663990	CpG: 31	366	31	248	16.9	67.8	0.75
chr4	148686933	148687175	CpG: 20	242	20	146	16.5	60.3	0.91
chr4	148715146	148715427	CpG: 23	281	23	174	16.4	61.9	0.87
chr4	148798839	148800284	CpG: 172	1445	172	993	23.8	68.7	1.01
chr4	148843093	148843364	CpG: 23	271	23	161	17.0	59.4	0.99
chr4	148934718	148935321	CpG: 66	603	66	418	21.9	69.3	0.91
chr4	148976803	148977090	CpG: 24	287	24	181	16.7	63.1	0.86
chr4	149048888	149049509	CpG: 75	621	75	465	24.2	74.9	0.88
chr4	149077383	149077690	CpG: 24	307	24	195	15.6	63.5	0.79
chr4	149248547	149248817	CpG: 20	270	20	162	14.8	60.0	0.83
chr4	149252233	149253981	CpG: 170	1748	170	1192	19.5	68.2	0.85
chr4	149307435	149307667	CpG: 19	232	19	135	16.4	58.2	0.98
chr4	149491702	149492387	CpG: 70	685	70	457	20.4	66.7	0.93
chr4	149512697	149512979	CpG: 24	282	24	175	17.0	62.1	0.89
chr4	149621838	149622264	CpG: 32	426	32	255	15.0	59.9	0.84
chr4	149673860	149674170	CpG: 25	310	25	190	16.1	61.3	0.86
chr4	149845643	149846614	CpG: 84	971	84	633	17.3	65.2	0.82
chr4	149936539	149936803	CpG: 21	264	21	159	15.9	60.2	0.88
chr4	149960793	149961145	CpG: 33	352	33	245	18.8	69.6	0.82
chr4	149961752	149964468	CpG: 232	2716	232	1736	17.1	63.9	0.84
chr4	149978672	149979325	CpG: 75	653	75	473	23.0	72.4	0.90
chr4	149987141	149987698	CpG: 47	557	47	324	16.9	58.2	1.00
chr4	150269284	150269614	CpG: 31	330	31	225	18.8	68.2	0.81
chr4	150323082	150323356	CpG: 24	274	24	171	17.5	62.4	0.91
chr4	150456571	150456844	CpG: 23	273	23	165	16.8	60.4	0.93
chr4	150554249	150554530	CpG: 24	281	24	174	17.1	61.9	0.91
chr4	150666756	150666995	CpG: 19	239	19	141	15.9	59.0	0.93
chr4	150667176	150667456	CpG: 24	280	24	178	17.1	63.6	0.87
chr4	150805177	150805739	CpG: 65	562	65	397	23.1	70.6	0.93
chr4	150941382	150941651	CpG: 19	269	19	161	14.1	59.9	0.83
chr4	150981333	150981613	CpG: 21	280	21	166	15.0	59.3	0.87
chr4	151007894	151008565	CpG: 62	671	62	424	18.5	63.2	0.93
chr4	151031673	151031939	CpG: 19	266	19	163	14.3	61.3	0.78
chr4	151055803	151056873	CpG: 128	1070	128	768	23.9	71.8	0.94
chr4	151235382	151235590	CpG: 14	208	14	118	13.5	56.7	0.85
chr4	151246322	151246595	CpG: 24	273	24	171	17.6	62.6	0.91
chr4	151260254	151260536	CpG: 22	282	22	173	15.6	61.3	0.84
chr4	151459708	151459987	CpG: 26	279	26	176	18.6	63.1	0.94
chr4	151647432	151647742	CpG: 26	310	26	185	16.8	59.7	0.95
chr4	151766171	151770001	CpG: 347	3830	347	2539	18.1	66.3	0.83
chr4	152150700	152150920	CpG: 19	220	19	130	17.3	59.1	1.01
chr4	152171283	152171561	CpG: 19	278	19	169	13.7	60.8	0.75
chr4	152186988	152187281	CpG: 23	293	23	177	15.7	60.4	0.87
chr4	152191667	152191903	CpG: 17	236	17	143	14.4	60.6	0.81
chr4	152675692	152675962	CpG: 22	270	22	166	16.3	61.5	0.87
chr4	152870895	152871172	CpG: 23	277	23	169	16.6	61.0	0.90
chr4	152954509	152954794	CpG: 24	285	24	178	16.8	62.5	0.88
chr4	152958492	152958777	CpG: 24	285	24	179	16.8	62.8	0.87
chr4	153399441	153400873	CpG: 172	1432	172	1048	24.0	73.2	0.90
chr4	153550429	153550710	CpG: 22	281	22	173	15.7	61.6	0.84
chr4	153580198	153580410	CpG: 22	212	22	159	20.8	75.0	0.74
chr4	153903457	153903993	CpG: 62	536	62	374	23.1	69.8	0.95
chr4	153906706	153907780	CpG: 95	1074	95	662	17.7	61.6	0.93
chr4	154017185	154017422	CpG: 20	237	20	144	16.9	60.8	0.94
chr4	154277607	154278222	CpG: 47	615	47	433	15.3	70.4	0.62
chr4	154287540	154288071	CpG: 41	531	41	377	15.4	71.0	0.62
chr4	154339379	154340245	CpG: 89	866	89	599	20.6	69.2	0.86
chr4	154355396	154355657	CpG: 21	261	21	161	16.1	61.7	0.86
chr4	154423202	154423842	CpG: 66	640	66	399	20.6	62.3	1.06
chr4	154442748	154442980	CpG: 16	232	16	137	13.8	59.1	0.81
chr4	154491514	154491794	CpG: 24	280	24	198	17.1	70.7	0.69
chr4	154630949	154631227	CpG: 22	278	22	168	15.8	60.4	0.88
chr4	154648950	154649699	CpG: 89	749	89	548	23.8	73.2	0.90
chr4	154732527	154733576	CpG: 102	1049	102	718	19.4	68.4	0.84
chr4	155054340	155055262	CpG: 70	922	70	653	15.2	70.8	0.61
chr4	155083991	155084243	CpG: 22	252	22	154	17.5	61.1	0.94
chr4	155128983	155129252	CpG: 22	269	22	164	16.4	61.0	0.90
chr4	155843311	155843596	CpG: 24	285	24	179	16.8	62.8	0.87
chr4	155858119	155859854	CpG: 167	1735	167	1223	19.3	70.5	0.77
chr4	155892545	155892816	CpG: 20	271	20	163	14.8	60.1	0.83
chr4	155994613	155994887	CpG: 23	274	23	170	16.8	62.0	0.88
chr4	156038847	156039114	CpG: 25	267	25	170	18.7	63.7	0.94
chr4	156088170	156089063	CpG: 69	893	69	629	15.5	70.4	0.62
chr4	156102457	156103409	CpG: 71	952	71	602	14.9	63.2	0.75
chr4	156138960	156139234	CpG: 22	274	22	169	16.1	61.7	0.85
chr4	156259000	156261290	CpG: 254	2290	254	1619	22.2	70.7	0.90
chr4	156299111	156299420	CpG: 25	309	25	218	16.2	70.6	0.65
chr4	156299512	156299809	CpG: 21	297	21	196	14.1	66.0	0.66
chr4	156444318	156444585	CpG: 20	267	20	162	15.0	60.7	0.83
chr4	156477202	156477864	CpG: 71	662	71	446	21.5	67.4	0.96
chr4	156546860	156547391	CpG: 58	531	58	380	21.8	71.6	0.86
chr4	156573309	156573541	CpG: 22	232	22	158	19.0	68.1	0.82
chr4	156591232	156591508	CpG: 23	276	23	175	16.7	63.4	0.84
chr4	156619859	156620482	CpG: 43	623	43	359	13.8	57.6	0.83
chr4	156638612	156638842	CpG: 18	230	18	139	15.7	60.4	0.87
chr4	156668884	156669671	CpG: 97	787	97	564	24.7	71.7	0.97
chr4	156762246	156762531	CpG: 25	285	25	164	17.5	57.5	1.08
chr4	156780252	156780529	CpG: 21	277	21	172	15.2	62.1	0.80
chr4	156790121	156791903	CpG: 170	1782	170	1201	19.1	67.4	0.84
chr4	157008431	157009374	CpG: 92	943	92	683	19.5	72.4	0.74
chr4	157084097	157084701	CpG: 66	604	66	449	21.9	74.3	0.79
chr4	157112873	157114190	CpG: 113	1317	113	878	17.2	66.7	0.79
chr4	157115436	157116059	CpG: 56	623	56	432	18.0	69.3	0.77
chr4	157116798	157117593	CpG: 58	795	58	484	14.6	60.9	0.79
chr4	157130626	157130899	CpG: 26	273	26	193	19.0	70.7	0.76
chr4	157375238	157375500	CpG: 26	262	26	165	19.8	63.0	1.01
chr4	157664706	157665179	CpG: 39	473	39	301	16.5	63.6	0.82
chr4	157672807	157673054	CpG: 19	247	19	150	15.4	60.7	0.86
chr4	157748487	157748844	CpG: 24	357	24	202	13.4	56.6	0.89
chr4	157821251	157823966	CpG: 243	2715	243	1773	17.9	65.3	0.84
chr4	157855293	157855727	CpG: 33	434	33	265	15.2	61.1	0.82
chr4	157881751	157882300	CpG: 40	549	40	327	14.6	59.6	0.85
chr4	157958640	157958978	CpG: 39	338	39	248	23.1	73.4	0.87
chr4	158072333	158072639	CpG: 23	306	23	187	15.0	61.1	0.81
chr4	158074464	158076489	CpG: 137	2025	137	1203	13.5	59.4	0.77
chr4	158113004	158113992	CpG: 92	988	92	652	18.6	66.0	0.86
chr4	158174301	158174575	CpG: 21	274	21	164	15.3	59.9	0.87
chr4	158300096	158300369	CpG: 22	273	22	169	16.1	61.9	0.85
chr4	158363640	158363871	CpG: 19	231	19	140	16.5	60.6	0.91
chr4	158539971	158540959	CpG: 70	988	70	646	14.2	65.4	0.66
chr4	158709247	158709740	CpG: 54	493	54	331	21.9	67.1	0.97
chr4	158755241	158755481	CpG: 19	240	19	144	15.8	60.0	0.89
chr4	158967615	158967844	CpG: 17	229	17	137	14.8	59.8	0.84
chr4	158999944	159000939	CpG: 102	995	102	694	20.5	69.7	0.84
chr4	159091739	159093030	CpG: 118	1291	118	917	18.3	71.0	0.73
chr4	159248915	159249190	CpG: 23	275	23	171	16.7	62.2	0.87
chr4	159286346	159286689	CpG: 44	343	44	254	25.7	74.1	0.94
chr4	159628289	159628496	CpG: 17	207	17	124	16.4	59.9	0.92
chr4	159635290	159635580	CpG: 25	290	25	175	17.2	60.3	0.95
chr4	159647361	159647583	CpG: 19	222	19	132	17.1	59.5	0.98
chr4	159724712	159724993	CpG: 22	281	22	173	15.7	61.6	0.84
chr4	160027982	160028215	CpG: 17	233	17	138	14.6	59.2	0.86
chr4	160316887	160317798	CpG: 105	911	105	673	23.1	73.9	0.85
chr4	160421511	160422031	CpG: 78	520	78	402	30.0	77.3	1.01
chr4	160531628	160531902	CpG: 25	274	25	172	18.2	62.8	0.94
chr4	160558044	160558325	CpG: 23	281	23	173	16.4	61.6	0.88
chr4	160565747	160566209	CpG: 59	462	59	320	25.5	69.3	1.08
chr4	160567635	160568392	CpG: 58	757	58	485	15.3	64.1	0.75
chr4	160668623	160668859	CpG: 17	236	17	141	14.4	59.7	0.82
chr4	160725677	160725962	CpG: 23	285	23	177	16.1	62.1	0.85
chr4	160786798	160787038	CpG: 19	240	19	143	15.8	59.6	0.92
chr4	160807127	160807360	CpG: 17	233	17	135	14.6	57.9	0.89
chr4	160981997	160983881	CpG: 177	1884	177	1456	18.8	77.3	0.63
chr4	161179923	161180204	CpG: 24	281	24	175	17.1	62.3	0.90
chr4	161337987	161338414	CpG: 34	427	34	259	15.9	60.7	0.87
chr4	161429707	161429936	CpG: 19	229	19	137	16.6	59.8	0.94
chr4	161448943	161449208	CpG: 24	265	24	167	18.1	63.0	0.93
chr4	161460449	161460724	CpG: 20	275	20	169	14.5	61.5	0.78
chr4	161493893	161494455	CpG: 42	562	42	330	14.9	58.7	0.88
chr4	161562538	161562766	CpG: 20	228	20	152	17.5	66.7	0.79
chr4	161760073	161760299	CpG: 26	226	26	172	23.0	76.1	0.80
chr4	161760554	161760839	CpG: 20	285	20	169	14.0	59.3	0.81
chr4	161855985	161856215	CpG: 20	230	20	141	17.4	61.3	0.94
chr4	161913020	161913250	CpG: 20	230	20	141	17.4	61.3	0.94
chr4	162009091	162009294	CpG: 16	203	16	106	15.8	52.2	1.16
chr4	162022213	162023183	CpG: 94	970	94	635	19.4	65.5	0.91
chr4	162073764	162074281	CpG: 53	517	53	337	20.5	65.2	0.98
chr4	162074704	162074948	CpG: 19	244	19	142	15.6	58.2	0.94
chr4	162085579	162085853	CpG: 23	274	23	170	16.8	62.0	0.88
chr4	162119296	162120419	CpG: 134	1123	134	809	23.9	72.0	0.92
chr4	162166196	162166414	CpG: 18	218	18	139	16.5	63.8	0.84
chr4	162181029	162181379	CpG: 28	350	28	210	16.0	60.0	0.90
chr4	162232870	162233185	CpG: 27	315	27	236	17.1	74.9	0.62
chr4	162278463	162278674	CpG: 17	211	17	151	16.1	71.6	0.63
chr4	162279522	162279776	CpG: 19	254	19	145	15.0	57.1	0.93
chr4	162371621	162371867	CpG: 19	246	19	150	15.4	61.0	0.87
chr4	162403758	162404036	CpG: 25	278	25	175	18.0	62.9	0.92
chr4	162453449	162455099	CpG: 212	1650	212	1247	25.7	75.6	0.90
chr4	162556811	162557029	CpG: 17	218	17	131	15.6	60.1	0.89
chr4	162686325	162686566	CpG: 20	241	20	141	16.6	58.5	1.01
chr4	163027398	163027701	CpG: 22	303	22	179	14.5	59.1	0.85
chr4	163066035	163066270	CpG: 19	235	19	141	16.2	60.0	0.90
chr4	163109581	163109859	CpG: 25	278	25	177	18.0	63.7	0.90
chr4	163382168	163382442	CpG: 22	274	22	170	16.1	62.0	0.84
chr4	163463901	163464131	CpG: 20	230	20	141	17.4	61.3	0.94
chr4	163900728	163901030	CpG: 28	302	28	221	18.5	73.2	0.70
chr4	163924600	163924834	CpG: 21	234	21	139	17.9	59.4	1.02
chr4	164182896	164183100	CpG: 16	204	16	122	15.7	59.8	0.89
chr4	164502938	164503166	CpG: 17	228	17	137	14.9	60.1	0.85
chr4	164627373	164627946	CpG: 53	573	53	422	18.5	73.6	0.68
chr4	164628472	164628708	CpG: 17	236	17	131	14.4	55.5	0.97
chr4	164638673	164638954	CpG: 24	281	24	175	17.1	62.3	0.89
chr4	164787507	164787755	CpG: 21	248	21	153	16.9	61.7	0.91
chr4	165101330	165101570	CpG: 19	240	19	149	15.8	62.1	0.84
chr4	165225246	165225561	CpG: 23	315	23	179	14.6	56.8	0.91
chr4	165465818	165466049	CpG: 18	231	18	139	15.6	60.2	0.87
chr4	165488670	165488943	CpG: 24	273	24	168	17.6	61.5	0.94
chr4	165550967	165551374	CpG: 37	407	37	297	18.2	73.0	0.68
chr4	165590377	165590764	CpG: 35	387	35	242	18.1	62.5	0.93
chr4	165649210	165649426	CpG: 19	216	19	131	17.6	60.6	0.96
chr4	165658686	165658960	CpG: 22	274	22	170	16.1	62.0	0.84
chr4	165749391	165749671	CpG: 26	280	26	176	18.6	62.9	0.95
chr4	165777481	165777721	CpG: 17	240	17	141	14.2	58.8	0.86
chr4	165876250	165876525	CpG: 21	275	21	164	15.3	59.6	0.87
chr4	166073341	166073615	CpG: 23	274	23	170	16.8	62.0	0.88
chr4	166087083	166087474	CpG: 40	391	40	285	20.5	72.9	0.77
chr4	166241044	166241318	CpG: 24	274	24	171	17.5	62.4	0.91
chr4	166289842	166290116	CpG: 24	274	24	170	17.5	62.0	0.92
chr4	166463108	166463318	CpG: 16	210	16	129	15.2	61.4	0.83
chr4	166500721	166501110	CpG: 32	389	32	279	16.5	71.7	0.64
chr4	166514178	166514937	CpG: 78	759	78	496	20.6	65.3	0.96
chr4	166537007	166537950	CpG: 64	943	64	597	13.6	63.3	0.68
chr4	166560457	166560692	CpG: 20	235	20	143	17.0	60.9	0.92
chr4	166653173	166653399	CpG: 16	226	16	133	14.2	58.8	0.83
chr4	166679629	166680146	CpG: 56	517	56	340	21.7	65.8	1.00
chr4	166691480	166692431	CpG: 96	951	96	690	20.2	72.6	0.77
chr4	166697692	166697910	CpG: 19	218	19	136	17.4	62.4	0.92
chr4	166807037	166807263	CpG: 16	226	16	131	14.2	58.0	0.86
chr4	166821334	166821722	CpG: 34	388	34	246	17.5	63.4	0.88
chr4	166842130	166842907	CpG: 61	777	61	501	15.7	64.5	0.76
chr4	166897868	166898142	CpG: 22	274	22	169	16.1	61.7	0.85
chr4	167027079	167027291	CpG: 19	212	19	132	17.9	62.3	0.95
chr4	167220379	167220657	CpG: 22	278	22	173	15.8	62.2	0.83
chr4	167535936	167536395	CpG: 42	459	42	287	18.3	62.5	0.94
chr4	167633136	167633429	CpG: 26	293	26	176	17.7	60.1	1.00
chr4	167698507	167698816	CpG: 24	309	24	188	15.5	60.8	0.84
chr4	167730845	167731694	CpG: 71	849	71	560	16.7	66.0	0.77
chr4	167841296	167841507	CpG: 18	211	18	125	17.1	59.2	0.99
chr4	167906759	167907046	CpG: 21	287	21	172	14.6	59.9	0.82
chr4	168120296	168120574	CpG: 27	278	27	177	19.4	63.7	0.97
chr4	168185807	168186080	CpG: 25	273	25	170	18.3	62.3	0.95
chr4	168277449	168277678	CpG: 17	229	17	134	14.8	58.5	0.87
chr4	168304547	168304957	CpG: 38	410	38	267	18.5	65.1	0.88
chr4	168352394	168352629	CpG: 17	235	17	145	14.5	61.7	0.77
chr4	168363431	168363668	CpG: 18	237	18	143	15.2	60.3	0.84
chr4	168367423	168368319	CpG: 74	896	74	629	16.5	70.2	0.67
chr4	168378406	168378648	CpG: 18	242	18	145	14.9	59.9	0.85
chr4	168379041	168380066	CpG: 67	1025	67	604	13.1	58.9	0.75
chr4	168386991	168387282	CpG: 26	291	26	184	17.9	63.2	0.91
chr4	168417005	168417216	CpG: 16	211	16	128	15.2	60.7	0.84
chr4	168442253	168442489	CpG: 17	236	17	143	14.4	60.6	0.80
chr4	168457257	168458101	CpG: 80	844	80	606	19.0	71.8	0.75
chr4	168492996	168493222	CpG: 20	226	20	136	17.7	60.2	1.02
chr4	168553220	168554090	CpG: 137	870	137	664	31.5	76.3	1.09
chr4	168597619	168597893	CpG: 24	274	24	171	17.5	62.4	0.91
chr4	168673297	168673903	CpG: 68	606	68	428	22.4	70.6	0.90
chr4	168724813	168725506	CpG: 76	693	76	493	21.9	71.1	0.87
chr4	168893515	168893745	CpG: 21	230	21	142	18.3	61.7	0.97
chr4	169220010	169220806	CpG: 78	796	78	540	19.6	67.8	0.85
chr4	169320778	169321048	CpG: 23	270	23	168	17.0	62.2	0.89
chr4	169763290	169763564	CpG: 24	274	24	171	17.5	62.4	0.91
chr4	169795479	169795740	CpG: 19	261	19	152	14.6	58.2	0.86
chr4	169861905	169862145	CpG: 17	240	17	144	14.2	60.0	0.82
chr4	169915852	169916160	CpG: 25	308	25	183	16.2	59.4	0.92
chr4	170113128	170113538	CpG: 31	410	31	247	15.1	60.2	0.84
chr4	170198035	170198306	CpG: 20	271	20	163	14.8	60.1	0.84
chr4	170207833	170208034	CpG: 17	201	17	117	16.9	58.2	1.00
chr4	170482791	170483033	CpG: 20	242	20	144	16.5	59.5	0.96
chr4	170591169	170591976	CpG: 64	807	64	516	15.9	63.9	0.79
chr4	170640232	170640461	CpG: 17	229	17	133	14.8	58.1	0.88
chr4	170738544	170738783	CpG: 19	239	19	146	15.9	61.1	0.87
chr4	171251144	171251429	CpG: 22	285	22	175	15.4	61.4	0.83
chr4	171541606	171542062	CpG: 34	456	34	254	14.9	55.7	0.96
chr4	171677403	171677678	CpG: 27	275	27	196	19.6	71.3	0.82
chr4	171839186	171839561	CpG: 37	375	37	249	19.7	66.4	0.91
chr4	171915117	171915353	CpG: 17	236	17	143	14.4	60.6	0.81
chr4	171990545	171990776	CpG: 32	231	32	163	27.7	70.6	1.11
chr4	172029417	172029709	CpG: 26	292	26	185	17.8	63.4	0.91
chr4	172031493	172031729	CpG: 16	236	16	139	13.6	58.9	0.80
chr4	172191345	172192832	CpG: 126	1487	126	1019	16.9	68.5	0.72
chr4	172237190	172237905	CpG: 101	715	101	553	28.3	77.3	1.03
chr4	172369065	172370108	CpG: 83	1043	83	603	15.9	57.8	0.95
chr4	172395304	172395690	CpG: 30	386	30	278	15.5	72.0	0.60
chr4	172629937	172631424	CpG: 164	1487	164	1086	22.1	73.0	0.83
chr4	172854992	172855264	CpG: 21	272	21	163	15.4	59.9	0.87
chr4	172880807	172881234	CpG: 31	427	31	255	14.5	59.7	0.82
chr4	172971996	172972570	CpG: 58	574	58	380	20.2	66.2	0.97
chr4	172979881	172980440	CpG: 58	559	58	360	20.8	64.4	1.01
chr4	173027480	173027756	CpG: 24	276	24	171	17.4	62.0	0.92
chr4	173032047	173032268	CpG: 15	221	15	129	13.6	58.4	0.81
chr4	173039090	173040040	CpG: 68	950	68	640	14.3	67.4	0.64
chr4	173117924	173118235	CpG: 38	311	38	220	24.4	70.7	1.03
chr4	173119294	173119506	CpG: 15	212	15	122	14.2	57.5	0.87
chr4	173134974	173135259	CpG: 30	285	30	201	21.1	70.5	0.86
chr4	173179500	173179778	CpG: 22	278	22	172	15.8	61.9	0.83
chr4	173247480	173247709	CpG: 19	229	19	143	16.6	62.4	0.86
chr4	173284047	173284263	CpG: 16	216	16	127	14.8	58.8	0.87
chr4	173307153	173307373	CpG: 17	220	17	130	15.5	59.1	0.90
chr4	173312030	173312260	CpG: 18	230	18	136	15.7	59.1	0.90
chr4	173321814	173322043	CpG: 21	229	21	139	18.3	60.7	1.00
chr4	173385804	173386963	CpG: 151	1159	151	851	26.1	73.4	0.98
chr4	173387525	173387947	CpG: 32	422	32	263	15.2	62.3	0.78
chr4	173406057	173407171	CpG: 87	1114	87	799	15.6	71.7	0.61
chr4	173449972	173450532	CpG: 78	560	78	421	27.9	75.2	0.99
chr4	173451256	173451808	CpG: 47	552	47	400	17.0	72.5	0.65
chr4	173789020	173789431	CpG: 29	411	29	249	14.1	60.6	0.78
chr4	173821277	173821555	CpG: 25	278	25	175	18.0	62.9	0.92
chr4	173923705	173923976	CpG: 18	271	18	165	13.3	60.9	0.73
chr4	173986055	173986329	CpG: 23	274	23	170	16.8	62.0	0.88
chr4	174071582	174071856	CpG: 21	274	21	169	15.3	61.7	0.82
chr4	174325182	174325464	CpG: 25	282	25	177	17.7	62.8	0.91
chr4	174329928	174330152	CpG: 19	224	19	138	17.0	61.6	0.93
chr4	174400411	174401027	CpG: 55	616	55	449	17.9	72.9	0.67
chr4	174655552	174655906	CpG: 42	354	42	270	23.7	76.3	0.82
chr4	174900500	174900776	CpG: 24	276	24	171	17.4	62.0	0.92
chr4	174929807	174930083	CpG: 19	276	19	168	13.8	60.9	0.75
chr4	175027755	175028021	CpG: 23	266	23	166	17.3	62.4	0.90
chr4	175164977	175166241	CpG: 119	1264	119	846	18.8	66.9	0.84
chr4	175435166	175435404	CpG: 18	238	18	145	15.1	60.9	0.84
chr4	175515669	175515951	CpG: 23	282	23	174	16.3	61.7	0.87
chr4	175689179	175689409	CpG: 20	230	20	141	17.4	61.3	0.94
chr4	175907959	175908197	CpG: 19	238	19	142	16.0	59.7	0.93
chr4	175997270	175997540	CpG: 23	270	23	165	17.0	61.1	0.92
chr4	176099283	176099564	CpG: 23	281	23	175	16.4	62.3	0.86
chr4	176127805	176128039	CpG: 18	234	18	136	15.4	58.1	0.93
chr4	176507997	176509701	CpG: 201	1704	201	1276	23.6	74.9	0.85
chr4	176523043	176523853	CpG: 66	810	66	564	16.3	69.6	0.67
chr4	176627426	176627692	CpG: 22	266	22	166	16.5	62.4	0.86
chr4	176672957	176674812	CpG: 165	1855	165	1206	17.8	65.0	0.85
chr4	176709199	176711524	CpG: 186	2325	186	1418	16.0	61.0	0.86
chr4	176839984	176840356	CpG: 31	372	31	224	16.7	60.2	0.92
chr4	176840664	176841083	CpG: 34	419	34	260	16.2	62.1	0.85
chr4	176846531	176846832	CpG: 27	301	27	191	17.9	63.5	0.89
chr4	176849028	176849501	CpG: 57	473	57	328	24.1	69.3	1.00
chr4	176856552	176856984	CpG: 34	432	34	274	15.7	63.4	0.80
chr4	176858450	176858887	CpG: 36	437	36	285	16.5	65.2	0.79
chr4	176862003	176862586	CpG: 57	583	57	367	19.6	63.0	1.01
chr4	176866974	176867486	CpG: 35	512	35	307	13.7	60.0	0.76
chr4	176868687	176870110	CpG: 151	1423	151	998	21.2	70.1	0.86
chr4	176870470	176871604	CpG: 74	1134	74	654	13.1	57.7	0.80
chr4	176877842	176878696	CpG: 68	854	68	555	15.9	65.0	0.76
chr4	176940144	176940418	CpG: 25	274	25	173	18.2	63.1	0.93
chr4	177205343	177205616	CpG: 24	273	24	171	17.6	62.6	0.91
chr4	177290044	177290314	CpG: 22	270	22	163	16.3	60.4	0.92
chr4	177379381	177379611	CpG: 20	230	20	140	17.4	60.9	0.95
chr4	177408673	177408947	CpG: 20	274	20	168	14.6	61.3	0.79
chr4	177479817	177480056	CpG: 19	239	19	144	15.9	60.3	0.89
chr4	177553939	177554171	CpG: 20	232	20	150	17.2	64.7	0.82
chr4	177608302	177608582	CpG: 21	280	21	173	15.0	61.8	0.79
chr4	177623253	177624083	CpG: 56	830	56	469	13.5	56.5	0.85
chr4	177638037	177638307	CpG: 21	270	21	166	15.6	61.5	0.83
chr4	177731942	177732234	CpG: 24	292	24	178	16.4	61.0	0.90
chr4	177747843	177748117	CpG: 21	274	21	170	15.3	62.0	0.80
chr4	177824023	177824296	CpG: 21	273	21	168	15.4	61.5	0.82
chr4	177842103	177842381	CpG: 21	278	21	170	15.1	61.2	0.82
chr4	177851379	177851645	CpG: 20	266	20	158	15.0	59.4	0.86
chr4	177861958	177862389	CpG: 53	431	53	309	24.6	71.7	0.96
chr4	178031179	178032048	CpG: 62	869	62	598	14.3	68.8	0.60
chr4	178056846	178057125	CpG: 23	279	23	178	16.5	63.8	0.82
chr4	178167047	178167301	CpG: 26	254	26	163	20.5	64.2	0.99
chr4	178357667	178358113	CpG: 33	446	33	266	14.8	59.6	0.83
chr4	178656832	178657102	CpG: 25	270	25	169	18.5	62.6	0.95
chr4	178714686	178714919	CpG: 17	233	17	134	14.6	57.5	0.90
chr4	178766371	178766748	CpG: 45	377	45	289	23.9	76.7	0.83
chr4	178811754	178811984	CpG: 19	230	19	140	16.5	60.9	0.90
chr4	178921464	178921742	CpG: 25	278	25	177	18.0	63.7	0.90
chr4	179155329	179155602	CpG: 24	273	24	172	17.6	63.0	0.90
chr4	179227977	179228207	CpG: 18	230	18	139	15.7	60.4	0.88
chr4	179339774	179340121	CpG: 26	347	26	213	15.0	61.4	0.81
chr4	179340376	179340931	CpG: 47	555	47	367	16.9	66.1	0.78
chr4	179364247	179364522	CpG: 23	275	23	171	16.7	62.2	0.88
chr4	179394976	179395230	CpG: 19	254	19	155	15.0	61.0	0.82
chr4	179404221	179404660	CpG: 48	439	48	314	21.9	71.5	0.85
chr4	179505772	179506045	CpG: 23	273	23	172	16.8	63.0	0.86
chr4	179533742	179534092	CpG: 34	350	34	224	19.4	64.0	0.96
chr4	179590370	179590606	CpG: 20	236	20	144	16.9	61.0	0.93
chr4	179658830	179659727	CpG: 128	897	128	644	28.5	71.8	1.11
chr4	179802302	179802576	CpG: 22	274	22	168	16.1	61.3	0.86
chr4	179812745	179813015	CpG: 20	270	20	164	14.8	60.7	0.81
chr4	179851680	179851911	CpG: 19	231	19	141	16.5	61.0	0.90
chr4	179893550	179893784	CpG: 17	234	17	143	14.5	61.1	0.80
chr4	179964197	179964623	CpG: 37	426	37	309	17.4	72.5	0.66
chr4	180031093	180031530	CpG: 39	437	39	255	17.8	58.4	1.05
chr4	180131099	180132327	CpG: 146	1228	146	917	23.8	74.7	0.85
chr4	180152377	180152651	CpG: 24	274	24	170	17.5	62.0	0.93
chr4	180240226	180240481	CpG: 20	255	20	156	15.7	61.2	0.85
chr4	180287187	180287462	CpG: 24	275	24	171	17.5	62.2	0.91
chr4	180492581	180492867	CpG: 20	286	20	163	14.0	57.0	0.87
chr4	180527650	180527924	CpG: 24	274	24	171	17.5	62.4	0.91
chr4	180532298	180532863	CpG: 49	565	49	410	17.3	72.6	0.66
chr4	180570258	180570531	CpG: 20	273	20	166	14.7	60.8	0.80
chr4	180648487	180648897	CpG: 41	410	41	272	20.0	66.3	0.91
chr4	180780756	180781225	CpG: 51	469	51	324	21.7	69.1	0.91
chr4	180809670	180809937	CpG: 22	267	22	170	16.5	63.7	0.81
chr4	180835258	180835470	CpG: 16	212	16	120	15.1	56.6	0.97
chr4	180879364	180879600	CpG: 17	236	17	141	14.4	59.7	0.83
chr4	180906764	180907000	CpG: 18	236	18	142	15.3	60.2	0.87
chr4	181353738	181353967	CpG: 21	229	21	140	18.3	61.1	0.98
chr4	181529184	181529459	CpG: 21	275	21	169	15.3	61.5	0.82
chr4	181616030	181616304	CpG: 22	274	22	168	16.1	61.3	0.87
chr4	182240293	182240574	CpG: 25	281	25	177	17.8	63.0	0.91
chr4	182465362	182465640	CpG: 24	278	24	171	17.3	61.5	0.92
chr4	182502274	182502553	CpG: 23	279	23	173	16.5	62.0	0.86
chr4	182535560	182535834	CpG: 24	274	24	172	17.5	62.8	0.90
chr4	182585660	182585941	CpG: 24	281	24	173	17.1	61.6	0.92
chr4	182622508	182622742	CpG: 17	234	17	139	14.5	59.4	0.85
chr4	182879862	182880135	CpG: 23	273	23	169	16.8	61.9	0.89
chr4	182994919	182995148	CpG: 19	229	19	138	16.6	60.3	0.92
chr4	183118923	183119199	CpG: 26	276	26	174	18.8	63.0	0.96
chr4	183209899	183210113	CpG: 19	214	19	133	17.8	62.1	0.93
chr4	183294130	183294414	CpG: 21	284	21	167	14.8	58.8	0.87
chr4	183316344	183316581	CpG: 16	237	16	138	13.5	58.2	0.82
chr4	183399796	183401377	CpG: 176	1581	176	1116	22.3	70.6	0.89
chr4	183525189	183525426	CpG: 21	237	21	142	17.7	59.9	1.01
chr4	183588206	183588436	CpG: 21	230	21	142	18.3	61.7	0.97
chr4	183695194	183695424	CpG: 17	230	17	134	14.8	58.3	0.88
chr4	183743039	183743325	CpG: 21	286	21	173	14.7	60.5	0.81
chr4	183896960	183897200	CpG: 20	240	20	147	16.7	61.2	0.91
chr4	183923985	183924260	CpG: 24	275	24	170	17.5	61.8	0.92
chr4	183932474	183932699	CpG: 19	225	19	137	16.9	60.9	0.93
chr4	183947360	183947662	CpG: 24	302	24	168	15.9	55.6	1.04
chr4	183967610	183967840	CpG: 20	230	20	140	17.4	60.9	0.96
chr4	184092561	184092849	CpG: 27	288	27	174	18.8	60.4	1.03
chr4	184139541	184139774	CpG: 16	233	16	136	13.7	58.4	0.82
chr4	184260690	184260965	CpG: 23	275	23	170	16.7	61.8	0.89
chr4	184337308	184337587	CpG: 24	279	24	171	17.2	61.3	0.92
chr4	184341463	184341733	CpG: 21	270	21	167	15.6	61.9	0.83
chr4	184411092	184411384	CpG: 25	292	25	180	17.1	61.6	0.92
chr4	184559325	184559591	CpG: 21	266	21	162	15.8	60.9	0.87
chr4	184561429	184561661	CpG: 18	232	18	138	15.5	59.5	0.89
chr4	184576784	184577043	CpG: 21	259	21	161	16.2	62.2	0.85
chr4	184627726	184627979	CpG: 20	253	20	154	15.8	60.9	0.86
chr4	184689040	184689316	CpG: 20	276	20	170	14.5	61.6	0.77
chr4	184756653	184757012	CpG: 30	359	30	217	16.7	60.4	0.92
chr4	184790300	184790583	CpG: 25	283	25	175	17.7	61.8	0.93
chr4	184895643	184895879	CpG: 20	236	20	142	16.9	60.2	0.95
chr4	184916374	184916659	CpG: 26	285	26	181	18.2	63.5	0.92
chr4	184946129	184946404	CpG: 23	275	23	168	16.7	61.1	0.91
chr4	185109130	185109355	CpG: 18	225	18	140	16.0	62.2	0.85
chr4	185466798	185467007	CpG: 15	209	15	130	14.4	62.2	0.76
chr4	185482943	185483146	CpG: 20	203	20	128	19.7	63.1	1.00
chr4	185484061	185487035	CpG: 267	2974	267	1924	18.0	64.7	0.86
chr4	185501855	185502145	CpG: 23	290	23	178	15.9	61.4	0.86
chr4	185502971	185503249	CpG: 27	278	27	176	19.4	63.3	0.98
chr4	185585766	185586040	CpG: 24	274	24	171	17.5	62.4	0.91
chr4	185677011	185677286	CpG: 24	275	24	172	17.5	62.5	0.91
chr4	185704315	185704533	CpG: 16	218	16	128	14.7	58.7	0.86
chr4	185706271	185706506	CpG: 20	235	20	142	17.0	60.4	0.95
chr4	185728367	185728747	CpG: 37	380	37	278	19.5	73.2	0.73
chr4	185731510	185731784	CpG: 20	274	20	169	14.6	61.7	0.78
chr4	185758806	185759082	CpG: 20	276	20	166	14.5	60.1	0.81
chr4	185789968	185791173	CpG: 161	1205	161	897	26.7	74.4	0.99
chr4	185859243	185859517	CpG: 26	274	26	173	19.0	63.1	0.96
chr4	186097422	186097700	CpG: 23	278	23	170	16.5	61.2	0.89
chr4	186126497	186126808	CpG: 23	311	23	191	14.8	61.4	0.79
chr4	186141375	186142456	CpG: 120	1081	120	717	22.2	66.3	1.01
chr4	186148279	186149083	CpG: 64	804	64	504	15.9	62.7	0.82
chr4	186149688	186150068	CpG: 30	380	30	263	15.8	69.2	0.66
chr4	186260442	186261692	CpG: 143	1250	143	890	22.9	71.2	0.90
chr4	186384210	186384628	CpG: 37	418	37	304	17.7	72.7	0.67
chr4	186388396	186388669	CpG: 21	273	21	195	15.4	71.4	0.60
chr4	186441219	186443768	CpG: 278	2549	278	1825	21.8	71.6	0.85
chr4	186476020	186476298	CpG: 23	278	23	173	16.5	62.2	0.87
chr4	186682180	186682444	CpG: 23	264	23	164	17.4	62.1	0.92
chr4	186741171	186741805	CpG: 57	634	57	428	18.0	67.5	0.79
chr4	186749231	186749507	CpG: 25	276	25	170	18.1	61.6	0.97
chr4	186786854	186788092	CpG: 149	1238	149	883	24.1	71.3	0.95
chr4	186800558	186800832	CpG: 21	274	21	167	15.3	60.9	0.84
chr4	186825605	186826414	CpG: 64	809	64	538	15.8	66.5	0.72
chr4	186833711	186833942	CpG: 17	231	17	137	14.7	59.3	0.85
chr4	186846899	186849265	CpG: 260	2366	260	1718	22.0	72.6	0.85
chr4	186852295	186852617	CpG: 26	322	26	188	16.1	58.4	0.96
chr4	186876376	186876739	CpG: 27	363	27	218	14.9	60.1	0.85
chr4	186913402	186913681	CpG: 21	279	21	172	15.1	61.6	0.80
chr4	186985403	186985633	CpG: 20	230	20	140	17.4	60.9	0.95
chr4	187001964	187002687	CpG: 85	723	85	537	23.5	74.3	0.86
chr4	187004587	187004864	CpG: 21	277	21	170	15.2	61.4	0.82
chr4	187065433	187065668	CpG: 20	235	20	142	17.0	60.4	0.94
chr4	187065958	187066458	CpG: 63	500	63	366	25.2	73.2	0.94
chr4	187089890	187090232	CpG: 28	342	28	246	16.4	71.9	0.63
chr4	187096454	187096677	CpG: 19	223	19	137	17.0	61.4	0.91
chr4	187101800	187102057	CpG: 20	257	20	170	15.6	66.1	0.78
chr4	187140539	187142030	CpG: 188	1491	188	1123	25.2	75.3	0.89
chr4	187150460	187150696	CpG: 19	236	19	139	16.1	58.9	0.95
chr4	187161988	187162355	CpG: 32	367	32	265	17.4	72.2	0.67
chr4	187162647	187162855	CpG: 17	208	17	127	16.3	61.1	0.89
chr4	187177128	187177364	CpG: 20	236	20	145	16.9	61.4	0.92
chr4	187218598	187218870	CpG: 22	272	22	169	16.2	62.1	0.85
chr4	187236282	187236558	CpG: 24	276	24	169	17.4	61.2	0.94
chr4	187249068	187250992	CpG: 201	1924	201	1308	20.9	68.0	0.90
chr4	187294842	187295120	CpG: 24	278	24	175	17.3	62.9	0.88
chr4	187441079	187441410	CpG: 26	331	26	207	15.7	62.5	0.84
chr4	187512324	187512626	CpG: 27	302	27	208	17.9	68.9	0.75
chr4	187550094	187550367	CpG: 24	273	24	173	17.6	63.4	0.88
chr4	187552177	187552488	CpG: 25	311	25	192	16.1	61.7	0.85
chr4	187800236	187800478	CpG: 24	242	24	160	19.8	66.1	0.91
chr4	187816538	187818849	CpG: 230	2311	230	1567	19.9	67.8	0.87
chr4	187862008	187862281	CpG: 21	273	21	167	15.4	61.2	0.84
chr4	187876912	187877148	CpG: 21	236	21	143	17.8	60.6	0.99
chr4	187891915	187892151	CpG: 20	236	20	146	16.9	61.9	0.91
chr4	187904154	187904394	CpG: 19	240	19	149	15.8	62.1	0.85
chr4	187935728	187936039	CpG: 32	311	32	233	20.6	74.9	0.74
chr4	187992491	187993510	CpG: 114	1019	114	764	22.4	75.0	0.84
chr4	188077110	188078120	CpG: 84	1010	84	618	16.6	61.2	0.90
chr4	188146708	188146921	CpG: 16	213	16	125	15.0	58.7	0.88
chr4	188168831	188170100	CpG: 174	1269	174	977	27.4	77.0	0.93
chr4	188197448	188197714	CpG: 19	266	19	164	14.3	61.7	0.77
chr4	188295347	188295839	CpG: 34	492	34	321	13.8	65.2	0.83
chr4	188307660	188307964	CpG: 23	304	23	178	15.1	58.6	0.89
chr4	188308677	188311190	CpG: 166	2513	166	1646	13.2	65.5	0.88
chr4	188333487	188333879	CpG: 37	392	37	287	18.9	73.2	0.70
chr4	188348638	188348909	CpG: 19	271	19	155	14.0	57.2	0.91
chr4	188359501	188360009	CpG: 36	508	36	294	14.2	57.9	0.85
chr4	188361481	188365006	CpG: 255	3525	255	2186	14.5	62.0	0.75
chr4	188396751	188397025	CpG: 24	274	24	170	17.5	62.0	0.92
chr4	188400086	188400360	CpG: 26	274	26	173	19.0	63.1	0.96
chr4	188409354	188409630	CpG: 22	276	22	168	15.9	60.9	0.87
chr4	188471060	188472739	CpG: 149	1679	149	1091	17.7	65.0	0.84
chr4	188473164	188473546	CpG: 30	382	30	228	15.7	59.7	0.90
chr4	188476405	188476677	CpG: 19	272	19	160	14.0	58.8	0.83
chr4	188486578	188487521	CpG: 116	943	116	671	24.6	71.2	0.97
chr4	188547223	188547998	CpG: 110	775	110	575	28.4	74.2	1.04
chr4	188553145	188554457	CpG: 170	1312	170	1002	25.9	76.4	0.89
chr4	188583605	188584637	CpG: 79	1032	79	732	15.3	70.9	0.61
chr4	188621045	188621319	CpG: 24	274	24	171	17.5	62.4	0.91
chr4	188739320	188740432	CpG: 126	1112	126	774	22.7	69.6	0.94
chr4	188762503	188762764	CpG: 18	261	18	160	13.8	61.3	0.74
chr4	188768982	188769759	CpG: 73	777	73	495	18.8	63.7	0.93
chr4	188783790	188784064	CpG: 23	274	23	171	16.8	62.4	0.87
chr4	188787264	188787545	CpG: 23	281	23	174	16.4	61.9	0.87
chr4	188814094	188815583	CpG: 140	1489	140	1074	18.8	72.1	0.77
chr4	188830774	188831047	CpG: 21	273	21	168	15.4	61.5	0.82
chr4	188875925	188876806	CpG: 89	881	89	607	20.2	68.9	0.86
chr4	188964382	188965131	CpG: 50	749	50	435	13.4	58.1	0.79
chr4	188979654	188979984	CpG: 28	330	28	224	17.0	67.9	0.80
chr4	189004656	189004922	CpG: 18	266	18	161	13.5	60.5	0.75
chr4	189108057	189108295	CpG: 21	238	21	148	17.6	62.2	0.95
chr4	189147186	189147461	CpG: 23	275	23	170	16.7	61.8	0.89
chr4	189444975	189446109	CpG: 135	1134	135	863	23.8	76.1	0.82
chr4	189447054	189447337	CpG: 22	283	22	172	15.5	60.8	0.85
chr4	189449295	189449535	CpG: 19	240	19	145	15.8	60.4	0.89
chr4	189456361	189456671	CpG: 27	310	27	191	17.4	61.6	0.92
chr4	189485001	189485679	CpG: 97	678	97	533	28.6	78.6	0.96
chr4	189490827	189491100	CpG: 23	273	23	170	16.8	62.3	0.88
chr4	189531146	189532496	CpG: 146	1350	146	971	21.6	71.9	0.84
chr4	189544530	189544953	CpG: 47	423	47	266	22.2	62.9	1.37
chr4	189576240	189576513	CpG: 26	273	26	173	19.0	63.4	0.96
chr4	189601745	189602027	CpG: 21	282	21	171	14.9	60.6	0.82
chr4	189632485	189632716	CpG: 18	231	18	137	15.6	59.3	0.89
chr4	189637439	189637864	CpG: 36	425	36	281	16.9	66.1	0.78
chr4	189663874	189664264	CpG: 41	390	41	291	21.0	74.6	0.76
chr4	189676582	189676821	CpG: 19	239	19	144	15.9	60.3	0.90
chr4	189710586	189712167	CpG: 113	1581	113	904	14.3	57.2	0.88
chr4	189847240	189847550	CpG: 29	310	29	196	18.7	63.2	0.99
chr4	189901855	189902420	CpG: 82	565	82	431	29.0	76.3	1.00
chr4	190039033	190039263	CpG: 20	230	20	141	17.4	61.3	0.94
chr4	190069871	190073805	CpG: 338	3934	338	2427	17.2	61.7	0.91
chr4	190235722	190236227	CpG: 44	505	44	344	17.4	68.1	0.82
chr4	190276104	190276511	CpG: 33	407	33	250	16.2	61.4	0.87
chr4	190306303	190319533	CpG: 784	13230	784	7872	11.9	59.5	0.68
chr4	190376618	190376888	CpG: 23	270	23	163	17.0	60.4	0.95
chr4	190397013	190397242	CpG: 19	229	19	135	16.6	59.0	0.96
chr4	190409726	190409983	CpG: 21	257	21	173	16.3	67.3	0.72
chr4	190410437	190410694	CpG: 27	257	27	162	21.0	63.0	1.06
chr4	190603385	190603613	CpG: 19	228	19	139	16.7	61.0	0.92
chr4	190625879	190626159	CpG: 26	280	26	176	18.6	62.9	0.95
chr4	190710304	190710518	CpG: 21	214	21	146	19.6	68.2	0.93
chr4	190768029	190768576	CpG: 39	547	39	342	14.3	62.5	0.73
chr4	190852750	190853614	CpG: 73	864	73	616	16.9	71.3	0.67
chr4	190854264	190854568	CpG: 22	304	22	179	14.5	58.9	0.90
chr4	190876647	190876877	CpG: 19	230	19	142	16.5	61.7	0.88
chr4	190908663	190908894	CpG: 17	231	17	142	14.7	61.5	0.80
chr4	190919664	190919898	CpG: 18	234	18	146	15.4	62.4	0.80
chr4	190961297	190961549	CpG: 31	252	31	170	24.6	67.5	1.08
chr4	191005413	191006105	CpG: 56	692	56	475	16.2	68.6	0.69
chr4	191040958	191041204	CpG: 18	246	18	149	14.6	60.6	0.81
chr4	191092265	191092497	CpG: 22	232	22	143	19.0	61.6	1.02
chr4	191112613	191112887	CpG: 25	274	25	172	18.2	62.8	0.93
chr4	191244506	191244789	CpG: 23	283	23	174	16.3	61.5	0.87
chr4	191264789	191265051	CpG: 22	262	22	165	16.8	63.0	0.86
chr4	191267594	191267895	CpG: 24	301	24	179	15.9	59.5	0.91
chr4	191288779	191289053	CpG: 26	274	26	176	19.0	64.2	0.93
chr4	191343049	191343666	CpG: 57	617	57	411	18.5	66.6	0.84
chr4	191344314	191344618	CpG: 22	304	22	177	14.5	58.2	0.87
chr4	191345239	191345483	CpG: 20	244	20	148	16.4	60.7	0.94
chr4	191380597	191381012	CpG: 29	415	29	239	14.0	57.6	0.85
chr4	191381946	191382182	CpG: 17	236	17	143	14.4	60.6	0.80
chr4	191424299	191424510	CpG: 16	211	16	123	15.2	58.3	0.91
chr4	191449544	191449798	CpG: 19	254	19	157	15.0	61.8	0.79
chr4	191453794	191454563	CpG: 69	769	69	484	17.9	62.9	0.91
chr4	191492059	191492289	CpG: 20	230	20	142	17.4	61.7	0.92
chr4	191506744	191507143	CpG: 33	399	33	232	16.5	58.1	1.06
chr4	191526036	191526444	CpG: 37	408	37	302	18.1	74.0	0.66
chr4	191565547	191566477	CpG: 68	930	68	573	14.6	61.6	0.77
chr4	191573501	191573726	CpG: 18	225	18	139	16.0	61.8	0.85
chr4	191614477	191614705	CpG: 19	228	19	141	16.7	61.8	0.88
chr4	191617228	191617524	CpG: 22	296	22	184	14.9	62.2	0.77
chr4	191629796	191630560	CpG: 63	764	63	517	16.5	67.7	0.74
chr4	191653432	191653668	CpG: 19	236	19	145	16.1	61.4	0.88
chr4	191683488	191683753	CpG: 21	265	21	168	15.8	63.4	0.81
chr4	191685018	191685292	CpG: 25	274	25	174	18.2	63.5	0.91
chr4	191789355	191789620	CpG: 20	265	20	162	15.1	61.1	0.82
chr4	191816274	191816497	CpG: 21	223	21	143	18.8	64.1	0.93
chr4	191826040	191826278	CpG: 21	238	21	143	17.6	60.1	1.01
chr4	191863841	191864115	CpG: 23	274	23	169	16.8	61.7	0.89
chr4	191908294	191908558	CpG: 21	264	21	142	15.9	53.8	1.11
chr4	191984291	191984750	CpG: 35	459	35	261	15.3	56.9	1.07
chr4	192012271	192012733	CpG: 47	462	47	313	20.3	67.7	0.89
chr4	192034347	192034619	CpG: 26	272	26	176	19.1	64.7	0.93
chr4	192059362	192059636	CpG: 20	274	20	167	14.6	60.9	0.79
chr4	192118803	192119080	CpG: 25	277	25	176	18.1	63.5	0.90
chr4	192149735	192150583	CpG: 99	848	99	601	23.3	70.9	1.21
chr4	192226823	192227103	CpG: 27	280	27	183	19.3	65.4	0.91
chr4	192365065	192365339	CpG: 24	274	24	175	17.5	63.9	0.88
chr4	192398581	192398933	CpG: 28	352	28	206	15.9	58.5	0.93
chr4	192456543	192457052	CpG: 36	509	36	314	14.1	61.7	0.75
chr4	192592201	192592457	CpG: 23	256	23	189	18.0	73.8	0.66
chr4	192664661	192666304	CpG: 106	1643	106	1065	12.9	64.8	0.62
chr4	192670972	192671853	CpG: 63	881	63	608	14.3	69.0	0.60
chr4	192712326	192712620	CpG: 34	294	34	215	23.1	73.1	0.88
chr4	192720497	192720909	CpG: 46	412	46	278	22.3	67.5	0.98
chr4	192825316	192825595	CpG: 27	279	27	177	19.4	63.4	0.97
chr4	192853054	192853256	CpG: 15	202	15	127	14.9	62.9	0.75
chr4	192974971	192975362	CpG: 40	391	40	293	20.5	74.9	0.73
chr4	193000214	193000435	CpG: 21	221	21	138	19.0	62.4	0.99
chr4	193003518	193004797	CpG: 152	1279	152	847	23.8	66.2	1.36
chr4	193064447	193064730	CpG: 23	283	23	175	16.3	61.8	0.87
chr4	193083247	193083463	CpG: 16	216	16	138	14.8	63.9	0.77
chr4	193160723	193160998	CpG: 22	275	22	169	16.0	61.5	0.86
chr4	193168216	193168506	CpG: 29	290	29	219	20.0	75.5	0.71
chr4	193171570	193172473	CpG: 126	903	126	684	27.9	75.7	1.00
chr4	193206050	193208475	CpG: 176	2425	176	1533	14.5	63.2	0.92
chr4	193222809	193223045	CpG: 21	236	21	147	17.8	62.3	0.94
chr4	193305421	193306305	CpG: 91	884	91	593	20.6	67.1	0.92
chr4	193352288	193353177	CpG: 74	889	74	623	16.6	70.1	0.68
chr4	193365037	193365315	CpG: 25	278	25	175	18.0	62.9	0.92
chr4	193382977	193391970	CpG: 616	8993	616	5693	13.7	63.3	0.68
chr4	193406094	193407061	CpG: 72	967	72	667	14.9	69.0	0.65
chr4	193409161	193409738	CpG: 69	577	69	415	23.9	71.9	0.93
chr4	193433356	193543495	CpG: 10848	110139	10848	79961	19.7	72.6	0.75
chr4	193570272	193570557	CpG: 23	285	23	173	16.1	60.7	0.89
chr4	193571429	193572275	CpG: 122	846	122	623	28.8	73.6	1.07
chr5	2681	3735	CpG: 192	1054	192	826	36.4	78.4	1.20
chr5	41275	41745	CpG: 52	470	52	339	22.1	72.1	0.87
chr5	42124	42369	CpG: 23	245	23	167	18.8	68.2	0.83
chr5	43583	44736	CpG: 124	1153	124	837	21.5	72.6	0.83
chr5	73843	75852	CpG: 170	2009	170	1408	16.9	70.1	0.91
chr5	82209	83578	CpG: 162	1369	162	1120	23.7	81.8	0.93
chr5	156434	158217	CpG: 120	1783	120	1109	13.5	62.2	0.70
chr5	161166	161386	CpG: 17	220	17	144	15.5	65.5	0.73
chr5	172967	173186	CpG: 17	219	17	148	15.5	67.6	0.68
chr5	183033	183785	CpG: 67	752	67	546	17.8	72.6	0.68
chr5	186428	186664	CpG: 24	236	24	159	20.3	67.4	0.91
chr5	201988	204403	CpG: 141	2415	141	1439	11.7	59.6	0.66
chr5	208964	210056	CpG: 131	1092	131	817	24.0	74.8	0.86
chr5	249381	252400	CpG: 279	3019	279	1929	18.5	63.9	0.96
chr5	261439	262398	CpG: 93	959	93	687	19.4	71.6	0.77
chr5	283537	284042	CpG: 36	505	36	285	14.3	56.4	0.94
chr5	297233	297446	CpG: 23	213	23	136	21.6	63.8	1.09
chr5	299559	300242	CpG: 75	683	75	513	22.0	75.1	0.82
chr5	311435	313776	CpG: 240	2341	240	1660	20.5	70.9	0.82
chr5	334262	335357	CpG: 121	1095	121	798	22.1	72.9	0.85
chr5	342462	342666	CpG: 15	204	15	120	14.7	58.8	0.86
chr5	349613	352570	CpG: 269	2957	269	2058	18.2	69.6	0.76
chr5	363178	363380	CpG: 20	202	20	151	19.8	74.8	0.76
chr5	366800	367384	CpG: 80	584	80	467	27.4	80.0	0.86
chr5	384445	385552	CpG: 115	1107	115	850	20.8	76.8	0.84
chr5	415742	416596	CpG: 76	854	76	560	17.8	65.6	0.83
chr5	437947	438692	CpG: 84	745	84	527	22.6	70.7	0.92
chr5	460037	460816	CpG: 69	779	69	535	17.7	68.7	0.75
chr5	467294	469637	CpG: 249	2343	249	1706	21.3	72.8	0.82
chr5	470705	471234	CpG: 44	529	44	361	16.6	68.2	0.72
chr5	475937	476368	CpG: 31	431	31	293	14.4	68.0	0.66
chr5	476909	478761	CpG: 126	1852	126	1228	13.6	66.3	0.62
chr5	480718	480978	CpG: 20	260	20	168	15.4	64.6	0.80
chr5	482041	482392	CpG: 32	351	32	245	18.2	69.8	0.75
chr5	485002	485840	CpG: 66	838	66	573	15.8	68.4	0.67
chr5	488428	489824	CpG: 144	1396	144	979	20.6	70.1	0.96
chr5	491567	492158	CpG: 48	591	48	401	16.2	67.9	0.74
chr5	495578	495818	CpG: 26	240	26	174	21.7	72.5	0.83
chr5	496655	496960	CpG: 27	305	27	173	17.7	56.7	1.11
chr5	500259	500495	CpG: 20	236	20	154	16.9	65.3	0.83
chr5	501748	503137	CpG: 131	1389	131	960	18.9	69.1	0.84
chr5	517983	519194	CpG: 148	1211	148	885	24.4	73.1	0.92
chr5	522690	523289	CpG: 84	599	84	471	28.0	78.6	0.94
chr5	529791	530121	CpG: 26	330	26	236	15.8	71.5	0.62
chr5	531610	531829	CpG: 19	219	19	144	17.4	65.8	0.81
chr5	550734	552204	CpG: 100	1470	100	1029	13.6	70.0	0.83
chr5	558977	563978	CpG: 505	5001	505	3726	20.2	74.5	0.73
chr5	600135	600564	CpG: 37	429	37	291	17.2	67.8	0.75
chr5	609879	610816	CpG: 107	937	107	704	22.8	75.1	0.82
chr5	621102	621490	CpG: 28	388	28	247	14.4	63.7	0.72
chr5	642226	642468	CpG: 19	242	19	158	15.7	65.3	0.76
chr5	644789	645090	CpG: 27	301	27	179	17.9	59.5	1.02
chr5	660297	661447	CpG: 101	1150	101	736	17.6	64.0	0.87
chr5	663232	663446	CpG: 18	214	18	142	16.8	66.4	0.76
chr5	664062	664304	CpG: 19	242	19	161	15.7	66.5	0.73
chr5	665902	666403	CpG: 45	501	45	341	18.0	68.1	0.80
chr5	674553	674969	CpG: 58	416	58	251	27.9	60.3	1.57
chr5	675499	675821	CpG: 27	322	27	217	16.8	67.4	0.75
chr5	689983	691630	CpG: 181	1647	181	1215	22.0	73.8	0.81
chr5	749395	749704	CpG: 24	309	24	215	15.5	69.6	0.64
chr5	750086	750351	CpG: 19	265	19	182	14.3	68.7	0.61
chr5	754326	754707	CpG: 27	381	27	246	14.2	64.6	0.69
chr5	771254	771579	CpG: 25	325	25	216	15.4	66.5	0.70
chr5	786917	787214	CpG: 23	297	23	192	15.5	64.6	0.75
chr5	798459	799416	CpG: 119	957	119	715	24.9	74.7	0.90
chr5	816852	817110	CpG: 21	258	21	157	16.3	60.9	0.90
chr5	817969	818336	CpG: 38	367	38	235	20.7	64.0	1.11
chr5	832063	832878	CpG: 77	815	77	552	18.9	67.7	0.83
chr5	864268	864655	CpG: 32	387	32	250	16.5	64.6	0.80
chr5	865162	865416	CpG: 21	254	21	181	16.5	71.3	0.67
chr5	881566	881780	CpG: 20	214	20	120	18.7	56.1	1.21
chr5	909456	911193	CpG: 166	1737	166	1193	19.1	68.7	0.81
chr5	914221	915545	CpG: 174	1324	174	1019	26.3	77.0	0.89
chr5	928864	929174	CpG: 21	310	21	215	13.5	69.4	0.62
chr5	929738	930321	CpG: 39	583	39	393	13.4	67.4	0.65
chr5	942007	942576	CpG: 42	569	42	400	14.8	70.3	0.63
chr5	954241	954473	CpG: 17	232	17	154	14.7	66.4	0.68
chr5	958658	958921	CpG: 21	263	21	171	16.0	65.0	0.77
chr5	959733	959994	CpG: 24	261	24	175	18.4	67.0	0.82
chr5	961433	961797	CpG: 28	364	28	240	15.4	65.9	0.71
chr5	966146	966379	CpG: 25	233	25	168	21.5	72.1	0.90
chr5	968716	969713	CpG: 86	997	86	686	17.3	68.8	0.78
chr5	973374	973628	CpG: 20	254	20	169	15.7	66.5	0.71
chr5	977871	978334	CpG: 33	463	33	315	14.3	68.0	0.62
chr5	982183	982490	CpG: 25	307	25	220	16.3	71.7	0.64
chr5	984368	984720	CpG: 30	352	30	249	17.0	70.7	0.69
chr5	988104	990039	CpG: 135	1935	135	1293	14.0	66.8	0.63
chr5	991254	992101	CpG: 62	847	62	526	14.6	62.1	0.76
chr5	992435	992656	CpG: 20	221	20	149	18.1	67.4	0.80
chr5	993013	993468	CpG: 35	455	35	301	15.4	66.2	0.70
chr5	997771	998040	CpG: 24	269	24	191	17.8	71.0	0.71
chr5	1005519	1006355	CpG: 57	836	57	520	13.6	62.2	0.71
chr5	1014377	1014626	CpG: 18	249	18	169	14.5	67.9	0.63
chr5	1016971	1017963	CpG: 122	992	122	764	24.6	77.0	0.83
chr5	1060811	1062081	CpG: 146	1270	146	977	23.0	76.9	0.78
chr5	1072735	1073009	CpG: 24	274	24	171	17.5	62.4	0.91
chr5	1076930	1077308	CpG: 26	378	26	197	13.8	52.1	1.09
chr5	1100492	1100752	CpG: 23	260	23	172	17.7	66.2	0.81
chr5	1102815	1103016	CpG: 20	201	20	138	19.9	68.7	0.92
chr5	1108217	1108912	CpG: 51	695	51	483	14.7	69.5	0.61
chr5	1113821	1114305	CpG: 38	484	38	335	15.7	69.2	0.66
chr5	1120265	1120478	CpG: 17	213	17	142	16.0	66.7	0.89
chr5	1123415	1123857	CpG: 33	442	33	274	14.9	62.0	0.79
chr5	1125273	1125497	CpG: 17	224	17	140	15.2	62.5	0.78
chr5	1133835	1134134	CpG: 35	299	35	208	23.4	69.6	1.09
chr5	1139806	1140124	CpG: 26	318	26	207	16.4	65.1	0.78
chr5	1149236	1149456	CpG: 16	220	16	147	14.5	66.8	0.65
chr5	1150427	1150742	CpG: 23	315	23	212	14.6	67.3	0.65
chr5	1152693	1153719	CpG: 86	1026	86	719	16.8	70.1	0.68
chr5	1160529	1160743	CpG: 16	214	16	152	15.0	71.0	0.60
chr5	1163760	1164014	CpG: 21	254	21	175	16.5	68.9	0.71
chr5	1177570	1177893	CpG: 26	323	26	208	16.1	64.4	0.78
chr5	1179679	1180291	CpG: 36	612	36	376	11.8	61.4	1.03
chr5	1184280	1184526	CpG: 18	246	18	154	14.6	62.6	0.75
chr5	1189462	1190057	CpG: 37	595	37	386	12.4	64.9	0.65
chr5	1192911	1193168	CpG: 21	257	21	161	16.3	62.6	0.84
chr5	1196088	1203665	CpG: 582	7577	582	5122	15.4	67.6	0.68
chr5	1245340	1245543	CpG: 18	203	18	139	17.7	68.5	0.77
chr5	1249924	1250344	CpG: 29	420	29	260	13.8	61.9	0.72
chr5	1254813	1255737	CpG: 129	924	129	703	27.9	76.1	0.97
chr5	1269717	1269942	CpG: 18	225	18	152	16.0	67.6	0.70
chr5	1290800	1291036	CpG: 27	236	27	182	22.9	77.1	0.78
chr5	1296241	1297125	CpG: 72	884	72	603	16.3	68.2	0.70
chr5	1328619	1328831	CpG: 16	212	16	122	15.1	57.5	1.03
chr5	1356109	1356317	CpG: 15	208	15	130	14.4	62.5	0.74
chr5	1356528	1358583	CpG: 229	2055	229	1496	22.3	72.8	0.85
chr5	1375072	1375580	CpG: 45	508	45	333	17.7	65.6	0.83
chr5	1376900	1377241	CpG: 23	341	23	177	13.5	51.9	1.15
chr5	1377659	1378188	CpG: 38	529	38	313	14.4	59.2	0.83
chr5	1378521	1378731	CpG: 18	210	18	139	17.1	66.2	0.81
chr5	1379562	1379994	CpG: 32	432	32	296	14.8	68.5	0.65
chr5	1395387	1395593	CpG: 15	206	15	119	14.6	57.8	0.87
chr5	1406435	1406869	CpG: 44	434	44	297	20.3	68.4	0.87
chr5	1432277	1432514	CpG: 17	237	17	137	14.3	57.8	0.88
chr5	1434604	1436167	CpG: 191	1563	191	1197	24.4	76.6	0.84
chr5	1469895	1470149	CpG: 18	254	18	137	14.2	53.9	1.05
chr5	1483144	1484280	CpG: 106	1136	106	716	18.7	63.0	1.01
chr5	1508129	1509078	CpG: 101	949	101	671	21.3	70.7	0.85
chr5	1525798	1526033	CpG: 17	235	17	133	14.5	56.6	0.95
chr5	1547599	1549380	CpG: 146	1781	146	1156	16.4	64.9	0.79
chr5	1559294	1559883	CpG: 49	589	49	389	16.6	66.0	0.76
chr5	1568845	1569333	CpG: 44	488	44	347	18.0	71.1	0.71
chr5	1578825	1579152	CpG: 38	327	38	252	23.2	77.1	0.98
chr5	1581999	1582976	CpG: 108	977	108	741	22.1	75.8	0.77
chr5	1597377	1597653	CpG: 24	276	24	171	17.4	62.0	0.92
chr5	1617171	1617464	CpG: 22	293	22	166	15.0	56.7	0.95
chr5	1624968	1625271	CpG: 24	303	24	186	15.8	61.4	0.84
chr5	1640012	1640298	CpG: 24	286	24	195	16.8	68.2	0.72
chr5	1640864	1641204	CpG: 24	340	24	215	14.1	63.2	0.71
chr5	1643950	1644159	CpG: 24	209	24	139	23.0	66.5	1.06
chr5	1644651	1645152	CpG: 38	501	38	331	15.2	66.1	0.71
chr5	1660411	1660728	CpG: 23	317	23	195	14.5	61.5	0.77
chr5	1661246	1662144	CpG: 78	898	78	640	17.4	71.3	0.69
chr5	1683794	1684778	CpG: 80	984	80	651	16.3	66.2	0.75
chr5	1714217	1716679	CpG: 193	2462	193	1487	15.7	60.4	0.86
chr5	1727472	1727751	CpG: 26	279	26	176	18.6	63.1	0.94
chr5	1743068	1743323	CpG: 24	255	24	179	18.8	70.2	0.82
chr5	1768093	1768315	CpG: 16	222	16	148	14.4	66.7	0.66
chr5	1773552	1775172	CpG: 121	1620	121	1072	14.9	66.2	0.69
chr5	1791450	1804279	CpG: 914	12829	914	8185	14.2	63.8	0.70
chr5	1846628	1847860	CpG: 109	1232	109	890	17.7	72.2	0.68
chr5	1866312	1866916	CpG: 45	604	45	370	14.9	61.3	0.79
chr5	1919684	1920248	CpG: 38	564	38	359	13.5	63.7	0.67
chr5	1920556	1920797	CpG: 20	241	20	156	16.6	64.7	0.81
chr5	1950897	1951332	CpG: 52	435	52	328	23.9	75.4	0.85
chr5	2025180	2025828	CpG: 51	648	51	391	15.7	60.3	0.88
chr5	2050141	2050649	CpG: 43	508	43	341	16.9	67.1	0.92
chr5	2085575	2086016	CpG: 33	441	33	286	15.0	64.9	0.72
chr5	2095824	2096040	CpG: 18	216	18	154	16.7	71.3	0.70
chr5	2228654	2228928	CpG: 28	274	28	176	20.4	64.2	1.00
chr5	2352322	2352595	CpG: 20	273	20	170	14.7	62.3	0.76
chr5	2476167	2476499	CpG: 25	332	25	192	15.1	57.8	0.91
chr5	2557950	2558158	CpG: 19	208	19	141	18.3	67.8	0.80
chr5	2653849	2656133	CpG: 193	2284	193	1583	16.9	69.3	0.70
chr5	2658362	2658646	CpG: 37	284	37	209	26.1	73.6	0.97
chr5	2663267	2671925	CpG: 768	8658	768	5541	17.7	64.0	0.87
chr5	2781521	2781827	CpG: 24	306	24	174	15.7	56.9	0.97
chr5	2840930	2841205	CpG: 20	275	20	167	14.5	60.7	0.80
chr5	3028232	3028464	CpG: 17	232	17	138	14.7	59.5	0.85
chr5	3102752	3103028	CpG: 22	276	22	167	15.9	60.5	0.88
chr5	3221480	3221903	CpG: 35	423	35	282	16.5	66.7	0.77
chr5	3243740	3244069	CpG: 24	329	24	227	14.6	69.0	0.62
chr5	3245424	3245741	CpG: 26	317	26	181	16.4	57.1	1.01
chr5	3246445	3246719	CpG: 24	274	24	170	17.5	62.0	0.92
chr5	3302916	3303424	CpG: 38	508	38	276	15.0	54.3	1.02
chr5	3454215	3454940	CpG: 63	725	63	493	17.4	68.0	0.75
chr5	3509063	3510582	CpG: 122	1519	122	945	16.1	62.2	0.83
chr5	3510973	3511226	CpG: 21	253	21	176	16.6	69.6	0.69
chr5	3513051	3521833	CpG: 662	8782	662	5366	15.1	61.1	0.81
chr5	3525069	3525716	CpG: 56	647	56	423	17.3	65.4	0.81
chr5	3774242	3774502	CpG: 22	260	22	170	16.9	65.4	0.79
chr5	4068892	4069130	CpG: 20	238	20	143	16.8	60.1	0.94
chr5	4123414	4123671	CpG: 20	257	20	158	15.6	61.5	0.83
chr5	4129850	4130110	CpG: 21	260	21	160	16.2	61.5	0.86
chr5	4206287	4206555	CpG: 23	268	23	166	17.2	61.9	0.91
chr5	4508653	4509000	CpG: 25	347	25	204	14.4	58.8	0.86
chr5	4542972	4543332	CpG: 30	360	30	217	16.7	60.3	0.92
chr5	4558064	4558339	CpG: 25	275	25	174	18.2	63.3	0.92
chr5	4702575	4702849	CpG: 22	274	22	170	16.1	62.0	0.84
chr5	4793745	4794062	CpG: 41	317	41	208	25.9	65.6	1.24
chr5	5066323	5068462	CpG: 200	2139	200	1446	18.7	67.6	0.84
chr5	5133777	5134051	CpG: 24	274	24	172	17.5	62.8	0.90
chr5	5147824	5148051	CpG: 19	227	19	134	16.7	59.0	0.99
chr5	5156616	5156897	CpG: 26	281	26	177	18.5	63.0	0.95
chr5	5179504	5179740	CpG: 20	236	20	148	16.9	62.7	0.87
chr5	5230739	5230965	CpG: 18	226	18	150	15.9	66.4	0.72
chr5	5349574	5350700	CpG: 115	1126	115	788	20.4	70.0	0.83
chr5	5422239	5422843	CpG: 49	604	49	420	16.2	69.5	0.68
chr5	5499286	5499546	CpG: 19	260	19	155	14.6	59.6	0.83
chr5	5522716	5522995	CpG: 25	279	25	178	17.9	63.8	0.89
chr5	5815002	5815468	CpG: 39	466	39	322	16.7	69.1	0.70
chr5	6306939	6307494	CpG: 52	555	52	386	18.7	69.5	0.77
chr5	6317361	6317639	CpG: 24	278	24	171	17.3	61.5	0.92
chr5	6377501	6379882	CpG: 307	2381	307	1791	25.8	75.2	0.91
chr5	6513177	6514102	CpG: 100	925	100	665	21.6	71.9	0.84
chr5	6536726	6537002	CpG: 21	276	21	169	15.2	61.2	0.83
chr5	6563302	6564724	CpG: 156	1422	156	1011	21.9	71.1	0.89
chr5	6589850	6590086	CpG: 17	236	17	141	14.4	59.7	0.83
chr5	6642867	6645446	CpG: 388	2579	388	1965	30.1	76.2	1.04
chr5	6668236	6668536	CpG: 21	300	21	166	14.0	55.3	0.92
chr5	6685636	6685919	CpG: 26	283	26	171	18.4	60.4	1.01
chr5	6704168	6705840	CpG: 154	1672	154	1241	18.4	74.2	1.13
chr5	6754338	6754550	CpG: 16	212	16	147	15.1	69.3	0.64
chr5	6777434	6778130	CpG: 52	696	52	447	14.9	64.2	0.74
chr5	7044608	7044885	CpG: 23	277	23	168	16.6	60.6	0.91
chr5	7227523	7227943	CpG: 50	420	50	308	23.8	73.3	0.90
chr5	7238942	7239181	CpG: 23	239	23	163	19.2	68.2	1.18
chr5	7333722	7335758	CpG: 215	2036	215	1496	21.1	73.5	0.78
chr5	7350649	7350927	CpG: 24	278	24	175	17.3	62.9	0.88
chr5	7352173	7352455	CpG: 21	282	21	171	14.9	60.6	0.82
chr5	7445993	7446267	CpG: 23	274	23	168	16.8	61.3	0.90
chr5	7613753	7614001	CpG: 17	248	17	145	13.7	58.5	0.81
chr5	7638006	7638280	CpG: 24	274	24	170	17.5	62.0	0.92
chr5	7643488	7643723	CpG: 18	235	18	142	15.3	60.4	0.85
chr5	7702232	7702509	CpG: 24	277	24	172	17.3	62.1	0.91
chr5	7788963	7790423	CpG: 117	1460	117	1047	16.0	71.7	0.66
chr5	7807874	7808851	CpG: 116	977	116	698	23.7	71.4	0.94
chr5	7896524	7896757	CpG: 19	233	19	138	16.3	59.2	0.95
chr5	8364324	8364594	CpG: 20	270	20	161	14.8	59.6	0.85
chr5	8372384	8372658	CpG: 23	274	23	169	16.8	61.7	0.89
chr5	8397180	8398021	CpG: 88	841	88	588	20.9	69.9	0.86
chr5	8459295	8459564	CpG: 18	269	18	165	13.4	61.3	0.72
chr5	8589252	8589570	CpG: 23	318	23	183	14.5	57.5	0.88
chr5	8780136	8780569	CpG: 42	433	42	296	19.4	68.4	0.83
chr5	9048945	9049215	CpG: 23	270	23	166	17.0	61.5	0.91
chr5	9340565	9340795	CpG: 20	230	20	141	17.4	61.3	0.94
chr5	9484345	9486368	CpG: 196	2023	196	1446	19.4	71.5	0.76
chr5	9659431	9659687	CpG: 21	256	21	154	16.4	60.2	0.92
chr5	10077352	10077621	CpG: 19	269	19	160	14.1	59.5	0.81
chr5	10188306	10188539	CpG: 17	233	17	141	14.6	60.5	0.80
chr5	10188961	10190189	CpG: 101	1228	101	745	16.4	60.7	0.90
chr5	10230680	10230957	CpG: 25	277	25	177	18.1	63.9	0.90
chr5	10246710	10247103	CpG: 42	393	42	259	21.4	65.9	1.01
chr5	10272375	10273254	CpG: 87	879	87	598	19.8	68.0	0.87
chr5	10292470	10293582	CpG: 130	1112	130	796	23.4	71.6	0.93
chr5	10314350	10314739	CpG: 31	389	31	282	15.9	72.5	0.61
chr5	10315444	10315658	CpG: 18	214	18	123	16.8	57.5	1.05
chr5	10331177	10331441	CpG: 20	264	20	160	15.2	60.6	0.83
chr5	10380628	10381535	CpG: 96	907	96	624	21.2	68.8	0.90
chr5	10382478	10382760	CpG: 25	282	25	176	17.7	62.4	0.92
chr5	10463127	10463400	CpG: 23	273	23	166	16.8	60.8	0.92
chr5	10487810	10488609	CpG: 71	799	71	441	17.8	55.2	1.42
chr5	10501894	10504758	CpG: 284	2864	284	2036	19.8	71.1	0.79
chr5	10573723	10574004	CpG: 24	281	24	176	17.1	62.6	0.89
chr5	10587276	10588261	CpG: 108	985	108	730	21.9	74.1	0.81
chr5	10698360	10699449	CpG: 150	1089	150	811	27.5	74.5	1.01
chr5	10855144	10855431	CpG: 22	287	22	171	15.3	59.6	0.87
chr5	10879982	10880219	CpG: 18	237	18	146	15.2	61.6	0.84
chr5	11006265	11006537	CpG: 21	272	21	166	15.4	61.0	0.84
chr5	11282277	11282539	CpG: 23	262	23	162	17.6	61.8	0.94
chr5	11322698	11323538	CpG: 115	840	115	635	27.4	75.6	0.98
chr5	11840838	11841991	CpG: 160	1153	160	872	27.8	75.6	0.97
chr5	12088949	12089219	CpG: 20	270	20	162	14.8	60.0	0.84
chr5	12137618	12137926	CpG: 22	308	22	178	14.3	57.8	0.87
chr5	12288445	12288713	CpG: 20	268	20	162	14.9	60.4	0.84
chr5	12376272	12376474	CpG: 17	202	17	123	16.8	60.9	0.93
chr5	12510872	12511935	CpG: 88	1063	88	774	16.6	72.8	0.62
chr5	12731730	12732405	CpG: 51	675	51	458	15.1	67.9	0.67
chr5	12755097	12755306	CpG: 16	209	16	126	15.3	60.3	0.87
chr5	13283959	13284227	CpG: 21	268	21	165	15.7	61.6	0.83
chr5	13331861	13332166	CpG: 25	305	25	174	16.4	57.0	1.19
chr5	13353481	13353773	CpG: 25	292	25	180	17.1	61.6	0.90
chr5	13515360	13515702	CpG: 39	342	39	258	22.8	75.4	0.81
chr5	13516309	13516548	CpG: 19	239	19	135	15.9	56.5	1.03
chr5	13746996	13747203	CpG: 26	207	26	152	25.1	73.4	0.94
chr5	13926544	13926753	CpG: 16	209	16	120	15.3	57.4	0.97
chr5	13948514	13948942	CpG: 58	428	58	327	27.1	76.4	0.94
chr5	14080065	14082398	CpG: 304	2333	304	1754	26.1	75.2	0.92
chr5	14400053	14400386	CpG: 39	333	39	239	23.4	71.8	0.91
chr5	14426449	14427468	CpG: 109	1019	109	759	21.4	74.5	0.78
chr5	14520440	14521644	CpG: 133	1204	133	864	22.1	71.8	0.86
chr5	14548700	14548966	CpG: 26	266	26	167	19.5	62.8	1.00
chr5	14603629	14604598	CpG: 129	969	129	711	26.6	73.4	0.99
chr5	14810722	14811908	CpG: 164	1186	164	913	27.7	77.0	0.97
chr5	14933237	14933629	CpG: 41	392	41	290	20.9	74.0	0.77
chr5	15254477	15254717	CpG: 20	240	20	146	16.7	60.8	0.93
chr5	15439378	15440225	CpG: 108	847	108	632	25.5	74.6	0.92
chr5	15688745	15688986	CpG: 17	241	17	139	14.1	57.7	0.87
chr5	15851466	15851877	CpG: 32	411	32	249	15.6	60.6	0.85
chr5	15867345	15867775	CpG: 34	430	34	288	15.8	67.0	0.73
chr5	15875898	15876573	CpG: 60	675	60	427	17.8	63.3	0.89
chr5	16118278	16119634	CpG: 187	1356	187	1047	27.6	77.2	0.95
chr5	16274770	16275069	CpG: 22	299	22	173	14.7	57.9	0.89
chr5	16328763	16329044	CpG: 20	281	20	171	14.2	60.9	0.78
chr5	16404474	16405696	CpG: 105	1222	105	785	17.2	64.2	0.84
chr5	16554451	16554690	CpG: 20	239	20	143	16.7	59.8	0.95
chr5	16555733	16556652	CpG: 103	919	103	680	22.4	74.0	0.82
chr5	16637859	16638134	CpG: 19	275	19	168	13.8	61.1	0.75
chr5	16640173	16640877	CpG: 54	704	54	447	15.3	63.5	0.76
chr5	16874571	16875704	CpG: 135	1133	135	819	23.8	72.3	0.93
chr5	16875809	16876013	CpG: 17	204	17	116	16.7	56.9	1.05
chr5	16891348	16891590	CpG: 18	242	18	146	14.9	60.3	0.83
chr5	16906840	16907113	CpG: 25	273	25	170	18.3	62.3	0.95
chr5	16911496	16911770	CpG: 25	274	25	172	18.2	62.8	0.94
chr5	16930152	16930507	CpG: 33	355	33	257	18.6	72.4	0.71
chr5	16970978	16971232	CpG: 21	254	21	141	16.5	55.5	1.12
chr5	16971745	16972128	CpG: 38	383	38	284	19.8	74.2	0.72
chr5	17001474	17001873	CpG: 40	399	40	297	20.1	74.4	0.72
chr5	17022801	17023026	CpG: 24	225	24	164	21.3	72.9	0.81
chr5	17142027	17142301	CpG: 20	274	20	167	14.6	60.9	0.79
chr5	17155756	17158290	CpG: 206	2534	206	1680	16.3	66.3	0.76
chr5	17214641	17215270	CpG: 59	629	59	449	18.8	71.4	0.74
chr5	17251131	17251521	CpG: 35	390	35	288	17.9	73.8	0.66
chr5	17257797	17258026	CpG: 17	229	17	136	14.8	59.4	0.86
chr5	17260590	17260800	CpG: 20	210	20	131	19.0	62.4	1.00
chr5	17293684	17294022	CpG: 32	338	32	220	18.9	65.1	0.98
chr5	17329084	17329897	CpG: 55	813	55	450	13.5	55.4	0.89
chr5	17430762	17431178	CpG: 31	416	31	275	14.9	66.1	0.69
chr5	17655342	17655813	CpG: 34	471	34	315	14.4	66.9	0.66
chr5	17663949	17664187	CpG: 18	238	18	142	15.1	59.7	0.87
chr5	17683456	17683722	CpG: 19	266	19	163	14.3	61.3	0.77
chr5	17712683	17712963	CpG: 24	280	24	171	17.1	61.1	0.93
chr5	17715059	17715333	CpG: 24	274	24	171	17.5	62.4	0.91
chr5	17719881	17720146	CpG: 22	265	22	158	16.6	59.6	0.96
chr5	17778772	17779004	CpG: 16	232	16	136	13.8	58.6	0.82
chr5	17779924	17780136	CpG: 16	212	16	132	15.1	62.3	0.81
chr5	17787141	17787365	CpG: 16	224	16	134	14.3	59.8	0.81
chr5	17792983	17793242	CpG: 21	259	21	147	16.2	56.8	1.03
chr5	17925750	17925986	CpG: 22	236	22	145	18.6	61.4	1.01
chr5	17926248	17926531	CpG: 21	283	21	171	14.8	60.4	0.83
chr5	18035915	18036155	CpG: 23	240	23	152	19.2	63.3	0.98
chr5	18113260	18113496	CpG: 21	236	21	146	17.8	61.9	0.96
chr5	18187180	18187417	CpG: 21	237	21	145	17.7	61.2	0.97
chr5	18342361	18342574	CpG: 15	213	15	127	14.1	59.6	0.80
chr5	18401454	18401884	CpG: 39	430	39	319	18.1	74.2	0.66
chr5	18572114	18572400	CpG: 23	286	23	178	16.1	62.2	0.85
chr5	18767747	18768028	CpG: 23	281	23	173	16.4	61.6	0.88
chr5	18905443	18905725	CpG: 23	282	23	174	16.3	61.7	0.87
chr5	19015149	19015428	CpG: 24	279	24	171	17.2	61.3	0.93
chr5	19164192	19164619	CpG: 34	427	34	258	15.9	60.4	0.88
chr5	19290797	19291189	CpG: 40	392	40	295	20.4	75.3	0.72
chr5	19291736	19291983	CpG: 19	247	19	140	15.4	56.7	0.98
chr5	19341050	19341287	CpG: 20	237	20	144	16.9	60.8	0.93
chr5	19430384	19430591	CpG: 16	207	16	112	15.5	54.1	1.10
chr5	19526580	19526842	CpG: 21	262	21	160	16.0	61.1	0.87
chr5	19805745	19805981	CpG: 17	236	17	139	14.4	58.9	0.86
chr5	20005442	20005650	CpG: 16	208	16	124	15.4	59.6	0.87
chr5	20020642	20020919	CpG: 23	277	23	167	16.6	60.3	0.92
chr5	20251270	20251494	CpG: 18	224	18	129	16.1	57.6	1.01
chr5	20307291	20307665	CpG: 45	374	45	254	24.1	67.9	1.05
chr5	20335990	20336267	CpG: 23	277	23	173	16.6	62.5	0.86
chr5	20377945	20378224	CpG: 23	279	23	171	16.5	61.3	0.89
chr5	20425432	20425708	CpG: 20	276	20	162	14.5	58.7	0.85
chr5	20786541	20786818	CpG: 25	277	25	172	18.1	62.1	0.94
chr5	20892676	20892949	CpG: 19	273	19	161	13.9	59.0	0.82
chr5	21003796	21004032	CpG: 19	236	19	144	16.1	61.0	0.88
chr5	21053542	21053816	CpG: 24	274	24	171	17.5	62.4	0.91
chr5	21109537	21109847	CpG: 26	310	26	188	16.8	60.6	0.92
chr5	21118471	21118754	CpG: 21	283	21	168	14.8	59.4	0.86
chr5	21191193	21191455	CpG: 22	262	22	160	16.8	61.1	0.91
chr5	21209701	21210094	CpG: 29	393	29	235	14.8	59.8	0.83
chr5	21349449	21350058	CpG: 66	609	66	464	21.7	76.2	0.75
chr5	21388117	21388387	CpG: 22	270	22	162	16.3	60.0	0.92
chr5	21465156	21465539	CpG: 38	383	38	257	19.8	67.1	0.89
chr5	21466347	21466619	CpG: 20	272	20	160	14.7	58.8	0.85
chr5	21635377	21635612	CpG: 19	235	19	143	16.2	60.9	0.89
chr5	21833971	21834207	CpG: 16	236	16	140	13.6	59.3	0.79
chr5	22299192	22299471	CpG: 25	279	25	174	17.9	62.4	0.93
chr5	22311814	22312073	CpG: 21	259	21	159	16.2	61.4	0.87
chr5	22395040	22395271	CpG: 19	231	19	138	16.5	59.7	0.95
chr5	22433849	22434124	CpG: 24	275	24	174	17.5	63.3	0.88
chr5	22491833	22492109	CpG: 21	276	21	167	15.2	60.5	0.84
chr5	22523712	22523949	CpG: 20	237	20	145	16.9	61.2	0.93
chr5	22531302	22531568	CpG: 22	266	22	165	16.5	62.0	0.88
chr5	22642908	22643146	CpG: 19	238	19	140	16.0	58.8	0.94
chr5	22669727	22670001	CpG: 21	274	21	169	15.3	61.7	0.82
chr5	22774063	22774275	CpG: 17	212	17	129	16.0	60.8	0.89
chr5	22805002	22805269	CpG: 19	267	19	164	14.2	61.4	0.77
chr5	22860281	22860558	CpG: 24	277	24	171	17.3	61.7	0.92
chr5	22904225	22904500	CpG: 24	275	24	170	17.5	61.8	0.92
chr5	22914089	22914327	CpG: 20	238	20	144	16.8	60.5	0.94
chr5	23197695	23197964	CpG: 21	269	21	164	15.6	61.0	0.85
chr5	23319122	23319416	CpG: 25	294	25	169	17.0	57.5	1.04
chr5	23459812	23460078	CpG: 20	266	20	162	15.0	60.9	0.83
chr5	23482181	23482462	CpG: 23	281	23	173	16.4	61.6	0.88
chr5	23485006	23485220	CpG: 17	214	17	126	15.9	58.9	0.93
chr5	23521373	23521652	CpG: 24	279	24	175	17.2	62.7	0.88
chr5	23570077	23570327	CpG: 20	250	20	149	16.0	59.6	0.91
chr5	23596964	23597235	CpG: 21	271	21	166	15.5	61.3	0.83
chr5	23614973	23615375	CpG: 30	402	30	264	14.9	65.7	0.70
chr5	23734079	23734302	CpG: 16	223	16	130	14.3	58.3	0.85
chr5	23765360	23765645	CpG: 25	285	25	179	17.5	62.8	0.90
chr5	23799045	23799248	CpG: 16	203	16	144	15.8	70.9	0.65
chr5	23834606	23834846	CpG: 20	240	20	143	16.7	59.6	0.95
chr5	23874682	23874921	CpG: 18	239	18	145	15.1	60.7	0.83
chr5	23989398	23989675	CpG: 24	277	24	171	17.3	61.7	0.92
chr5	24058512	24059075	CpG: 54	563	54	407	19.2	72.3	0.73
chr5	24198967	24199241	CpG: 24	274	24	170	17.5	62.0	0.92
chr5	24606184	24606420	CpG: 17	236	17	136	14.4	57.6	0.89
chr5	24667716	24668009	CpG: 20	293	20	170	13.7	58.0	0.82
chr5	24692079	24692357	CpG: 25	278	25	173	18.0	62.2	0.94
chr5	25178162	25178421	CpG: 24	259	24	159	18.5	61.4	1.00
chr5	25188508	25188868	CpG: 27	360	27	211	15.0	58.6	0.88
chr5	25295562	25296172	CpG: 67	610	67	429	22.0	70.3	0.89
chr5	25305176	25305565	CpG: 35	389	35	279	18.0	71.7	0.70
chr5	25380461	25380742	CpG: 24	281	24	174	17.1	61.9	0.91
chr5	25419722	25419996	CpG: 22	274	22	170	16.1	62.0	0.84
chr5	25421267	25421543	CpG: 26	276	26	175	18.8	63.4	0.95
chr5	25458770	25458981	CpG: 15	211	15	128	14.2	60.7	0.78
chr5	25489298	25489590	CpG: 23	292	23	178	15.8	61.0	0.85
chr5	25526721	25526994	CpG: 19	273	19	157	13.9	57.5	0.87
chr5	25539062	25539297	CpG: 20	235	20	139	17.0	59.1	1.00
chr5	26013936	26014245	CpG: 29	309	29	201	18.8	65.0	0.89
chr5	26133433	26133719	CpG: 26	286	26	181	18.2	63.3	0.92
chr5	26140240	26140516	CpG: 22	276	22	165	15.9	59.8	0.89
chr5	26190161	26190435	CpG: 23	274	23	169	16.8	61.7	0.90
chr5	26429161	26429400	CpG: 29	239	29	186	24.3	77.8	0.82
chr5	26580947	26581165	CpG: 17	218	17	129	15.6	59.2	0.89
chr5	26590011	26590399	CpG: 38	388	38	284	19.6	73.2	0.73
chr5	26716799	26717069	CpG: 22	270	22	166	16.3	61.5	0.87
chr5	26774173	26774529	CpG: 28	356	28	236	15.7	66.3	0.72
chr5	26830282	26830563	CpG: 24	281	24	174	17.1	61.9	0.91
chr5	26944602	26944825	CpG: 19	223	19	135	17.0	60.5	0.94
chr5	27168091	27168372	CpG: 20	281	20	167	14.2	59.4	0.81
chr5	27198763	27199048	CpG: 20	285	20	161	14.0	56.5	0.91
chr5	27224653	27225058	CpG: 34	405	34	293	16.8	72.3	0.64
chr5	27225441	27225809	CpG: 26	368	26	206	14.1	56.0	0.91
chr5	27323368	27323604	CpG: 18	236	18	139	15.3	58.9	0.90
chr5	27427972	27428246	CpG: 24	274	24	171	17.5	62.4	0.91
chr5	27537033	27537237	CpG: 14	204	14	109	13.7	53.4	0.99
chr5	27599088	27599353	CpG: 19	265	19	159	14.3	60.0	0.81
chr5	27627851	27628128	CpG: 23	277	23	169	16.6	61.0	0.90
chr5	27724591	27724862	CpG: 24	271	24	170	17.7	62.7	0.91
chr5	27732458	27732740	CpG: 20	282	20	171	14.2	60.6	0.79
chr5	27818761	27819059	CpG: 23	298	23	179	15.4	60.1	0.87
chr5	27849074	27849391	CpG: 31	317	31	237	19.6	74.8	0.70
chr5	27942336	27942571	CpG: 19	235	19	139	16.2	59.1	0.93
chr5	28014373	28014603	CpG: 18	230	18	139	15.7	60.4	0.88
chr5	28018595	28018877	CpG: 24	282	24	178	17.0	63.1	0.86
chr5	28142084	28142292	CpG: 15	208	15	118	14.4	56.7	0.90
chr5	28183489	28183769	CpG: 27	280	27	208	19.3	74.3	0.70
chr5	28248244	28248477	CpG: 17	233	17	136	14.6	58.4	0.87
chr5	28281092	28281361	CpG: 20	269	20	162	14.9	60.2	0.83
chr5	28294051	28294285	CpG: 16	234	16	138	13.7	59.0	0.81
chr5	28399326	28399602	CpG: 20	276	20	163	14.5	59.1	0.84
chr5	28712447	28712725	CpG: 24	278	24	174	17.3	62.6	0.89
chr5	28788185	28788476	CpG: 21	291	21	175	14.4	60.1	0.81
chr5	28792919	28793155	CpG: 22	236	22	151	18.6	64.0	0.94
chr5	28808475	28808687	CpG: 16	212	16	130	15.1	61.3	0.82
chr5	28914761	28915881	CpG: 76	1120	76	746	13.6	66.6	0.61
chr5	29032618	29033747	CpG: 99	1129	99	793	17.5	70.2	0.71
chr5	29034708	29034916	CpG: 19	208	19	156	18.3	75.0	0.65
chr5	29371022	29371287	CpG: 19	265	19	162	14.3	61.1	0.78
chr5	29462215	29462450	CpG: 18	235	18	146	15.3	62.1	0.81
chr5	29510676	29510961	CpG: 25	285	25	177	17.5	62.1	0.93
chr5	29573065	29573346	CpG: 24	281	24	174	17.1	61.9	0.91
chr5	29678256	29678522	CpG: 22	266	22	165	16.5	62.0	0.87
chr5	29882428	29882704	CpG: 20	276	20	163	14.5	59.1	0.85
chr5	29900381	29900662	CpG: 22	281	22	171	15.7	60.9	0.86
chr5	30459729	30460187	CpG: 39	458	39	341	17.0	74.5	0.62
chr5	30690966	30691253	CpG: 21	287	21	173	14.6	60.3	0.81
chr5	30769468	30769705	CpG: 18	237	18	142	15.2	59.9	0.87
chr5	30937629	30937905	CpG: 22	276	22	164	15.9	59.4	0.91
chr5	30978221	30978484	CpG: 24	263	24	163	18.3	62.0	0.97
chr5	31148910	31149174	CpG: 20	264	20	157	15.2	59.5	0.87
chr5	31307324	31307902	CpG: 64	578	64	397	22.1	68.7	0.95
chr5	31370813	31371062	CpG: 18	249	18	147	14.5	59.0	0.85
chr5	31645714	31646141	CpG: 42	427	42	269	19.7	63.0	0.99
chr5	31646725	31646973	CpG: 19	248	19	145	15.3	58.5	0.90
chr5	31671064	31671329	CpG: 21	265	21	163	15.8	61.5	0.84
chr5	31752639	31753690	CpG: 115	1051	115	757	21.9	72.0	0.85
chr5	31784150	31784432	CpG: 21	282	21	169	14.9	59.9	0.84
chr5	31805349	31805681	CpG: 31	332	31	244	18.7	73.5	0.70
chr5	31890442	31890807	CpG: 31	365	31	275	17.0	75.3	0.61
chr5	31892767	31893003	CpG: 17	236	17	144	14.4	61.0	0.80
chr5	31968111	31968534	CpG: 34	423	34	285	16.1	67.4	0.71
chr5	31991804	31992088	CpG: 23	284	23	178	16.2	62.7	0.83
chr5	32078331	32078612	CpG: 23	281	23	173	16.4	61.6	0.88
chr5	32255337	32256507	CpG: 96	1170	96	842	16.4	72.0	0.63
chr5	32274399	32274635	CpG: 17	236	17	144	14.4	61.0	0.79
chr5	32275355	32275634	CpG: 20	279	20	171	14.3	61.3	0.77
chr5	32286171	32286430	CpG: 21	259	21	151	16.2	58.3	0.97
chr5	32287099	32288338	CpG: 147	1239	147	877	23.7	70.8	0.95
chr5	32289686	32289893	CpG: 15	207	15	122	14.5	58.9	0.84
chr5	32299139	32299424	CpG: 23	285	23	177	16.1	62.1	0.85
chr5	32303389	32303631	CpG: 21	242	21	146	17.4	60.3	0.99
chr5	32364781	32364987	CpG: 19	206	19	127	18.4	61.7	0.98
chr5	32425924	32427055	CpG: 120	1131	120	809	21.2	71.5	0.85
chr5	32438164	32438394	CpG: 18	230	18	136	15.7	59.1	0.90
chr5	32472091	32472335	CpG: 18	244	18	148	14.8	60.7	0.80
chr5	32557320	32558681	CpG: 146	1361	146	985	21.5	72.4	0.82
chr5	32559685	32559948	CpG: 20	263	20	159	15.2	60.5	0.84
chr5	32699167	32699929	CpG: 89	762	89	547	23.4	71.8	0.91
chr5	32750725	32750959	CpG: 16	234	16	137	13.7	58.5	0.81
chr5	32763558	32763804	CpG: 20	246	20	145	16.3	58.9	0.96
chr5	32823464	32828012	CpG: 310	4548	310	2683	13.6	59.0	0.79
chr5	32842714	32842988	CpG: 22	274	22	169	16.1	61.7	0.86
chr5	32845621	32845906	CpG: 23	285	23	178	16.1	62.5	0.84
chr5	32876170	32876451	CpG: 24	281	24	174	17.1	61.9	0.91
chr5	33237563	33237789	CpG: 19	226	19	136	16.8	60.2	0.93
chr5	33283955	33284192	CpG: 22	237	22	147	18.6	62.0	0.99
chr5	33315814	33316088	CpG: 24	274	24	170	17.5	62.0	0.92
chr5	33412947	33413153	CpG: 16	206	16	134	15.5	65.0	0.75
chr5	33555128	33555858	CpG: 55	730	55	444	15.1	60.8	0.82
chr5	33558150	33558393	CpG: 17	243	17	146	14.0	60.1	0.80
chr5	33616555	33616864	CpG: 25	309	25	223	16.2	72.2	0.62
chr5	33629221	33629425	CpG: 18	204	18	118	17.6	57.8	1.08
chr5	33629980	33630367	CpG: 31	387	31	281	16.0	72.6	0.61
chr5	33844450	33844716	CpG: 20	266	20	157	15.0	59.0	0.88
chr5	34013996	34014208	CpG: 25	212	25	164	23.6	77.4	0.82
chr5	34057986	34060127	CpG: 173	2141	173	1368	16.2	63.9	0.79
chr5	34129624	34130161	CpG: 60	537	60	394	22.3	73.4	0.86
chr5	34269808	34270234	CpG: 30	426	30	253	14.1	59.4	0.80
chr5	34489339	34489959	CpG: 69	620	69	472	22.3	76.1	0.77
chr5	34496194	34496467	CpG: 22	273	22	169	16.1	61.9	0.86
chr5	34571920	34572205	CpG: 25	285	25	179	17.5	62.8	0.90
chr5	34768179	34768402	CpG: 18	223	18	134	16.1	60.1	0.91
chr5	34903114	34904321	CpG: 131	1207	131	890	21.7	73.7	0.81
chr5	34930886	34931129	CpG: 22	243	22	149	18.1	61.3	0.97
chr5	35046845	35047079	CpG: 17	234	17	142	14.5	60.7	0.81
chr5	35085938	35086642	CpG: 69	704	69	457	19.6	64.9	0.94
chr5	35162164	35163169	CpG: 87	1005	87	619	17.3	61.6	0.92
chr5	35176276	35177365	CpG: 129	1089	129	807	23.7	74.1	0.92
chr5	35186309	35186590	CpG: 24	281	24	174	17.1	61.9	0.91
chr5	35202810	35203080	CpG: 23	270	23	167	17.0	61.9	0.90
chr5	35231251	35231534	CpG: 23	283	23	172	16.3	60.8	0.89
chr5	35337902	35338140	CpG: 16	238	16	138	13.4	58.0	0.81
chr5	35438110	35438384	CpG: 24	274	24	170	17.5	62.0	0.92
chr5	35568137	35568411	CpG: 23	274	23	171	16.8	62.4	0.87
chr5	35761886	35762166	CpG: 25	280	25	177	17.9	63.2	0.90
chr5	35778645	35779035	CpG: 32	390	32	287	16.4	73.6	0.61
chr5	35861079	35861353	CpG: 25	274	25	172	18.2	62.8	0.94
chr5	35864746	35865230	CpG: 38	484	38	319	15.7	65.9	0.72
chr5	36399689	36400571	CpG: 85	882	85	568	19.3	64.4	0.93
chr5	36482413	36482682	CpG: 23	269	23	164	17.1	61.0	0.93
chr5	36489210	36490864	CpG: 162	1654	162	1146	19.6	69.3	0.82
chr5	36582378	36582650	CpG: 27	272	27	171	19.9	62.9	1.02
chr5	36596796	36597064	CpG: 21	268	21	164	15.7	61.2	0.84
chr5	36623986	36624259	CpG: 24	273	24	167	17.6	61.2	0.95
chr5	36847152	36847382	CpG: 18	230	18	143	15.7	62.2	0.83
chr5	36939919	36940370	CpG: 46	451	46	316	20.4	70.1	0.85
chr5	36995046	36995297	CpG: 17	251	17	159	13.5	63.3	0.70
chr5	37125655	37127388	CpG: 172	1733	172	1137	19.8	65.6	0.92
chr5	37408948	37409229	CpG: 24	281	24	174	17.1	61.9	0.91
chr5	37436605	37436842	CpG: 19	237	19	142	16.0	59.9	0.92
chr5	37458796	37459185	CpG: 28	389	28	245	14.4	63.0	0.73
chr5	37498686	37499486	CpG: 92	800	92	583	23.0	72.9	0.87
chr5	37543534	37543815	CpG: 23	281	23	175	16.4	62.3	0.86
chr5	37620653	37620959	CpG: 29	306	29	178	19.0	58.2	1.12
chr5	37628969	37629359	CpG: 38	390	38	262	19.5	67.2	0.87
chr5	37630166	37630407	CpG: 20	241	20	143	16.6	59.3	0.96
chr5	37665171	37666046	CpG: 69	875	69	616	15.8	70.4	0.64
chr5	37733390	37734093	CpG: 52	703	52	474	14.8	67.4	0.65
chr5	37768980	37769373	CpG: 42	393	42	295	21.4	75.1	0.76
chr5	37812830	37813697	CpG: 68	867	68	604	15.7	69.7	0.65
chr5	38006133	38006372	CpG: 21	239	21	145	17.6	60.7	0.98
chr5	38083635	38084092	CpG: 51	457	51	331	22.3	72.4	0.85
chr5	38085711	38089690	CpG: 308	3979	308	2495	15.5	62.7	0.79
chr5	38100739	38101011	CpG: 21	272	21	163	15.4	59.9	0.86
chr5	38363501	38363709	CpG: 17	208	17	128	16.3	61.5	0.88
chr5	38424227	38424470	CpG: 23	243	23	149	18.9	61.3	1.01
chr5	38506827	38508137	CpG: 108	1310	108	888	16.5	67.8	0.74
chr5	38539888	38540167	CpG: 21	279	21	168	15.1	60.2	0.84
chr5	38643539	38643772	CpG: 19	233	19	142	16.3	60.9	0.90
chr5	38805197	38806538	CpG: 165	1341	165	961	24.6	71.7	0.96
chr5	38844866	38845109	CpG: 20	243	20	151	16.5	62.1	0.87
chr5	38884560	38884796	CpG: 20	236	20	145	16.9	61.4	0.91
chr5	39094496	39094731	CpG: 17	235	17	140	14.5	59.6	0.84
chr5	39094871	39095845	CpG: 100	974	100	649	20.5	66.6	0.93
chr5	39277711	39277985	CpG: 23	274	23	169	16.8	61.7	0.89
chr5	39303120	39303393	CpG: 21	273	21	170	15.4	62.3	0.80
chr5	39323286	39324641	CpG: 148	1355	148	955	21.8	70.5	0.88
chr5	39608202	39608473	CpG: 20	271	20	167	14.8	61.6	0.80
chr5	39674398	39674826	CpG: 39	428	39	275	18.2	64.3	0.88
chr5	39679191	39679431	CpG: 18	240	18	144	15.0	60.0	0.87
chr5	39731225	39731497	CpG: 24	272	24	169	17.6	62.1	0.92
chr5	39825503	39825738	CpG: 18	235	18	138	15.3	58.7	0.91
chr5	39915559	39915972	CpG: 28	413	28	279	13.6	67.6	0.60
chr5	39917232	39917515	CpG: 23	283	23	175	16.3	61.8	0.86
chr5	39971637	39971924	CpG: 29	287	29	204	20.2	71.1	0.81
chr5	40037859	40038253	CpG: 31	394	31	237	15.7	60.2	0.87
chr5	40297110	40297536	CpG: 33	426	33	256	15.5	60.1	0.86
chr5	40371277	40371520	CpG: 22	243	22	150	18.1	61.7	0.97
chr5	40374787	40375061	CpG: 22	274	22	169	16.1	61.7	0.86
chr5	40413621	40413891	CpG: 23	270	23	167	17.0	61.9	0.90
chr5	40478795	40479036	CpG: 18	241	18	135	14.9	56.0	0.99
chr5	40513666	40513951	CpG: 24	285	24	177	16.8	62.1	0.89
chr5	40695058	40695447	CpG: 29	389	29	275	14.9	70.7	0.60
chr5	40797765	40798192	CpG: 32	427	32	253	15.0	59.3	0.86
chr5	40898923	40899145	CpG: 18	222	18	135	16.2	60.8	0.89
chr5	40935816	40938395	CpG: 196	2579	196	1586	15.2	61.5	0.81
chr5	40978607	40979247	CpG: 52	640	52	464	16.2	72.5	0.62
chr5	41011834	41012715	CpG: 77	881	77	547	17.5	62.1	0.92
chr5	41054052	41055343	CpG: 119	1291	119	877	18.4	67.9	0.80
chr5	41091563	41092193	CpG: 52	630	52	369	16.5	58.6	0.96
chr5	41702304	41702561	CpG: 20	257	20	155	15.6	60.3	0.88
chr5	41766061	41766444	CpG: 26	383	26	215	13.6	56.1	0.87
chr5	41766602	41766929	CpG: 28	327	28	210	17.1	64.2	0.83
chr5	41860279	41860560	CpG: 23	281	23	174	16.4	61.9	0.87
chr5	42048200	42048481	CpG: 20	281	20	169	14.2	60.1	0.80
chr5	42124869	42125099	CpG: 19	230	19	140	16.5	60.9	0.90
chr5	42125942	42127155	CpG: 104	1213	104	804	17.1	66.3	0.78
chr5	42157728	42157965	CpG: 21	237	21	145	17.7	61.2	0.97
chr5	42160336	42160933	CpG: 44	597	44	387	14.7	64.8	0.71
chr5	42181591	42182018	CpG: 53	427	53	318	24.8	74.5	0.90
chr5	42187132	42187360	CpG: 17	228	17	135	14.9	59.2	0.86
chr5	42612748	42613022	CpG: 23	274	23	170	16.8	62.0	0.88
chr5	42618745	42618985	CpG: 19	240	19	145	15.8	60.4	0.89
chr5	42678905	42680430	CpG: 118	1525	118	953	15.5	62.5	0.81
chr5	42719208	42719482	CpG: 23	274	23	169	16.8	61.7	0.89
chr5	42742077	42742351	CpG: 20	274	20	164	14.6	59.9	0.82
chr5	42881015	42881293	CpG: 25	278	25	173	18.0	62.2	0.94
chr5	42924601	42924841	CpG: 19	240	19	147	15.8	61.2	0.87
chr5	42987660	42987969	CpG: 24	309	24	182	15.5	58.9	0.90
chr5	43013009	43013239	CpG: 19	230	19	135	16.5	58.7	0.96
chr5	43057125	43057399	CpG: 21	274	21	164	15.3	59.9	0.86
chr5	43147787	43148014	CpG: 17	227	17	137	15.0	60.4	0.84
chr5	43177066	43177522	CpG: 47	456	47	311	20.6	68.2	0.89
chr5	43197102	43197418	CpG: 25	316	25	200	15.8	63.3	0.79
chr5	43203899	43205258	CpG: 111	1359	111	832	16.3	61.2	0.87
chr5	43231761	43233697	CpG: 136	1936	136	1303	14.0	67.3	0.62
chr5	43244302	43245224	CpG: 79	922	79	568	17.1	61.6	0.91
chr5	43252631	43253079	CpG: 34	448	34	284	15.2	63.4	0.76
chr5	43260908	43261180	CpG: 23	272	23	159	16.9	58.5	0.99
chr5	43270271	43271248	CpG: 90	977	90	599	18.4	61.3	0.98
chr5	43285900	43286178	CpG: 22	278	22	171	15.8	61.5	0.85
chr5	43290019	43290280	CpG: 22	261	22	145	16.9	55.6	1.09
chr5	43293105	43293393	CpG: 23	288	23	148	16.0	51.4	1.21
chr5	43293605	43293921	CpG: 24	316	24	180	15.2	57.0	0.94
chr5	43294866	43296236	CpG: 124	1370	124	832	18.1	60.7	0.98
chr5	43315608	43315847	CpG: 18	239	18	144	15.1	60.3	0.86
chr5	43319198	43319811	CpG: 67	613	67	394	21.9	64.3	1.06
chr5	43331228	43331746	CpG: 37	518	37	302	14.3	58.3	0.85
chr5	43373728	43374807	CpG: 121	1079	121	767	22.4	71.1	0.90
chr5	43439625	43439826	CpG: 16	201	16	119	15.9	59.2	0.93
chr5	43442608	43442845	CpG: 18	237	18	143	15.2	60.3	0.87
chr5	43444767	43445948	CpG: 105	1181	105	792	17.8	67.1	0.79
chr5	43565924	43566657	CpG: 68	733	68	484	18.6	66.0	0.85
chr5	43630583	43630857	CpG: 24	274	24	170	17.5	62.0	0.92
chr5	43649608	43650091	CpG: 52	483	52	310	21.5	64.2	1.06
chr5	43734767	43734968	CpG: 18	201	18	123	17.9	61.2	0.97
chr5	43736250	43737286	CpG: 88	1036	88	661	17.0	63.8	0.84
chr5	43763805	43764378	CpG: 50	573	50	418	17.5	72.9	0.66
chr5	43767818	43768084	CpG: 20	266	20	162	15.0	60.9	0.81
chr5	43774340	43775237	CpG: 70	897	70	630	15.6	70.2	0.63
chr5	43793921	43794427	CpG: 36	506	36	297	14.2	58.7	0.83
chr5	43809965	43811149	CpG: 139	1184	139	877	23.5	74.1	0.86
chr5	43831832	43832669	CpG: 69	837	69	584	16.5	69.8	0.68
chr5	43841448	43841722	CpG: 20	274	20	167	14.6	60.9	0.80
chr5	43856507	43857180	CpG: 67	673	67	473	19.9	70.3	0.84
chr5	43858869	43859150	CpG: 24	281	24	175	17.1	62.3	0.90
chr5	43919327	43920098	CpG: 58	771	58	523	15.0	67.8	0.65
chr5	43962047	43962328	CpG: 24	281	24	175	17.1	62.3	0.90
chr5	44104052	44104288	CpG: 18	236	18	139	15.3	58.9	0.90
chr5	44203558	44203800	CpG: 19	242	19	151	15.7	62.4	0.83
chr5	44890272	44890551	CpG: 23	279	23	171	16.5	61.3	0.89
chr5	45062651	45063296	CpG: 74	645	74	428	22.9	66.4	1.04
chr5	45121636	45121917	CpG: 24	281	24	175	17.1	62.3	0.90
chr5	45137599	45137995	CpG: 35	396	35	296	17.7	74.7	0.63
chr5	45193325	45193607	CpG: 20	282	20	155	14.2	55.0	0.95
chr5	45450387	45450655	CpG: 18	268	18	156	13.4	58.2	0.81
chr5	45515775	45516109	CpG: 26	334	26	221	15.6	66.2	0.75
chr5	45911784	45912094	CpG: 25	310	25	188	16.1	60.6	0.88
chr5	45948466	45949582	CpG: 133	1116	133	802	23.8	71.9	0.93
chr5	50007582	50008444	CpG: 66	862	66	571	15.3	66.2	0.70
chr5	51006884	51007120	CpG: 21	236	21	145	17.8	61.4	0.97
chr5	51259920	51260613	CpG: 79	693	79	500	22.8	72.2	0.88
chr5	51392362	51392635	CpG: 24	273	24	171	17.6	62.6	0.91
chr5	51485596	51487109	CpG: 139	1513	139	1018	18.4	67.3	0.81
chr5	51494542	51494774	CpG: 16	232	16	133	13.8	57.3	0.85
chr5	51593630	51594158	CpG: 44	528	44	381	16.7	72.2	0.64
chr5	51594491	51594728	CpG: 18	237	18	150	15.2	63.3	0.77
chr5	51696715	51696988	CpG: 24	273	24	170	17.6	62.3	0.92
chr5	51788396	51789048	CpG: 52	652	52	424	16.0	65.0	0.75
chr5	51920851	51921136	CpG: 24	285	24	175	16.8	61.4	0.91
chr5	51936084	51936333	CpG: 21	249	21	151	16.9	60.6	0.93
chr5	52083174	52083448	CpG: 20	274	20	167	14.6	60.9	0.80
chr5	52108894	52109122	CpG: 22	228	22	143	19.3	62.7	1.01
chr5	52132179	52132407	CpG: 18	228	18	141	15.8	61.8	0.84
chr5	52201978	52202721	CpG: 79	743	79	512	21.3	68.9	0.90
chr5	52206632	52206962	CpG: 28	330	28	214	17.0	64.8	0.81
chr5	52208702	52209495	CpG: 72	793	72	531	18.2	67.0	0.81
chr5	52218340	52218708	CpG: 42	368	42	231	22.8	62.8	1.16
chr5	52241669	52241906	CpG: 22	237	22	141	18.6	59.5	1.10
chr5	52313492	52313773	CpG: 23	281	23	172	16.4	61.2	0.88
chr5	52817148	52817423	CpG: 19	275	19	158	13.8	57.5	0.86
chr5	52821717	52821935	CpG: 20	218	20	137	18.3	62.8	0.94
chr5	52871475	52871714	CpG: 18	239	18	143	15.1	59.8	0.86
chr5	52961094	52961377	CpG: 22	283	22	173	15.5	61.1	0.84
chr5	53194244	53194482	CpG: 20	238	20	144	16.8	60.5	0.94
chr5	53289037	53289243	CpG: 21	206	21	127	20.4	61.7	1.07
chr5	53322750	53323029	CpG: 25	279	25	177	17.9	63.4	0.90
chr5	53615817	53616158	CpG: 34	341	34	233	19.9	68.3	0.85
chr5	53627683	53627897	CpG: 29	214	29	146	27.1	68.2	1.17
chr5	53714537	53714771	CpG: 17	234	17	139	14.5	59.4	0.83
chr5	53763757	53764032	CpG: 24	275	24	172	17.5	62.5	0.90
chr5	53816648	53817422	CpG: 71	774	71	547	18.3	70.7	0.74
chr5	53937225	53937723	CpG: 50	498	50	345	20.1	69.3	0.84
chr5	53955950	53956232	CpG: 23	282	23	173	16.3	61.3	0.88
chr5	53991099	53991377	CpG: 26	278	26	177	18.7	63.7	0.93
chr5	54237457	54237738	CpG: 24	281	24	175	17.1	62.3	0.90
chr5	54307510	54308622	CpG: 133	1112	133	772	23.9	69.4	1.01
chr5	54309772	54309980	CpG: 26	208	26	149	25.0	71.6	1.00
chr5	54388682	54388887	CpG: 16	205	16	129	15.6	62.9	0.89
chr5	54449552	54449829	CpG: 22	277	22	169	15.9	61.0	0.86
chr5	54626024	54626328	CpG: 24	304	24	185	15.8	60.9	0.86
chr5	54838238	54838501	CpG: 21	263	21	163	16.0	62.0	0.86
chr5	55067530	55067800	CpG: 19	270	19	166	14.1	61.5	0.76
chr5	55137675	55138541	CpG: 67	866	67	548	15.5	63.3	0.77
chr5	55199838	55200107	CpG: 22	269	22	169	16.4	62.8	0.84
chr5	55208494	55209265	CpG: 62	771	62	535	16.1	69.4	0.67
chr5	55248166	55248802	CpG: 51	636	51	429	16.0	67.5	0.71
chr5	55345297	55347224	CpG: 216	1927	216	1355	22.4	70.3	0.91
chr5	55476940	55477143	CpG: 23	203	23	154	22.7	75.9	0.80
chr5	55692738	55693158	CpG: 38	420	38	311	18.1	74.0	0.66
chr5	55711190	55711998	CpG: 84	808	84	569	20.8	70.4	0.84
chr5	55766930	55767142	CpG: 18	212	18	129	17.0	60.8	0.94
chr5	55997121	55997396	CpG: 20	275	20	165	14.5	60.0	0.81
chr5	56000241	56000782	CpG: 60	541	60	384	22.2	71.0	0.89
chr5	56003679	56003987	CpG: 34	308	34	225	22.1	73.1	0.84
chr5	56013281	56013555	CpG: 21	274	21	166	15.3	60.6	0.84
chr5	56047729	56048381	CpG: 60	652	60	436	18.4	66.9	0.82
chr5	56050516	56051090	CpG: 54	574	54	376	18.8	65.5	0.88
chr5	56053764	56054995	CpG: 133	1231	133	865	21.6	70.3	0.88
chr5	56055138	56055363	CpG: 18	225	18	131	16.0	58.2	1.01
chr5	56058781	56061608	CpG: 227	2827	227	1778	16.1	62.9	0.82
chr5	56126058	56126339	CpG: 24	281	24	175	17.1	62.3	0.90
chr5	56134688	56135383	CpG: 61	695	61	433	17.6	62.3	0.91
chr5	56358374	56358590	CpG: 23	216	23	148	21.3	68.5	0.95
chr5	56361911	56362883	CpG: 116	972	116	718	23.9	73.9	0.87
chr5	56387345	56387681	CpG: 28	336	28	208	16.7	61.9	0.88
chr5	56397575	56397853	CpG: 21	278	21	167	15.1	60.1	0.85
chr5	56515046	56515308	CpG: 26	262	26	167	19.8	63.7	0.99
chr5	56540301	56540831	CpG: 46	530	46	340	17.4	64.2	0.85
chr5	56561565	56561816	CpG: 22	251	22	155	17.5	61.8	0.93
chr5	56564881	56565122	CpG: 22	241	22	146	18.3	60.6	1.01
chr5	56566154	56566453	CpG: 30	299	30	190	20.1	63.5	1.01
chr5	56650038	56650431	CpG: 45	393	45	286	22.9	72.8	0.87
chr5	56822931	56823985	CpG: 107	1054	107	720	20.3	68.3	0.87
chr5	56856598	56856809	CpG: 16	211	16	129	15.2	61.1	0.83
chr5	56863854	56864241	CpG: 32	387	32	277	16.5	71.6	0.65
chr5	56867164	56867815	CpG: 51	651	51	464	15.7	71.3	0.62
chr5	56880031	56880305	CpG: 23	274	23	170	16.8	62.0	0.88
chr5	56916438	56916712	CpG: 23	274	23	170	16.8	62.0	0.88
chr5	57037100	57037333	CpG: 17	233	17	139	14.6	59.7	0.84
chr5	57037867	57038128	CpG: 23	261	23	163	17.6	62.5	0.93
chr5	57085813	57086284	CpG: 36	471	36	305	15.3	64.8	0.73
chr5	57112106	57112317	CpG: 19	211	19	130	18.0	61.6	0.98
chr5	57225699	57225959	CpG: 21	260	21	192	16.2	73.8	0.60
chr5	57308743	57309372	CpG: 60	629	60	438	19.1	69.6	0.79
chr5	57370752	57370977	CpG: 19	225	19	137	16.9	60.9	0.92
chr5	57460063	57460337	CpG: 23	274	23	169	16.8	61.7	0.89
chr5	57464261	57464539	CpG: 26	278	26	177	18.7	63.7	0.93
chr5	57622061	57622298	CpG: 20	237	20	145	16.9	61.2	0.93
chr5	57642815	57643034	CpG: 19	219	19	138	17.4	63.0	0.87
chr5	57643224	57645408	CpG: 256	2184	256	1572	23.4	72.0	0.91
chr5	57737386	57738768	CpG: 120	1382	120	891	17.4	64.5	0.85
chr5	57778970	57780786	CpG: 201	1816	201	1313	22.1	72.3	0.86
chr5	57869568	57869791	CpG: 19	223	19	134	17.0	60.1	0.96
chr5	57988751	57989018	CpG: 23	267	23	167	17.2	62.5	0.89
chr5	57999677	58000089	CpG: 31	412	31	238	15.0	57.8	0.91
chr5	58001495	58002999	CpG: 143	1504	143	1029	19.0	68.4	0.81
chr5	58276118	58276343	CpG: 16	225	16	135	14.2	60.0	0.80
chr5	58399387	58399622	CpG: 17	235	17	139	14.5	59.1	0.85
chr5	58699295	58699551	CpG: 20	256	20	152	15.6	59.4	0.89
chr5	58898242	58898483	CpG: 20	241	20	143	16.6	59.3	0.96
chr5	58990196	58990439	CpG: 19	243	19	142	15.6	58.4	0.94
chr5	59194890	59195152	CpG: 20	262	20	161	15.3	61.5	0.82
chr5	59202585	59203012	CpG: 31	427	31	252	14.5	59.0	0.84
chr5	59277954	59279423	CpG: 165	1469	165	1031	22.5	70.2	0.91
chr5	59367255	59367510	CpG: 20	255	20	150	15.7	58.8	0.91
chr5	59375681	59375975	CpG: 22	294	22	177	15.0	60.2	0.83
chr5	59381902	59382104	CpG: 17	202	17	142	16.8	70.3	0.68
chr5	59400224	59400676	CpG: 37	452	37	276	16.4	61.1	0.89
chr5	59474431	59474657	CpG: 19	226	19	138	16.8	61.1	0.94
chr5	59857474	59858519	CpG: 119	1045	119	736	22.8	70.4	0.92
chr5	60332460	60332694	CpG: 16	234	16	138	13.7	59.0	0.82
chr5	60390768	60391046	CpG: 20	278	20	169	14.4	60.8	0.80
chr5	60711481	60712329	CpG: 90	848	90	617	21.2	72.8	0.81
chr5	60848475	60848756	CpG: 23	281	23	174	16.4	61.9	0.87
chr5	60910079	60910352	CpG: 24	273	24	169	17.6	61.9	0.93
chr5	60985594	60985823	CpG: 19	229	19	143	16.6	62.4	0.86
chr5	61011697	61011971	CpG: 20	274	20	170	14.6	62.0	0.77
chr5	61121686	61121921	CpG: 22	235	22	144	18.7	61.3	1.02
chr5	61122684	61122965	CpG: 24	281	24	174	17.1	61.9	0.91
chr5	61249527	61250282	CpG: 52	755	52	499	13.8	66.1	0.63
chr5	61517983	61518940	CpG: 85	957	85	617	17.8	64.5	0.86
chr5	61560252	61560500	CpG: 16	248	16	154	12.9	62.1	0.68
chr5	61659896	61660902	CpG: 123	1006	123	753	24.5	74.9	0.88
chr5	61673792	61674066	CpG: 22	274	22	169	16.1	61.7	0.85
chr5	61676913	61677138	CpG: 17	225	17	131	15.1	58.2	0.89
chr5	61761343	61762054	CpG: 56	711	56	439	15.8	61.7	0.83
chr5	61787761	61787973	CpG: 17	212	17	128	16.0	60.4	0.90
chr5	61978442	61979256	CpG: 73	814	73	540	17.9	66.3	0.82
chr5	62077112	62077415	CpG: 27	303	27	185	17.8	61.1	0.96
chr5	62149822	62153111	CpG: 419	3289	419	2401	25.5	73.0	0.96
chr5	62193699	62193967	CpG: 20	268	20	162	14.9	60.4	0.83
chr5	62444826	62445764	CpG: 80	938	80	674	17.1	71.9	0.66
chr5	62817015	62817300	CpG: 25	285	25	179	17.5	62.8	0.90
chr5	63092590	63092891	CpG: 22	301	22	175	14.6	58.1	0.88
chr5	63125018	63126331	CpG: 149	1313	149	926	22.7	70.5	0.91
chr5	63158780	63159054	CpG: 24	274	24	171	17.5	62.4	0.91
chr5	63223118	63223645	CpG: 56	527	56	371	21.3	70.4	0.86
chr5	63223996	63224270	CpG: 20	274	20	169	14.6	61.7	0.78
chr5	63232140	63232804	CpG: 63	664	63	429	19.0	64.6	0.93
chr5	63243778	63244010	CpG: 18	232	18	139	15.5	59.9	0.87
chr5	63277496	63277765	CpG: 20	269	20	167	14.9	62.1	0.79
chr5	63601018	63601253	CpG: 21	235	21	147	17.9	62.6	0.94
chr5	63604867	63605128	CpG: 18	261	18	160	13.8	61.3	0.75
chr5	63624232	63624542	CpG: 26	310	26	194	16.8	62.6	0.86
chr5	63636996	63637423	CpG: 31	427	31	255	14.5	59.7	0.82
chr5	63994648	63994912	CpG: 23	264	23	164	17.4	62.1	0.91
chr5	64064127	64064405	CpG: 20	278	20	165	14.4	59.4	0.82
chr5	64145358	64145639	CpG: 23	281	23	173	16.4	61.6	0.88
chr5	64411768	64412044	CpG: 23	276	23	173	16.7	62.7	0.87
chr5	64537289	64537503	CpG: 15	214	15	128	14.0	59.8	0.80
chr5	64597229	64597513	CpG: 23	284	23	173	16.2	60.9	0.89
chr5	64667145	64667360	CpG: 17	215	17	132	15.8	61.4	0.85
chr5	64779352	64779715	CpG: 32	363	32	231	17.6	63.6	0.88
chr5	64780856	64782194	CpG: 100	1338	100	827	14.9	61.8	0.78
chr5	64898060	64898300	CpG: 18	240	18	142	15.0	59.2	0.87
chr5	64985725	64986383	CpG: 92	658	92	499	28.0	75.8	0.99
chr5	65326020	65326844	CpG: 73	824	73	536	17.7	65.0	0.84
chr5	65464480	65464720	CpG: 18	240	18	140	15.0	58.3	0.90
chr5	65497137	65497378	CpG: 19	241	19	151	15.8	62.7	0.83
chr5	65510486	65511271	CpG: 78	785	78	557	19.9	71.0	0.79
chr5	65588535	65588830	CpG: 25	295	25	183	16.9	62.0	0.89
chr5	65677989	65678465	CpG: 38	476	38	270	16.0	56.7	1.01
chr5	65790384	65790654	CpG: 22	270	22	168	16.3	62.2	0.85
chr5	65810462	65810703	CpG: 21	241	21	147	17.4	61.0	0.96
chr5	65855530	65856093	CpG: 57	563	57	386	20.2	68.6	0.87
chr5	65922997	65923514	CpG: 56	517	56	358	21.7	69.2	0.92
chr5	65984131	65984562	CpG: 35	431	35	263	16.2	61.0	0.88
chr5	66031929	66032206	CpG: 26	277	26	172	18.8	62.1	0.98
chr5	66192164	66192411	CpG: 20	247	20	149	16.2	60.3	0.89
chr5	66210743	66210962	CpG: 18	219	18	132	16.4	60.3	0.92
chr5	66288527	66288738	CpG: 17	211	17	129	16.1	61.1	0.88
chr5	66381110	66381384	CpG: 23	274	23	171	16.8	62.4	0.87
chr5	66384708	66385216	CpG: 43	508	43	298	16.9	58.7	0.99
chr5	66396233	66396518	CpG: 24	285	24	178	16.8	62.5	0.87
chr5	66445867	66446241	CpG: 30	374	30	241	16.0	64.4	0.78
chr5	66543563	66544472	CpG: 102	909	102	678	22.4	74.6	0.81
chr5	66545318	66545557	CpG: 18	239	18	144	15.1	60.3	0.85
chr5	66546647	66546887	CpG: 18	240	18	141	15.0	58.8	0.89
chr5	66717430	66717654	CpG: 20	224	20	140	17.9	62.5	0.94
chr5	66746773	66748430	CpG: 191	1657	191	1167	23.1	70.4	0.93
chr5	66761511	66762640	CpG: 91	1129	91	820	16.1	72.6	0.61
chr5	66779659	66780376	CpG: 59	717	59	494	16.5	68.9	0.70
chr5	66798950	66799456	CpG: 39	506	39	351	15.4	69.4	0.64
chr5	66965220	66966148	CpG: 100	928	100	588	21.6	63.4	1.08
chr5	66973117	66973363	CpG: 19	246	19	151	15.4	61.4	0.84
chr5	67095041	67095315	CpG: 25	274	25	172	18.2	62.8	0.94
chr5	67418129	67419791	CpG: 159	1662	159	1148	19.1	69.1	0.80
chr5	67572540	67572857	CpG: 24	317	24	187	15.1	59.0	0.87
chr5	67826044	67826359	CpG: 36	315	36	219	22.9	69.5	0.95
chr5	67985358	67985918	CpG: 48	560	48	378	17.1	67.5	0.76
chr5	68041437	68041667	CpG: 16	230	16	135	13.9	58.7	0.82
chr5	68446747	68446973	CpG: 16	226	16	133	14.2	58.8	0.82
chr5	68454649	68454915	CpG: 23	266	23	165	17.3	62.0	0.91
chr5	68564822	68565028	CpG: 20	206	20	124	19.4	60.2	1.08
chr5	68711987	68712212	CpG: 20	225	20	133	17.8	59.1	1.02
chr5	68842579	68843007	CpG: 41	428	41	316	19.2	73.8	0.70
chr5	69008331	69008754	CpG: 44	423	44	286	20.8	67.6	0.92
chr5	69037129	69038784	CpG: 180	1655	180	1213	21.8	73.3	0.81
chr5	69110689	69110927	CpG: 30	238	30	174	25.2	73.1	0.95
chr5	69145981	69146742	CpG: 60	761	60	518	15.8	68.1	0.68
chr5	69544345	69544628	CpG: 20	283	20	172	14.1	60.8	0.77
chr5	69699291	69699521	CpG: 20	230	20	140	17.4	60.9	0.95
chr5	69743332	69743544	CpG: 21	212	21	157	19.8	74.1	0.73
chr5	69859862	69860123	CpG: 19	261	19	159	14.6	60.9	0.80
chr5	69890635	69890881	CpG: 20	246	20	144	16.3	58.5	0.97
chr5	69916331	69916988	CpG: 80	657	80	475	24.4	72.3	0.94
chr5	69919623	69919848	CpG: 20	225	20	136	17.8	60.4	0.98
chr5	69989458	69989997	CpG: 44	539	44	358	16.3	66.4	0.74
chr5	70011994	70012487	CpG: 43	493	43	312	17.4	63.3	0.87
chr5	70040299	70040985	CpG: 68	686	68	458	19.8	66.8	0.90
chr5	70060529	70060933	CpG: 35	404	35	257	17.3	63.6	0.88
chr5	70158297	70158614	CpG: 35	317	35	227	22.1	71.6	0.90
chr5	70195020	70195824	CpG: 79	804	79	550	19.7	68.4	0.85
chr5	70240972	70241685	CpG: 85	713	85	507	23.8	71.1	0.95
chr5	70317964	70319636	CpG: 161	1672	161	1155	19.3	69.1	0.81
chr5	70323534	70323764	CpG: 20	230	20	141	17.4	61.3	0.94
chr5	70385760	70386112	CpG: 38	352	38	232	21.6	65.9	1.00
chr5	70425003	70425243	CpG: 20	240	20	146	16.7	60.8	0.92
chr5	70536236	70536888	CpG: 72	652	72	499	22.1	76.5	0.76
chr5	70560201	70560475	CpG: 20	274	20	166	14.6	60.6	0.81
chr5	70563845	70564119	CpG: 23	274	23	170	16.8	62.0	0.88
chr5	70597097	70597371	CpG: 23	274	23	170	16.8	62.0	0.88
chr5	70600383	70600657	CpG: 19	274	19	165	13.9	60.2	0.78
chr5	70647238	70647890	CpG: 72	652	72	499	22.1	76.5	0.76
chr5	70815537	70815763	CpG: 20	226	20	138	17.7	61.1	0.99
chr5	70833059	70833296	CpG: 17	237	17	138	14.3	58.2	0.88
chr5	70836529	70836769	CpG: 20	240	20	147	16.7	61.2	0.90
chr5	70837349	70837804	CpG: 43	455	43	286	18.9	62.9	0.96
chr5	70858379	70859078	CpG: 48	699	48	417	13.7	59.7	0.78
chr5	70861648	70862158	CpG: 62	510	62	369	24.3	72.4	0.95
chr5	71042766	71043418	CpG: 72	652	72	499	22.1	76.5	0.76
chr5	71090048	71090322	CpG: 20	274	20	166	14.6	60.6	0.81
chr5	71093433	71093707	CpG: 23	274	23	170	16.8	62.0	0.88
chr5	71126716	71126990	CpG: 23	274	23	170	16.8	62.0	0.88
chr5	71129997	71130271	CpG: 19	274	19	165	13.9	60.2	0.78
chr5	71176817	71177469	CpG: 72	652	72	499	22.1	76.5	0.76
chr5	71349842	71350123	CpG: 24	281	24	175	17.1	62.3	0.90
chr5	71357387	71357897	CpG: 62	510	62	369	24.3	72.4	0.95
chr5	71360465	71361164	CpG: 48	699	48	417	13.7	59.7	0.78
chr5	71381745	71382200	CpG: 43	455	43	286	18.9	62.9	0.96
chr5	71382780	71383020	CpG: 20	240	20	147	16.7	61.2	0.90
chr5	71386254	71386491	CpG: 17	237	17	138	14.3	58.2	0.88
chr5	71403787	71404013	CpG: 20	226	20	138	17.7	61.1	0.99
chr5	71485136	71485376	CpG: 20	240	20	146	16.7	60.8	0.92
chr5	71524264	71524616	CpG: 39	352	39	235	22.2	66.8	1.00
chr5	71771004	71771656	CpG: 72	652	72	499	22.1	76.5	0.76
chr5	71818112	71818386	CpG: 19	274	19	165	13.9	60.2	0.78
chr5	71821512	71821786	CpG: 23	274	23	170	16.8	62.0	0.88
chr5	71936890	71937376	CpG: 42	486	42	327	17.3	67.3	0.78
chr5	72068449	72068926	CpG: 49	477	49	340	20.5	71.3	0.81
chr5	72091479	72091789	CpG: 26	310	26	190	16.8	61.3	0.90
chr5	72112869	72113143	CpG: 22	274	22	169	16.1	61.7	0.86
chr5	72149729	72149965	CpG: 16	236	16	141	13.6	59.7	0.78
chr5	72200412	72201210	CpG: 62	798	62	527	15.5	66.0	0.72
chr5	72588227	72590218	CpG: 172	1991	172	1348	17.3	67.7	0.76
chr5	72789157	72789742	CpG: 66	585	66	414	22.6	70.8	0.91
chr5	72800773	72801077	CpG: 25	304	25	179	16.4	58.9	0.96
chr5	72801350	72801688	CpG: 31	338	31	212	18.3	62.7	0.93
chr5	72801926	72802270	CpG: 26	344	26	190	15.1	55.2	0.99
chr5	72898623	72899215	CpG: 48	592	48	385	16.2	65.0	0.77
chr5	72901444	72901691	CpG: 19	247	19	151	15.4	61.1	0.84
chr5	72941545	72942096	CpG: 39	551	39	359	14.2	65.2	0.67
chr5	72965353	72965630	CpG: 26	277	26	175	18.8	63.2	0.95
chr5	73021314	73021588	CpG: 24	274	24	171	17.5	62.4	0.91
chr5	73101907	73102136	CpG: 20	229	20	141	17.5	61.6	0.93
chr5	73297479	73298428	CpG: 111	949	111	677	23.4	71.3	0.92
chr5	73329235	73330148	CpG: 105	913	105	665	23.0	72.8	0.87
chr5	73436438	73437772	CpG: 142	1334	142	916	21.3	68.7	0.90
chr5	73460503	73460781	CpG: 26	278	26	176	18.7	63.3	0.94
chr5	73477725	73478098	CpG: 29	373	29	259	15.5	69.4	0.65
chr5	73530240	73530514	CpG: 25	274	25	172	18.2	62.8	0.94
chr5	73601117	73602272	CpG: 133	1155	133	841	23.0	72.8	0.87
chr5	73697214	73697935	CpG: 68	721	68	498	18.9	69.1	0.79
chr5	73711693	73711987	CpG: 27	294	27	210	18.4	71.4	0.73
chr5	73714590	73715467	CpG: 75	877	75	575	17.1	65.6	0.80
chr5	73779628	73781289	CpG: 145	1661	145	998	17.5	60.1	0.97
chr5	73784439	73785137	CpG: 71	698	71	484	20.3	69.3	0.85
chr5	73861607	73863908	CpG: 193	2301	193	1473	16.8	64.0	0.82
chr5	73886257	73886487	CpG: 17	230	17	133	14.8	57.8	0.91
chr5	73900819	73901492	CpG: 71	673	71	428	21.1	63.6	1.05
chr5	73917317	73917557	CpG: 19	240	19	151	15.8	62.9	0.85
chr5	73917861	73919228	CpG: 145	1367	145	935	21.2	68.4	0.91
chr5	73921271	73921540	CpG: 24	269	24	164	17.8	61.0	0.97
chr5	73925547	73926296	CpG: 62	749	62	460	16.6	61.4	0.89
chr5	73928104	73930083	CpG: 283	1979	283	1468	28.6	74.2	1.04
chr5	73932487	73933085	CpG: 66	598	66	425	22.1	71.1	0.88
chr5	73946253	73946515	CpG: 22	262	22	160	16.8	61.1	0.91
chr5	73979538	73980155	CpG: 57	617	57	412	18.5	66.8	0.83
chr5	74028460	74028695	CpG: 16	235	16	134	13.6	57.0	0.86
chr5	74046446	74047097	CpG: 56	651	56	388	17.2	59.6	0.98
chr5	74107112	74108046	CpG: 109	934	109	695	23.3	74.4	0.86
chr5	74414174	74414442	CpG: 24	268	24	166	17.9	61.9	0.94
chr5	74834235	74834509	CpG: 22	274	22	169	16.1	61.7	0.86
chr5	74872997	74873272	CpG: 22	275	22	166	16.0	60.4	0.89
chr5	74984632	74984874	CpG: 19	242	19	141	15.7	58.3	0.95
chr5	75120865	75122691	CpG: 161	1826	161	1189	17.6	65.1	0.84
chr5	75165516	75166621	CpG: 93	1105	93	729	16.8	66.0	0.77
chr5	75246957	75247186	CpG: 21	229	21	143	18.3	62.4	0.95
chr5	75247628	75248287	CpG: 55	659	55	395	16.7	59.9	0.93
chr5	75346565	75347745	CpG: 155	1180	155	868	26.3	73.6	0.97
chr5	75378356	75378595	CpG: 22	239	22	147	18.4	61.5	0.98
chr5	75515765	75515983	CpG: 20	218	20	138	18.3	63.3	0.94
chr5	75533272	75535270	CpG: 223	1998	223	1363	22.3	68.2	0.96
chr5	75717668	75717941	CpG: 41	273	41	204	30.0	74.7	1.08
chr5	75798200	75798442	CpG: 20	242	20	150	16.5	62.0	0.88
chr5	75814584	75814975	CpG: 32	391	32	279	16.4	71.4	0.64
chr5	75817544	75818741	CpG: 102	1197	102	773	17.0	64.6	0.83
chr5	75820197	75820471	CpG: 24	274	24	171	17.5	62.4	0.91
chr5	75991825	75993218	CpG: 126	1393	126	921	18.1	66.1	0.84
chr5	76092531	76093015	CpG: 42	484	42	342	17.4	70.7	0.70
chr5	76198213	76198766	CpG: 41	553	41	344	14.8	62.2	0.77
chr5	76222599	76222815	CpG: 17	216	17	127	15.7	58.8	0.93
chr5	76267580	76267854	CpG: 24	274	24	172	17.5	62.8	0.90
chr5	76460574	76460855	CpG: 24	281	24	171	17.1	60.9	0.93
chr5	76563447	76563738	CpG: 30	291	30	200	20.6	68.7	0.88
chr5	76564520	76566342	CpG: 159	1822	159	1215	17.5	66.7	0.80
chr5	76652248	76653980	CpG: 167	1732	167	1346	19.3	77.7	0.64
chr5	76655633	76655838	CpG: 24	205	24	132	23.4	64.4	1.16
chr5	76791084	76791350	CpG: 18	266	18	161	13.5	60.5	0.75
chr5	76884691	76886092	CpG: 133	1401	133	948	19.0	67.7	0.83
chr5	76993462	76993732	CpG: 22	270	22	165	16.3	61.1	0.88
chr5	77032577	77033055	CpG: 40	478	40	348	16.7	72.8	0.63
chr5	77040673	77040899	CpG: 16	226	16	132	14.2	58.4	0.85
chr5	77194323	77194598	CpG: 20	275	20	166	14.5	60.4	0.80
chr5	77197165	77198350	CpG: 127	1185	127	811	21.4	68.4	0.92
chr5	77217085	77217318	CpG: 16	233	16	138	13.7	59.2	0.80
chr5	77229952	77230168	CpG: 16	216	16	119	14.8	55.1	0.98
chr5	77255967	77256236	CpG: 19	269	19	162	14.1	60.2	0.79
chr5	77279936	77280171	CpG: 17	235	17	140	14.5	59.6	0.83
chr5	77300549	77301031	CpG: 51	482	51	325	21.2	67.4	0.94
chr5	77301497	77302076	CpG: 41	579	41	375	14.2	64.8	0.68
chr5	77435442	77436535	CpG: 104	1093	104	738	19.0	67.5	0.84
chr5	77461794	77462076	CpG: 26	282	26	177	18.4	62.8	0.95
chr5	77466231	77467491	CpG: 104	1260	104	930	16.5	73.8	0.61
chr5	77512019	77512770	CpG: 78	751	78	503	20.8	67.0	0.93
chr5	77514018	77514247	CpG: 17	229	17	131	14.8	57.2	0.93
chr5	77558689	77559527	CpG: 112	838	112	646	26.7	77.1	0.90
chr5	77568533	77568973	CpG: 52	440	52	310	23.6	70.5	0.95
chr5	77662140	77662955	CpG: 67	815	67	545	16.4	66.9	0.74
chr5	77692133	77693293	CpG: 164	1160	164	909	28.3	78.4	0.94
chr5	77722112	77722354	CpG: 23	242	23	152	19.0	62.8	0.98
chr5	77902655	77902930	CpG: 24	275	24	171	17.5	62.2	0.91
chr5	77957446	77957733	CpG: 23	287	23	170	16.0	59.2	0.92
chr5	77974517	77975219	CpG: 85	702	85	503	24.2	71.7	0.95
chr5	78110645	78111260	CpG: 60	615	60	424	19.5	68.9	0.83
chr5	78112203	78113633	CpG: 148	1430	148	1007	20.7	70.4	0.88
chr5	78119074	78119921	CpG: 65	847	65	560	15.3	66.1	0.70
chr5	78121338	78122053	CpG: 60	715	60	494	16.8	69.1	0.71
chr5	78122879	78123737	CpG: 65	858	65	545	15.2	63.5	0.75
chr5	78127801	78128641	CpG: 87	840	87	586	20.7	69.8	0.85
chr5	78242786	78243015	CpG: 18	229	18	144	15.7	62.9	0.80
chr5	78245262	78245503	CpG: 20	241	20	146	16.6	60.6	0.93
chr5	78257805	78258463	CpG: 85	658	85	478	25.8	72.6	0.98
chr5	78326463	78326835	CpG: 38	372	38	262	20.4	70.4	0.83
chr5	78332917	78333832	CpG: 94	915	94	599	20.5	65.5	0.97
chr5	78352368	78352642	CpG: 20	274	20	168	14.6	61.3	0.80
chr5	78439803	78440020	CpG: 29	217	29	174	26.7	80.2	0.83
chr5	78454320	78454757	CpG: 50	437	50	320	22.9	73.2	0.86
chr5	78521284	78521565	CpG: 20	281	20	170	14.2	60.5	0.78
chr5	78563157	78563383	CpG: 20	226	20	138	17.7	61.1	0.98
chr5	78775940	78776524	CpG: 47	584	47	385	16.1	65.9	0.75
chr5	78841100	78841338	CpG: 18	238	18	139	15.1	58.4	0.90
chr5	78841710	78842822	CpG: 120	1112	120	772	21.6	69.4	0.90
chr5	78939344	78939570	CpG: 19	226	19	134	16.8	59.3	0.96
chr5	78991415	78991975	CpG: 56	560	56	377	20.0	67.3	0.88
chr5	79057510	79057746	CpG: 18	236	18	144	15.3	61.0	0.84
chr5	79129482	79130834	CpG: 169	1352	169	1036	25.0	76.6	0.86
chr5	79278494	79278845	CpG: 28	351	28	216	16.0	61.5	0.85
chr5	79289401	79289675	CpG: 24	274	24	171	17.5	62.4	0.91
chr5	79348602	79349029	CpG: 29	427	29	253	13.6	59.3	0.78
chr5	79355304	79355578	CpG: 22	274	22	170	16.1	62.0	0.84
chr5	79394919	79395194	CpG: 22	275	22	169	16.0	61.5	0.86
chr5	79465599	79466595	CpG: 131	996	131	751	26.3	75.4	0.93
chr5	79550579	79551411	CpG: 81	832	81	570	19.5	68.5	0.83
chr5	79671250	79671486	CpG: 20	236	20	144	16.9	61.0	0.93
chr5	79677356	79677634	CpG: 22	278	22	166	15.8	59.7	0.90
chr5	79719942	79721906	CpG: 220	1964	220	1353	22.4	68.9	0.95
chr5	79920032	79920313	CpG: 25	281	25	176	17.8	62.6	0.92
chr5	79997703	79998824	CpG: 127	1121	127	826	22.7	73.7	0.84
chr5	80014396	80014673	CpG: 24	277	24	173	17.3	62.5	0.90
chr5	80096659	80097131	CpG: 35	472	35	283	14.8	60.0	0.83
chr5	80167906	80168189	CpG: 23	283	23	172	16.3	60.8	0.89
chr5	80173875	80174352	CpG: 56	477	56	344	23.5	72.1	0.93
chr5	80268484	80268843	CpG: 28	359	28	213	15.6	59.3	0.89
chr5	80474612	80475162	CpG: 48	550	48	368	17.5	66.9	0.78
chr5	80518955	80519515	CpG: 70	560	70	434	25.0	77.5	0.85
chr5	80739902	80740827	CpG: 115	925	115	681	24.9	73.6	0.93
chr5	80741276	80741520	CpG: 18	244	18	140	14.8	57.4	0.90
chr5	80742641	80742866	CpG: 20	225	20	138	17.8	61.3	0.95
chr5	80752555	80752786	CpG: 19	231	19	140	16.5	60.6	0.91
chr5	80784779	80785729	CpG: 77	950	77	667	16.2	70.2	0.66
chr5	80791338	80791603	CpG: 19	265	19	155	14.3	58.5	0.85
chr5	80793946	80794150	CpG: 20	204	20	149	19.6	73.0	0.74
chr5	80833145	80833382	CpG: 17	237	17	142	14.3	59.9	0.83
chr5	80837854	80838098	CpG: 18	244	18	137	14.8	56.1	0.97
chr5	80891483	80892614	CpG: 98	1131	98	760	17.3	67.2	0.77
chr5	80971811	80972321	CpG: 65	510	65	357	25.5	70.0	1.04
chr5	80973640	80973876	CpG: 18	236	18	137	15.3	58.1	0.92
chr5	81053064	81054643	CpG: 161	1579	161	1126	20.4	71.3	0.80
chr5	81065373	81065647	CpG: 24	274	24	171	17.5	62.4	0.91
chr5	81139065	81139963	CpG: 95	898	95	645	21.2	71.8	0.83
chr5	81444689	81445819	CpG: 147	1130	147	825	26.0	73.0	0.98
chr5	81681787	81682068	CpG: 24	281	24	174	17.1	61.9	0.91
chr5	81707946	81708219	CpG: 19	273	19	165	13.9	60.4	0.77
chr5	81785938	81786490	CpG: 49	552	49	353	17.8	63.9	0.87
chr5	81878403	81878999	CpG: 67	596	67	446	22.5	74.8	0.81
chr5	81890737	81891022	CpG: 23	285	23	177	16.1	62.1	0.85
chr5	81939942	81940223	CpG: 24	281	24	175	17.1	62.3	0.90
chr5	82098683	82098957	CpG: 22	274	22	165	16.1	60.2	0.90
chr5	82100713	82101072	CpG: 29	359	29	214	16.2	59.6	0.91
chr5	82108037	82108241	CpG: 15	204	15	121	14.7	59.3	0.85
chr5	82234580	82236632	CpG: 232	2052	232	1512	22.6	73.7	0.89
chr5	82308337	82308548	CpG: 20	211	20	153	19.0	72.5	0.73
chr5	82371344	82371625	CpG: 24	281	24	174	17.1	61.9	0.91
chr5	82431090	82431371	CpG: 26	281	26	178	18.5	63.3	0.93
chr5	82456386	82457176	CpG: 86	790	86	584	21.8	73.9	0.80
chr5	82460688	82460933	CpG: 19	245	19	144	15.5	58.8	0.91
chr5	82521924	82522198	CpG: 24	274	24	171	17.5	62.4	0.91
chr5	82763804	82764266	CpG: 48	462	48	316	20.8	68.4	0.93
chr5	82920776	82921087	CpG: 24	311	24	188	15.4	60.5	0.85
chr5	83116189	83116463	CpG: 23	274	23	170	16.8	62.0	0.88
chr5	83177168	83177448	CpG: 23	280	23	173	16.4	61.8	0.88
chr5	83182426	83182660	CpG: 17	234	17	140	14.5	59.8	0.85
chr5	83211883	83212141	CpG: 19	258	19	157	14.7	60.9	0.81
chr5	83212442	83212719	CpG: 25	277	25	177	18.1	63.9	0.89
chr5	83346717	83346991	CpG: 25	274	25	172	18.2	62.8	0.94
chr5	83566412	83566657	CpG: 23	245	23	158	18.8	64.5	0.91
chr5	83764082	83764357	CpG: 24	275	24	171	17.5	62.2	0.91
chr5	83872309	83872587	CpG: 23	278	23	174	16.5	62.6	0.85
chr5	83952214	83952456	CpG: 21	242	21	146	17.4	60.3	0.95
chr5	83961343	83963555	CpG: 143	2212	143	1358	12.9	61.4	0.69
chr5	84119629	84119886	CpG: 21	257	21	159	16.3	61.9	0.87
chr5	84149990	84150245	CpG: 21	255	21	156	16.5	61.2	0.89
chr5	84210583	84211047	CpG: 59	464	59	349	25.4	75.2	0.97
chr5	84296904	84297175	CpG: 20	271	20	160	14.8	59.0	0.85
chr5	84342581	84342807	CpG: 17	226	17	136	15.0	60.2	0.84
chr5	84605601	84605878	CpG: 21	277	21	167	15.2	60.3	0.85
chr5	84696977	84697258	CpG: 22	281	22	174	15.7	61.9	0.83
chr5	84740801	84741046	CpG: 20	245	20	147	16.3	60.0	0.92
chr5	84807831	84808097	CpG: 25	266	25	165	18.8	62.0	0.99
chr5	84870947	84871204	CpG: 25	257	25	168	19.5	65.4	0.91
chr5	84872394	84873567	CpG: 127	1173	127	823	21.7	70.2	0.88
chr5	85071941	85072175	CpG: 24	234	24	148	20.5	63.2	1.05
chr5	85311916	85312214	CpG: 23	298	23	215	15.4	72.1	0.61
chr5	85359693	85359913	CpG: 18	220	18	120	16.4	54.5	1.12
chr5	85481048	85481329	CpG: 23	281	23	174	16.4	61.9	0.87
chr5	85789815	85790089	CpG: 23	274	23	170	16.8	62.0	0.88
chr5	85801529	85801804	CpG: 24	275	24	171	17.5	62.2	0.91
chr5	85886370	85886610	CpG: 20	240	20	147	16.7	61.2	0.91
chr5	86146100	86146317	CpG: 16	217	16	134	14.7	61.8	0.77
chr5	86152201	86152477	CpG: 23	276	23	170	16.7	61.6	0.89
chr5	86250488	86250716	CpG: 18	228	18	139	15.8	61.0	0.87
chr5	86460727	86461008	CpG: 24	281	24	176	17.1	62.6	0.89
chr5	86529516	86529790	CpG: 20	274	20	169	14.6	61.7	0.78
chr5	86579734	86580015	CpG: 22	281	22	168	15.7	59.8	0.88
chr5	86709399	86709635	CpG: 19	236	19	143	16.1	60.6	0.91
chr5	86993767	86994161	CpG: 30	394	30	236	15.2	59.9	0.85
chr5	87051643	87051860	CpG: 15	217	15	128	13.8	59.0	0.81
chr5	87052523	87052916	CpG: 35	393	35	294	17.8	74.8	0.64
chr5	87323932	87324206	CpG: 24	274	24	172	17.5	62.8	0.90
chr5	87486693	87486967	CpG: 23	274	23	169	16.8	61.7	0.89
chr5	87493217	87493487	CpG: 22	270	22	169	16.3	62.6	0.84
chr5	87499516	87499735	CpG: 20	219	20	134	18.3	61.2	1.00
chr5	87557249	87557479	CpG: 21	230	21	142	18.3	61.7	0.97
chr5	87622770	87623039	CpG: 18	269	18	158	13.4	58.7	0.78
chr5	87748663	87749694	CpG: 82	1031	82	690	15.9	66.9	0.71
chr5	87893585	87894167	CpG: 55	582	55	348	18.9	59.8	1.06
chr5	88622332	88622814	CpG: 36	482	36	318	14.9	66.0	0.73
chr5	88749841	88750114	CpG: 27	273	27	178	19.8	65.2	0.95
chr5	88804471	88804749	CpG: 23	278	23	172	16.5	61.9	0.88
chr5	89083750	89083998	CpG: 21	248	21	148	16.9	59.7	0.95
chr5	89086027	89086267	CpG: 18	240	18	143	15.0	59.6	0.88
chr5	89096442	89097336	CpG: 71	894	71	620	15.9	69.4	0.66
chr5	89140951	89141177	CpG: 22	226	22	157	19.5	69.5	0.81
chr5	89141802	89142500	CpG: 72	698	72	460	20.6	65.9	0.96
chr5	89153949	89154221	CpG: 30	272	30	192	22.1	70.6	0.89
chr5	89155276	89157388	CpG: 166	2112	166	1288	15.7	61.0	0.85
chr5	89159267	89159866	CpG: 50	599	50	383	16.7	63.9	0.83
chr5	89161410	89161862	CpG: 46	452	46	318	20.4	70.4	0.83
chr5	89166196	89166590	CpG: 40	394	40	261	20.3	66.2	0.94
chr5	89170784	89171124	CpG: 28	340	28	212	16.5	62.4	0.85
chr5	89176012	89176248	CpG: 18	236	18	138	15.3	58.5	0.91
chr5	89217343	89217628	CpG: 25	285	25	178	17.5	62.5	0.91
chr5	89228500	89228775	CpG: 23	275	23	170	16.7	61.8	0.88
chr5	89255480	89255702	CpG: 16	222	16	133	14.4	59.9	0.81
chr5	89365158	89365550	CpG: 38	392	38	235	19.4	59.9	1.09
chr5	89370514	89370879	CpG: 27	365	27	241	14.8	66.0	0.81
chr5	89484688	89485270	CpG: 56	582	56	426	19.2	73.2	0.72
chr5	89489110	89489391	CpG: 23	281	23	174	16.4	61.9	0.87
chr5	89798223	89798442	CpG: 18	219	18	127	16.4	58.0	0.99
chr5	89957923	89958204	CpG: 24	281	24	175	17.1	62.3	0.90
chr5	90094992	90095273	CpG: 24	281	24	174	17.1	61.9	0.91
chr5	90553833	90554125	CpG: 24	292	24	179	16.4	61.3	0.88
chr5	90566152	90566425	CpG: 22	273	22	169	16.1	61.9	0.86
chr5	90582134	90582409	CpG: 25	275	25	170	18.2	61.8	0.96
chr5	90635573	90635797	CpG: 19	224	19	135	17.0	60.3	0.93
chr5	90694978	90695324	CpG: 24	346	24	211	13.9	61.0	0.75
chr5	90890142	90890408	CpG: 23	266	23	166	17.3	62.4	0.90
chr5	90896076	90896313	CpG: 17	237	17	141	14.3	59.5	0.96
chr5	90896469	90896674	CpG: 20	205	20	133	19.5	64.9	0.94
chr5	90960366	90961597	CpG: 118	1231	118	832	19.2	67.6	0.84
chr5	91015914	91016602	CpG: 66	688	66	481	19.2	69.9	0.79
chr5	91045085	91045751	CpG: 58	666	58	466	17.4	70.0	0.75
chr5	91154727	91154933	CpG: 16	206	16	122	15.5	59.2	0.89
chr5	91308473	91308760	CpG: 23	287	23	171	16.0	59.6	0.91
chr5	91403115	91403386	CpG: 22	271	22	166	16.2	61.3	0.87
chr5	91415672	91415982	CpG: 26	310	26	192	16.8	61.9	0.88
chr5	91423974	91424210	CpG: 18	236	18	143	15.3	60.6	0.85
chr5	91764390	91764672	CpG: 35	282	35	202	24.8	71.6	0.97
chr5	91826881	91827168	CpG: 27	287	27	207	18.8	72.1	0.72
chr5	91863857	91864965	CpG: 102	1108	102	708	18.4	63.9	0.91
chr5	92401202	92401622	CpG: 39	420	39	314	18.6	74.8	0.66
chr5	92457332	92457600	CpG: 19	268	19	159	14.2	59.3	0.81
chr5	92565193	92565418	CpG: 19	225	19	134	16.9	59.6	1.00
chr5	93060835	93061071	CpG: 17	236	17	139	14.4	58.9	0.85
chr5	93085262	93085485	CpG: 19	223	19	134	17.0	60.1	0.97
chr5	93115385	93115627	CpG: 28	242	28	182	23.1	75.2	0.82
chr5	93688651	93688916	CpG: 23	265	23	167	17.4	63.0	0.88
chr5	93745247	93745558	CpG: 27	311	27	194	17.4	62.4	0.90
chr5	93825523	93825804	CpG: 23	281	23	175	16.4	62.3	0.86
chr5	93835558	93835811	CpG: 20	253	20	153	15.8	60.5	0.88
chr5	93923441	93923678	CpG: 17	237	17	144	14.3	60.8	0.79
chr5	94054612	94057248	CpG: 182	2636	182	1600	13.8	60.7	0.75
chr5	94063143	94065710	CpG: 210	2567	210	1622	16.4	63.2	0.82
chr5	94067915	94069787	CpG: 225	1872	225	1372	24.0	73.3	0.90
chr5	94071843	94072853	CpG: 119	1010	119	704	23.6	69.7	0.97
chr5	94077624	94077845	CpG: 19	221	19	137	17.2	62.0	0.91
chr5	94078885	94079186	CpG: 27	301	27	207	17.9	68.8	0.80
chr5	94088151	94088572	CpG: 51	421	51	306	24.2	72.7	0.93
chr5	94104679	94105699	CpG: 109	1020	109	694	21.4	68.0	0.93
chr5	94118188	94118422	CpG: 16	234	16	141	13.7	60.3	0.77
chr5	94302983	94303256	CpG: 23	273	23	167	16.8	61.2	0.91
chr5	94595305	94595788	CpG: 41	483	41	313	17.0	64.8	0.81
chr5	94610382	94610648	CpG: 21	266	21	164	15.8	61.7	0.84
chr5	94635194	94635475	CpG: 24	281	24	176	17.1	62.6	0.89
chr5	94718145	94718386	CpG: 20	241	20	145	16.6	60.2	0.94
chr5	94956490	94956729	CpG: 20	239	20	144	16.7	60.3	0.94
chr5	95000545	95000814	CpG: 26	269	26	171	19.3	63.6	0.97
chr5	95064613	95064891	CpG: 26	278	26	176	18.7	63.3	0.94
chr5	95102591	95103521	CpG: 77	930	77	591	16.6	63.5	0.82
chr5	95162388	95162599	CpG: 15	211	15	127	14.2	60.2	0.81
chr5	95258279	95258587	CpG: 25	308	25	185	16.2	60.1	0.91
chr5	95404807	95405085	CpG: 20	278	20	168	14.4	60.4	0.79
chr5	95579385	95579659	CpG: 22	274	22	169	16.1	61.7	0.86
chr5	95784765	95786422	CpG: 176	1657	176	1211	21.2	73.1	0.80
chr5	95970982	95971219	CpG: 17	237	17	143	14.3	60.3	0.81
chr5	95993295	95993570	CpG: 24	275	24	170	17.5	61.8	0.92
chr5	96036269	96036535	CpG: 24	266	24	164	18.0	61.7	0.96
chr5	96055642	96056404	CpG: 62	762	62	464	16.3	60.9	0.88
chr5	96057664	96057948	CpG: 22	284	22	170	15.5	59.9	0.87
chr5	96073435	96073709	CpG: 21	274	21	168	15.3	61.3	0.83
chr5	96120853	96122467	CpG: 185	1614	185	1151	22.9	71.3	0.90
chr5	96147548	96147913	CpG: 42	365	42	253	23.0	69.3	0.97
chr5	96159461	96159751	CpG: 24	290	24	170	16.6	58.6	0.98
chr5	96232232	96233344	CpG: 128	1112	128	786	23.0	70.7	0.92
chr5	96335935	96336378	CpG: 37	443	37	287	16.7	64.8	0.80
chr5	96352399	96352800	CpG: 37	401	37	294	18.5	73.3	0.69
chr5	96379084	96379365	CpG: 24	281	24	170	17.1	60.5	0.94
chr5	96461985	96463435	CpG: 142	1450	142	990	19.6	68.3	0.86
chr5	96674734	96675006	CpG: 20	272	20	163	14.7	59.9	0.83
chr5	96783842	96784079	CpG: 20	237	20	143	16.9	60.3	0.96
chr5	96934143	96934349	CpG: 18	206	18	123	17.5	59.7	1.00
chr5	96953644	96953925	CpG: 24	281	24	175	17.1	62.3	0.90
chr5	96992186	96992467	CpG: 20	281	20	168	14.2	59.8	0.81
chr5	97062890	97063163	CpG: 23	273	23	168	16.8	61.5	0.90
chr5	97162847	97164257	CpG: 127	1410	127	988	18.0	70.1	0.74
chr5	97182299	97182573	CpG: 24	274	24	171	17.5	62.4	0.91
chr5	97203360	97204035	CpG: 63	675	63	446	18.7	66.1	0.86
chr5	97308198	97308987	CpG: 90	789	90	586	22.8	74.3	0.83
chr5	97412792	97413030	CpG: 19	238	19	147	16.0	61.8	0.85
chr5	97422899	97423173	CpG: 22	274	22	172	16.1	62.8	0.83
chr5	97435613	97437301	CpG: 158	1688	158	1151	18.7	68.2	0.81
chr5	97574808	97575043	CpG: 19	235	19	148	16.2	63.0	0.83
chr5	97684530	97684756	CpG: 18	226	18	138	15.9	61.1	0.91
chr5	98254742	98254978	CpG: 19	236	19	143	16.1	60.6	0.90
chr5	98273347	98273582	CpG: 19	235	19	145	16.2	61.7	0.85
chr5	98365869	98366106	CpG: 19	237	19	141	16.0	59.5	0.94
chr5	98448309	98448526	CpG: 19	217	19	135	17.5	62.2	0.92
chr5	99011459	99011695	CpG: 21	236	21	145	17.8	61.4	0.97
chr5	99272167	99273859	CpG: 135	1692	135	1091	16.0	64.5	0.78
chr5	99276267	99277896	CpG: 169	1629	169	1095	20.7	67.2	0.92
chr5	99324998	99325272	CpG: 24	274	24	171	17.5	62.4	0.91
chr5	99354859	99355140	CpG: 23	281	23	174	16.4	61.9	0.87
chr5	99431362	99433147	CpG: 216	1785	216	1258	24.2	70.5	0.97
chr5	99750721	99750999	CpG: 26	278	26	176	18.7	63.3	0.94
chr5	99911394	99911727	CpG: 32	333	32	241	19.2	72.4	0.74
chr5	100240438	100240719	CpG: 25	281	25	176	17.8	62.6	0.92
chr5	100352953	100353394	CpG: 33	441	33	265	15.0	60.1	0.83
chr5	100394456	100394729	CpG: 22	273	22	168	16.1	61.5	0.86
chr5	100468610	100468888	CpG: 24	278	24	174	17.3	62.6	0.89
chr5	100473383	100473613	CpG: 20	230	20	141	17.4	61.3	0.94
chr5	100482854	100483133	CpG: 19	279	19	166	13.6	59.5	0.77
chr5	100576898	100577179	CpG: 23	281	23	171	16.4	60.9	0.91
chr5	100798407	100798647	CpG: 23	240	23	150	19.2	62.5	1.00
chr5	100862312	100862645	CpG: 33	333	33	242	19.8	72.7	0.75
chr5	100890085	100890315	CpG: 19	230	19	138	16.5	60.0	0.93
chr5	100925340	100925621	CpG: 23	281	23	176	16.4	62.6	0.85
chr5	100952995	100953273	CpG: 24	278	24	174	17.3	62.6	0.89
chr5	101043544	101044339	CpG: 62	795	62	533	15.6	67.0	0.69
chr5	101096161	101096439	CpG: 25	278	25	176	18.0	63.3	0.91
chr5	101197273	101197595	CpG: 25	322	25	230	15.5	71.4	0.61
chr5	101268509	101268732	CpG: 19	223	19	137	17.0	61.4	0.91
chr5	101337958	101338235	CpG: 23	277	23	171	16.6	61.7	0.88
chr5	101409120	101409508	CpG: 32	388	32	248	16.5	63.9	0.82
chr5	101411275	101411691	CpG: 30	416	30	263	14.4	63.2	0.73
chr5	101550389	101550618	CpG: 21	229	21	140	18.3	61.1	1.02
chr5	101561982	101562212	CpG: 20	230	20	142	17.4	61.7	0.92
chr5	101602721	101602995	CpG: 22	274	22	172	16.1	62.8	0.83
chr5	101969136	101969383	CpG: 18	247	18	143	14.6	57.9	0.90
chr5	102159326	102159596	CpG: 22	270	22	166	16.3	61.5	0.88
chr5	102246828	102247105	CpG: 25	277	25	170	18.1	61.4	0.97
chr5	102639610	102639902	CpG: 22	292	22	176	15.1	60.3	0.83
chr5	102662916	102663438	CpG: 51	522	51	392	19.5	75.1	0.69
chr5	102685168	102685454	CpG: 26	286	26	178	18.2	62.2	0.95
chr5	102697585	102697944	CpG: 28	359	28	212	15.6	59.1	0.90
chr5	102804417	102804741	CpG: 34	324	34	232	21.0	71.6	0.83
chr5	102833963	102834195	CpG: 16	232	16	132	13.8	56.9	0.87
chr5	103006715	103007101	CpG: 32	386	32	255	16.6	66.1	0.76
chr5	103179463	103179706	CpG: 21	243	21	145	17.3	59.7	0.97
chr5	103195527	103195802	CpG: 23	275	23	171	16.7	62.2	0.87
chr5	103220453	103220727	CpG: 22	274	22	168	16.1	61.3	0.87
chr5	103259955	103260233	CpG: 24	278	24	203	17.3	73.0	0.65
chr5	103262952	103263549	CpG: 66	597	66	447	22.1	74.9	0.79
chr5	103263757	103263974	CpG: 17	217	17	133	15.7	61.3	0.83
chr5	103309829	103310112	CpG: 24	283	24	177	17.0	62.5	0.88
chr5	103373892	103374221	CpG: 47	329	47	246	28.6	74.8	1.02
chr5	103547143	103547439	CpG: 23	296	23	179	15.5	60.5	0.89
chr5	103554945	103555169	CpG: 17	224	17	129	15.2	57.6	0.92
chr5	103627951	103628388	CpG: 33	437	33	238	15.1	54.5	1.02
chr5	103648674	103648936	CpG: 24	262	24	164	18.3	62.6	0.94
chr5	103766648	103767970	CpG: 144	1322	144	962	21.8	72.8	0.83
chr5	104096980	104097255	CpG: 21	275	21	168	15.3	61.1	0.83
chr5	104150633	104150910	CpG: 19	277	19	170	13.7	61.4	0.75
chr5	104203230	104203504	CpG: 25	274	25	172	18.2	62.8	0.94
chr5	104234983	104235257	CpG: 24	274	24	171	17.5	62.4	0.91
chr5	104397220	104397475	CpG: 24	255	24	160	18.8	62.7	0.96
chr5	104462122	104462701	CpG: 44	579	44	412	15.2	71.2	0.60
chr5	104474655	104474857	CpG: 17	202	17	145	16.8	71.8	0.68
chr5	104637126	104637413	CpG: 24	287	24	180	16.7	62.7	0.87
chr5	104913400	104913673	CpG: 24	273	24	171	17.6	62.6	0.91
chr5	104960915	104961192	CpG: 24	277	24	168	17.3	60.6	0.95
chr5	105071391	105071664	CpG: 23	273	23	173	16.8	63.4	0.85
chr5	105152724	105152964	CpG: 19	240	19	139	15.8	57.9	0.96
chr5	105173351	105173578	CpG: 16	227	16	134	14.1	59.0	0.82
chr5	105339471	105339699	CpG: 17	228	17	120	14.9	52.6	1.08
chr5	105433200	105433593	CpG: 31	393	31	281	15.8	71.5	0.62
chr5	105557218	105557496	CpG: 25	278	25	175	18.0	62.9	0.92
chr5	105759443	105759717	CpG: 23	274	23	166	16.8	60.6	0.93
chr5	105785984	105786258	CpG: 20	274	20	168	14.6	61.3	0.79
chr5	105820705	105820935	CpG: 20	230	20	141	17.4	61.3	0.94
chr5	105871111	105871386	CpG: 21	275	21	168	15.3	61.1	0.83
chr5	105888330	105888604	CpG: 21	274	21	168	15.3	61.3	0.82
chr5	106023041	106023468	CpG: 31	427	31	255	14.5	59.7	0.82
chr5	106099671	106099932	CpG: 23	261	23	161	17.6	61.7	0.94
chr5	106318154	106318363	CpG: 15	209	15	121	14.4	57.9	0.86
chr5	106363563	106363887	CpG: 33	324	33	246	20.4	75.9	0.71
chr5	106658765	106659107	CpG: 34	342	34	250	19.9	73.1	0.75
chr5	106722374	106722614	CpG: 18	240	18	148	15.0	61.7	0.80
chr5	106750544	106751033	CpG: 42	489	42	352	17.2	72.0	0.66
chr5	106921782	106921999	CpG: 22	217	22	159	20.3	73.3	0.76
chr5	107118777	107118995	CpG: 21	218	21	135	19.3	61.9	1.02
chr5	107224100	107224443	CpG: 25	343	25	203	14.6	59.2	0.83
chr5	107669503	107669784	CpG: 24	281	24	170	17.1	60.5	0.95
chr5	108125579	108125864	CpG: 25	285	25	178	17.5	62.5	0.92
chr5	108172271	108175331	CpG: 269	3060	269	1943	17.6	63.5	0.87
chr5	108883159	108885151	CpG: 239	1992	239	1478	24.0	74.2	0.88
chr5	108925138	108925412	CpG: 21	274	21	168	15.3	61.3	0.82
chr5	109230516	109230988	CpG: 49	472	49	333	20.8	70.6	0.84
chr5	109250903	109252119	CpG: 112	1216	112	858	18.4	70.6	0.74
chr5	109357951	109358196	CpG: 21	245	21	152	17.1	62.0	0.91
chr5	109495881	109496865	CpG: 72	984	72	685	14.6	69.6	0.60
chr5	109762868	109763294	CpG: 33	426	33	256	15.5	60.1	0.86
chr5	109868966	109869236	CpG: 23	270	23	169	17.0	62.6	0.88
chr5	109913840	109914665	CpG: 76	825	76	539	18.4	65.3	0.87
chr5	109992330	109992909	CpG: 64	579	64	434	22.1	75.0	0.79
chr5	110193786	110195522	CpG: 193	1736	193	1238	22.2	71.3	0.88
chr5	110389736	110389949	CpG: 23	213	23	160	21.6	75.1	0.78
chr5	110465854	110466128	CpG: 24	274	24	170	17.5	62.0	0.92
chr5	110654604	110655030	CpG: 33	426	33	257	15.5	60.3	0.86
chr5	111249489	111250107	CpG: 60	618	60	415	19.4	67.2	0.86
chr5	111251257	111251532	CpG: 22	275	22	167	16.0	60.7	0.88
chr5	111377142	111377378	CpG: 21	236	21	145	17.8	61.4	0.96
chr5	111396021	111396295	CpG: 23	274	23	169	16.8	61.7	0.89
chr5	111404635	111404985	CpG: 32	350	32	255	18.3	72.9	0.69
chr5	111583669	111583974	CpG: 27	305	27	201	17.7	65.9	0.82
chr5	111602713	111603206	CpG: 41	493	41	298	16.6	60.4	0.91
chr5	111734507	111735384	CpG: 108	877	108	638	24.6	72.7	0.93
chr5	111778064	111778326	CpG: 25	262	25	165	19.1	63.0	0.98
chr5	111792402	111792675	CpG: 23	273	23	173	16.8	63.4	0.85
chr5	111812874	111813301	CpG: 31	427	31	256	14.5	60.0	0.81
chr5	111966520	111966780	CpG: 19	260	19	161	14.6	61.9	0.77
chr5	112022422	112023047	CpG: 55	625	55	429	17.6	68.6	0.75
chr5	112041503	112041731	CpG: 18	228	18	136	15.8	59.6	0.92
chr5	112267837	112268621	CpG: 95	784	95	564	24.2	71.9	0.94
chr5	112315063	112315335	CpG: 19	272	19	166	14.0	61.0	0.76
chr5	112492262	112492544	CpG: 22	282	22	173	15.6	61.3	0.85
chr5	112671164	112671797	CpG: 51	633	51	375	16.1	59.2	0.92
chr5	112741966	112742247	CpG: 23	281	23	176	16.4	62.6	0.85
chr5	112870889	112871473	CpG: 40	584	40	380	13.7	65.1	0.65
chr5	112929222	112930967	CpG: 194	1745	194	1230	22.2	70.5	0.89
chr5	113162375	113162637	CpG: 24	262	24	164	18.3	62.6	0.95
chr5	113217946	113218784	CpG: 64	838	64	554	15.3	66.1	0.70
chr5	113371692	113372090	CpG: 37	398	37	254	18.6	63.8	0.92
chr5	113431814	113432966	CpG: 128	1152	128	831	22.2	72.1	0.87
chr5	113448414	113448697	CpG: 22	283	22	173	15.5	61.1	0.85
chr5	113464888	113465768	CpG: 75	880	75	618	17.0	70.2	0.69
chr5	113487223	113487842	CpG: 64	619	64	408	20.7	65.9	0.98
chr5	113585753	113586000	CpG: 20	247	20	179	16.2	72.5	0.63
chr5	113807165	113807570	CpG: 48	405	48	276	23.7	68.1	1.02
chr5	113914700	113914911	CpG: 17	211	17	128	16.1	60.7	0.88
chr5	114000276	114001324	CpG: 100	1048	100	687	19.1	65.6	0.89
chr5	114004554	114004832	CpG: 25	278	25	174	18.0	62.6	0.93
chr5	114026275	114026992	CpG: 69	717	69	494	19.2	68.9	0.81
chr5	114058456	114058730	CpG: 24	274	24	171	17.5	62.4	0.91
chr5	114299165	114299405	CpG: 17	240	17	142	14.2	59.2	0.83
chr5	114459453	114459709	CpG: 21	256	21	152	16.4	59.4	0.94
chr5	114568309	114569243	CpG: 76	934	76	571	16.3	61.1	0.87
chr5	114636351	114636588	CpG: 22	237	22	146	18.6	61.6	1.00
chr5	114690072	114690297	CpG: 18	225	18	140	16.0	62.2	0.83
chr5	114745848	114746122	CpG: 24	274	24	171	17.5	62.4	0.91
chr5	114873642	114876318	CpG: 247	2676	247	1828	18.5	68.3	0.80
chr5	115532674	115532959	CpG: 25	285	25	178	17.5	62.5	0.91
chr5	115682336	115684117	CpG: 174	1781	174	1250	19.5	70.2	0.79
chr5	115692233	115693737	CpG: 135	1504	135	964	18.0	64.1	0.88
chr5	115775928	115776284	CpG: 37	356	37	238	20.8	66.9	0.94
chr5	115809478	115810258	CpG: 83	780	83	572	21.3	73.3	0.81
chr5	115917024	115917253	CpG: 19	229	19	143	16.6	62.4	0.86
chr5	116057218	116057877	CpG: 79	659	79	486	24.0	73.7	0.88
chr5	116091002	116091276	CpG: 24	274	24	171	17.5	62.4	0.91
chr5	116114699	116115235	CpG: 65	536	65	412	24.3	76.9	0.83
chr5	116138414	116139054	CpG: 71	640	71	438	22.2	68.4	0.97
chr5	116328049	116329414	CpG: 122	1365	122	890	17.9	65.2	0.84
chr5	116353933	116354955	CpG: 117	1022	117	708	22.9	69.3	0.96
chr5	116427296	116427555	CpG: 18	259	18	163	13.9	62.9	0.71
chr5	116474318	116474804	CpG: 33	486	33	293	13.6	60.3	0.75
chr5	116475061	116475848	CpG: 74	787	74	537	18.8	68.2	0.81
chr5	116577326	116577588	CpG: 18	262	18	156	13.7	59.5	0.78
chr5	116597270	116597854	CpG: 62	584	62	394	21.2	67.5	0.94
chr5	116670347	116670574	CpG: 16	227	16	137	14.1	60.4	1.88
chr5	116873875	116874330	CpG: 45	455	45	316	19.8	69.5	0.85
chr5	116959832	116960182	CpG: 27	350	27	224	15.4	64.0	0.77
chr5	117084839	117087234	CpG: 193	2395	193	1538	16.1	64.2	0.78
chr5	117088443	117088826	CpG: 38	383	38	264	19.8	68.9	0.84
chr5	117129976	117130219	CpG: 19	243	19	141	15.6	58.0	0.96
chr5	117130462	117130735	CpG: 23	273	23	169	16.8	61.9	0.90
chr5	117159779	117160011	CpG: 16	232	16	139	13.8	59.9	0.79
chr5	117213229	117213451	CpG: 18	222	18	132	16.2	59.5	0.95
chr5	117354247	117354522	CpG: 22	275	22	171	16.0	62.2	0.83
chr5	117605063	117605344	CpG: 24	281	24	176	17.1	62.6	0.88
chr5	117668647	117668863	CpG: 18	216	18	133	16.7	61.6	0.91
chr5	117715211	117715422	CpG: 16	211	16	129	15.2	61.1	0.83
chr5	117740807	117741048	CpG: 19	241	19	146	15.8	60.6	0.88
chr5	117817323	117817711	CpG: 31	388	31	280	16.0	72.2	0.61
chr5	117871514	117871788	CpG: 23	274	23	170	16.8	62.0	0.88
chr5	118045591	118045884	CpG: 24	293	24	176	16.4	60.1	0.91
chr5	118111937	118113054	CpG: 87	1117	87	794	15.6	71.1	0.62
chr5	118202000	118202230	CpG: 17	230	17	136	14.8	59.1	0.86
chr5	118434721	118434995	CpG: 25	274	25	171	18.2	62.4	0.95
chr5	118558690	118558968	CpG: 25	278	25	175	18.0	62.9	0.92
chr5	118794689	118795528	CpG: 64	839	64	581	15.3	69.2	0.64
chr5	118901781	118902054	CpG: 22	273	22	163	16.1	59.7	0.91
chr5	119005356	119005599	CpG: 19	243	19	146	15.6	60.1	0.88
chr5	119477622	119478483	CpG: 66	861	66	593	15.3	68.9	0.65
chr5	119486672	119486879	CpG: 26	207	26	140	25.1	67.6	1.21
chr5	119501219	119501776	CpG: 69	557	69	409	24.8	73.4	0.93
chr5	119504460	119504741	CpG: 23	281	23	173	16.4	61.6	0.88
chr5	119511570	119512177	CpG: 42	607	42	394	13.8	64.9	0.66
chr5	119577681	119577921	CpG: 19	240	19	143	15.8	59.6	0.91
chr5	119584034	119584732	CpG: 77	698	77	499	22.1	71.5	0.88
chr5	119613820	119614057	CpG: 18	237	18	140	15.2	59.1	0.89
chr5	119789350	119789987	CpG: 68	637	68	444	21.4	69.7	0.91
chr5	119876542	119876900	CpG: 42	358	42	237	23.5	66.2	1.08
chr5	119973266	119973569	CpG: 34	303	34	205	22.4	67.7	0.98
chr5	120037964	120038222	CpG: 22	258	22	187	17.1	72.5	0.65
chr5	120089146	120089353	CpG: 15	207	15	114	14.5	55.1	0.98
chr5	120210904	120211214	CpG: 24	310	24	188	15.5	60.6	0.84
chr5	120265458	120265699	CpG: 21	241	21	148	17.4	61.4	0.95
chr5	120296789	120297059	CpG: 22	270	22	168	16.3	62.2	0.85
chr5	120410116	120410356	CpG: 18	240	18	142	15.0	59.2	0.88
chr5	120665712	120666342	CpG: 45	630	45	419	14.3	66.5	0.65
chr5	120849212	120849478	CpG: 23	266	23	166	17.3	62.4	0.90
chr5	120927990	120928225	CpG: 21	235	21	143	17.9	60.9	0.98
chr5	120944938	120945154	CpG: 17	216	17	131	15.7	60.6	0.86
chr5	120982143	120982470	CpG: 52	327	52	256	31.8	78.3	1.05
chr5	120983293	120983516	CpG: 15	223	15	136	13.5	61.0	0.76
chr5	120983575	120983815	CpG: 25	240	25	171	20.8	71.2	0.89
chr5	121055824	121056102	CpG: 24	278	24	173	17.3	62.2	0.90
chr5	121195922	121196152	CpG: 18	230	18	136	15.7	59.1	0.90
chr5	121212397	121212670	CpG: 23	273	23	172	16.8	63.0	0.86
chr5	121371859	121372082	CpG: 16	223	16	129	14.3	57.8	0.89
chr5	121427477	121427685	CpG: 17	208	17	123	16.3	59.1	0.95
chr5	121454629	121454919	CpG: 27	290	27	217	18.6	74.8	0.68
chr5	121747050	121747279	CpG: 19	229	19	144	16.6	62.9	0.85
chr5	121937288	121937569	CpG: 23	281	23	174	16.4	61.9	0.87
chr5	122184359	122184633	CpG: 24	274	24	170	17.5	62.0	0.92
chr5	122368559	122369296	CpG: 71	737	71	500	19.3	67.8	0.85
chr5	122470752	122471213	CpG: 51	461	51	338	22.1	73.3	0.83
chr5	122475772	122476050	CpG: 24	278	24	174	17.3	62.6	0.89
chr5	122478568	122478959	CpG: 32	391	32	230	16.4	58.8	0.96
chr5	122518338	122518619	CpG: 22	281	22	171	15.7	60.9	0.86
chr5	122593560	122595149	CpG: 137	1589	137	1022	17.2	64.3	0.84
chr5	122828590	122829287	CpG: 96	697	96	539	27.5	77.3	0.93
chr5	122829452	122829689	CpG: 17	237	17	141	14.3	59.5	0.81
chr5	122847015	122847251	CpG: 20	236	20	145	16.9	61.4	0.91
chr5	122900037	122900279	CpG: 20	242	20	143	16.5	59.1	0.95
chr5	123144687	123144961	CpG: 24	274	24	171	17.5	62.4	0.91
chr5	123275743	123275977	CpG: 16	234	16	137	13.7	58.5	0.81
chr5	123291675	123292305	CpG: 66	630	66	446	21.0	70.8	0.85
chr5	123362137	123362855	CpG: 90	718	90	546	25.1	76.0	0.87
chr5	123430190	123430871	CpG: 49	681	49	469	14.4	68.9	0.61
chr5	123552421	123553674	CpG: 136	1253	136	900	21.7	71.8	0.84
chr5	123602978	123603409	CpG: 37	431	37	290	17.2	67.3	0.76
chr5	123605155	123607627	CpG: 228	2472	228	1678	18.4	67.9	0.80
chr5	123611476	123612243	CpG: 67	767	67	523	17.5	68.2	0.75
chr5	123614867	123616540	CpG: 125	1673	125	1052	14.9	62.9	0.75
chr5	123628095	123628368	CpG: 23	273	23	168	16.8	61.5	0.91
chr5	123793902	123794189	CpG: 24	287	24	178	16.7	62.0	0.88
chr5	123917131	123917492	CpG: 23	361	23	228	12.7	63.2	0.64
chr5	123939163	123939835	CpG: 62	672	62	449	18.5	66.8	0.83
chr5	123946753	123947149	CpG: 43	396	43	299	21.7	75.5	0.76
chr5	124028199	124029146	CpG: 118	947	118	679	24.9	71.7	0.98
chr5	124152294	124152544	CpG: 20	250	20	171	16.0	68.4	0.69
chr5	124374818	124375096	CpG: 25	278	25	175	18.0	62.9	0.92
chr5	124594394	124594669	CpG: 23	275	23	170	16.7	61.8	0.88
chr5	125072381	125072661	CpG: 25	280	25	176	17.9	62.9	0.91
chr5	125168153	125168503	CpG: 48	350	48	247	27.4	70.6	1.10
chr5	125232343	125232617	CpG: 20	274	20	172	14.6	62.8	0.75
chr5	125316159	125316430	CpG: 21	271	21	165	15.5	60.9	0.85
chr5	125328641	125328915	CpG: 25	274	25	173	18.2	63.1	0.92
chr5	125409046	125409618	CpG: 49	572	49	420	17.1	73.4	0.64
chr5	125618988	125619259	CpG: 21	271	21	163	15.5	60.1	0.87
chr5	125782122	125782400	CpG: 21	278	21	162	15.1	58.3	0.91
chr5	125880863	125881157	CpG: 26	294	26	180	17.7	61.2	0.95
chr5	125934878	125935159	CpG: 24	281	24	175	17.1	62.3	0.90
chr5	125968337	125968615	CpG: 28	278	28	179	20.1	64.4	0.98
chr5	126168417	126168657	CpG: 18	240	18	143	15.0	59.6	0.86
chr5	126509984	126510260	CpG: 24	276	24	171	17.4	62.0	0.92
chr5	126580887	126581165	CpG: 26	278	26	174	18.7	62.6	0.97
chr5	126588804	126589077	CpG: 23	273	23	167	16.8	61.2	0.91
chr5	126884583	126884819	CpG: 20	236	20	145	16.9	61.4	0.92
chr5	126911807	126912085	CpG: 26	278	26	176	18.7	63.3	0.94
chr5	126940499	126940750	CpG: 30	251	30	185	23.9	73.7	0.88
chr5	127111771	127112219	CpG: 37	448	37	302	16.5	67.4	0.74
chr5	127117692	127118270	CpG: 69	578	69	429	23.9	74.2	0.88
chr5	127118588	127119105	CpG: 36	517	36	299	13.9	57.8	0.84
chr5	127119591	127119824	CpG: 18	233	18	141	15.5	60.5	0.86
chr5	127155349	127155805	CpG: 36	456	36	254	15.8	55.7	1.03
chr5	127256641	127256854	CpG: 16	213	16	129	15.0	60.6	0.83
chr5	127269586	127269825	CpG: 17	239	17	141	14.2	59.0	0.84
chr5	127296493	127298493	CpG: 228	2000	228	1368	22.8	68.4	0.97
chr5	127299575	127299785	CpG: 17	210	17	125	16.2	59.5	0.93
chr5	127319019	127319292	CpG: 23	273	23	173	16.8	63.4	0.85
chr5	127374808	127375087	CpG: 23	279	23	204	16.5	73.1	0.62
chr5	127474164	127474441	CpG: 19	277	19	157	13.7	56.7	0.89
chr5	127494012	127494297	CpG: 23	285	23	176	16.1	61.8	0.87
chr5	127523308	127523813	CpG: 42	505	42	306	16.6	60.6	0.92
chr5	127550010	127551637	CpG: 173	1627	173	1100	21.3	67.6	0.93
chr5	127593391	127593712	CpG: 37	321	37	218	23.1	67.9	1.04
chr5	127748936	127749519	CpG: 60	583	60	418	20.6	71.7	0.81
chr5	127810131	127810979	CpG: 63	848	63	528	14.9	62.3	0.77
chr5	128037353	128038110	CpG: 82	757	82	532	21.7	70.3	0.89
chr5	128089274	128089666	CpG: 44	392	44	295	22.4	75.3	0.79
chr5	128126534	128126815	CpG: 24	281	24	175	17.1	62.3	0.90
chr5	128272442	128272752	CpG: 24	310	24	188	15.5	60.6	0.84
chr5	128601738	128603656	CpG: 236	1918	236	1400	24.6	73.0	0.93
chr5	129019305	129019577	CpG: 22	272	22	166	16.2	61.0	0.89
chr5	129055083	129055388	CpG: 21	305	21	171	13.8	56.1	0.88
chr5	129055688	129058070	CpG: 215	2382	215	1603	18.1	67.3	0.81
chr5	129261304	129261565	CpG: 21	261	21	160	16.1	61.3	0.87
chr5	129264055	129264321	CpG: 24	266	24	165	18.0	62.0	0.95
chr5	129352531	129352805	CpG: 24	274	24	170	17.5	62.0	0.92
chr5	129380123	129380395	CpG: 20	272	20	168	14.7	61.8	0.79
chr5	129467347	129467628	CpG: 22	281	22	171	15.7	60.9	0.86
chr5	129483962	129484491	CpG: 48	529	48	360	18.1	68.1	0.79
chr5	129524941	129525163	CpG: 19	222	19	136	17.1	61.3	0.94
chr5	129561796	129562069	CpG: 23	273	23	170	16.8	62.3	0.88
chr5	129613008	129614067	CpG: 134	1059	134	766	25.3	72.3	0.97
chr5	129913215	129913533	CpG: 21	318	21	178	13.2	56.0	0.85
chr5	129948028	129948302	CpG: 24	274	24	171	17.5	62.4	0.91
chr5	129978446	129980360	CpG: 174	1914	174	1248	18.2	65.2	0.86
chr5	130164672	130164946	CpG: 24	274	24	171	17.5	62.4	0.91
chr5	130232916	130233197	CpG: 24	281	24	175	17.1	62.3	0.90
chr5	130402796	130403035	CpG: 17	239	17	141	14.2	59.0	0.84
chr5	130403828	130404085	CpG: 19	257	19	156	14.8	60.7	0.81
chr5	130422668	130424727	CpG: 222	2059	222	1466	21.6	71.2	0.85
chr5	130437637	130437918	CpG: 24	281	24	176	17.1	62.6	0.89
chr5	130499727	130499983	CpG: 20	256	20	146	15.6	57.0	0.99
chr5	130712849	130713082	CpG: 17	233	17	136	14.6	58.4	0.87
chr5	131017898	131018106	CpG: 16	208	16	113	15.4	54.3	1.05
chr5	131272675	131272950	CpG: 23	275	23	173	16.7	62.9	0.85
chr5	131336716	131336955	CpG: 21	239	21	146	17.6	61.1	0.94
chr5	131408613	131408820	CpG: 15	207	15	121	14.5	58.5	0.86
chr5	131437930	131438204	CpG: 25	274	25	170	18.2	62.0	0.96
chr5	131513926	131514247	CpG: 27	321	27	211	16.8	65.7	0.81
chr5	131516245	131516526	CpG: 22	281	22	172	15.7	61.2	0.86
chr5	131573218	131573496	CpG: 23	278	23	173	16.5	62.2	0.86
chr5	131590007	131590218	CpG: 16	211	16	123	15.2	58.3	0.91
chr5	131673073	131673347	CpG: 24	274	24	173	17.5	63.1	0.89
chr5	131683524	131684393	CpG: 97	869	97	616	22.3	70.9	0.89
chr5	131689614	131690070	CpG: 36	456	36	268	15.8	58.8	0.93
chr5	131782656	131783727	CpG: 123	1071	123	763	23.0	71.2	0.91
chr5	131971553	131971811	CpG: 20	258	20	155	15.5	60.1	0.87
chr5	132037158	132037439	CpG: 23	281	23	174	16.4	61.9	0.87
chr5	132154678	132155768	CpG: 85	1090	85	641	15.6	58.8	0.90
chr5	132316099	132317473	CpG: 127	1374	127	923	18.5	67.2	0.82
chr5	132339668	132339942	CpG: 24	274	24	171	17.5	62.4	0.91
chr5	132447746	132447985	CpG: 22	239	22	146	18.4	61.1	1.00
chr5	132465097	132465630	CpG: 44	533	44	350	16.5	65.7	0.77
chr5	132502054	132502328	CpG: 23	274	23	170	16.8	62.0	0.88
chr5	132531071	132531955	CpG: 94	884	94	638	21.3	72.2	0.82
chr5	132687389	132687663	CpG: 23	274	23	170	16.8	62.0	0.88
chr5	132711107	132711381	CpG: 24	274	24	171	17.5	62.4	0.91
chr5	132747279	132748139	CpG: 104	860	104	650	24.2	75.6	0.86
chr5	132777225	132778000	CpG: 81	775	81	574	20.9	74.1	0.77
chr5	132791205	132792076	CpG: 75	871	75	592	17.2	68.0	0.76
chr5	132813435	132815002	CpG: 140	1567	140	1078	17.9	68.8	0.76
chr5	132865834	132866116	CpG: 23	282	23	174	16.3	61.7	0.87
chr5	132889371	132890173	CpG: 101	802	101	597	25.2	74.4	0.92
chr5	132930444	132931095	CpG: 84	651	84	489	25.8	75.1	0.91
chr5	133009928	133011021	CpG: 140	1093	140	811	25.6	74.2	0.93
chr5	133016427	133016966	CpG: 57	539	57	381	21.2	70.7	0.87
chr5	133033926	133034209	CpG: 21	283	21	168	14.8	59.4	0.84
chr5	133073467	133073706	CpG: 20	239	20	147	16.7	61.5	0.89
chr5	133076675	133077068	CpG: 43	393	43	278	21.9	70.7	0.88
chr5	133144910	133145188	CpG: 25	278	25	175	18.0	62.9	0.92
chr5	133175074	133175311	CpG: 18	237	18	142	15.2	59.9	0.87
chr5	133175663	133176413	CpG: 84	750	84	544	22.4	72.5	0.86
chr5	133256738	133257472	CpG: 74	734	74	515	20.2	70.2	0.84
chr5	133266918	133267956	CpG: 117	1038	117	761	22.5	73.3	0.84
chr5	133296495	133297668	CpG: 138	1173	138	868	23.5	74.0	0.86
chr5	133332900	133334964	CpG: 251	2064	251	1511	24.3	73.2	0.91
chr5	133339334	133339543	CpG: 19	209	19	128	18.2	61.2	0.97
chr5	133342155	133342391	CpG: 18	236	18	140	15.3	59.3	0.90
chr5	133342582	133343243	CpG: 64	661	64	465	19.4	70.3	0.78
chr5	133344944	133345849	CpG: 104	905	104	663	23.0	73.3	0.86
chr5	133349517	133350724	CpG: 148	1207	148	896	24.5	74.2	0.89
chr5	133385963	133386899	CpG: 73	936	73	610	15.6	65.2	0.73
chr5	133474320	133474594	CpG: 22	274	22	169	16.1	61.7	0.85
chr5	133482845	133483796	CpG: 102	951	102	702	21.5	73.8	0.79
chr5	133502712	133503561	CpG: 62	849	62	585	14.6	68.9	0.62
chr5	133507016	133507230	CpG: 15	214	15	124	14.0	57.9	0.84
chr5	133544984	133545195	CpG: 18	211	18	133	17.1	63.0	0.87
chr5	133545890	133546580	CpG: 60	690	60	450	17.4	65.2	0.84
chr5	133571150	133572654	CpG: 129	1504	129	940	17.2	62.5	0.88
chr5	133915005	133915234	CpG: 19	229	19	126	16.6	55.0	1.14
chr5	134033588	134033839	CpG: 18	251	18	147	14.3	58.6	0.85
chr5	134103024	134103449	CpG: 32	425	32	256	15.1	60.2	0.83
chr5	134134431	134136154	CpG: 205	1723	205	1256	23.8	72.9	0.90
chr5	134381204	134381931	CpG: 51	727	51	496	14.0	68.2	0.60
chr5	134491940	134492353	CpG: 36	413	36	278	17.4	67.3	0.79
chr5	134527544	134529453	CpG: 216	1909	216	1350	22.6	70.7	0.91
chr5	134557315	134557601	CpG: 20	286	20	171	14.0	59.8	0.79
chr5	134594743	134595085	CpG: 30	342	30	245	17.5	71.6	0.68
chr5	134618064	134618307	CpG: 20	243	20	145	16.5	59.7	0.94
chr5	134637258	134639198	CpG: 217	1940	217	1362	22.4	70.2	0.91
chr5	134691205	134691439	CpG: 16	234	16	138	13.7	59.0	0.81
chr5	134699900	134701049	CpG: 120	1149	120	774	20.9	67.4	0.92
chr5	134749098	134750502	CpG: 149	1404	149	969	21.2	69.0	0.89
chr5	134888851	134889057	CpG: 17	206	17	126	16.5	61.2	0.93
chr5	134890724	134891000	CpG: 26	276	26	173	18.8	62.7	0.98
chr5	134892125	134892360	CpG: 18	235	18	140	15.3	59.6	0.90
chr5	134894805	134895987	CpG: 100	1182	100	753	16.9	63.7	0.84
chr5	134928944	134929214	CpG: 22	270	22	165	16.3	61.1	0.88
chr5	134935494	134935927	CpG: 49	433	49	311	22.6	71.8	0.89
chr5	134991430	134991666	CpG: 25	236	25	171	21.2	72.5	0.81
chr5	135008088	135008346	CpG: 19	258	19	156	14.7	60.5	0.83
chr5	135008553	135009156	CpG: 41	603	41	362	13.6	60.0	0.76
chr5	135009354	135009604	CpG: 20	250	20	156	16.0	62.4	0.82
chr5	135049871	135053358	CpG: 292	3487	292	2329	16.7	66.8	0.75
chr5	135158142	135158650	CpG: 42	508	42	338	16.5	66.5	0.76
chr5	135158875	135159151	CpG: 19	276	19	161	13.8	58.3	0.81
chr5	135174104	135174927	CpG: 77	823	77	558	18.7	67.8	0.81
chr5	135238588	135238858	CpG: 20	270	20	165	14.8	61.1	0.80
chr5	135263686	135264431	CpG: 68	745	68	495	18.3	66.4	0.83
chr5	135284106	135284708	CpG: 66	602	66	403	21.9	66.9	0.99
chr5	135372746	135373513	CpG: 90	767	90	539	23.5	70.3	0.96
chr5	135401145	135401762	CpG: 74	617	74	448	24.0	72.6	0.91
chr5	135408724	135409697	CpG: 70	973	70	671	14.4	69.0	0.61
chr5	135430928	135431206	CpG: 22	278	22	169	15.8	60.8	0.87
chr5	135431504	135432586	CpG: 130	1082	130	780	24.0	72.1	0.93
chr5	135432851	135433502	CpG: 46	651	46	350	14.1	53.8	0.98
chr5	135554415	135556471	CpG: 193	2056	193	1367	18.8	66.5	0.85
chr5	135558238	135558763	CpG: 51	525	51	361	19.4	68.8	0.83
chr5	135559903	135561791	CpG: 215	1888	215	1346	22.8	71.3	0.90
chr5	135565710	135568076	CpG: 201	2366	201	1618	17.0	68.4	0.73
chr5	135577292	135577695	CpG: 43	403	43	289	21.3	71.7	0.84
chr5	135718298	135718790	CpG: 45	492	45	347	18.3	70.5	0.74
chr5	135854219	135854525	CpG: 31	306	31	208	20.3	68.0	0.89
chr5	135925578	135926743	CpG: 139	1165	139	853	23.9	73.2	0.90
chr5	135931753	135931994	CpG: 18	241	18	146	14.9	60.6	0.85
chr5	135935869	135936634	CpG: 62	765	62	525	16.2	68.6	0.69
chr5	136015909	136017973	CpG: 140	2064	140	1278	13.6	61.9	0.71
chr5	136018762	136019121	CpG: 34	359	34	247	18.9	68.8	0.80
chr5	136062172	136063497	CpG: 152	1325	152	935	22.9	70.6	0.93
chr5	136070718	136071920	CpG: 110	1202	110	757	18.3	63.0	0.92
chr5	136105631	136106434	CpG: 82	803	82	546	20.4	68.0	0.90
chr5	136357096	136357981	CpG: 70	885	70	571	15.8	64.5	0.76
chr5	136374980	136375321	CpG: 24	341	24	218	14.1	63.9	0.69
chr5	136452662	136453331	CpG: 92	669	92	510	27.5	76.2	0.95
chr5	136551316	136551845	CpG: 57	529	57	391	21.6	73.9	0.79
chr5	136601899	136602137	CpG: 19	238	19	148	16.0	62.2	0.85
chr5	136603034	136603305	CpG: 24	271	24	170	17.7	62.7	0.90
chr5	136655192	136656005	CpG: 99	813	99	585	24.4	72.0	0.94
chr5	136713898	136715820	CpG: 179	1922	179	1288	18.6	67.0	0.83
chr5	136879213	136879858	CpG: 56	645	56	408	17.4	63.3	0.87
chr5	136932983	136933261	CpG: 24	278	24	173	17.3	62.2	0.90
chr5	136989138	136989374	CpG: 18	236	18	140	15.3	59.3	0.88
chr5	137572892	137573319	CpG: 32	427	32	257	15.0	60.2	0.83
chr5	137842346	137842627	CpG: 23	281	23	174	16.4	61.9	0.87
chr5	138021030	138022155	CpG: 133	1125	133	818	23.6	72.7	0.89
chr5	138205822	138206248	CpG: 33	426	33	256	15.5	60.1	0.86
chr5	138279021	138281030	CpG: 208	2009	208	1334	20.7	66.4	0.96
chr5	138415733	138416224	CpG: 51	491	51	331	20.8	67.4	0.92
chr5	138532342	138532577	CpG: 19	235	19	140	16.2	59.6	0.93
chr5	138558783	138559664	CpG: 90	881	90	626	20.4	71.1	0.82
chr5	138592870	138593144	CpG: 25	274	25	172	18.2	62.8	0.94
chr5	138594033	138594281	CpG: 22	248	22	151	17.7	60.9	0.97
chr5	138607312	138607563	CpG: 18	251	18	153	14.3	61.0	0.79
chr5	138640312	138640541	CpG: 18	229	18	135	15.7	59.0	0.92
chr5	138641120	138641357	CpG: 18	237	18	143	15.2	60.3	0.85
chr5	138661103	138661331	CpG: 17	228	17	140	14.9	61.4	0.80
chr5	138705263	138705544	CpG: 22	281	22	163	15.7	58.0	0.94
chr5	138738610	138738865	CpG: 21	255	21	147	16.5	57.6	1.00
chr5	138740282	138740568	CpG: 22	286	22	173	15.4	60.5	0.85
chr5	138747227	138747496	CpG: 22	269	22	170	16.4	63.2	0.83
chr5	138768056	138768528	CpG: 54	472	54	328	22.9	69.5	0.97
chr5	138776127	138776400	CpG: 22	273	22	166	16.1	60.8	0.88
chr5	138783878	138784127	CpG: 26	249	26	182	20.9	73.1	0.80
chr5	138800448	138800940	CpG: 59	492	59	371	24.0	75.4	0.85
chr5	138822854	138823120	CpG: 19	266	19	162	14.3	60.9	0.79
chr5	138858032	138858567	CpG: 39	535	39	310	14.6	57.9	0.87
chr5	138863908	138864855	CpG: 77	947	77	644	16.3	68.0	0.70
chr5	138871588	138871801	CpG: 19	213	19	146	17.8	68.5	0.80
chr5	138878675	138879583	CpG: 110	908	110	698	24.2	76.9	0.83
chr5	138965106	138965569	CpG: 60	463	60	351	25.9	75.8	0.90
chr5	138976889	138977155	CpG: 21	266	21	161	15.8	60.5	0.87
chr5	138990154	138992792	CpG: 220	2638	220	1815	16.7	68.8	0.70
chr5	138993634	138993872	CpG: 22	238	22	157	18.5	66.0	0.99
chr5	139017940	139018742	CpG: 93	802	93	599	23.2	74.7	0.84
chr5	139068806	139069967	CpG: 106	1161	106	781	18.3	67.3	0.81
chr5	139101405	139102692	CpG: 110	1287	110	794	17.1	61.7	0.90
chr5	139105193	139105507	CpG: 26	314	26	177	16.6	56.4	1.06
chr5	139263175	139263453	CpG: 24	278	24	171	17.3	61.5	0.92
chr5	139279165	139280342	CpG: 144	1177	144	870	24.5	73.9	0.90
chr5	139302738	139303852	CpG: 90	1114	90	807	16.2	72.4	0.62
chr5	139311204	139311478	CpG: 23	274	23	168	16.8	61.3	0.90
chr5	139336942	139337936	CpG: 77	994	77	698	15.5	70.2	0.63
chr5	139349806	139350076	CpG: 23	270	23	168	17.0	62.2	0.89
chr5	139403581	139403862	CpG: 23	281	23	174	16.4	61.9	0.87
chr5	139428570	139428800	CpG: 17	230	17	138	14.8	60.0	0.83
chr5	139638085	139638858	CpG: 63	773	63	538	16.3	69.6	0.67
chr5	139724255	139724591	CpG: 43	336	43	260	25.6	77.4	0.88
chr5	139739558	139739832	CpG: 24	274	24	170	17.5	62.0	0.93
chr5	139750088	139750809	CpG: 51	721	51	486	14.1	67.4	0.62
chr5	139751174	139751430	CpG: 20	256	20	152	15.6	59.4	0.90
chr5	139757557	139757831	CpG: 24	274	24	171	17.5	62.4	0.91
chr5	139773098	139773339	CpG: 19	241	19	145	15.8	60.2	0.89
chr5	139776745	139777032	CpG: 23	287	23	172	16.0	59.9	0.91
chr5	139799706	139800237	CpG: 40	531	40	334	15.1	62.9	0.76
chr5	139818688	139818987	CpG: 23	299	23	175	15.4	58.5	0.91
chr5	139819560	139820706	CpG: 121	1146	121	737	21.1	64.3	1.03
chr5	139850972	139851286	CpG: 23	314	23	183	14.6	58.3	0.87
chr5	139867706	139868621	CpG: 87	915	87	582	19.0	63.6	0.95
chr5	139904218	139904744	CpG: 44	526	44	349	16.7	66.3	0.77
chr5	139918117	139921318	CpG: 318	3201	318	2247	19.9	70.2	0.81
chr5	139929606	139930026	CpG: 34	420	34	274	16.2	65.2	0.78
chr5	139963851	139964087	CpG: 21	236	21	146	17.8	61.9	0.95
chr5	139964900	139965340	CpG: 36	440	36	302	16.4	68.6	0.70
chr5	140042950	140043465	CpG: 48	515	48	359	18.6	69.7	0.77
chr5	140074298	140074857	CpG: 47	559	47	408	16.8	73.0	0.63
chr5	140086080	140087288	CpG: 133	1208	133	856	22.0	70.9	0.88
chr5	140162471	140163146	CpG: 66	675	66	486	19.6	72.0	0.76
chr5	140172921	140175698	CpG: 267	2777	267	1911	19.2	68.8	0.81
chr5	140186222	140186506	CpG: 23	284	23	192	16.2	67.6	0.73
chr5	140193384	140193714	CpG: 41	330	41	251	24.8	76.1	0.88
chr5	140202060	140202339	CpG: 25	279	25	191	17.9	68.5	0.77
chr5	140206038	140206417	CpG: 28	379	28	251	14.8	66.2	0.67
chr5	140222032	140222669	CpG: 54	637	54	456	17.0	71.6	0.66
chr5	140226490	140226691	CpG: 15	201	15	132	14.9	65.7	0.69
chr5	140234309	140236706	CpG: 208	2397	208	1606	17.4	67.0	0.78
chr5	140265499	140265709	CpG: 16	210	16	126	15.2	60.0	0.86
chr5	140271391	140273200	CpG: 128	1809	128	1185	14.2	65.5	0.66
chr5	140281075	140281462	CpG: 40	387	40	268	20.7	69.3	0.86
chr5	140284361	140284728	CpG: 31	367	31	236	16.9	64.3	0.83
chr5	140289304	140289710	CpG: 40	406	40	290	19.7	71.4	0.78
chr5	140290673	140291023	CpG: 35	350	35	248	20.0	70.9	0.80
chr5	140312672	140313525	CpG: 68	853	68	562	15.9	65.9	0.73
chr5	140320407	140321676	CpG: 129	1269	129	938	20.3	73.9	0.75
chr5	140372987	140373848	CpG: 139	861	139	668	32.3	77.6	1.08
chr5	140428871	140429803	CpG: 107	932	107	690	23.0	74.0	0.84
chr5	140549379	140549654	CpG: 20	275	20	167	14.5	60.7	0.80
chr5	140567594	140568668	CpG: 101	1074	101	748	18.8	69.6	0.78
chr5	140599499	140599777	CpG: 20	278	20	162	14.4	58.3	0.86
chr5	140632442	140633375	CpG: 110	933	110	674	23.6	72.2	0.90
chr5	140638234	140638477	CpG: 21	243	21	176	17.3	72.4	0.67
chr5	140638886	140640052	CpG: 129	1166	129	827	22.1	70.9	0.89
chr5	140670946	140671735	CpG: 77	789	77	564	19.5	71.5	0.76
chr5	140682658	140682918	CpG: 20	260	20	178	15.4	68.5	0.66
chr5	140699901	140700969	CpG: 109	1068	109	747	20.4	69.9	0.85
chr5	140701931	140702153	CpG: 18	222	18	134	16.2	60.4	0.91
chr5	140713597	140713829	CpG: 20	232	20	142	17.2	61.2	0.94
chr5	140740657	140740938	CpG: 24	281	24	175	17.1	62.3	0.90
chr5	140871377	140872293	CpG: 101	916	101	661	22.1	72.2	0.85
chr5	140888747	140888996	CpG: 21	249	21	172	16.9	69.1	0.71
chr5	140926079	140927957	CpG: 164	1878	164	1191	17.5	63.4	0.87
chr5	141058751	141059018	CpG: 19	267	19	159	14.2	59.6	0.81
chr5	141073002	141073336	CpG: 36	334	36	227	21.6	68.0	0.93
chr5	141082623	141083039	CpG: 42	416	42	285	20.2	68.5	0.86
chr5	141089681	141090323	CpG: 69	642	69	438	21.5	68.2	0.93
chr5	141118733	141119220	CpG: 31	487	31	278	12.7	57.1	0.79
chr5	141137783	141138013	CpG: 21	230	21	143	18.3	62.2	0.96
chr5	141157305	141158562	CpG: 96	1257	96	787	15.3	62.6	0.78
chr5	141164701	141165324	CpG: 59	623	59	439	18.9	70.5	0.76
chr5	141172647	141173325	CpG: 59	678	59	412	17.4	60.8	0.95
chr5	141190005	141190544	CpG: 47	539	47	355	17.4	65.9	0.80
chr5	141197871	141199149	CpG: 108	1278	108	846	16.9	66.2	0.77
chr5	141216606	141217130	CpG: 45	524	45	343	17.2	65.5	0.82
chr5	141226039	141226283	CpG: 19	244	19	135	15.6	55.3	1.02
chr5	141244536	141244776	CpG: 19	240	19	145	15.8	60.4	0.89
chr5	141245381	141245601	CpG: 17	220	17	131	15.5	59.5	0.90
chr5	141311706	141311962	CpG: 20	256	20	156	15.6	60.9	0.85
chr5	141312839	141313887	CpG: 120	1048	120	702	22.9	67.0	1.04
chr5	141320321	141320636	CpG: 28	315	28	206	17.8	65.4	0.85
chr5	141321414	141322561	CpG: 125	1147	125	754	21.8	65.7	1.02
chr5	141326592	141326830	CpG: 21	238	21	153	17.6	64.3	0.88
chr5	141327636	141328762	CpG: 121	1126	121	747	21.5	66.3	0.99
chr5	141332540	141333016	CpG: 40	476	40	295	16.8	62.0	0.88
chr5	141333762	141334734	CpG: 111	972	111	648	22.8	66.7	1.04
chr5	141347189	141347406	CpG: 21	217	21	140	19.4	64.5	0.95
chr5	141348322	141349359	CpG: 118	1037	118	704	22.8	67.9	1.00
chr5	141353474	141353827	CpG: 29	353	29	223	16.4	63.2	0.83
chr5	141354502	141355706	CpG: 136	1204	136	793	22.6	65.9	1.05
chr5	141359817	141360213	CpG: 35	396	35	238	17.7	60.1	1.01
chr5	141360949	141361908	CpG: 110	959	110	636	22.9	66.3	1.06
chr5	141366749	141367123	CpG: 31	374	31	226	16.6	60.4	0.93
chr5	141367864	141368850	CpG: 114	986	114	660	23.1	66.9	1.05
chr5	141373921	141374316	CpG: 35	395	35	238	17.7	60.3	0.99
chr5	141375062	141376122	CpG: 129	1060	129	714	24.3	67.4	1.10
chr5	141381477	141381773	CpG: 23	296	23	182	15.5	61.5	0.85
chr5	141382602	141383631	CpG: 118	1029	118	693	22.9	67.3	1.03
chr5	141387813	141388747	CpG: 88	934	88	598	18.8	64.0	0.94
chr5	141394529	141394880	CpG: 29	351	29	209	16.5	59.5	0.96
chr5	141395474	141396689	CpG: 138	1215	138	801	22.7	65.9	1.05
chr5	141400898	141401190	CpG: 26	292	26	179	17.8	61.3	0.98
chr5	141402013	141403030	CpG: 127	1017	127	691	25.0	67.9	1.09
chr5	141407624	141407893	CpG: 23	269	23	169	17.1	62.8	0.88
chr5	141408825	141409894	CpG: 136	1069	136	728	25.4	68.1	1.12
chr5	141451426	141452907	CpG: 134	1481	134	957	18.1	64.6	0.87
chr5	141462364	141462638	CpG: 21	274	21	168	15.3	61.3	0.82
chr5	141491813	141492639	CpG: 80	826	80	569	19.4	68.9	0.82
chr5	141530755	141530984	CpG: 18	229	18	136	15.7	59.4	0.90
chr5	141601593	141601874	CpG: 24	281	24	175	17.1	62.3	0.89
chr5	141603627	141603863	CpG: 18	236	18	144	15.3	61.0	0.84
chr5	141621333	141622341	CpG: 103	1008	103	692	20.4	68.7	0.87
chr5	141627280	141628194	CpG: 88	914	88	625	19.3	68.4	0.83
chr5	141629363	141629637	CpG: 23	274	23	170	16.8	62.0	0.88
chr5	141642590	141642865	CpG: 21	275	21	167	15.3	60.7	0.84
chr5	141648626	141649540	CpG: 90	914	90	628	19.7	68.7	0.84
chr5	141662047	141663036	CpG: 95	989	95	674	19.2	68.1	0.83
chr5	141676895	141677755	CpG: 86	860	86	586	20.0	68.1	0.87
chr5	141682635	141683505	CpG: 86	870	86	594	19.8	68.3	0.85
chr5	141699421	141700377	CpG: 91	956	91	651	19.0	68.1	0.83
chr5	141704671	141705529	CpG: 82	858	82	587	19.1	68.4	0.82
chr5	141709250	141710101	CpG: 85	851	85	591	20.0	69.4	0.83
chr5	141713957	141714859	CpG: 84	902	84	619	18.6	68.6	0.79
chr5	141719164	141720057	CpG: 91	893	91	618	20.4	69.2	0.86
chr5	141726464	141727366	CpG: 86	902	86	617	19.1	68.4	0.82
chr5	141735485	141736398	CpG: 90	913	90	624	19.7	68.3	0.85
chr5	141740749	141741621	CpG: 85	872	85	594	19.5	68.1	0.84
chr5	141750192	141751043	CpG: 87	851	87	592	20.4	69.6	0.85
chr5	141761133	141762092	CpG: 92	959	92	648	19.2	67.6	0.84
chr5	141766607	141767433	CpG: 75	826	75	556	18.2	67.3	0.80
chr5	141772182	141773111	CpG: 90	929	90	632	19.4	68.0	0.84
chr5	141828927	141829739	CpG: 70	812	70	520	17.2	64.0	0.84
chr5	141845634	141846231	CpG: 54	597	54	356	18.1	59.6	1.02
chr5	141857535	141858280	CpG: 70	745	70	495	18.8	66.4	0.85
chr5	141858692	141858988	CpG: 25	296	25	185	16.9	62.5	0.88
chr5	141865208	141865422	CpG: 19	214	19	128	17.8	59.8	0.99
chr5	141866217	141866908	CpG: 59	691	59	457	17.1	66.1	0.78
chr5	141869626	141869978	CpG: 30	352	30	207	17.0	58.8	1.00
chr5	141871129	141871969	CpG: 78	840	78	552	18.6	65.7	0.87
chr5	141877296	141878036	CpG: 72	740	72	495	19.5	66.9	0.87
chr5	141880777	141881085	CpG: 27	308	27	200	17.5	64.9	0.83
chr5	141882878	141883115	CpG: 18	237	18	149	15.2	62.9	0.77
chr5	141887231	141887796	CpG: 65	565	65	383	23.0	67.8	1.00
chr5	141890018	141890699	CpG: 49	681	49	380	14.4	55.8	0.93
chr5	141891588	141891950	CpG: 30	362	30	235	16.6	64.9	0.79
chr5	141896111	141896325	CpG: 16	214	16	118	15.0	55.1	1.02
chr5	141897359	141897944	CpG: 58	585	58	385	19.8	65.8	0.92
chr5	141899715	141900013	CpG: 27	298	27	192	18.1	64.4	0.88
chr5	141901315	141902634	CpG: 94	1319	94	783	14.3	59.4	0.81
chr5	141908477	141908844	CpG: 28	367	28	232	15.3	63.2	0.77
chr5	141910377	141910756	CpG: 28	379	28	246	14.8	64.9	0.70
chr5	141913273	141913772	CpG: 35	499	35	296	14.0	59.3	0.80
chr5	141915016	141915560	CpG: 64	544	64	368	23.5	67.6	1.03
chr5	141918458	141918755	CpG: 27	297	27	189	18.2	63.6	0.90
chr5	141919928	141920514	CpG: 50	586	50	381	17.1	65.0	0.81
chr5	141923511	141924007	CpG: 35	496	35	296	14.1	59.7	0.79
chr5	141925082	141925728	CpG: 66	646	66	424	20.4	65.6	0.95
chr5	141933719	141934316	CpG: 51	597	51	374	17.1	62.6	0.87
chr5	141935366	141936034	CpG: 70	668	70	438	21.0	65.6	0.98
chr5	141940633	141941320	CpG: 62	687	62	456	18.0	66.4	0.82
chr5	141943429	141943968	CpG: 46	539	46	338	17.1	62.7	0.87
chr5	141945024	141945626	CpG: 67	602	67	403	22.3	66.9	0.99
chr5	141947027	141947339	CpG: 29	312	29	196	18.6	62.8	0.96
chr5	141948666	141949099	CpG: 39	433	39	292	18.0	67.4	0.79
chr5	141953608	141954057	CpG: 49	449	49	300	21.8	66.8	0.98
chr5	141956760	141958883	CpG: 155	2123	155	1225	14.6	57.7	0.88
chr5	141967459	141967919	CpG: 47	460	47	302	20.4	65.7	0.95
chr5	142001626	142002860	CpG: 95	1234	95	727	15.4	58.9	0.89
chr5	142004104	142004305	CpG: 19	201	19	134	18.9	66.7	0.86
chr5	142010931	142011152	CpG: 22	221	22	142	19.9	64.3	0.98
chr5	142017468	142018739	CpG: 122	1271	122	863	19.2	67.9	0.84
chr5	142038678	142039606	CpG: 65	928	65	532	14.0	57.3	0.86
chr5	142099144	142099417	CpG: 25	273	25	168	18.3	61.5	0.97
chr5	142144515	142145313	CpG: 92	798	92	585	23.1	73.3	0.86
chr5	142162759	142164124	CpG: 128	1365	128	951	18.8	69.7	0.77
chr5	142177366	142177625	CpG: 31	259	31	190	23.9	73.4	0.89
chr5	142186242	142186518	CpG: 21	276	21	168	15.2	60.9	0.83
chr5	142207876	142208474	CpG: 64	598	64	450	21.4	75.3	0.76
chr5	142218089	142218432	CpG: 25	343	25	224	14.6	65.3	0.69
chr5	142228319	142229058	CpG: 57	739	57	498	15.4	67.4	0.69
chr5	142279281	142279807	CpG: 41	526	41	351	15.6	66.7	0.70
chr5	142375318	142376738	CpG: 117	1420	117	923	16.5	65.0	0.78
chr5	142379956	142380284	CpG: 24	328	24	226	14.6	68.9	0.67
chr5	142399314	142399527	CpG: 16	213	16	135	15.0	63.4	0.75
chr5	142401929	142404488	CpG: 213	2559	213	1699	16.6	66.4	0.76
chr5	142404747	142405141	CpG: 30	394	30	259	15.2	65.7	0.70
chr5	142409313	142409520	CpG: 20	207	20	143	19.3	69.1	0.82
chr5	142440180	142440580	CpG: 38	400	38	284	19.0	71.0	0.75
chr5	142449517	142450032	CpG: 49	515	49	350	19.0	68.0	0.84
chr5	142494924	142495497	CpG: 60	573	60	409	20.9	71.4	0.84
chr5	142542999	142543333	CpG: 48	334	48	255	28.7	76.3	1.00
chr5	142556689	142556931	CpG: 22	242	22	144	18.2	59.5	1.04
chr5	142581406	142581680	CpG: 25	274	25	172	18.2	62.8	0.94
chr5	142639105	142639872	CpG: 99	767	99	568	25.8	74.1	0.94
chr5	142693919	142694177	CpG: 21	258	21	158	16.3	61.2	0.89
chr5	142854795	142856069	CpG: 105	1274	105	817	16.5	64.1	0.81
chr5	142856437	142856734	CpG: 24	297	24	207	16.2	69.7	0.68
chr5	142887606	142888394	CpG: 87	788	87	560	22.1	71.1	0.87
chr5	142910055	142910336	CpG: 22	281	22	174	15.7	61.9	0.84
chr5	143020198	143020432	CpG: 19	234	19	140	16.2	59.8	0.94
chr5	143165145	143165392	CpG: 19	247	19	142	15.4	57.5	0.97
chr5	143220970	143221545	CpG: 42	575	42	339	14.6	59.0	0.84
chr5	143301342	143302575	CpG: 150	1233	150	877	24.3	71.1	0.97
chr5	143933824	143936825	CpG: 308	3001	308	2017	20.5	67.2	0.91
chr5	144087157	144087431	CpG: 24	274	24	171	17.5	62.4	0.91
chr5	144152639	144152913	CpG: 26	274	26	173	19.0	63.1	0.96
chr5	144162591	144162869	CpG: 25	278	25	175	18.0	62.9	0.92
chr5	144442013	144442256	CpG: 18	243	18	147	14.8	60.5	0.82
chr5	144702564	144702958	CpG: 30	394	30	249	15.2	63.2	0.77
chr5	144708606	144708887	CpG: 24	281	24	174	17.1	61.9	0.91
chr5	144737368	144737689	CpG: 29	321	29	209	18.1	65.1	0.88
chr5	144920327	144920565	CpG: 19	238	19	141	16.0	59.2	0.93
chr5	145075412	145075686	CpG: 23	274	23	170	16.8	62.0	0.89
chr5	145127135	145127350	CpG: 18	215	18	154	16.7	71.6	0.67
chr5	145130784	145131039	CpG: 21	255	21	165	16.5	64.7	0.79
chr5	145152599	145152879	CpG: 24	280	24	175	17.1	62.5	0.89
chr5	145275605	145275886	CpG: 24	281	24	174	17.1	61.9	0.91
chr5	145337044	145337248	CpG: 16	204	16	117	15.7	57.4	0.96
chr5	145752554	145752828	CpG: 24	274	24	170	17.5	62.0	0.92
chr5	145959692	145959924	CpG: 19	232	19	138	16.4	59.5	0.93
chr5	146149783	146150060	CpG: 21	277	21	174	15.2	62.8	0.78
chr5	146174620	146175021	CpG: 36	401	36	247	18.0	61.6	0.97
chr5	146369409	146369899	CpG: 54	490	54	344	22.0	70.2	0.89
chr5	146470966	146471175	CpG: 17	209	17	137	16.3	65.6	0.77
chr5	146620339	146620617	CpG: 25	278	25	174	18.0	62.6	0.92
chr5	146701839	146702139	CpG: 24	300	24	178	16.0	59.3	0.92
chr5	146718996	146719231	CpG: 19	235	19	140	16.2	59.6	0.93
chr5	146739256	146739548	CpG: 29	292	29	214	19.9	73.3	0.82
chr5	146740564	146740793	CpG: 18	229	18	138	15.7	60.3	0.87
chr5	146795280	146795667	CpG: 29	387	29	222	15.0	57.4	0.93
chr5	146869648	146869920	CpG: 22	272	22	175	16.2	64.3	0.78
chr5	146874291	146876097	CpG: 143	1806	143	1116	15.8	61.8	0.83
chr5	146878469	146878927	CpG: 34	458	34	257	14.8	56.1	0.94
chr5	146880296	146880553	CpG: 19	257	19	159	14.8	61.9	0.77
chr5	146881288	146881854	CpG: 70	566	70	402	24.7	71.0	0.99
chr5	146914830	146915143	CpG: 24	313	24	208	15.3	66.5	0.70
chr5	146982885	146983739	CpG: 75	854	75	542	17.6	63.5	0.87
chr5	147145395	147145822	CpG: 32	427	32	256	15.0	60.0	0.84
chr5	147232026	147232297	CpG: 18	271	18	162	13.3	59.8	0.75
chr5	147413789	147415033	CpG: 97	1244	97	833	15.6	67.0	0.69
chr5	147770428	147771050	CpG: 51	622	51	427	16.4	68.6	0.72
chr5	147777170	147777433	CpG: 20	263	20	163	15.2	62.0	0.80
chr5	147891175	147891457	CpG: 22	282	22	170	15.6	60.3	0.87
chr5	147938147	147938421	CpG: 24	274	24	172	17.5	62.8	0.90
chr5	147988770	147990148	CpG: 121	1378	121	905	17.6	65.7	0.82
chr5	148013366	148013647	CpG: 24	281	24	175	17.1	62.3	0.90
chr5	148044966	148046056	CpG: 108	1090	108	744	19.8	68.3	0.85
chr5	148211761	148212038	CpG: 22	277	22	172	15.9	62.1	0.84
chr5	148257189	148257548	CpG: 30	359	30	215	16.7	59.9	0.93
chr5	148474425	148474701	CpG: 24	276	24	174	17.4	63.0	0.88
chr5	148482482	148482729	CpG: 20	247	20	148	16.2	59.9	0.91
chr5	148618334	148618607	CpG: 22	273	22	172	16.1	63.0	0.82
chr5	148664269	148664522	CpG: 21	253	21	155	16.6	61.3	0.90
chr5	148695245	148695519	CpG: 24	274	24	172	17.5	62.8	0.90
chr5	148747741	148747958	CpG: 16	217	16	128	14.7	59.0	0.87
chr5	148829486	148829744	CpG: 19	258	19	148	14.7	57.4	0.92
chr5	148854647	148854935	CpG: 22	288	22	172	15.3	59.7	0.87
chr5	148918242	148918625	CpG: 33	383	33	240	17.2	62.7	0.88
chr5	149188408	149189016	CpG: 67	608	67	471	22.0	77.5	0.75
chr5	149347397	149347670	CpG: 22	273	22	171	16.1	62.6	0.84
chr5	149361345	149361752	CpG: 42	407	42	278	20.6	68.3	0.89
chr5	149477259	149477483	CpG: 20	224	20	133	17.9	59.4	1.01
chr5	149676336	149676811	CpG: 47	475	47	334	19.8	70.3	0.80
chr5	149708637	149708877	CpG: 22	240	22	145	18.3	60.4	1.03
chr5	149806176	149807028	CpG: 102	852	102	618	23.9	72.5	0.94
chr5	149880113	149880611	CpG: 45	498	45	318	18.1	63.9	0.90
chr5	149881620	149881836	CpG: 19	216	19	133	17.6	61.6	0.96
chr5	149892598	149893016	CpG: 52	418	52	308	24.9	73.7	0.93
chr5	150085432	150086427	CpG: 93	995	93	642	18.7	64.5	0.90
chr5	150087302	150087532	CpG: 16	230	16	130	13.9	56.5	0.88
chr5	150097210	150097482	CpG: 21	272	21	167	15.4	61.4	0.83
chr5	150115970	150116376	CpG: 49	406	49	294	24.1	72.4	0.92
chr5	150266397	150268743	CpG: 239	2346	239	1654	20.4	70.5	0.83
chr5	150490885	150491122	CpG: 17	237	17	143	14.3	60.3	0.80
chr5	150496915	150497935	CpG: 102	1020	102	679	20.0	66.6	0.90
chr5	150536947	150537785	CpG: 98	838	98	600	23.4	71.6	0.91
chr5	150669340	150669570	CpG: 20	230	20	149	17.4	64.8	0.83
chr5	150703068	150704264	CpG: 124	1196	124	871	20.7	72.8	0.79
chr5	150726544	150726989	CpG: 52	445	52	324	23.4	72.8	0.89
chr5	150728060	150728290	CpG: 16	230	16	136	13.9	59.1	0.80
chr5	150833954	150834727	CpG: 48	773	48	483	12.4	62.5	0.64
chr5	150838678	150839577	CpG: 79	899	79	631	17.6	70.2	0.71
chr5	150894010	150894808	CpG: 88	798	88	560	22.1	70.2	0.90
chr5	150903211	150903492	CpG: 24	281	24	174	17.1	61.9	0.91
chr5	150985840	150986602	CpG: 66	762	66	473	17.3	62.1	0.90
chr5	150994914	150995149	CpG: 17	235	17	139	14.5	59.1	0.84
chr5	151022043	151023482	CpG: 164	1439	164	1076	22.8	74.8	0.82
chr5	151064447	151064669	CpG: 20	222	20	146	18.0	65.8	0.83
chr5	151109262	151109536	CpG: 22	274	22	168	16.1	61.3	0.87
chr5	151161110	151161950	CpG: 84	840	84	627	20.0	74.6	0.73
chr5	151185899	151186411	CpG: 33	512	33	334	12.9	65.2	0.61
chr5	151192924	151193585	CpG: 86	661	86	507	26.0	76.7	0.92
chr5	151208065	151209089	CpG: 78	1024	78	705	15.2	68.8	0.64
chr5	151237078	151237650	CpG: 52	572	52	381	18.2	66.6	0.82
chr5	151264005	151264279	CpG: 26	274	26	171	19.0	62.4	0.99
chr5	151295320	151295663	CpG: 36	343	36	212	21.0	61.8	1.12
chr5	151315080	151315607	CpG: 45	527	45	361	17.1	68.5	0.73
chr5	151315734	151315965	CpG: 16	231	16	156	13.9	67.5	0.61
chr5	151441321	151441571	CpG: 23	250	23	161	18.4	64.4	0.89
chr5	151465645	151465920	CpG: 23	275	23	170	16.7	61.8	0.89
chr5	151482811	151483101	CpG: 25	290	25	172	17.2	59.3	0.98
chr5	151556918	151557408	CpG: 43	490	43	342	17.6	69.8	0.72
chr5	151617011	151617834	CpG: 94	823	94	614	22.8	74.6	0.83
chr5	151693927	151694326	CpG: 48	399	48	289	24.1	72.4	0.93
chr5	151762600	151763140	CpG: 53	540	53	377	19.6	69.8	0.81
chr5	151791301	151792047	CpG: 63	746	63	461	16.9	61.8	0.90
chr5	151848137	151848531	CpG: 38	394	38	292	19.3	74.1	0.70
chr5	151849119	151849432	CpG: 23	313	23	185	14.7	59.1	0.86
chr5	151897659	151897945	CpG: 25	286	25	179	17.5	62.6	0.91
chr5	151916340	151916613	CpG: 24	273	24	168	17.6	61.5	0.94
chr5	151986519	151986917	CpG: 38	398	38	278	19.1	69.8	0.79
chr5	152070591	152070940	CpG: 29	349	29	234	16.6	67.0	0.74
chr5	152252953	152253738	CpG: 63	785	63	541	16.1	68.9	0.68
chr5	152297403	152297829	CpG: 47	426	47	303	22.1	71.1	0.87
chr5	152309433	152311770	CpG: 210	2337	210	1498	18.0	64.1	0.87
chr5	152463985	152464277	CpG: 21	292	21	175	14.4	59.9	0.81
chr5	152504366	152504604	CpG: 19	238	19	142	16.0	59.7	0.91
chr5	152558724	152559000	CpG: 19	276	19	162	13.8	58.7	0.81
chr5	152740417	152740659	CpG: 18	242	18	144	14.9	59.5	0.84
chr5	152856557	152856831	CpG: 23	274	23	171	16.8	62.4	0.87
chr5	152878692	152878968	CpG: 24	276	24	165	17.4	59.8	0.98
chr5	152914365	152914639	CpG: 24	274	24	171	17.5	62.4	0.91
chr5	152973882	152974126	CpG: 19	244	19	146	15.6	59.8	0.89
chr5	153012686	153013278	CpG: 52	592	52	437	17.6	73.8	0.64
chr5	153086208	153086492	CpG: 24	284	24	174	16.9	61.3	0.91
chr5	153262512	153262786	CpG: 23	274	23	170	16.8	62.0	0.88
chr5	153276858	153277132	CpG: 23	274	23	170	16.8	62.0	0.88
chr5	153343648	153343937	CpG: 22	289	22	174	15.2	60.2	0.86
chr5	153349173	153349447	CpG: 25	274	25	172	18.2	62.8	0.93
chr5	153425214	153425497	CpG: 22	283	22	170	15.5	60.1	0.86
chr5	153531638	153531916	CpG: 24	278	24	172	17.3	61.9	0.91
chr5	153551843	153552128	CpG: 24	285	24	177	16.8	62.1	0.89
chr5	153609777	153610204	CpG: 32	427	32	258	15.0	60.4	0.82
chr5	153783921	153784195	CpG: 24	274	24	167	17.5	60.9	0.96
chr5	153976816	153977090	CpG: 23	274	23	169	16.8	61.7	0.89
chr5	154133286	154133552	CpG: 21	266	21	159	15.8	59.8	0.90
chr5	154464410	154464675	CpG: 20	265	20	161	15.1	60.8	0.83
chr5	154482614	154482890	CpG: 21	276	21	167	15.2	60.5	0.84
chr5	154571758	154572244	CpG: 50	486	50	312	20.6	64.2	1.00
chr5	154722583	154724036	CpG: 159	1453	159	1032	21.9	71.0	0.87
chr5	154939022	154939511	CpG: 34	489	34	315	13.9	64.4	0.67
chr5	154979804	154980913	CpG: 136	1109	136	840	24.5	75.7	0.86
chr5	155007455	155007950	CpG: 38	495	38	309	15.4	62.4	0.79
chr5	155009589	155010527	CpG: 66	938	66	565	14.1	60.2	0.78
chr5	155011437	155013512	CpG: 154	2075	154	1326	14.8	63.9	0.73
chr5	155016541	155016850	CpG: 32	309	32	189	20.7	61.2	1.13
chr5	155027409	155027619	CpG: 19	210	19	147	18.1	70.0	0.75
chr5	155055435	155055670	CpG: 19	235	19	137	16.2	58.3	0.97
chr5	155090170	155090455	CpG: 24	285	24	179	16.8	62.8	0.87
chr5	155095632	155095853	CpG: 19	221	19	134	17.2	60.6	0.95
chr5	155144372	155145013	CpG: 49	641	49	430	15.3	67.1	0.69
chr5	155165288	155165597	CpG: 29	309	29	214	18.8	69.3	0.79
chr5	155180822	155181683	CpG: 57	861	57	524	13.2	60.9	0.72
chr5	155216401	155217154	CpG: 56	753	56	529	14.9	70.3	0.63
chr5	155224559	155226066	CpG: 104	1507	104	915	13.8	60.7	0.75
chr5	155278622	155278900	CpG: 25	278	25	175	18.0	62.9	0.92
chr5	155288542	155291413	CpG: 304	2871	304	2033	21.2	70.8	0.85
chr5	155390233	155390471	CpG: 18	238	18	145	15.1	60.9	0.85
chr5	155391410	155392764	CpG: 128	1354	128	881	18.9	65.1	0.90
chr5	155471786	155472268	CpG: 55	482	55	338	22.8	70.1	0.93
chr5	155648648	155648895	CpG: 22	247	22	182	17.8	73.7	0.66
chr5	155800821	155801096	CpG: 24	275	24	171	17.5	62.2	0.91
chr5	156105142	156105422	CpG: 24	280	24	174	17.1	62.1	0.91
chr5	156119760	156119967	CpG: 15	207	15	118	14.5	57.0	0.91
chr5	156261796	156263226	CpG: 141	1430	141	980	19.7	68.5	0.84
chr5	156586214	156586640	CpG: 33	426	33	256	15.5	60.1	0.86
chr5	156931651	156931938	CpG: 23	287	23	177	16.0	61.7	0.86
chr5	157290303	157290568	CpG: 20	265	20	163	15.1	61.5	0.81
chr5	157369308	157369691	CpG: 45	383	45	261	23.5	68.1	1.01
chr5	157459001	157459839	CpG: 62	838	62	568	14.8	67.8	0.65
chr5	157660085	157660319	CpG: 19	234	19	137	16.2	58.5	0.97
chr5	157661460	157661999	CpG: 42	539	42	328	15.6	60.9	0.87
chr5	157784733	157785670	CpG: 113	937	113	714	24.1	76.2	0.83
chr5	157927129	157927407	CpG: 25	278	25	175	18.0	62.9	0.92
chr5	157978981	157979452	CpG: 50	471	50	352	21.2	74.7	0.77
chr5	158079021	158079295	CpG: 24	274	24	170	17.5	62.0	0.92
chr5	158093493	158095207	CpG: 137	1714	137	1157	16.0	67.5	0.70
chr5	158170350	158171587	CpG: 104	1237	104	810	16.8	65.5	0.79
chr5	158190280	158191058	CpG: 81	778	81	518	20.8	66.6	0.98
chr5	158209167	158210397	CpG: 103	1230	103	795	16.7	64.6	0.81
chr5	158211112	158211386	CpG: 22	274	22	171	16.1	62.4	0.83
chr5	158250382	158250860	CpG: 40	478	40	288	16.7	60.3	0.93
chr5	158262504	158263320	CpG: 112	816	112	612	27.5	75.0	0.98
chr5	158380932	158381417	CpG: 54	485	54	348	22.3	71.8	0.88
chr5	158731000	158731234	CpG: 18	234	18	143	15.4	61.1	0.84
chr5	159050433	159050669	CpG: 19	236	19	143	16.1	60.6	0.90
chr5	159266244	159266519	CpG: 24	275	24	165	17.5	60.0	0.98
chr5	159369609	159369879	CpG: 23	270	23	167	17.0	61.9	0.90
chr5	159453436	159453673	CpG: 20	237	20	140	16.9	59.1	0.99
chr5	159580171	159580423	CpG: 30	252	30	180	23.8	71.4	1.00
chr5	159625258	159625520	CpG: 18	262	18	165	13.7	63.0	0.70
chr5	159625700	159626774	CpG: 75	1074	75	649	14.0	60.4	0.77
chr5	159627927	159628219	CpG: 43	292	43	226	29.5	77.4	1.01
chr5	159629160	159629769	CpG: 60	609	60	413	19.7	67.8	0.87
chr5	159633160	159633432	CpG: 27	272	27	186	19.9	68.4	0.86
chr5	159634078	159634286	CpG: 20	208	20	133	19.2	63.9	0.95
chr5	159635351	159635794	CpG: 34	443	34	259	15.3	58.5	0.90
chr5	159647554	159648080	CpG: 44	526	44	348	16.7	66.2	0.76
chr5	159691252	159691537	CpG: 24	285	24	177	16.8	62.1	0.89
chr5	159736630	159736837	CpG: 22	207	22	130	21.3	62.8	1.08
chr5	159737591	159738403	CpG: 109	812	109	594	26.8	73.2	1.00
chr5	159791494	159792022	CpG: 51	528	51	339	19.3	64.2	0.94
chr5	159859962	159860327	CpG: 37	365	37	253	20.3	69.3	0.86
chr5	160176654	160176924	CpG: 22	270	22	164	16.3	60.7	0.90
chr5	160262353	160262638	CpG: 24	285	24	179	16.8	62.8	0.87
chr5	160301622	160302077	CpG: 62	455	62	335	27.3	73.6	1.01
chr5	160444774	160445431	CpG: 76	657	76	488	23.1	74.3	0.84
chr5	160500570	160501494	CpG: 115	924	115	668	24.9	72.3	0.96
chr5	160515612	160516146	CpG: 47	534	47	340	17.6	63.7	0.87
chr5	160610722	160610996	CpG: 23	274	23	170	16.8	62.0	0.88
chr5	160647185	160648113	CpG: 112	928	112	685	24.1	73.8	0.89
chr5	160722449	160722849	CpG: 39	400	39	297	19.5	74.2	0.71
chr5	160840332	160841464	CpG: 123	1132	123	797	21.7	70.4	0.89
chr5	160898876	160899185	CpG: 38	309	38	226	24.6	73.1	0.95
chr5	160928290	160928593	CpG: 27	303	27	206	17.8	68.0	0.78
chr5	160947501	160947765	CpG: 26	264	26	158	19.7	59.8	1.12
chr5	160950282	160950622	CpG: 32	340	32	227	18.8	66.8	0.87
chr5	161244030	161244457	CpG: 31	427	31	254	14.5	59.5	0.82
chr5	161254349	161254585	CpG: 17	236	17	141	14.4	59.7	0.82
chr5	161284372	161284646	CpG: 25	274	25	170	18.2	62.0	0.95
chr5	161447827	161448100	CpG: 22	273	22	166	16.1	60.8	0.88
chr5	161524398	161524615	CpG: 17	217	17	131	15.7	60.4	0.87
chr5	161533210	161533485	CpG: 22	275	22	168	16.0	61.1	0.87
chr5	161695232	161695507	CpG: 24	275	24	198	17.5	72.0	0.67
chr5	161744946	161745221	CpG: 24	275	24	171	17.5	62.2	0.91
chr5	161860702	161860953	CpG: 20	251	20	152	15.9	60.6	0.88
chr5	162076531	162077824	CpG: 102	1293	102	834	15.8	64.5	0.76
chr5	162220187	162220466	CpG: 22	279	22	171	15.8	61.3	0.84
chr5	162565427	162565669	CpG: 21	242	21	144	17.4	59.5	0.98
chr5	163069509	163069771	CpG: 19	262	19	150	14.5	57.3	0.89
chr5	163275346	163275620	CpG: 24	274	24	171	17.5	62.4	0.91
chr5	163433504	163433770	CpG: 20	266	20	164	15.0	61.7	0.81
chr5	163543347	163543622	CpG: 25	275	25	172	18.2	62.5	0.94
chr5	163756053	163756328	CpG: 25	275	25	169	18.2	61.5	0.97
chr5	163857362	163857637	CpG: 20	275	20	167	14.5	60.7	0.80
chr5	163879315	163879586	CpG: 24	271	24	166	17.7	61.3	0.96
chr5	163972546	163973169	CpG: 49	623	49	403	15.7	64.7	0.75
chr5	163994950	163995413	CpG: 49	463	49	308	21.2	66.5	0.96
chr5	163996688	163996917	CpG: 22	229	22	142	19.2	62.0	1.02
chr5	164036856	164037170	CpG: 25	314	25	185	15.9	58.9	0.93
chr5	164040613	164041105	CpG: 58	492	58	351	23.6	71.3	0.97
chr5	164059095	164059369	CpG: 25	274	25	173	18.2	63.1	0.93
chr5	164118641	164119248	CpG: 49	607	49	444	16.1	73.1	0.60
chr5	164164528	164164768	CpG: 17	240	17	141	14.2	58.8	0.84
chr5	164272587	164272860	CpG: 21	273	21	166	15.4	60.8	0.84
chr5	164531837	164532117	CpG: 23	280	23	172	16.4	61.4	0.88
chr5	164713095	164713379	CpG: 25	284	25	177	17.6	62.3	0.91
chr5	164972352	164972614	CpG: 26	262	26	167	19.8	63.7	0.99
chr5	164978216	164978539	CpG: 27	323	27	192	16.7	59.4	0.96
chr5	165093480	165093694	CpG: 15	214	15	129	14.0	60.3	0.78
chr5	165114521	165114797	CpG: 25	276	25	177	18.1	64.1	0.89
chr5	165504036	165504271	CpG: 18	235	18	141	15.3	60.0	0.87
chr5	165871618	165871893	CpG: 24	275	24	171	17.5	62.2	0.91
chr5	166025474	166025714	CpG: 17	240	17	142	14.2	59.2	0.83
chr5	166033725	166033961	CpG: 17	236	17	140	14.4	59.3	0.84
chr5	166163515	166163796	CpG: 22	281	22	173	15.7	61.6	0.84
chr5	166282694	166282958	CpG: 19	264	19	152	14.4	57.6	0.89
chr5	166303839	166304117	CpG: 25	278	25	173	18.0	62.2	0.94
chr5	166318841	166319116	CpG: 21	275	21	167	15.3	60.7	0.85
chr5	166451595	166451825	CpG: 21	230	21	142	18.3	61.7	0.97
chr5	166577288	166577810	CpG: 39	522	39	303	14.9	58.0	0.90
chr5	166632356	166632653	CpG: 26	297	26	182	17.5	61.3	0.94
chr5	166680051	166680478	CpG: 30	427	30	253	14.1	59.3	0.81
chr5	166791492	166791759	CpG: 19	267	19	169	14.2	63.3	0.72
chr5	166803617	166803891	CpG: 24	274	24	171	17.5	62.4	0.91
chr5	167167058	167167288	CpG: 18	230	18	140	15.7	60.9	0.86
chr5	167258532	167258817	CpG: 24	285	24	177	16.8	62.1	0.89
chr5	167269413	167269650	CpG: 17	237	17	144	14.3	60.8	0.80
chr5	167344098	167344346	CpG: 18	248	18	138	14.5	55.6	0.96
chr5	167352980	167353219	CpG: 17	239	17	142	14.2	59.4	0.83
chr5	167412464	167412684	CpG: 18	220	18	131	16.4	59.5	0.94
chr5	167425802	167426026	CpG: 19	224	19	130	17.0	58.0	1.02
chr5	167461591	167462066	CpG: 44	475	44	346	18.5	72.8	0.70
chr5	167507005	167507297	CpG: 24	292	24	178	16.4	61.0	0.89
chr5	167513117	167513957	CpG: 72	840	72	555	17.1	66.1	0.79
chr5	167568994	167569268	CpG: 22	274	22	169	16.1	61.7	0.86
chr5	167640282	167640560	CpG: 25	278	25	175	18.0	62.9	0.92
chr5	167745166	167745422	CpG: 20	256	20	156	15.6	60.9	0.86
chr5	167822946	167823228	CpG: 21	282	21	171	14.9	60.6	0.83
chr5	167833002	167833275	CpG: 20	273	20	169	14.7	61.9	0.77
chr5	167871514	167871799	CpG: 22	285	22	178	15.4	62.5	0.81
chr5	167888269	167888547	CpG: 24	278	24	174	17.3	62.6	0.89
chr5	168000695	168000938	CpG: 22	243	22	148	18.1	60.9	1.00
chr5	168170944	168171218	CpG: 20	274	20	164	14.6	59.9	0.83
chr5	168241970	168242211	CpG: 18	241	18	148	14.9	61.4	0.82
chr5	168393802	168395704	CpG: 178	1902	178	1474	18.7	77.5	0.62
chr5	168446394	168446669	CpG: 22	275	22	169	16.0	61.5	0.86
chr5	168788342	168788559	CpG: 19	217	19	133	17.5	61.3	0.94
chr5	168797053	168797564	CpG: 36	511	36	320	14.1	62.6	0.72
chr5	168826347	168827553	CpG: 135	1206	135	915	22.4	75.9	0.78
chr5	169021083	169021427	CpG: 32	344	32	229	18.6	66.6	0.85
chr5	169063995	169065147	CpG: 158	1152	158	849	27.4	73.7	1.01
chr5	169104888	169105165	CpG: 20	277	20	166	14.4	59.9	0.81
chr5	169113885	169114705	CpG: 88	820	88	592	21.5	72.2	0.82
chr5	169177933	169179062	CpG: 91	1129	91	819	16.1	72.5	0.61
chr5	169205960	169206223	CpG: 20	263	20	180	15.2	68.4	0.65
chr5	169503121	169503396	CpG: 24	275	24	172	17.5	62.5	0.90
chr5	169836000	169836845	CpG: 103	845	103	651	24.4	77.0	0.84
chr5	170118963	170119560	CpG: 47	597	47	371	15.7	62.1	0.83
chr5	170172639	170173071	CpG: 45	432	45	317	20.8	73.4	0.78
chr5	170644554	170645008	CpG: 31	454	31	305	13.7	67.2	0.63
chr5	170771680	170772079	CpG: 30	399	30	265	15.0	66.4	0.69
chr5	170784277	170784519	CpG: 19	242	19	142	15.7	58.7	0.92
chr5	171042695	171043297	CpG: 73	602	73	457	24.3	75.9	0.84
chr5	171051596	171051880	CpG: 21	284	21	172	14.8	60.6	0.82
chr5	171282826	171283473	CpG: 54	647	54	428	16.7	66.2	0.79
chr5	171313687	171313925	CpG: 21	238	21	145	17.6	60.9	0.97
chr5	171398583	171398857	CpG: 24	274	24	172	17.5	62.8	0.90
chr5	171402047	171403046	CpG: 124	999	124	745	24.8	74.6	0.89
chr5	171629946	171630162	CpG: 18	216	18	127	16.7	58.8	0.96
chr5	171645435	171645709	CpG: 23	274	23	170	16.8	62.0	0.88
chr5	171726901	171727131	CpG: 20	230	20	140	17.4	60.9	0.95
chr5	171848505	171857448	CpG: 691	8943	691	5563	15.5	62.2	0.80
chr5	171882275	171882496	CpG: 17	221	17	134	15.4	60.6	0.85
chr5	171914559	171914837	CpG: 23	278	23	171	16.5	61.5	0.90
chr5	171927769	171928977	CpG: 109	1208	109	800	18.0	66.2	0.88
chr5	171959086	171961450	CpG: 249	2364	249	1671	21.1	70.7	0.84
chr5	171970839	171971120	CpG: 23	281	23	173	16.4	61.6	0.88
chr5	171990981	171991748	CpG: 84	767	84	569	21.9	74.2	0.81
chr5	171996949	171997185	CpG: 20	236	20	157	16.9	66.5	0.77
chr5	172135341	172135602	CpG: 19	261	19	163	14.6	62.5	0.76
chr5	172170422	172170691	CpG: 23	269	23	186	17.1	69.1	0.72
chr5	172546314	172547392	CpG: 105	1078	105	733	19.5	68.0	0.84
chr5	172595872	172596076	CpG: 14	204	14	129	13.7	63.2	0.71
chr5	172627954	172628235	CpG: 24	281	24	176	17.1	62.6	0.89
chr5	172659918	172660180	CpG: 19	262	19	157	14.5	59.9	0.82
chr5	172727733	172729242	CpG: 168	1509	168	1056	22.3	70.0	0.91
chr5	172795782	172796015	CpG: 21	233	21	161	18.0	69.1	0.76
chr5	172823468	172824871	CpG: 162	1403	162	1028	23.1	73.3	0.86
chr5	172837012	172837383	CpG: 45	371	45	229	24.3	61.7	1.27
chr5	172861434	172861655	CpG: 17	221	17	125	15.4	56.6	0.96
chr5	172879678	172880082	CpG: 28	404	28	262	13.9	64.9	0.66
chr5	172895808	172896078	CpG: 23	270	23	166	17.0	61.5	0.91
chr5	172963734	172963959	CpG: 16	225	16	125	14.2	55.6	0.92
chr5	172993783	172994868	CpG: 128	1085	128	800	23.6	73.7	0.87
chr5	173062738	173063013	CpG: 23	275	23	170	16.7	61.8	0.89
chr5	173119165	173119424	CpG: 18	259	18	169	13.9	65.3	0.85
chr5	173158014	173158242	CpG: 21	228	21	159	18.4	69.7	0.76
chr5	173181181	173182337	CpG: 129	1156	129	838	22.3	72.5	0.85
chr5	173209918	173210573	CpG: 89	655	89	477	27.2	72.8	1.03
chr5	173223483	173224728	CpG: 178	1245	178	904	28.6	72.6	1.09
chr5	173226878	173227106	CpG: 20	228	20	158	17.5	69.3	0.73
chr5	173257043	173257271	CpG: 16	228	16	125	14.0	54.8	0.95
chr5	173288583	173289019	CpG: 42	436	42	290	19.3	66.5	0.88
chr5	173310594	173312719	CpG: 199	2125	199	1411	18.7	66.4	0.85
chr5	173374288	173374813	CpG: 61	525	61	399	23.2	76.0	0.81
chr5	173498565	173499605	CpG: 87	1040	87	669	16.7	64.3	0.81
chr5	173499956	173500165	CpG: 21	209	21	125	20.1	59.8	1.16
chr5	173523791	173524261	CpG: 45	470	45	320	19.1	68.1	0.84
chr5	173525119	173525343	CpG: 18	224	18	136	16.1	60.7	0.88
chr5	173532175	173532450	CpG: 24	275	24	173	17.5	62.9	0.89
chr5	173596216	173597514	CpG: 125	1298	125	946	19.3	72.9	0.74
chr5	173598609	173599047	CpG: 32	438	32	254	14.6	58.0	0.88
chr5	173685530	173685806	CpG: 25	276	25	175	18.1	63.4	0.91
chr5	173753436	173753953	CpG: 47	517	47	380	18.2	73.5	0.67
chr5	173768908	173769270	CpG: 38	362	38	231	21.0	63.8	1.06
chr5	173772118	173775297	CpG: 236	3179	236	1961	14.8	61.7	0.78
chr5	173776686	173777653	CpG: 64	967	64	566	13.2	58.5	0.78
chr5	173778373	173779167	CpG: 74	794	74	482	18.6	60.7	1.01
chr5	173783910	173786052	CpG: 159	2142	159	1253	14.8	58.5	0.87
chr5	173813331	173813607	CpG: 26	276	26	172	18.8	62.3	0.98
chr5	173823845	173824142	CpG: 32	297	32	218	21.5	73.4	0.80
chr5	173834023	173834245	CpG: 19	222	19	127	17.1	57.2	1.06
chr5	173867111	173870153	CpG: 246	3042	246	1971	16.2	64.8	0.77
chr5	173948466	173948893	CpG: 31	427	31	256	14.5	60.0	0.81
chr5	174002799	174003077	CpG: 24	278	24	174	17.3	62.6	0.89
chr5	174086642	174086916	CpG: 22	274	22	169	16.1	61.7	0.86
chr5	174156182	174156954	CpG: 76	772	76	524	19.7	67.9	0.86
chr5	174276269	174276527	CpG: 22	258	22	159	17.1	61.6	0.91
chr5	174428297	174429345	CpG: 73	1048	73	624	13.9	59.5	0.79
chr5	174529508	174530068	CpG: 57	560	57	404	20.4	72.1	0.81
chr5	174555771	174556045	CpG: 24	274	24	171	17.5	62.4	0.91
chr5	174557987	174558268	CpG: 23	281	23	173	16.4	61.6	0.88
chr5	174607107	174607313	CpG: 17	206	17	125	16.5	60.7	0.91
chr5	174721111	174721391	CpG: 21	280	21	172	15.0	61.4	0.81
chr5	174852777	174853499	CpG: 68	722	68	515	18.8	71.3	0.75
chr5	174996937	174997163	CpG: 18	226	18	137	15.9	60.6	0.88
chr5	175088305	175088586	CpG: 24	281	24	175	17.1	62.3	0.89
chr5	175174835	175175101	CpG: 20	266	20	162	15.0	60.9	0.83
chr5	175261824	175262453	CpG: 68	629	68	436	21.6	69.3	0.90
chr5	175265451	175266337	CpG: 97	886	97	605	21.9	68.3	0.94
chr5	175272636	175273685	CpG: 88	1049	88	642	16.8	61.2	0.90
chr5	175276320	175276797	CpG: 49	477	49	321	20.5	67.3	0.92
chr5	175294365	175295190	CpG: 92	825	92	564	22.3	68.4	0.96
chr5	175610440	175610714	CpG: 20	274	20	165	14.6	60.2	0.81
chr5	175877630	175877904	CpG: 23	274	23	166	16.8	60.6	0.93
chr5	175987528	175989120	CpG: 148	1592	148	1067	18.6	67.0	0.83
chr5	176000483	176000715	CpG: 18	232	18	137	15.5	59.1	0.92
chr5	176022131	176022853	CpG: 95	722	95	558	26.3	77.3	0.89
chr5	176023917	176024149	CpG: 18	232	18	141	15.5	60.8	0.86
chr5	176071763	176071989	CpG: 17	226	17	136	15.0	60.2	0.85
chr5	176201780	176202532	CpG: 83	752	83	532	22.1	70.7	0.89
chr5	176317032	176317327	CpG: 28	295	28	182	19.0	61.7	1.01
chr5	176340288	176341359	CpG: 117	1071	117	769	21.8	71.8	0.85
chr5	176415210	176416761	CpG: 125	1551	125	1042	16.1	67.2	0.72
chr5	176511561	176512094	CpG: 59	533	59	374	22.1	70.2	0.93
chr5	176603997	176605508	CpG: 128	1511	128	987	16.9	65.3	0.85
chr5	176605843	176606094	CpG: 20	251	20	150	15.9	59.8	0.91
chr5	176676885	176677414	CpG: 42	529	42	362	15.9	68.4	0.73
chr5	176694578	176694852	CpG: 22	274	22	174	16.1	63.5	0.80
chr5	176716585	176716788	CpG: 15	203	15	110	14.8	54.2	1.02
chr5	176737896	176738614	CpG: 63	718	63	517	17.5	72.0	0.69
chr5	176742547	176743287	CpG: 74	740	74	531	20.0	71.8	0.79
chr5	176765584	176765974	CpG: 39	390	39	286	20.0	73.3	0.75
chr5	176781704	176782596	CpG: 122	892	122	671	27.4	75.2	0.97
chr5	176795738	176796605	CpG: 67	867	67	597	15.5	68.9	0.65
chr5	176834950	176835225	CpG: 22	275	22	168	16.0	61.1	0.87
chr5	176873503	176873748	CpG: 19	245	19	146	15.5	59.6	0.88
chr5	176905665	176906342	CpG: 60	677	60	460	17.7	67.9	0.77
chr5	176909412	176910849	CpG: 153	1437	153	1017	21.3	70.8	0.86
chr5	176932645	176933805	CpG: 88	1160	88	706	15.2	60.9	0.82
chr5	176960475	176961200	CpG: 100	725	100	557	27.6	76.8	0.94
chr5	176977668	176978681	CpG: 75	1013	75	704	14.8	69.5	0.61
chr5	176991971	176992835	CpG: 83	864	83	542	19.2	62.7	0.99
chr5	176995021	176995245	CpG: 20	224	20	130	17.9	58.0	1.07
chr5	177014896	177015140	CpG: 19	244	19	149	15.6	61.1	0.87
chr5	177081060	177082678	CpG: 136	1618	136	1060	16.8	65.5	0.78
chr5	177087221	177088615	CpG: 165	1394	165	1004	23.7	72.0	0.91
chr5	177096345	177096588	CpG: 19	243	19	141	15.6	58.0	0.95
chr5	177143368	177144242	CpG: 124	874	124	661	28.4	75.6	0.99
chr5	177156049	177157331	CpG: 162	1282	162	969	25.3	75.6	0.89
chr5	177165725	177167224	CpG: 120	1499	120	1004	16.0	67.0	0.72
chr5	177176099	177177320	CpG: 127	1221	127	863	20.8	70.7	0.84
chr5	177193725	177194210	CpG: 53	485	53	373	21.9	76.9	0.77
chr5	177226618	177227067	CpG: 47	449	47	328	20.9	73.1	0.79
chr5	177289845	177290397	CpG: 47	552	47	385	17.0	69.7	0.71
chr5	177345112	177345448	CpG: 27	336	27	231	16.1	68.8	0.68
chr5	177356323	177357668	CpG: 171	1345	171	1033	25.4	76.8	0.86
chr5	177364147	177364922	CpG: 89	775	89	571	23.0	73.7	0.85
chr5	177366572	177366783	CpG: 17	211	17	124	16.1	58.8	0.95
chr5	177388489	177388723	CpG: 19	234	19	141	16.2	60.3	0.93
chr5	177415840	177416232	CpG: 33	392	33	275	16.8	70.2	0.70
chr5	177423790	177423991	CpG: 15	201	15	135	14.9	67.2	0.68
chr5	177433276	177433487	CpG: 15	211	15	145	14.2	68.7	0.60
chr5	177505215	177505489	CpG: 20	274	20	167	14.6	60.9	0.79
chr5	177527133	177527663	CpG: 44	530	44	382	16.6	72.1	0.64
chr5	177549025	177550079	CpG: 127	1054	127	752	24.1	71.3	0.95
chr5	177565671	177566287	CpG: 66	616	66	428	21.4	69.5	0.89
chr5	177629858	177630711	CpG: 81	853	81	636	19.0	74.6	0.71
chr5	177631320	177631560	CpG: 22	240	22	147	18.3	61.2	1.00
chr5	177636364	177636829	CpG: 37	465	37	315	15.9	67.7	0.70
chr5	177649922	177650188	CpG: 19	266	19	154	14.3	57.9	0.88
chr5	177660108	177660436	CpG: 35	328	35	230	21.3	70.1	0.87
chr5	177660675	177660920	CpG: 19	245	19	148	15.5	60.4	0.85
chr5	177675061	177677861	CpG: 300	2800	300	2089	21.4	74.6	0.78
chr5	177809578	177809869	CpG: 24	291	24	176	16.5	60.5	0.91
chr5	177846264	177847363	CpG: 126	1099	126	766	22.9	69.7	0.95
chr5	177850832	177851177	CpG: 28	345	28	246	16.2	71.3	0.66
chr5	177854556	177855795	CpG: 106	1239	106	864	17.1	69.7	0.71
chr5	177875293	177875583	CpG: 26	290	26	202	17.9	69.7	0.75
chr5	177880337	177880764	CpG: 33	427	33	283	15.5	66.3	0.71
chr5	177894795	177895313	CpG: 41	518	41	325	15.8	62.7	0.81
chr5	177906199	177906604	CpG: 42	405	42	294	20.7	72.6	0.82
chr5	177910180	177911062	CpG: 69	882	69	610	15.6	69.2	0.67
chr5	177914054	177914358	CpG: 35	304	35	235	23.0	77.3	0.80
chr5	177939640	177939887	CpG: 25	247	25	187	20.2	75.7	0.76
chr5	177943298	177947856	CpG: 332	4558	332	2821	14.6	61.9	0.76
chr5	177969105	177970375	CpG: 132	1270	132	869	20.8	68.4	0.89
chr5	177977112	177977348	CpG: 20	236	20	159	16.9	67.4	0.75
chr5	177979312	177979516	CpG: 17	204	17	131	16.7	64.2	0.82
chr5	177989610	177990998	CpG: 147	1388	147	1040	21.2	74.9	0.76
chr5	177997266	177999199	CpG: 239	1933	239	1423	24.7	73.6	0.92
chr5	178004164	178004438	CpG: 23	274	23	170	16.8	62.0	0.88
chr5	178009899	178010711	CpG: 56	812	56	539	13.8	66.4	0.64
chr5	178015771	178016939	CpG: 151	1168	151	922	25.9	78.9	0.84
chr5	178034547	178035632	CpG: 93	1085	93	778	17.1	71.7	0.67
chr5	178039777	178039980	CpG: 18	203	18	146	17.7	71.9	0.69
chr5	178040257	178041360	CpG: 109	1103	109	767	19.8	69.5	0.82
chr5	178047092	178047383	CpG: 21	291	21	200	14.4	68.7	0.62
chr5	178059506	178060489	CpG: 101	983	101	647	20.5	65.8	0.96
chr5	178073559	178073775	CpG: 18	216	18	145	16.7	67.1	0.74
chr5	178083698	178083929	CpG: 18	231	18	139	15.6	60.2	0.87
chr5	178089572	178089846	CpG: 23	274	23	167	16.8	60.9	0.91
chr5	178096047	178097049	CpG: 120	1002	120	743	24.0	74.2	0.87
chr5	178134342	178134912	CpG: 62	570	62	393	21.8	68.9	0.93
chr5	178141780	178142798	CpG: 108	1018	108	714	21.2	70.1	0.86
chr5	178146440	178146859	CpG: 30	419	30	288	14.3	68.7	0.62
chr5	178150634	178150935	CpG: 24	301	24	207	15.9	68.8	0.68
chr5	178215106	178215998	CpG: 122	892	122	671	27.4	75.2	0.97
chr5	178231714	178232102	CpG: 38	388	38	284	19.6	73.2	0.73
chr5	178245424	178245671	CpG: 19	247	19	149	15.4	60.3	0.86
chr5	178315745	178316172	CpG: 32	427	32	257	15.0	60.2	0.83
chr5	178325258	178325518	CpG: 21	260	21	154	16.2	59.2	0.94
chr5	178325853	178327612	CpG: 147	1759	147	1128	16.7	64.1	0.90
chr5	178419810	178420342	CpG: 59	532	59	373	22.2	70.1	0.94
chr5	178488219	178489036	CpG: 77	817	77	579	18.8	70.9	0.76
chr5	178492879	178493535	CpG: 59	656	59	465	18.0	70.9	0.74
chr5	178511465	178511947	CpG: 35	482	35	315	14.5	65.4	0.90
chr5	178512671	178513024	CpG: 26	353	26	231	14.7	65.4	0.90
chr5	178513388	178513884	CpG: 36	496	36	324	14.5	65.3	0.90
chr5	178522664	178522912	CpG: 37	248	37	194	29.8	78.2	1.00
chr5	178535209	178536859	CpG: 135	1650	135	1068	16.4	64.7	0.79
chr5	178557102	178558818	CpG: 154	1716	154	1122	17.9	65.4	0.91
chr5	178559130	178559389	CpG: 23	259	23	153	17.8	59.1	1.05
chr5	178607097	178607359	CpG: 20	262	20	151	15.3	57.6	0.92
chr5	178651814	178652089	CpG: 24	275	24	171	17.5	62.2	0.91
chr5	178663437	178664464	CpG: 136	1027	136	789	26.5	76.8	0.90
chr5	178679926	178681628	CpG: 153	1702	153	1099	18.0	64.6	0.86
chr5	178703792	178704707	CpG: 76	915	76	573	16.6	62.6	0.85
chr5	178715913	178716244	CpG: 39	331	39	236	23.6	71.3	0.94
chr5	178737334	178737822	CpG: 42	488	42	326	17.2	66.8	0.79
chr5	178753487	178755798	CpG: 244	2311	244	1521	21.1	65.8	0.98
chr5	178768222	178768458	CpG: 21	236	21	143	17.8	60.6	0.99
chr5	178782479	178783209	CpG: 100	730	100	561	27.4	76.8	0.93
chr5	178830211	178830449	CpG: 20	238	20	145	16.8	60.9	0.91
chr5	178851799	178852357	CpG: 48	558	48	352	17.2	63.1	0.87
chr5	178887017	178887222	CpG: 17	205	17	139	16.6	67.8	0.73
chr5	178944674	178947215	CpG: 236	2541	236	1766	18.6	69.5	0.78
chr5	179068854	179069505	CpG: 78	651	78	487	24.0	74.8	0.86
chr5	179075445	179076853	CpG: 116	1408	116	869	16.5	61.7	0.87
chr5	179113405	179113669	CpG: 23	264	23	149	17.4	56.4	1.10
chr5	179127672	179128948	CpG: 130	1276	130	928	20.4	72.7	0.78
chr5	179141529	179142641	CpG: 138	1112	138	838	24.8	75.4	0.88
chr5	179178402	179179386	CpG: 103	984	103	670	20.9	68.1	0.93
chr5	179212009	179212235	CpG: 17	226	17	135	15.0	59.7	0.88
chr5	179213494	179213724	CpG: 17	230	17	141	14.8	61.3	0.80
chr5	179249250	179249480	CpG: 20	230	20	145	17.4	63.0	0.89
chr5	179271694	179271972	CpG: 26	278	26	176	18.7	63.3	0.94
chr5	179281173	179282870	CpG: 166	1697	166	1149	19.6	67.7	0.86
chr5	179413139	179414207	CpG: 117	1068	117	776	21.9	72.7	0.83
chr5	179421959	179422195	CpG: 18	236	18	140	15.3	59.3	0.88
chr5	179448978	179449803	CpG: 78	825	78	588	18.9	71.3	0.75
chr5	179493888	179494993	CpG: 91	1105	91	714	16.5	64.6	0.79
chr5	179495389	179495607	CpG: 21	218	21	130	19.3	59.6	1.10
chr5	179505328	179505601	CpG: 25	273	25	170	18.3	62.3	0.95
chr5	179526828	179527064	CpG: 17	236	17	140	14.4	59.3	0.84
chr5	179539551	179540264	CpG: 51	713	51	482	14.3	67.6	0.63
chr5	179542190	179542452	CpG: 19	262	19	169	14.5	64.5	0.70
chr5	179547422	179548594	CpG: 144	1172	144	861	24.6	73.5	0.91
chr5	179573617	179573891	CpG: 21	274	21	172	15.3	62.8	0.78
chr5	179576371	179576610	CpG: 18	239	18	141	15.1	59.0	0.89
chr5	179576824	179577410	CpG: 73	586	73	420	24.9	71.7	0.98
chr5	179613333	179614108	CpG: 78	775	78	521	20.1	67.2	0.90
chr5	179622775	179623012	CpG: 19	237	19	144	16.0	60.8	0.89
chr5	179652014	179652287	CpG: 22	273	22	169	16.1	61.9	0.85
chr5	179654393	179654628	CpG: 19	235	19	142	16.2	60.4	0.89
chr5	179673611	179674891	CpG: 116	1280	116	849	18.1	66.3	0.83
chr5	179677967	179678310	CpG: 34	343	34	234	19.8	68.2	0.88
chr5	179690978	179691181	CpG: 18	203	18	142	17.7	70.0	0.74
chr5	179691920	179692122	CpG: 19	202	19	146	18.8	72.3	0.72
chr5	179720107	179720860	CpG: 63	753	63	505	16.7	67.1	0.74
chr5	179759042	179759302	CpG: 21	260	21	136	16.2	52.3	1.19
chr5	179777194	179777471	CpG: 22	277	22	173	15.9	62.5	0.82
chr5	179782396	179782616	CpG: 18	220	18	137	16.4	62.3	0.97
chr5	179798591	179798827	CpG: 20	236	20	144	16.9	61.0	0.93
chr5	179810430	179810763	CpG: 25	333	25	228	15.0	68.5	0.64
chr5	179831061	179831512	CpG: 31	451	31	316	13.7	70.1	0.63
chr5	179881513	179881724	CpG: 17	211	17	128	16.1	60.7	0.89
chr5	179897165	179899187	CpG: 240	2022	240	1533	23.7	75.8	0.83
chr5	179916460	179916677	CpG: 15	217	15	128	13.8	59.0	0.81
chr5	179927667	179928185	CpG: 37	518	37	343	14.3	66.2	0.76
chr5	179936672	179936916	CpG: 19	244	19	148	15.6	60.7	0.88
chr5	179980636	179980899	CpG: 23	263	23	162	17.5	61.6	0.94
chr5	180083029	180083529	CpG: 48	500	48	343	19.2	68.6	0.82
chr5	180089824	180090099	CpG: 22	275	22	169	16.0	61.5	0.86
chr5	180096668	180096902	CpG: 16	234	16	138	13.7	59.0	0.80
chr5	180102929	180104101	CpG: 164	1172	164	887	28.0	75.7	0.98
chr5	180112322	180112808	CpG: 37	486	37	313	15.2	64.4	0.73
chr5	180113237	180113493	CpG: 18	256	18	148	14.1	57.8	0.88
chr5	180122602	180122838	CpG: 17	236	17	143	14.4	60.6	0.82
chr5	180130180	180130628	CpG: 40	448	40	295	17.9	65.8	0.88
chr5	180166674	180166967	CpG: 26	293	26	179	17.7	61.1	0.96
chr5	180176858	180177114	CpG: 20	256	20	148	15.6	57.8	0.94
chr5	180177260	180179066	CpG: 189	1806	189	1197	20.9	66.3	0.97
chr5	180183487	180183727	CpG: 21	240	21	149	17.5	62.1	0.92
chr5	180187150	180187892	CpG: 68	742	68	466	18.3	62.8	0.93
chr5	180189418	180190052	CpG: 57	634	57	401	18.0	63.2	0.90
chr5	180192292	180192506	CpG: 15	214	15	124	14.0	57.9	0.84
chr5	180213074	180213537	CpG: 46	463	46	295	19.9	63.7	0.98
chr5	180232645	180233092	CpG: 32	447	32	266	14.3	59.5	0.83
chr5	180233352	180234595	CpG: 121	1243	121	843	19.5	67.8	0.85
chr5	180253523	180254522	CpG: 120	999	120	725	24.0	72.6	0.92
chr5	180287651	180288718	CpG: 130	1067	130	774	24.4	72.5	0.93
chr5	180345585	180345807	CpG: 17	222	17	131	15.3	59.0	0.90
chr5	180350803	180352020	CpG: 150	1217	150	908	24.7	74.6	0.89
chr5	180352928	180353181	CpG: 27	253	27	188	21.3	74.3	0.77
chr5	180356479	180357199	CpG: 65	720	65	488	18.1	67.8	0.79
chr5	180360728	180363269	CpG: 265	2541	265	1845	20.9	72.6	0.80
chr5	180367031	180367311	CpG: 21	280	21	172	15.0	61.4	0.80
chr5	180371582	180372664	CpG: 99	1082	99	769	18.3	71.1	0.73
chr5	180375995	180376922	CpG: 122	927	122	694	26.3	74.9	0.95
chr5	180390193	180390796	CpG: 46	603	46	405	15.3	67.2	0.68
chr5	180413399	180414565	CpG: 122	1166	122	792	20.9	67.9	0.91
chr5	180434088	180434326	CpG: 18	238	18	148	15.1	62.2	0.78
chr5	180459225	180459506	CpG: 21	281	21	172	14.9	61.2	0.81
chr5	180462323	180463094	CpG: 127	771	127	626	32.9	81.2	1.01
chr5	180501639	180501847	CpG: 16	208	16	125	15.4	60.1	0.88
chr5	180512906	180513180	CpG: 23	274	23	168	16.8	61.3	0.90
chr5	180615885	180616090	CpG: 18	205	18	129	17.6	62.9	0.92
chr5	180626376	180627423	CpG: 151	1047	151	809	28.8	77.3	0.97
chr5	180627759	180628030	CpG: 23	271	23	178	17.0	65.7	0.79
chr5	180645218	180645854	CpG: 57	636	57	419	17.9	65.9	0.85
chr5	180658036	180658341	CpG: 22	305	22	184	14.4	60.3	0.81
chr5	180667792	180668459	CpG: 63	667	63	470	18.9	70.5	1.11
chr5	180681766	180682212	CpG: 45	446	45	333	20.2	74.7	0.73
chr5	180691842	180692422	CpG: 49	580	49	403	16.9	69.5	0.71
chr5	180692604	180692889	CpG: 20	285	20	191	14.0	67.0	0.65
chr5	180717033	180717406	CpG: 34	373	34	271	18.2	72.7	0.69
chr5	180731351	180731619	CpG: 20	268	20	165	14.9	61.6	0.80
chr5	180737554	180737792	CpG: 20	238	20	143	16.8	60.1	0.96
chr5	180750900	180751206	CpG: 23	306	23	186	15.0	60.8	0.82
chr5	180755820	180756060	CpG: 20	240	20	145	16.7	60.4	0.93
chr5	180758177	180758405	CpG: 17	228	17	137	14.9	60.1	0.84
chr5	180763035	180763348	CpG: 28	313	28	228	17.9	72.8	0.75
chr5	180764225	180764895	CpG: 112	670	112	557	33.4	83.1	0.99
chr5	180846932	180848420	CpG: 190	1488	190	1128	25.5	75.8	0.90
chr5	180868771	180869580	CpG: 68	809	68	507	16.8	62.7	0.86
chr5	180870658	180870937	CpG: 21	279	21	174	15.1	62.4	0.79
chr5	180872939	180873175	CpG: 20	236	20	142	16.9	60.2	0.96
chr5	180875481	180875703	CpG: 16	222	16	135	14.4	60.8	0.79
chr5	180877302	180877542	CpG: 18	240	18	143	15.0	59.6	0.87
chr5	180907574	180909731	CpG: 232	2157	232	1536	21.5	71.2	0.85
chr5	180945101	180945528	CpG: 29	427	29	279	13.6	65.3	0.64
chr5	180952767	180953049	CpG: 26	282	26	184	18.4	65.2	0.87
chr5	180954330	180954549	CpG: 16	219	16	128	14.6	58.4	0.88
chr5	180981233	180981456	CpG: 16	223	16	133	14.3	59.6	0.82
chr5	180982168	180982402	CpG: 19	234	19	143	16.2	61.1	0.90
chr5	180985754	180986008	CpG: 21	254	21	155	16.5	61.0	0.89
chr5	180987455	180987713	CpG: 24	258	24	185	18.6	71.7	0.73
chr5	181014540	181015181	CpG: 59	641	59	474	18.4	73.9	0.67
chr5	181049603	181051044	CpG: 168	1441	168	1014	23.3	70.4	0.99
chr5	181086902	181087726	CpG: 59	824	59	556	14.3	67.5	0.63
chr5	181145987	181147951	CpG: 176	1964	176	1438	17.9	73.2	0.67
chr5	181166678	181166952	CpG: 20	274	20	166	14.6	60.6	0.80
chr5	181170105	181170379	CpG: 26	274	26	187	19.0	68.2	1.13
chr5	181171148	181171561	CpG: 27	413	27	263	13.1	63.7	0.72
chr5	181174655	181177767	CpG: 239	3112	239	2076	15.4	66.7	0.69
chr5	181184724	181185001	CpG: 20	277	20	186	14.4	67.1	0.64
chr5	181205378	181206974	CpG: 189	1596	189	1120	23.7	70.2	0.96
chr5	181215503	181216097	CpG: 46	594	46	389	15.5	65.5	0.75
chr5	181221165	181221439	CpG: 23	274	23	175	16.8	63.9	0.83
chr5	181230393	181230984	CpG: 68	591	68	432	23.0	73.1	0.86
chr5	181298865	181299163	CpG: 29	298	29	193	19.5	64.8	0.93
chr5	181327583	181328037	CpG: 36	454	36	315	15.9	69.4	0.66
chr5	181348015	181348273	CpG: 19	258	19	165	14.7	64.0	0.73
chr5	181348359	181349235	CpG: 77	876	77	597	17.6	68.2	0.76
chr5	181358728	181359500	CpG: 87	772	87	572	22.5	74.1	0.84
chr5	181366345	181367562	CpG: 115	1217	115	834	18.9	68.5	0.81
chr5	181387305	181388144	CpG: 85	839	85	573	20.3	68.3	0.87
chr5	181417237	181418196	CpG: 89	959	89	674	18.6	70.3	0.75
chr5	181526659	181526934	CpG: 31	275	31	196	22.5	71.3	0.91
chr5	181588719	181588958	CpG: 28	239	28	186	23.4	77.8	0.79
chr5	181613822	181615196	CpG: 171	1374	171	974	24.9	70.9	0.99
chr5	181620389	181621127	CpG: 89	738	89	532	24.1	72.1	0.93
chr5	181657113	181657910	CpG: 76	797	76	538	19.1	67.5	0.86
chr5	181660004	181661953	CpG: 152	1949	152	1405	15.6	72.1	0.64
chr5	181663590	181664253	CpG: 59	663	59	424	17.8	64.0	0.92
chr5	181674685	181674932	CpG: 24	247	24	151	19.4	61.1	1.07
chr5	181675187	181675436	CpG: 21	249	21	145	16.9	58.2	1.00
chr5	181720706	181721255	CpG: 48	549	48	382	17.5	69.6	0.85
chr5	181724430	181725263	CpG: 57	833	57	491	13.7	58.9	0.79
chr5	181729886	181730508	CpG: 52	622	52	413	16.7	66.4	0.79
chr5	181733932	181734347	CpG: 32	415	32	257	15.4	61.9	0.81
chr5	181734972	181735217	CpG: 18	245	18	150	14.7	61.2	0.79
chr5	181738284	181738499	CpG: 20	215	20	135	18.6	62.8	0.96
chr5	181743085	181744348	CpG: 98	1263	98	749	15.5	59.3	0.90
chr5	181744663	181744881	CpG: 19	218	19	136	17.4	62.4	0.92
chr5	181748117	181748581	CpG: 33	464	33	264	14.2	56.9	0.88
chr5	181749492	181752150	CpG: 211	2658	211	1656	15.9	62.3	0.82
chr5	181755214	181755694	CpG: 48	480	48	330	20.0	68.8	0.85
chr5	181762630	181762850	CpG: 16	220	16	134	14.5	60.9	0.80
chr5	181764015	181765603	CpG: 166	1588	166	1142	20.9	71.9	0.81
chr5	181768682	181769649	CpG: 63	967	63	537	13.0	55.5	0.85
chr5	181775953	181776236	CpG: 20	283	20	171	14.1	60.4	0.78
chr5	181776898	181777635	CpG: 54	737	54	458	14.7	62.1	0.76
chr5	181778502	181778826	CpG: 27	324	27	180	16.7	55.6	1.08
chr5	181779368	181780001	CpG: 43	633	43	384	13.6	60.7	0.76
chr5	181780762	181781042	CpG: 21	280	21	163	15.0	58.2	0.92
chr5	181782258	181783654	CpG: 109	1396	109	829	15.6	59.4	0.89
chr5	181783869	181784073	CpG: 16	204	16	135	15.7	66.2	0.73
chr5	181794133	181794506	CpG: 32	373	32	266	17.2	71.3	0.68
chr5	181803325	181803948	CpG: 49	623	49	375	15.7	60.2	0.87
chr5	181806020	181807102	CpG: 81	1082	81	703	15.0	65.0	0.72
chr5	181807359	181807592	CpG: 19	233	19	143	16.3	61.4	0.89
chr5	181821003	181821914	CpG: 84	911	84	645	18.4	70.8	0.74
chr5	181833073	181833639	CpG: 49	566	49	381	17.3	67.3	0.78
chr5	181841554	181842250	CpG: 47	696	47	485	13.5	69.7	0.70
chr5	181890773	181891212	CpG: 29	439	29	295	13.2	67.2	0.62
chr5	181999900	182000913	CpG: 84	1013	84	734	16.6	72.5	0.64
chr5	182012022	182014373	CpG: 209	2351	209	1460	17.8	62.1	0.92
chr5	182042365	182043648	CpG: 197	1283	197	974	30.7	75.9	1.09
chr6	2935	3445	CpG: 48	510	48	351	18.8	68.8	0.80
chr6	146884	147775	CpG: 119	891	119	673	26.7	75.5	0.94
chr6	166333	166569	CpG: 20	236	20	146	16.9	61.9	0.91
chr6	249572	252186	CpG: 287	2614	287	1866	22.0	71.4	0.86
chr6	282188	283321	CpG: 135	1133	135	891	23.8	78.6	0.82
chr6	284642	285068	CpG: 44	426	44	312	20.7	73.2	0.77
chr6	294056	294559	CpG: 46	503	46	360	18.3	71.6	0.71
chr6	308333	308852	CpG: 50	519	50	377	19.3	72.6	0.73
chr6	353229	353502	CpG: 22	273	22	167	16.1	61.2	0.87
chr6	377426	380431	CpG: 342	3005	342	1923	22.8	64.0	1.31
chr6	396846	397224	CpG: 57	378	57	232	30.2	61.4	1.62
chr6	404569	404850	CpG: 22	281	22	173	15.7	61.6	0.84
chr6	448940	449170	CpG: 22	230	22	134	19.1	58.3	1.13
chr6	475536	475810	CpG: 24	274	24	172	17.5	62.8	0.90
chr6	515619	516365	CpG: 76	746	76	520	20.4	69.7	0.84
chr6	547277	547519	CpG: 23	242	23	144	19.0	59.5	1.08
chr6	549355	550254	CpG: 97	899	97	633	21.6	70.4	0.88
chr6	551540	551920	CpG: 33	380	33	281	17.4	73.9	0.64
chr6	567777	568240	CpG: 39	463	39	311	16.8	67.2	0.75
chr6	593102	593580	CpG: 38	478	38	283	15.9	59.2	0.91
chr6	617812	618488	CpG: 53	676	53	427	15.7	63.2	0.80
chr6	643596	643826	CpG: 21	230	21	143	18.3	62.2	0.96
chr6	709368	709644	CpG: 23	276	23	170	16.7	61.6	0.90
chr6	728286	728552	CpG: 22	266	22	163	16.5	61.3	0.90
chr6	748075	748378	CpG: 23	303	23	196	15.2	64.7	0.73
chr6	790550	790822	CpG: 19	272	19	166	14.0	61.0	0.76
chr6	920695	920932	CpG: 18	237	18	141	15.2	59.5	0.87
chr6	1174346	1177499	CpG: 352	3153	352	2194	22.3	69.6	0.92
chr6	1180180	1180471	CpG: 28	291	28	218	19.2	74.9	0.69
chr6	1181211	1181622	CpG: 38	411	38	292	18.5	71.0	0.74
chr6	1240482	1240710	CpG: 20	228	20	139	17.5	61.0	0.96
chr6	1241398	1242967	CpG: 146	1569	146	995	18.6	63.4	0.93
chr6	1244696	1248164	CpG: 280	3468	280	2296	16.1	66.2	0.74
chr6	1252090	1254347	CpG: 272	2257	272	1652	24.1	73.2	0.90
chr6	1256003	1257124	CpG: 105	1121	105	775	18.7	69.1	0.78
chr6	1271581	1271884	CpG: 22	303	22	165	14.5	54.5	0.98
chr6	1297574	1297791	CpG: 17	217	17	129	15.7	59.4	0.89
chr6	1320053	1320442	CpG: 33	389	33	279	17.0	71.7	0.66
chr6	1378140	1378423	CpG: 27	283	27	191	19.1	67.5	0.84
chr6	1386778	1387202	CpG: 45	424	45	293	21.2	69.1	0.90
chr6	1418031	1418350	CpG: 33	319	33	230	20.7	72.1	0.81
chr6	1461856	1462168	CpG: 24	312	24	202	15.4	64.7	0.74
chr6	1464390	1464904	CpG: 52	514	52	365	20.2	71.0	0.80
chr6	1467372	1478635	CpG: 875	11263	875	6893	15.5	61.2	0.83
chr6	1481862	1483863	CpG: 183	2001	183	1375	18.3	68.7	0.78
chr6	1486954	1488447	CpG: 127	1493	127	953	17.0	63.8	0.84
chr6	1545622	1545896	CpG: 24	274	24	170	17.5	62.0	0.92
chr6	1606423	1606647	CpG: 19	224	19	140	17.0	62.5	0.90
chr6	1716189	1716463	CpG: 21	274	21	168	15.3	61.3	0.83
chr6	1776125	1776395	CpG: 24	270	24	168	17.8	62.2	0.92
chr6	1796215	1796452	CpG: 17	237	17	138	14.3	58.2	0.87
chr6	1807884	1808238	CpG: 23	354	23	203	13.0	57.3	0.82
chr6	1923033	1923307	CpG: 23	274	23	170	16.8	62.0	0.88
chr6	2108518	2109553	CpG: 121	1035	121	745	23.4	72.0	0.90
chr6	2288695	2288919	CpG: 20	224	20	135	17.9	60.3	0.98
chr6	2499714	2500287	CpG: 62	573	62	397	21.6	69.3	0.90
chr6	2550748	2550973	CpG: 18	225	18	136	16.0	60.4	0.91
chr6	2629219	2629652	CpG: 37	433	37	299	17.1	69.1	0.72
chr6	2629721	2629947	CpG: 16	226	16	131	14.2	58.0	0.87
chr6	2630830	2632403	CpG: 219	1573	219	1158	27.8	73.6	1.03
chr6	2639666	2639897	CpG: 20	231	20	141	17.3	61.0	0.94
chr6	2707691	2708197	CpG: 56	506	56	381	22.1	75.3	0.79
chr6	2726282	2726667	CpG: 36	385	36	280	18.7	72.7	0.71
chr6	2736231	2736570	CpG: 28	339	28	248	16.5	73.2	0.62
chr6	2741496	2742290	CpG: 73	794	73	539	18.4	67.9	0.80
chr6	2755539	2755750	CpG: 17	211	17	129	16.1	61.1	0.88
chr6	2757818	2758071	CpG: 21	253	21	162	16.6	64.0	0.81
chr6	2769179	2769910	CpG: 77	731	77	532	21.1	72.8	0.80
chr6	2773406	2774382	CpG: 78	976	78	524	16.0	53.7	1.58
chr6	2786184	2788179	CpG: 187	1995	187	1554	18.7	77.9	0.62
chr6	2804561	2805048	CpG: 39	487	39	344	16.0	70.6	0.64
chr6	2808385	2808588	CpG: 22	203	22	150	21.7	73.9	0.81
chr6	2811038	2811246	CpG: 16	208	16	121	15.4	58.2	0.92
chr6	2839767	2840642	CpG: 122	875	122	664	27.9	75.9	0.97
chr6	2857517	2858211	CpG: 59	694	59	498	17.0	71.8	0.67
chr6	2868521	2869188	CpG: 78	667	78	491	23.4	73.6	0.91
chr6	2881879	2882157	CpG: 25	278	25	178	18.0	64.0	0.89
chr6	2896433	2896868	CpG: 42	435	42	316	19.3	72.6	0.73
chr6	2922480	2922933	CpG: 47	453	47	332	20.8	73.3	0.78
chr6	2925269	2925543	CpG: 25	274	25	167	18.2	60.9	1.01
chr6	2932476	2933218	CpG: 83	742	83	531	22.4	71.6	0.87
chr6	2933851	2934113	CpG: 19	262	19	153	14.5	58.4	0.88
chr6	2937195	2938019	CpG: 116	824	116	613	28.2	74.4	1.02
chr6	2959584	2962122	CpG: 314	2538	314	1713	24.7	67.5	1.20
chr6	2986377	2987097	CpG: 96	720	96	535	26.7	74.3	0.98
chr6	3002665	3002892	CpG: 17	227	17	132	15.0	58.1	0.91
chr6	3008348	3008588	CpG: 18	240	18	141	15.0	58.8	0.89
chr6	3021090	3021732	CpG: 58	642	58	416	18.1	64.8	0.86
chr6	3023946	3024154	CpG: 16	208	16	138	15.4	66.3	0.70
chr6	3024387	3025405	CpG: 112	1018	112	761	22.0	74.8	0.79
chr6	3029812	3030503	CpG: 77	691	77	506	22.3	73.2	0.83
chr6	3037956	3038220	CpG: 21	264	21	186	15.9	70.5	0.65
chr6	3093084	3093802	CpG: 66	718	66	469	18.4	65.3	0.86
chr6	3095193	3098228	CpG: 240	3035	240	1982	15.8	65.3	0.74
chr6	3099761	3100455	CpG: 47	694	47	420	13.5	60.5	0.74
chr6	3121831	3122385	CpG: 62	554	62	398	22.4	71.8	0.87
chr6	3127200	3127891	CpG: 80	691	80	516	23.2	74.7	0.83
chr6	3135319	3135555	CpG: 18	236	18	140	15.3	59.3	0.88
chr6	3167117	3167402	CpG: 24	285	24	178	16.8	62.5	0.88
chr6	3204210	3204432	CpG: 18	222	18	133	16.2	59.9	0.94
chr6	3224420	3224928	CpG: 45	508	45	403	17.7	79.3	1.07
chr6	3317323	3317551	CpG: 17	228	17	139	14.9	61.0	0.83
chr6	3324572	3326473	CpG: 235	1901	235	1435	24.7	75.5	0.87
chr6	3417248	3417486	CpG: 20	238	20	145	16.8	60.9	0.93
chr6	3515241	3515485	CpG: 22	244	22	152	18.0	62.3	0.95
chr6	3619492	3621471	CpG: 256	1979	256	1472	25.9	74.4	0.93
chr6	3626940	3627407	CpG: 50	467	50	349	21.4	74.7	0.77
chr6	3630171	3630601	CpG: 42	430	42	316	19.5	73.5	0.72
chr6	3640404	3640963	CpG: 59	559	59	415	21.1	74.2	0.77
chr6	3718674	3720451	CpG: 148	1777	148	1173	16.7	66.0	0.76
chr6	3887880	3888503	CpG: 60	623	60	424	19.3	68.1	0.83
chr6	3889520	3889735	CpG: 18	215	18	126	16.7	58.6	0.98
chr6	3890846	3891406	CpG: 61	560	61	377	21.8	67.3	0.96
chr6	3948120	3948789	CpG: 87	669	87	525	26.0	78.5	0.85
chr6	4004229	4005514	CpG: 123	1285	123	900	19.1	70.0	0.80
chr6	4150766	4151072	CpG: 25	306	25	202	16.3	66.0	0.76
chr6	4584902	4585139	CpG: 17	237	17	140	14.3	59.1	0.84
chr6	4594284	4594788	CpG: 43	504	43	367	17.1	72.8	0.65
chr6	4643841	4646260	CpG: 289	2419	289	1778	23.9	73.5	0.89
chr6	4872046	4873124	CpG: 92	1078	92	696	17.1	64.6	0.82
chr6	4906790	4908085	CpG: 101	1295	101	922	15.6	71.2	0.62
chr6	4953490	4956006	CpG: 274	2516	274	1806	21.8	71.8	0.85
chr6	5004263	5004690	CpG: 40	427	40	310	18.7	72.6	0.79
chr6	5112005	5112286	CpG: 21	281	21	173	14.9	61.6	0.81
chr6	5129704	5130909	CpG: 118	1205	118	805	19.6	66.8	0.88
chr6	5406626	5406880	CpG: 19	254	19	161	15.0	63.4	0.74
chr6	5704846	5705522	CpG: 49	676	49	457	14.5	67.6	0.63
chr6	5720357	5720588	CpG: 29	231	29	175	25.1	75.8	0.88
chr6	5760768	5761378	CpG: 50	610	50	360	16.4	59.0	0.95
chr6	5863547	5863841	CpG: 20	294	20	191	13.6	65.0	0.66
chr6	5864823	5865124	CpG: 25	301	25	181	16.6	60.1	0.93
chr6	5865665	5866052	CpG: 36	387	36	235	18.6	60.7	1.03
chr6	5867785	5868599	CpG: 61	814	61	521	15.0	64.0	0.74
chr6	5871117	5873768	CpG: 199	2651	199	1596	15.0	60.2	0.83
chr6	5875332	5875686	CpG: 29	354	29	208	16.4	58.8	0.97
chr6	5876029	5878239	CpG: 148	2210	148	1341	13.4	60.7	0.73
chr6	5903421	5903699	CpG: 24	278	24	174	17.3	62.6	0.89
chr6	5927630	5927939	CpG: 24	309	24	195	15.5	63.1	0.78
chr6	5965371	5965661	CpG: 20	290	20	167	13.8	57.6	0.83
chr6	6068387	6068599	CpG: 15	212	15	126	14.2	59.4	0.82
chr6	6246234	6246517	CpG: 24	283	24	176	17.0	62.2	0.89
chr6	6415320	6416180	CpG: 71	860	71	574	16.5	66.7	0.74
chr6	6475656	6476143	CpG: 44	487	44	351	18.1	72.1	0.70
chr6	6482456	6482969	CpG: 47	513	47	367	18.3	71.5	0.72
chr6	6571664	6571940	CpG: 24	276	24	171	17.4	62.0	0.92
chr6	6585245	6585475	CpG: 20	230	20	141	17.4	61.3	0.94
chr6	6614913	6615459	CpG: 51	546	51	401	18.7	73.4	0.70
chr6	6631754	6632094	CpG: 29	340	29	246	17.1	72.4	0.65
chr6	6809519	6810060	CpG: 46	541	46	386	17.0	71.3	0.67
chr6	6822044	6822329	CpG: 32	285	32	215	22.5	75.4	0.79
chr6	6920770	6922206	CpG: 139	1436	139	1030	19.4	71.7	0.75
chr6	6934245	6934485	CpG: 21	240	21	147	17.5	61.2	0.96
chr6	6976448	6979236	CpG: 293	2788	293	1963	21.0	70.4	0.85
chr6	7000611	7000835	CpG: 19	224	19	134	17.0	59.8	0.97
chr6	7010412	7010952	CpG: 60	540	60	393	22.2	72.8	0.85
chr6	7090809	7091098	CpG: 24	289	24	178	16.6	61.6	0.89
chr6	7099270	7100258	CpG: 91	988	91	668	18.4	67.6	0.81
chr6	7116059	7116966	CpG: 82	907	82	622	18.1	68.6	0.78
chr6	7130709	7131009	CpG: 21	300	21	190	14.0	63.3	0.71
chr6	7138562	7138775	CpG: 17	213	17	136	16.0	63.8	0.79
chr6	7175733	7175964	CpG: 17	231	17	140	14.7	60.6	0.82
chr6	7181640	7182485	CpG: 84	845	84	594	19.9	70.3	0.80
chr6	7185862	7186170	CpG: 31	308	31	224	20.1	72.7	0.76
chr6	7213292	7213681	CpG: 31	389	31	278	15.9	71.5	0.62
chr6	7258440	7259192	CpG: 68	752	68	488	18.1	64.9	0.86
chr6	7294781	7295171	CpG: 42	390	42	287	21.5	73.6	0.80
chr6	7310194	7310720	CpG: 39	526	39	361	14.8	68.6	0.63
chr6	7325274	7325814	CpG: 47	540	47	391	17.4	72.4	0.66
chr6	7410325	7412279	CpG: 211	1954	211	1372	21.6	70.2	0.88
chr6	7459210	7459760	CpG: 61	550	61	393	22.2	71.5	0.89
chr6	7594598	7596664	CpG: 240	2066	240	1488	23.2	72.0	0.90
chr6	7597388	7597611	CpG: 17	223	17	138	15.2	61.9	0.80
chr6	7707413	7707645	CpG: 17	232	17	137	14.7	59.1	0.86
chr6	7725372	7725646	CpG: 24	274	24	171	17.5	62.4	0.91
chr6	7778603	7779934	CpG: 184	1331	184	1028	27.6	77.2	0.94
chr6	7830612	7830886	CpG: 22	274	22	171	16.1	62.4	0.84
chr6	7854856	7855370	CpG: 41	514	41	312	16.0	60.7	0.89
chr6	7891361	7891635	CpG: 23	274	23	170	16.8	62.0	0.88
chr6	7910439	7910705	CpG: 20	266	20	163	15.0	61.3	0.82
chr6	7920781	7921016	CpG: 18	235	18	142	15.3	60.4	0.86
chr6	7932549	7933268	CpG: 61	719	61	465	17.0	64.7	0.81
chr6	7971016	7971444	CpG: 37	428	37	287	17.3	67.1	0.77
chr6	7979500	7979774	CpG: 24	274	24	170	17.5	62.0	0.92
chr6	7985321	7985603	CpG: 21	282	21	170	14.9	60.3	0.84
chr6	8033440	8033827	CpG: 32	387	32	279	16.5	72.1	0.64
chr6	8034444	8034798	CpG: 30	354	30	207	16.9	58.5	1.00
chr6	8096791	8097072	CpG: 25	281	25	177	17.8	63.0	0.91
chr6	8151617	8151998	CpG: 40	381	40	263	21.0	69.0	0.88
chr6	8304365	8305192	CpG: 71	827	71	531	17.2	64.2	0.84
chr6	8625973	8626196	CpG: 18	223	18	134	16.1	60.1	0.92
chr6	8645440	8645907	CpG: 35	467	35	280	15.0	60.0	0.84
chr6	8756547	8756936	CpG: 35	389	35	281	18.0	72.2	0.69
chr6	8834457	8834731	CpG: 23	274	23	174	16.8	63.5	0.84
chr6	8868576	8868810	CpG: 21	234	21	145	17.9	62.0	0.94
chr6	8893588	8894115	CpG: 51	527	51	390	19.4	74.0	0.71
chr6	8910072	8910541	CpG: 46	469	46	335	19.6	71.4	0.77
chr6	9086021	9086299	CpG: 22	278	22	171	15.8	61.5	0.84
chr6	9132303	9132527	CpG: 18	224	18	134	16.1	59.8	0.91
chr6	9159228	9159617	CpG: 41	389	41	295	21.1	75.8	0.73
chr6	9267646	9268152	CpG: 41	506	41	333	16.2	65.8	0.75
chr6	9302416	9302685	CpG: 21	269	21	163	15.6	60.6	0.86
chr6	9362914	9363193	CpG: 26	279	26	176	18.6	63.1	0.94
chr6	9679604	9679898	CpG: 26	294	26	183	17.7	62.2	0.92
chr6	9840347	9840576	CpG: 19	229	19	135	16.6	59.0	0.96
chr6	9943037	9943547	CpG: 57	510	57	384	22.4	75.3	0.79
chr6	10175687	10175902	CpG: 17	215	17	130	15.8	60.5	0.88
chr6	10187034	10187549	CpG: 47	515	47	331	18.3	64.3	1.32
chr6	10205153	10205542	CpG: 31	389	31	278	15.9	71.5	0.63
chr6	10216648	10216884	CpG: 19	236	19	144	16.1	61.0	0.89
chr6	10249052	10249848	CpG: 58	796	58	527	14.6	66.2	0.67
chr6	10251019	10251608	CpG: 48	589	48	395	16.3	67.1	0.74
chr6	10252459	10252986	CpG: 56	527	56	330	21.3	62.6	1.09
chr6	10257533	10258060	CpG: 40	527	40	306	15.2	58.1	0.90
chr6	10258383	10258593	CpG: 16	210	16	134	15.2	63.8	0.79
chr6	10265914	10266309	CpG: 32	395	32	269	16.2	68.1	0.75
chr6	10271859	10272677	CpG: 100	818	100	576	24.4	70.4	0.99
chr6	10277606	10278187	CpG: 45	581	45	376	15.5	64.7	0.78
chr6	10278892	10281353	CpG: 204	2461	204	1548	16.6	62.9	0.84
chr6	10281711	10281993	CpG: 24	282	24	192	17.0	68.1	0.74
chr6	10282509	10282809	CpG: 31	300	31	183	20.7	61.0	1.13
chr6	10284878	10285336	CpG: 39	458	39	297	17.0	64.8	0.81
chr6	10286893	10287817	CpG: 68	924	68	610	14.7	66.0	0.69
chr6	10288908	10289221	CpG: 30	313	30	217	19.2	69.3	0.82
chr6	10289815	10290142	CpG: 26	327	26	221	15.9	67.6	0.70
chr6	10293700	10294138	CpG: 43	438	43	314	19.6	71.7	0.77
chr6	10303114	10303349	CpG: 17	235	17	135	14.5	57.4	0.90
chr6	10350403	10350803	CpG: 43	400	43	302	21.5	75.5	0.76
chr6	10355459	10355866	CpG: 38	407	38	285	18.7	70.0	0.76
chr6	10484744	10485087	CpG: 30	343	30	251	17.5	73.2	0.66
chr6	10527481	10528006	CpG: 45	525	45	382	17.1	72.8	0.65
chr6	10562103	10562838	CpG: 56	735	56	424	15.2	57.7	0.92
chr6	10587821	10588573	CpG: 64	752	64	537	17.0	71.4	0.67
chr6	10590486	10591073	CpG: 52	587	52	376	17.7	64.1	0.88
chr6	10607386	10607612	CpG: 18	226	18	124	15.9	54.9	1.08
chr6	10615294	10615585	CpG: 41	291	41	214	28.2	73.5	1.09
chr6	10705505	10706322	CpG: 68	817	68	555	16.6	67.9	0.72
chr6	10749226	10749431	CpG: 23	205	23	132	22.4	64.4	1.15
chr6	10750306	10750529	CpG: 21	223	21	147	18.8	65.9	0.88
chr6	10751588	10751847	CpG: 21	259	21	160	16.2	61.8	0.85
chr6	10754325	10755022	CpG: 55	697	55	413	15.8	59.3	0.91
chr6	10911297	10912590	CpG: 179	1293	179	966	27.7	74.7	0.99
chr6	10919163	10919436	CpG: 24	273	24	170	17.6	62.3	0.91
chr6	10927616	10927853	CpG: 20	237	20	142	16.9	59.9	0.97
chr6	10955160	10955584	CpG: 42	424	42	311	19.8	73.3	0.74
chr6	10961274	10962354	CpG: 115	1080	115	742	21.3	68.7	0.90
chr6	11038880	11039448	CpG: 52	568	52	418	18.3	73.6	0.68
chr6	11067652	11067897	CpG: 21	245	21	150	17.1	61.2	0.94
chr6	11270512	11271055	CpG: 50	543	50	395	18.4	72.7	0.70
chr6	11284891	11285352	CpG: 48	461	48	341	20.8	74.0	0.76
chr6	11312078	11312362	CpG: 25	284	25	178	17.6	62.7	0.91
chr6	11405995	11407387	CpG: 182	1392	182	1065	26.1	76.5	0.89
chr6	11459898	11460143	CpG: 20	245	20	148	16.3	60.4	0.91
chr6	11517265	11517470	CpG: 17	205	17	124	16.6	60.5	0.93
chr6	11649508	11649780	CpG: 22	272	22	167	16.2	61.4	0.87
chr6	11763745	11763984	CpG: 18	239	18	140	15.1	58.6	0.90
chr6	11801035	11801483	CpG: 42	448	42	327	18.8	73.0	0.70
chr6	11877106	11877583	CpG: 67	477	67	361	28.1	75.7	1.03
chr6	11879461	11881300	CpG: 232	1839	232	1409	25.2	76.6	0.86
chr6	11967371	11967630	CpG: 23	259	23	161	17.8	62.2	0.92
chr6	11976554	11976945	CpG: 34	391	34	288	17.4	73.7	0.64
chr6	12079492	12079729	CpG: 20	237	20	146	16.9	61.6	0.91
chr6	12192176	12192409	CpG: 18	233	18	141	15.5	60.5	0.87
chr6	12205934	12206148	CpG: 19	214	19	132	17.8	61.7	0.94
chr6	12313031	12313265	CpG: 18	234	18	135	15.4	57.7	0.94
chr6	12335834	12336101	CpG: 20	267	20	159	15.0	59.6	0.86
chr6	12485495	12485776	CpG: 23	281	23	174	16.4	61.9	0.86
chr6	12532434	12532708	CpG: 25	274	25	172	18.2	62.8	0.93
chr6	12617997	12618698	CpG: 73	701	73	498	20.8	71.0	0.83
chr6	12636601	12636837	CpG: 17	236	17	141	14.4	59.7	0.83
chr6	12882140	12882751	CpG: 76	611	76	434	24.9	71.0	1.00
chr6	12883201	12883431	CpG: 20	230	20	157	17.4	68.3	0.75
chr6	12902501	12902775	CpG: 22	274	22	168	16.1	61.3	0.87
chr6	13006777	13007621	CpG: 62	844	62	578	14.7	68.5	0.63
chr6	13201595	13202104	CpG: 56	509	56	357	22.0	70.1	0.89
chr6	13238009	13238959	CpG: 82	950	82	623	17.3	65.6	0.80
chr6	13359592	13362060	CpG: 234	2468	234	1644	19.0	66.6	0.86
chr6	13384547	13384939	CpG: 41	392	41	290	20.9	74.0	0.77
chr6	13385873	13386147	CpG: 26	274	26	184	19.0	67.2	0.84
chr6	13414921	13415472	CpG: 50	551	50	400	18.1	72.6	0.69
chr6	13447763	13448777	CpG: 93	1014	93	720	18.3	71.0	0.75
chr6	13488226	13489228	CpG: 108	1002	108	679	21.6	67.8	0.94
chr6	13491819	13492104	CpG: 24	285	24	178	16.8	62.5	0.88
chr6	13584273	13585850	CpG: 230	1577	230	1228	29.2	77.9	0.97
chr6	13590153	13590708	CpG: 52	555	52	405	18.7	73.0	0.70
chr6	13616600	13617184	CpG: 54	584	54	420	18.5	71.9	0.72
chr6	13621033	13621264	CpG: 18	231	18	138	15.6	59.7	0.89
chr6	13642724	13643569	CpG: 72	845	72	569	17.0	67.3	0.75
chr6	13646111	13646499	CpG: 29	388	29	273	14.9	70.4	0.61
chr6	13687312	13688315	CpG: 134	1003	134	762	26.7	76.0	0.93
chr6	13733427	13734127	CpG: 69	700	69	508	19.7	72.6	0.75
chr6	13745505	13745844	CpG: 28	339	28	246	16.5	72.6	0.63
chr6	13747089	13747586	CpG: 40	497	40	347	16.1	69.8	0.67
chr6	13773248	13773514	CpG: 19	266	19	162	14.3	60.9	0.78
chr6	13796931	13797703	CpG: 105	772	105	608	27.2	78.8	0.88
chr6	13874729	13875205	CpG: 41	476	41	337	17.2	70.8	0.69
chr6	13890335	13890839	CpG: 42	504	42	366	16.7	72.6	0.63
chr6	13962084	13962331	CpG: 21	247	21	152	17.0	61.5	0.90
chr6	13989850	13990428	CpG: 90	578	90	439	31.1	76.0	1.08
chr6	14083390	14084053	CpG: 95	663	95	492	28.7	74.2	1.06
chr6	14396164	14396445	CpG: 22	281	22	173	15.7	61.6	0.84
chr6	14644932	14645173	CpG: 19	241	19	144	15.8	59.8	0.90
chr6	14656773	14657428	CpG: 60	655	60	453	18.3	69.2	0.77
chr6	14789044	14789448	CpG: 34	404	34	291	16.8	72.0	0.65
chr6	14897187	14897402	CpG: 16	215	16	130	14.9	60.5	0.82
chr6	14902735	14902976	CpG: 17	241	17	142	14.1	58.9	0.84
chr6	15095696	15095962	CpG: 23	266	23	167	17.3	62.8	0.88
chr6	15117841	15122178	CpG: 327	4337	327	2507	15.1	57.8	0.92
chr6	15165275	15165512	CpG: 18	237	18	138	15.2	58.2	0.92
chr6	15369727	15370259	CpG: 51	532	51	352	19.2	66.2	0.88
chr6	15390219	15390494	CpG: 21	275	21	179	15.3	65.1	0.73
chr6	15439259	15439490	CpG: 20	231	20	140	17.3	60.6	0.95
chr6	15535406	15536374	CpG: 116	968	116	712	24.0	73.6	0.89
chr6	15559054	15559292	CpG: 23	238	23	144	19.3	60.5	1.08
chr6	15564354	15564595	CpG: 17	241	17	140	14.1	58.1	0.85
chr6	15565993	15566225	CpG: 17	232	17	139	14.7	59.9	0.83
chr6	15628690	15628971	CpG: 25	281	25	176	17.8	62.6	0.93
chr6	15941428	15941768	CpG: 37	340	37	251	21.8	73.8	0.80
chr6	15992116	15992358	CpG: 18	242	18	146	14.9	60.3	0.84
chr6	16001338	16002369	CpG: 113	1031	113	764	21.9	74.1	0.81
chr6	16053302	16053690	CpG: 34	388	34	276	17.5	71.1	0.70
chr6	16070640	16071209	CpG: 52	569	52	412	18.3	72.4	0.70
chr6	16089256	16089637	CpG: 38	381	38	275	19.9	72.2	0.77
chr6	16099623	16099872	CpG: 28	249	28	192	22.5	77.1	0.77
chr6	16110734	16111614	CpG: 86	880	86	577	19.5	65.6	0.91
chr6	16138876	16139089	CpG: 16	213	16	117	15.0	54.9	1.00
chr6	16139402	16139683	CpG: 23	281	23	165	16.4	58.7	0.95
chr6	16160807	16161132	CpG: 26	325	26	237	16.0	72.9	0.60
chr6	16199274	16200105	CpG: 56	831	56	548	13.5	65.9	0.64
chr6	16200496	16200890	CpG: 30	394	30	267	15.2	67.8	0.66
chr6	16219409	16219791	CpG: 34	382	34	276	17.8	72.3	0.68
chr6	16485665	16485946	CpG: 23	281	23	175	16.4	62.3	0.86
chr6	16632642	16635449	CpG: 265	2807	265	1906	18.9	67.9	0.82
chr6	16887578	16888006	CpG: 41	428	41	293	19.2	68.5	0.82
chr6	16973707	16973937	CpG: 34	230	34	173	29.6	75.2	1.09
chr6	17001196	17001420	CpG: 17	224	17	136	15.2	60.7	0.84
chr6	17037745	17038022	CpG: 24	277	24	171	17.3	61.7	0.92
chr6	17072125	17072475	CpG: 37	350	37	248	21.1	70.9	0.84
chr6	17138853	17139083	CpG: 18	230	18	139	15.7	60.4	0.87
chr6	17152571	17154166	CpG: 174	1595	174	1112	21.8	69.7	0.90
chr6	17226440	17226658	CpG: 16	218	16	132	14.7	60.6	0.83
chr6	17249518	17249792	CpG: 21	274	21	164	15.3	59.9	0.87
chr6	17265771	17266243	CpG: 67	472	67	371	28.4	78.6	0.95
chr6	17269557	17269780	CpG: 19	223	19	137	17.0	61.4	0.92
chr6	17296216	17296456	CpG: 20	240	20	143	16.7	59.6	0.96
chr6	17344167	17344441	CpG: 23	274	23	170	16.8	62.0	0.88
chr6	17452708	17453196	CpG: 52	488	52	354	21.3	72.5	0.81
chr6	17471118	17471392	CpG: 20	274	20	166	14.6	60.6	0.80
chr6	17472354	17473369	CpG: 106	1015	106	741	20.9	73.0	0.78
chr6	17518413	17518687	CpG: 19	274	19	164	13.9	59.9	0.78
chr6	17578312	17579359	CpG: 116	1047	116	732	22.2	69.9	0.91
chr6	17598207	17598481	CpG: 20	274	20	166	14.6	60.6	0.80
chr6	17601021	17601404	CpG: 43	383	43	289	22.5	75.5	0.79
chr6	17617544	17617934	CpG: 38	390	38	277	19.5	71.0	0.77
chr6	17842103	17842381	CpG: 23	278	23	171	16.5	61.5	0.89
chr6	17848336	17848718	CpG: 41	382	41	284	21.5	74.3	0.78
chr6	17859359	17860349	CpG: 162	990	162	793	32.7	80.1	1.02
chr6	17871231	17871505	CpG: 23	274	23	169	16.8	61.7	0.89
chr6	17882165	17882376	CpG: 17	211	17	125	16.1	59.2	0.95
chr6	17891788	17892578	CpG: 73	790	73	552	18.5	69.9	0.76
chr6	17994189	17994933	CpG: 77	744	77	515	20.7	69.2	0.86
chr6	18027134	18028276	CpG: 125	1142	125	801	21.9	70.1	0.89
chr6	18136008	18137101	CpG: 153	1093	153	804	28.0	73.6	1.04
chr6	18149330	18149975	CpG: 66	645	66	456	20.5	70.7	0.82
chr6	18200381	18200662	CpG: 24	281	24	175	17.1	62.3	0.90
chr6	18259724	18260120	CpG: 34	396	34	252	17.2	63.6	0.86
chr6	18395719	18395946	CpG: 16	227	16	133	14.1	58.6	0.83
chr6	19008715	19008996	CpG: 22	281	22	173	15.7	61.6	0.84
chr6	19205352	19205587	CpG: 17	235	17	141	14.5	60.0	0.82
chr6	19218007	19218281	CpG: 25	274	25	171	18.2	62.4	0.95
chr6	19329939	19330213	CpG: 23	274	23	171	16.8	62.4	0.88
chr6	19525621	19525855	CpG: 16	234	16	138	13.7	59.0	0.82
chr6	19545306	19545547	CpG: 18	241	18	143	14.9	59.3	0.88
chr6	19563298	19563693	CpG: 37	395	37	270	18.7	68.4	0.81
chr6	19589280	19589516	CpG: 18	236	18	142	15.3	60.2	0.87
chr6	19636537	19636964	CpG: 31	427	31	252	14.5	59.0	0.84
chr6	19676268	19676784	CpG: 64	516	64	374	24.8	72.5	0.95
chr6	19708492	19710727	CpG: 247	2235	247	1580	22.1	70.7	0.88
chr6	19726024	19726443	CpG: 40	419	40	311	19.1	74.2	0.69
chr6	19904333	19904827	CpG: 53	494	53	360	21.5	72.9	0.81
chr6	19973920	19974198	CpG: 25	278	25	175	18.0	62.9	0.92
chr6	20028182	20028447	CpG: 18	265	18	159	13.6	60.0	0.77
chr6	20065217	20065492	CpG: 21	275	21	170	15.3	61.8	0.80
chr6	20084237	20085102	CpG: 92	865	92	621	21.3	71.8	0.83
chr6	20105215	20105734	CpG: 43	519	43	368	16.6	70.9	0.66
chr6	20111083	20111613	CpG: 43	530	43	383	16.2	72.3	0.62
chr6	20117056	20117292	CpG: 19	236	19	170	16.1	72.0	0.62
chr6	20131645	20132044	CpG: 33	399	33	281	16.5	70.4	0.67
chr6	20173362	20173706	CpG: 28	344	28	245	16.3	71.2	0.64
chr6	20190867	20191366	CpG: 44	499	44	357	17.6	71.5	0.69
chr6	20211447	20211713	CpG: 27	266	27	170	20.3	63.9	1.01
chr6	20273524	20276175	CpG: 238	2651	238	1811	18.0	68.3	0.77
chr6	20416324	20416559	CpG: 20	235	20	142	17.0	60.4	0.95
chr6	20439915	20440147	CpG: 16	232	16	141	13.8	60.8	0.77
chr6	20637063	20637341	CpG: 25	278	25	175	18.0	62.9	0.92
chr6	20746853	20747133	CpG: 23	280	23	172	16.4	61.4	0.88
chr6	20759544	20759818	CpG: 24	274	24	170	17.5	62.0	0.92
chr6	20808381	20808655	CpG: 24	274	24	170	17.5	62.0	0.92
chr6	20986093	20986333	CpG: 20	240	20	149	16.7	62.1	0.88
chr6	21064161	21064442	CpG: 23	281	23	174	16.4	61.9	0.87
chr6	21120386	21120664	CpG: 24	278	24	175	17.3	62.9	0.88
chr6	21257424	21257655	CpG: 18	231	18	142	15.6	61.5	0.84
chr6	21366788	21367021	CpG: 17	233	17	134	14.6	57.5	0.90
chr6	21371378	21371607	CpG: 18	229	18	137	15.7	59.8	0.89
chr6	21424927	21425315	CpG: 31	388	31	274	16.0	70.6	0.64
chr6	21459585	21461604	CpG: 146	2019	146	1260	14.5	62.4	0.74
chr6	21467043	21468867	CpG: 230	1824	230	1271	25.2	69.7	1.04
chr6	21469161	21469521	CpG: 27	360	27	223	15.0	61.9	0.82
chr6	21521924	21522202	CpG: 23	278	23	172	16.5	61.9	0.87
chr6	21530678	21530952	CpG: 21	274	21	169	15.3	61.7	0.82
chr6	21531789	21532064	CpG: 20	275	20	167	14.5	60.7	0.80
chr6	21536947	21537618	CpG: 75	671	75	458	22.4	68.3	0.96
chr6	21538155	21538471	CpG: 24	316	24	210	15.2	66.5	0.74
chr6	21538879	21539302	CpG: 32	423	32	276	15.1	65.2	0.73
chr6	21561312	21561542	CpG: 16	230	16	136	13.9	59.1	0.80
chr6	21832526	21832737	CpG: 15	211	15	124	14.2	58.8	0.85
chr6	21929906	21930168	CpG: 18	262	18	161	13.7	61.5	0.74
chr6	22053280	22053580	CpG: 24	300	24	186	16.0	62.0	0.84
chr6	22229118	22229397	CpG: 22	279	22	198	15.8	71.0	0.63
chr6	22441802	22442923	CpG: 113	1121	113	756	20.2	67.4	0.89
chr6	22518899	22519143	CpG: 18	244	18	145	14.8	59.4	0.84
chr6	22593718	22594003	CpG: 23	285	23	173	16.1	60.7	0.90
chr6	22655165	22655440	CpG: 24	275	24	171	17.5	62.2	0.91
chr6	22687255	22687528	CpG: 23	273	23	173	16.8	63.4	0.85
chr6	22851657	22851889	CpG: 18	232	18	141	15.5	60.8	0.85
chr6	22892630	22892911	CpG: 24	281	24	176	17.1	62.6	0.89
chr6	22926142	22926423	CpG: 24	281	24	175	17.1	62.3	0.90
chr6	22977268	22977549	CpG: 22	281	22	174	15.7	61.9	0.83
chr6	23550661	23550879	CpG: 21	218	21	135	19.3	61.9	1.02
chr6	23559560	23559841	CpG: 23	281	23	174	16.4	61.9	0.87
chr6	23650386	23650660	CpG: 22	274	22	169	16.1	61.7	0.86
chr6	23715499	23715778	CpG: 25	279	25	175	17.9	62.7	0.92
chr6	23997696	23997952	CpG: 42	256	42	202	32.8	78.9	1.07
chr6	24162422	24162696	CpG: 22	274	22	169	16.1	61.7	0.86
chr6	24227450	24228040	CpG: 56	590	56	375	19.0	63.6	0.94
chr6	24229768	24230150	CpG: 44	382	44	266	23.0	69.6	0.95
chr6	24259113	24259348	CpG: 21	235	21	144	17.9	61.3	0.97
chr6	24272896	24273493	CpG: 58	597	58	415	19.4	69.5	0.81
chr6	24364694	24365423	CpG: 93	729	93	542	25.5	74.3	0.92
chr6	24472473	24472710	CpG: 18	237	18	142	15.2	59.9	0.87
chr6	24515693	24516301	CpG: 65	608	65	416	21.4	68.4	0.94
chr6	24536703	24537562	CpG: 77	859	77	553	17.9	64.4	0.87
chr6	24591292	24592824	CpG: 114	1532	114	921	14.9	60.1	0.83
chr6	24645953	24646636	CpG: 72	683	72	461	21.1	67.5	0.94
chr6	24775467	24776427	CpG: 82	960	82	635	17.1	66.1	0.78
chr6	24992026	24992231	CpG: 17	205	17	121	16.6	59.0	0.98
chr6	25005428	25005754	CpG: 36	326	36	221	22.1	67.8	0.97
chr6	25109987	25110220	CpG: 18	233	18	140	15.5	60.1	0.87
chr6	25144713	25145417	CpG: 78	704	78	500	22.2	71.0	0.88
chr6	25329649	25329923	CpG: 21	274	21	166	15.3	60.6	0.85
chr6	25451879	25452632	CpG: 58	753	58	518	15.4	68.8	0.65
chr6	25517962	25518291	CpG: 30	329	30	211	18.2	64.1	0.89
chr6	25574611	25574850	CpG: 18	239	18	142	15.1	59.4	0.87
chr6	25592004	25592272	CpG: 20	268	20	144	14.9	53.7	1.04
chr6	25598242	25598507	CpG: 25	265	25	173	18.9	65.3	0.89
chr6	25747915	25748148	CpG: 24	233	24	157	20.6	67.4	0.91
chr6	25763592	25763828	CpG: 21	236	21	145	17.8	61.4	0.96
chr6	25785279	25785546	CpG: 20	267	20	162	15.0	60.7	0.83
chr6	25857892	25858875	CpG: 67	983	67	588	13.6	59.8	0.76
chr6	25886382	25887153	CpG: 62	771	62	429	16.1	55.6	1.04
chr6	25887668	25887904	CpG: 24	236	24	146	20.3	61.9	1.07
chr6	25892868	25893334	CpG: 39	466	39	252	16.7	54.1	1.16
chr6	25897608	25897992	CpG: 38	384	38	232	19.8	60.4	1.09
chr6	25899202	25899515	CpG: 35	313	35	198	22.4	63.3	1.12
chr6	25907365	25907600	CpG: 17	235	17	133	14.5	56.6	0.94
chr6	25908779	25909139	CpG: 28	360	28	205	15.6	56.9	0.96
chr6	25912139	25912405	CpG: 22	266	22	148	16.5	55.6	1.07
chr6	25913580	25913969	CpG: 39	389	39	236	20.1	60.7	1.10
chr6	25924104	25924735	CpG: 46	631	46	376	14.6	59.6	0.82
chr6	25972104	25972422	CpG: 29	318	29	173	18.2	54.4	1.25
chr6	25992413	25992702	CpG: 33	289	33	190	22.8	65.7	1.06
chr6	25993967	25994203	CpG: 19	236	19	144	16.1	61.0	0.88
chr6	26014030	26014304	CpG: 22	274	22	169	16.1	61.7	0.86
chr6	26017128	26017367	CpG: 18	239	18	143	15.1	59.8	0.86
chr6	26022909	26023120	CpG: 17	211	17	128	16.1	60.7	0.89
chr6	26024357	26025452	CpG: 85	1095	85	668	15.5	61.0	0.83
chr6	26039942	26040644	CpG: 69	702	69	437	19.7	62.3	1.02
chr6	26051943	26052243	CpG: 28	300	28	182	18.7	60.7	1.02
chr6	26055895	26056169	CpG: 22	274	22	169	16.1	61.7	0.85
chr6	26057230	26057528	CpG: 30	298	30	171	20.1	57.4	1.22
chr6	26065303	26065770	CpG: 42	467	42	281	18.0	60.2	0.99
chr6	26067435	26067704	CpG: 33	269	33	182	24.5	67.7	1.07
chr6	26068076	26068358	CpG: 24	282	24	171	17.0	60.6	0.93
chr6	26073000	26073449	CpG: 40	449	40	239	17.8	53.2	1.27
chr6	26081086	26081364	CpG: 26	278	26	176	18.7	63.3	0.94
chr6	26082645	26082890	CpG: 21	245	21	151	17.1	61.6	0.92
chr6	26085460	26085770	CpG: 32	310	32	188	20.6	60.6	1.12
chr6	26093631	26094035	CpG: 39	404	39	249	19.3	61.6	1.02
chr6	26108935	26109189	CpG: 27	254	27	149	21.3	58.7	1.24
chr6	26115059	26115344	CpG: 24	285	24	167	16.8	58.6	0.98
chr6	26118679	26119070	CpG: 35	391	35	240	17.9	61.4	0.96
chr6	26120141	26120476	CpG: 27	335	27	201	16.1	60.0	0.90
chr6	26122309	26122695	CpG: 32	386	32	231	16.6	59.8	0.93
chr6	26139576	26139819	CpG: 29	243	29	152	23.9	62.6	1.22
chr6	26140701	26140927	CpG: 25	226	25	151	22.1	66.8	0.99
chr6	26141522	26141789	CpG: 24	267	24	161	18.0	60.3	0.99
chr6	26153562	26154079	CpG: 40	517	40	285	15.5	55.1	1.04
chr6	26188405	26188618	CpG: 16	213	16	127	15.0	59.6	0.87
chr6	26190596	26191005	CpG: 38	409	38	245	18.6	59.9	1.04
chr6	26326447	26326671	CpG: 19	224	19	142	17.0	63.4	0.92
chr6	26369904	26370286	CpG: 45	382	45	253	23.6	66.2	1.08
chr6	26389166	26390750	CpG: 132	1584	132	977	16.7	61.7	0.88
chr6	26403934	26404151	CpG: 16	217	16	124	14.7	57.1	0.92
chr6	26405700	26405980	CpG: 22	280	22	161	15.7	57.5	0.96
chr6	26406343	26407182	CpG: 62	839	62	498	14.8	59.4	0.84
chr6	26418947	26419281	CpG: 32	334	32	221	19.2	66.2	0.88
chr6	26427862	26428135	CpG: 23	273	23	168	16.8	61.5	0.90
chr6	26434312	26434578	CpG: 26	266	26	171	19.5	64.3	0.96
chr6	26464253	26464528	CpG: 28	275	28	183	20.4	66.5	0.92
chr6	26465332	26465759	CpG: 39	427	39	268	18.3	62.8	0.94
chr6	26466315	26466523	CpG: 19	208	19	130	18.3	62.5	0.94
chr6	26466731	26466965	CpG: 19	234	19	147	16.2	62.8	0.83
chr6	26482216	26483054	CpG: 63	838	63	528	15.0	63.0	0.76
chr6	26493714	26493987	CpG: 21	273	21	166	15.4	60.8	0.85
chr6	26527716	26528345	CpG: 51	629	51	425	16.2	67.6	0.71
chr6	26557960	26558249	CpG: 34	289	34	201	23.5	69.6	0.98
chr6	26590806	26591344	CpG: 40	538	40	319	14.9	59.3	0.85
chr6	26592068	26592344	CpG: 25	276	25	168	18.1	60.9	0.99
chr6	26603576	26603851	CpG: 21	275	21	152	15.3	55.3	1.00
chr6	26634573	26634848	CpG: 21	275	21	151	15.3	54.9	1.01
chr6	26646072	26646348	CpG: 25	276	25	168	18.1	60.9	0.99
chr6	26647072	26647610	CpG: 41	538	41	319	15.2	59.3	0.87
chr6	26680161	26680450	CpG: 34	289	34	201	23.5	69.6	0.98
chr6	26764051	26764369	CpG: 22	318	22	192	13.8	60.4	0.78
chr6	26824882	26825493	CpG: 67	611	67	468	21.9	76.6	0.75
chr6	26888316	26888919	CpG: 53	603	53	364	17.6	60.4	0.97
chr6	26913827	26914163	CpG: 28	336	28	242	16.7	72.0	0.65
chr6	26915384	26915684	CpG: 25	300	25	183	16.7	61.0	0.91
chr6	26965525	26966063	CpG: 43	538	43	306	16.0	56.9	0.99
chr6	26967827	26968042	CpG: 18	215	18	124	16.7	57.7	1.02
chr6	27001210	27002160	CpG: 74	950	74	537	15.6	56.5	0.98
chr6	27008174	27008430	CpG: 30	256	30	166	23.4	64.8	1.12
chr6	27015259	27016218	CpG: 72	959	72	542	15.0	56.5	0.94
chr6	27016693	27016937	CpG: 18	244	18	147	14.8	60.2	0.83
chr6	27044454	27044741	CpG: 24	287	24	179	16.7	62.4	0.87
chr6	27046363	27046742	CpG: 29	379	29	235	15.3	62.0	0.80
chr6	27047253	27047502	CpG: 21	249	21	137	16.9	55.0	1.12
chr6	27059593	27059851	CpG: 20	258	20	161	15.5	62.4	0.82
chr6	27077425	27077705	CpG: 24	280	24	170	17.1	60.7	0.93
chr6	27079714	27080055	CpG: 26	341	26	194	15.2	56.9	0.95
chr6	27082480	27082741	CpG: 21	261	21	153	16.1	58.6	0.96
chr6	27083740	27084015	CpG: 20	275	20	149	14.5	54.2	1.02
chr6	27085459	27085849	CpG: 27	390	27	230	13.8	59.0	0.80
chr6	27096313	27096550	CpG: 19	237	19	139	16.0	58.6	0.94
chr6	27096926	27097211	CpG: 24	285	24	174	16.8	61.1	0.91
chr6	27101794	27102076	CpG: 22	282	22	174	15.6	61.7	0.84
chr6	27119846	27120867	CpG: 83	1021	83	687	16.3	67.3	0.75
chr6	27129158	27129422	CpG: 24	264	24	170	18.2	64.4	0.88
chr6	27141355	27141641	CpG: 25	286	25	179	17.5	62.6	0.91
chr6	27152844	27153267	CpG: 30	423	30	213	14.2	50.4	1.15
chr6	27160292	27160497	CpG: 16	205	16	114	15.6	55.6	1.01
chr6	27181122	27181963	CpG: 72	841	72	530	17.1	63.0	0.89
chr6	27243816	27244158	CpG: 28	342	28	216	16.4	63.2	0.85
chr6	27250160	27250693	CpG: 46	533	46	383	17.3	71.9	0.67
chr6	27257819	27258347	CpG: 44	528	44	333	16.7	63.1	0.85
chr6	27293908	27294299	CpG: 37	391	37	288	18.9	73.7	0.70
chr6	27341966	27342772	CpG: 63	806	63	480	15.6	59.6	0.88
chr6	27348633	27348873	CpG: 19	240	19	124	15.8	51.7	1.22
chr6	27364984	27365187	CpG: 18	203	18	128	17.7	63.1	0.90
chr6	27384691	27384892	CpG: 18	201	18	115	17.9	57.2	1.13
chr6	27388616	27388873	CpG: 24	257	24	151	18.7	58.8	1.08
chr6	27395080	27395359	CpG: 23	279	23	172	16.5	61.6	0.88
chr6	27395860	27396094	CpG: 19	234	19	137	16.2	58.5	0.99
chr6	27399411	27399644	CpG: 24	233	24	176	20.6	75.5	0.72
chr6	27408653	27408929	CpG: 23	276	23	168	16.7	60.9	0.90
chr6	27413808	27414032	CpG: 17	224	17	131	15.2	58.5	0.93
chr6	27425136	27425638	CpG: 36	502	36	275	14.3	54.8	0.96
chr6	27435847	27436168	CpG: 23	321	23	182	14.3	56.7	0.89
chr6	27446611	27446868	CpG: 22	257	22	146	17.1	56.8	1.09
chr6	27457646	27457863	CpG: 18	217	18	132	16.6	60.8	0.92
chr6	27473204	27473444	CpG: 18	240	18	143	15.0	59.6	0.85
chr6	27484051	27484326	CpG: 22	275	22	164	16.0	59.6	0.92
chr6	27500556	27501146	CpG: 45	590	45	344	15.3	58.3	0.92
chr6	27522697	27523607	CpG: 84	910	84	635	18.5	69.8	0.76
chr6	27533145	27533381	CpG: 19	236	19	141	16.1	59.7	0.92
chr6	27538227	27538551	CpG: 25	324	25	174	15.4	53.7	1.07
chr6	27548983	27549192	CpG: 16	209	16	119	15.3	56.9	0.95
chr6	27549668	27550387	CpG: 49	719	49	365	13.6	50.8	1.06
chr6	27557222	27557586	CpG: 29	364	29	223	15.9	61.3	0.85
chr6	27557844	27558091	CpG: 19	247	19	126	15.4	51.0	1.18
chr6	27563195	27563457	CpG: 21	262	21	153	16.0	58.4	0.95
chr6	27568290	27568519	CpG: 17	229	17	135	14.8	59.0	0.87
chr6	27575596	27575809	CpG: 20	213	20	129	18.8	60.6	1.03
chr6	27622372	27622597	CpG: 16	225	16	134	14.2	59.6	0.83
chr6	27627017	27627412	CpG: 33	395	33	277	16.7	70.1	0.68
chr6	27631677	27631925	CpG: 20	248	20	153	16.1	61.7	0.89
chr6	27657523	27657768	CpG: 19	245	19	146	15.5	59.6	0.89
chr6	27659628	27659840	CpG: 16	212	16	119	15.1	56.1	0.97
chr6	27677225	27678154	CpG: 69	929	69	525	14.9	56.5	0.93
chr6	27679751	27680147	CpG: 40	396	40	253	20.2	63.9	0.99
chr6	27684143	27684381	CpG: 27	238	27	160	22.7	67.2	1.01
chr6	27693675	27694112	CpG: 47	437	47	277	21.5	63.4	1.07
chr6	27696378	27698022	CpG: 143	1644	143	1235	17.4	75.1	0.62
chr6	27700885	27701322	CpG: 47	437	47	276	21.5	63.2	1.08
chr6	27707738	27708748	CpG: 79	1010	79	573	15.6	56.7	0.98
chr6	27708906	27709110	CpG: 15	204	15	115	14.7	56.4	0.95
chr6	27726527	27726808	CpG: 24	281	24	174	17.1	61.9	0.90
chr6	27733758	27735299	CpG: 104	1541	104	838	13.5	54.4	0.92
chr6	27737083	27737354	CpG: 26	271	26	166	19.2	61.3	1.02
chr6	27741591	27741962	CpG: 40	371	40	237	21.6	63.9	1.06
chr6	27742894	27743172	CpG: 28	278	28	164	20.1	59.0	1.16
chr6	27744704	27745072	CpG: 26	368	26	207	14.1	56.2	0.90
chr6	27745548	27745823	CpG: 22	275	22	169	16.0	61.5	0.86
chr6	27753902	27754134	CpG: 17	232	17	135	14.7	58.2	0.89
chr6	27760039	27760437	CpG: 38	398	38	240	19.1	60.3	1.05
chr6	27762526	27762791	CpG: 28	265	28	176	21.1	66.4	0.96
chr6	27763190	27763468	CpG: 24	278	24	170	17.3	61.2	0.93
chr6	27763856	27764092	CpG: 21	236	21	133	17.8	56.4	1.14
chr6	27944251	27944536	CpG: 24	285	24	177	16.8	62.1	0.89
chr6	27950455	27951245	CpG: 54	790	54	444	13.7	56.2	0.87
chr6	27974706	27975168	CpG: 43	462	43	321	18.6	69.5	0.77
chr6	28006702	28006913	CpG: 17	211	17	128	16.1	60.7	0.88
chr6	28007026	28007485	CpG: 38	459	38	288	16.6	62.7	0.84
chr6	28011609	28012183	CpG: 45	574	45	364	15.7	63.4	0.78
chr6	28079552	28079875	CpG: 27	323	27	187	16.7	57.9	1.00
chr6	28090769	28091182	CpG: 43	413	43	294	20.8	71.2	0.83
chr6	28096919	28097242	CpG: 31	323	31	216	19.2	66.9	0.89
chr6	28123481	28123703	CpG: 23	222	23	154	20.7	69.4	0.86
chr6	28130930	28131434	CpG: 48	504	48	319	19.0	63.3	0.95
chr6	28138806	28139088	CpG: 23	282	23	185	16.3	65.6	0.77
chr6	28153130	28153532	CpG: 40	402	40	277	19.9	68.9	0.84
chr6	28254792	28255111	CpG: 25	319	25	202	15.7	63.3	0.78
chr6	28270129	28270374	CpG: 20	245	20	141	16.3	57.6	1.00
chr6	28270802	28271374	CpG: 43	572	43	356	15.0	62.2	0.78
chr6	28288237	28288510	CpG: 23	273	23	168	16.8	61.5	0.90
chr6	28340764	28341306	CpG: 52	542	52	391	19.2	72.1	0.74
chr6	28356007	28356237	CpG: 20	230	20	141	17.4	61.3	0.94
chr6	28361217	28361575	CpG: 28	358	28	236	15.6	65.9	0.74
chr6	28373124	28374030	CpG: 72	906	72	637	15.9	70.3	0.64
chr6	28383127	28383649	CpG: 49	522	49	385	18.8	73.8	0.69
chr6	28458460	28458721	CpG: 20	261	20	175	15.3	67.0	0.68
chr6	28487529	28487983	CpG: 43	454	43	297	18.9	65.4	0.89
chr6	28506440	28506882	CpG: 32	442	32	249	14.5	56.3	0.95
chr6	28511365	28511626	CpG: 28	261	28	188	21.5	72.0	0.83
chr6	28512480	28512718	CpG: 20	238	20	144	16.8	60.5	0.94
chr6	28537514	28537739	CpG: 16	225	16	131	14.2	58.2	0.85
chr6	28547497	28547751	CpG: 22	254	22	151	17.3	59.4	1.01
chr6	28580236	28580509	CpG: 18	273	18	150	13.2	54.9	0.89
chr6	28611941	28612213	CpG: 25	272	25	167	18.4	61.4	0.99
chr6	28650601	28650873	CpG: 29	272	29	159	21.3	58.5	1.25
chr6	28656435	28656671	CpG: 18	236	18	147	15.3	62.3	0.81
chr6	28658750	28659027	CpG: 21	277	21	167	15.2	60.3	0.86
chr6	28660831	28661100	CpG: 21	269	21	166	15.6	61.7	0.84
chr6	28665143	28665377	CpG: 17	234	17	136	14.5	58.1	0.87
chr6	28680099	28680493	CpG: 32	394	32	235	16.2	59.6	0.93
chr6	28687594	28687851	CpG: 20	257	20	149	15.6	58.0	0.93
chr6	28688765	28689210	CpG: 40	445	40	278	18.0	62.5	0.93
chr6	28712518	28712740	CpG: 19	222	19	132	17.1	59.5	1.00
chr6	28713563	28713804	CpG: 29	241	29	162	24.1	67.2	1.07
chr6	28738341	28739005	CpG: 49	664	49	372	14.8	56.0	0.94
chr6	28741085	28741616	CpG: 54	531	54	380	20.3	71.6	0.80
chr6	28759885	28760171	CpG: 31	286	31	218	21.7	76.2	0.76
chr6	28770360	28770943	CpG: 42	583	42	299	14.4	51.3	1.11
chr6	28797958	28799101	CpG: 125	1143	125	797	21.9	69.7	0.90
chr6	28801781	28801991	CpG: 17	210	17	117	16.2	55.7	1.04
chr6	28824550	28824938	CpG: 38	388	38	280	19.6	72.2	0.75
chr6	28825257	28825484	CpG: 17	227	17	134	15.0	59.0	0.87
chr6	28826361	28826756	CpG: 30	395	30	229	15.2	58.0	0.91
chr6	28846889	28847147	CpG: 20	258	20	160	15.5	62.0	0.82
chr6	28852170	28852566	CpG: 45	396	45	283	22.7	71.5	0.89
chr6	28863126	28863598	CpG: 44	472	44	266	18.6	56.4	1.18
chr6	28886171	28886424	CpG: 28	253	28	166	22.1	65.6	1.10
chr6	28889573	28890207	CpG: 78	634	78	472	24.6	74.4	0.89
chr6	28891340	28891609	CpG: 24	269	24	169	17.8	62.8	0.90
chr6	28910672	28910981	CpG: 25	309	25	204	16.2	66.0	0.75
chr6	28940957	28941208	CpG: 23	251	23	159	18.3	63.3	0.93
chr6	28958404	28958626	CpG: 15	222	15	130	13.5	58.6	0.81
chr6	29034435	29034944	CpG: 42	509	42	349	16.5	68.6	0.70
chr6	29040418	29040927	CpG: 43	509	43	352	16.9	69.2	0.71
chr6	29193359	29193596	CpG: 17	237	17	140	14.3	59.1	0.85
chr6	29239292	29239558	CpG: 23	266	23	166	17.3	62.4	0.90
chr6	29330901	29331125	CpG: 17	224	17	131	15.2	58.5	0.93
chr6	29419985	29420251	CpG: 22	266	22	165	16.5	62.0	0.87
chr6	29428017	29428740	CpG: 80	723	80	498	22.1	68.9	0.94
chr6	29502225	29503102	CpG: 70	877	70	626	16.0	71.4	0.69
chr6	29506968	29508082	CpG: 102	1114	102	831	18.3	74.6	0.66
chr6	29524685	29524894	CpG: 16	209	16	118	15.3	56.5	0.96
chr6	29564640	29565206	CpG: 38	566	38	336	13.4	59.4	0.77
chr6	29594366	29594593	CpG: 20	227	20	137	17.6	60.4	1.00
chr6	29595424	29596411	CpG: 93	987	93	668	18.8	67.7	0.82
chr6	29620777	29621466	CpG: 54	689	54	457	15.7	66.3	0.72
chr6	29624604	29625404	CpG: 63	800	63	502	15.8	62.8	0.80
chr6	29626202	29626464	CpG: 18	262	18	147	13.7	56.1	0.89
chr6	29664189	29665132	CpG: 82	943	82	636	17.4	67.4	0.77
chr6	29670991	29671263	CpG: 20	272	20	161	14.7	59.2	0.85
chr6	29699577	29700618	CpG: 95	1041	95	708	18.3	68.0	0.79
chr6	29721735	29722143	CpG: 35	408	35	273	17.2	66.9	0.77
chr6	29735640	29735877	CpG: 21	237	21	177	17.7	74.7	0.64
chr6	29753384	29754682	CpG: 125	1298	125	877	19.3	67.6	0.85
chr6	29792220	29793171	CpG: 89	951	89	642	18.7	67.5	0.82
chr6	29798214	29798422	CpG: 18	208	18	141	17.3	67.8	0.76
chr6	29806352	29807517	CpG: 118	1165	118	795	20.3	68.2	0.87
chr6	29820339	29820649	CpG: 22	310	22	192	14.2	61.9	0.74
chr6	29840507	29841274	CpG: 69	767	69	484	18.0	63.1	0.90
chr6	29870333	29871482	CpG: 102	1149	102	771	17.8	67.1	0.79
chr6	29894628	29894914	CpG: 25	286	25	179	17.5	62.6	0.91
chr6	29925439	29925698	CpG: 27	259	27	161	20.8	62.2	1.08
chr6	29935378	29935974	CpG: 64	596	64	427	21.5	71.6	0.84
chr6	29939415	29939997	CpG: 63	582	63	412	21.6	70.8	0.88
chr6	29964989	29965291	CpG: 30	302	30	214	19.9	70.9	0.79
chr6	29966247	29966656	CpG: 38	409	38	278	18.6	68.0	0.81
chr6	29967722	29967925	CpG: 15	203	15	119	14.8	58.6	0.89
chr6	29975579	29975798	CpG: 21	219	21	136	19.2	62.1	1.00
chr6	29991666	29992103	CpG: 36	437	36	259	16.5	59.3	0.96
chr6	30036200	30036745	CpG: 53	545	53	376	19.4	69.0	0.82
chr6	30052171	30052444	CpG: 22	273	22	170	16.1	62.3	0.84
chr6	30077390	30078644	CpG: 104	1254	104	780	16.6	62.2	0.86
chr6	30079136	30079411	CpG: 22	275	22	168	16.0	61.1	0.86
chr6	30086214	30086499	CpG: 21	285	21	197	14.7	69.1	0.62
chr6	30101470	30101697	CpG: 18	227	18	140	15.9	61.7	0.86
chr6	30123770	30124705	CpG: 89	935	89	634	19.0	67.8	0.83
chr6	30190367	30191499	CpG: 123	1132	123	773	21.7	68.3	0.94
chr6	30209271	30209853	CpG: 60	582	60	416	20.6	71.5	0.82
chr6	30315299	30316085	CpG: 54	786	54	523	13.7	66.5	0.62
chr6	30328019	30328782	CpG: 60	763	60	518	15.7	67.9	0.68
chr6	30330486	30331187	CpG: 64	701	64	444	18.3	63.3	0.91
chr6	30338856	30339476	CpG: 42	620	42	406	13.5	65.5	0.63
chr6	30353779	30354585	CpG: 79	806	79	545	19.6	67.6	0.86
chr6	30362821	30363464	CpG: 54	643	54	450	16.8	70.0	0.69
chr6	30419685	30419918	CpG: 20	233	20	158	17.2	67.8	0.75
chr6	30420174	30421588	CpG: 112	1414	112	904	15.8	63.9	0.78
chr6	30435385	30435889	CpG: 57	504	57	344	22.6	68.3	0.98
chr6	30444253	30444486	CpG: 18	233	18	138	15.5	59.2	0.91
chr6	30481289	30482081	CpG: 57	792	57	431	14.4	54.4	1.02
chr6	30511124	30512046	CpG: 97	922	97	667	21.0	72.3	0.80
chr6	30536379	30537281	CpG: 71	902	71	537	15.7	59.5	0.89
chr6	30550821	30551830	CpG: 81	1009	81	717	16.1	71.1	0.64
chr6	30555030	30555454	CpG: 32	424	32	287	15.1	67.7	0.66
chr6	30556113	30556342	CpG: 21	229	21	140	18.3	61.1	1.02
chr6	30581262	30581929	CpG: 53	667	53	401	15.9	60.1	0.88
chr6	30584366	30584638	CpG: 27	272	27	185	19.9	68.0	0.94
chr6	30585049	30585955	CpG: 84	906	84	575	18.5	63.5	0.95
chr6	30606733	30608866	CpG: 160	2133	160	1344	15.0	63.0	0.76
chr6	30640295	30640534	CpG: 18	239	18	138	15.1	57.7	0.92
chr6	30651280	30651554	CpG: 24	274	24	171	17.5	62.4	0.91
chr6	30672101	30672453	CpG: 32	352	32	258	18.2	73.3	0.68
chr6	30680935	30681293	CpG: 34	358	34	266	19.0	74.3	0.69
chr6	30748738	30749555	CpG: 95	817	95	635	23.3	77.7	0.79
chr6	30772405	30772846	CpG: 37	441	37	269	16.8	61.0	0.92
chr6	30778422	30779185	CpG: 75	763	75	522	19.7	68.4	0.85
chr6	30820098	30820675	CpG: 46	577	46	376	15.9	65.2	0.76
chr6	30857813	30858668	CpG: 68	855	68	583	15.9	68.2	0.69
chr6	30865163	30865525	CpG: 29	362	29	261	16.0	72.1	0.62
chr6	30877804	30878085	CpG: 24	281	24	170	17.1	60.5	0.94
chr6	30881727	30882158	CpG: 34	431	34	312	15.8	72.4	0.60
chr6	30934804	30935621	CpG: 61	817	61	554	14.9	67.8	0.65
chr6	31004871	31005143	CpG: 20	272	20	164	14.7	60.3	0.81
chr6	31025801	31026468	CpG: 66	667	66	441	19.8	66.1	0.91
chr6	31048288	31048496	CpG: 19	208	19	139	18.3	66.8	0.82
chr6	31048960	31049176	CpG: 16	216	16	131	14.8	60.6	0.82
chr6	31063166	31063557	CpG: 32	391	32	281	16.4	71.9	0.64
chr6	31064834	31065842	CpG: 70	1008	70	597	13.9	59.2	0.79
chr6	31137233	31138502	CpG: 122	1269	122	868	19.2	68.4	0.82
chr6	31173075	31173315	CpG: 18	240	18	146	15.0	60.8	0.83
chr6	31174565	31174850	CpG: 36	285	36	211	25.3	74.0	0.93
chr6	31212058	31213180	CpG: 114	1122	114	779	20.3	69.4	0.84
chr6	31255585	31256613	CpG: 76	1028	76	612	14.8	59.5	0.84
chr6	31259024	31260026	CpG: 79	1002	79	660	15.8	65.9	0.73
chr6	31337357	31337623	CpG: 21	266	21	164	15.8	61.7	0.84
chr6	31344541	31344772	CpG: 17	231	17	135	14.7	58.4	0.87
chr6	31347017	31348085	CpG: 78	1068	78	638	14.6	59.7	0.82
chr6	31350792	31352076	CpG: 96	1284	96	801	15.0	62.4	0.77
chr6	31394983	31395211	CpG: 19	228	19	137	16.7	60.1	0.93
chr6	31433711	31434552	CpG: 80	841	80	560	19.0	66.6	0.86
chr6	31473051	31474295	CpG: 112	1244	112	815	18.0	65.5	0.85
chr6	31484785	31485027	CpG: 22	242	22	161	18.2	66.5	0.88
chr6	31505108	31505781	CpG: 66	673	66	433	19.6	64.3	0.99
chr6	31505996	31506414	CpG: 29	418	29	237	13.9	56.7	0.88
chr6	31513594	31513914	CpG: 42	320	42	228	26.2	71.2	1.03
chr6	31518072	31519350	CpG: 93	1278	93	794	14.6	62.1	0.76
chr6	31534338	31534630	CpG: 32	292	32	206	21.9	70.5	0.89
chr6	31535905	31536549	CpG: 46	644	46	388	14.3	60.2	0.82
chr6	31555852	31556532	CpG: 48	680	48	414	14.1	60.9	0.76
chr6	31576681	31576974	CpG: 26	293	26	199	17.7	67.9	0.78
chr6	31581150	31583501	CpG: 153	2351	153	1505	13.0	64.0	0.64
chr6	31592736	31593614	CpG: 70	878	70	559	15.9	63.7	0.79
chr6	31624756	31625033	CpG: 22	277	22	169	15.9	61.0	0.87
chr6	31648511	31649247	CpG: 89	736	89	539	24.2	73.2	0.91
chr6	31659747	31660134	CpG: 45	387	45	277	23.3	71.6	0.92
chr6	31667185	31667439	CpG: 20	254	20	154	15.7	60.6	0.89
chr6	31668152	31670470	CpG: 186	2318	186	1472	16.0	63.5	0.80
chr6	31674443	31674645	CpG: 16	202	16	135	15.8	66.8	0.72
chr6	31680754	31682671	CpG: 167	1917	167	1221	17.4	63.7	0.86
chr6	31687059	31687319	CpG: 19	260	19	158	14.6	60.8	0.80
chr6	31687526	31688106	CpG: 47	580	47	338	16.2	58.3	0.96
chr6	31698094	31698365	CpG: 20	271	20	162	14.8	59.8	0.84
chr6	31704950	31705214	CpG: 27	264	27	195	20.5	73.9	0.75
chr6	31715762	31716411	CpG: 55	649	55	415	16.9	63.9	0.83
chr6	31722938	31723216	CpG: 21	278	21	171	15.1	61.5	0.81
chr6	31742354	31742562	CpG: 18	208	18	138	17.3	66.3	0.79
chr6	31750362	31750988	CpG: 80	626	80	505	25.6	80.7	0.82
chr6	31753158	31753424	CpG: 26	266	26	168	19.5	63.2	1.00
chr6	31754248	31755778	CpG: 147	1530	147	1066	19.2	69.7	0.80
chr6	31811917	31812368	CpG: 52	451	52	299	23.1	66.3	1.05
chr6	31825158	31825987	CpG: 74	829	74	536	17.9	64.7	0.86
chr6	31932241	31932520	CpG: 22	279	22	192	15.8	68.8	0.67
chr6	31940492	31941172	CpG: 72	680	72	505	21.2	74.3	0.78
chr6	31948954	31950465	CpG: 150	1511	150	1061	19.9	70.2	0.83
chr6	31983235	31983501	CpG: 22	266	22	168	16.5	63.2	0.84
chr6	31984451	31984764	CpG: 25	313	25	205	16.0	65.5	0.78
chr6	32002001	32002640	CpG: 56	639	56	407	17.5	63.7	0.94
chr6	32003512	32003955	CpG: 45	443	45	335	20.3	75.6	0.73
chr6	32005005	32005222	CpG: 18	217	18	161	16.6	74.2	0.77
chr6	32007240	32007940	CpG: 51	700	51	441	14.6	63.0	0.74
chr6	32013264	32013531	CpG: 18	267	18	159	13.5	59.6	0.77
chr6	32019874	32020610	CpG: 49	736	49	475	13.3	64.5	0.64
chr6	32048704	32049795	CpG: 92	1091	92	732	16.9	67.1	0.75
chr6	32161665	32161895	CpG: 19	230	19	141	16.5	61.3	0.89
chr6	32214932	32215172	CpG: 17	240	17	146	14.2	60.8	0.78
chr6	32237694	32238902	CpG: 99	1208	99	885	16.4	73.3	0.61
chr6	32350346	32350686	CpG: 29	340	29	222	17.1	65.3	0.83
chr6	32413927	32414344	CpG: 38	417	38	264	18.2	63.3	0.94
chr6	32487797	32488411	CpG: 67	614	67	425	21.8	69.2	0.93
chr6	32522239	32522477	CpG: 18	238	18	143	15.1	60.1	0.86
chr6	32526564	32526848	CpG: 23	284	23	174	16.2	61.3	0.87
chr6	32541503	32541777	CpG: 22	274	22	168	16.1	61.3	0.87
chr6	32543201	32543473	CpG: 23	272	23	172	16.9	63.2	0.85
chr6	32565608	32565885	CpG: 24	277	24	168	17.3	60.6	0.95
chr6	32584295	32584829	CpG: 52	534	52	349	19.5	65.4	0.94
chr6	32659880	32660265	CpG: 39	385	39	267	20.3	69.4	0.84
chr6	32665092	32665437	CpG: 31	345	31	227	18.0	65.8	0.86
chr6	32674447	32675968	CpG: 118	1521	118	998	15.5	65.6	0.72
chr6	32699754	32700029	CpG: 19	275	19	165	13.8	60.0	0.78
chr6	32701044	32701392	CpG: 35	348	35	232	20.1	66.7	0.91
chr6	32715704	32716333	CpG: 51	629	51	400	16.2	63.6	0.80
chr6	32789478	32790374	CpG: 75	896	75	615	16.7	68.6	0.71
chr6	32792211	32792463	CpG: 23	252	23	188	18.3	74.6	0.71
chr6	32792857	32794536	CpG: 140	1679	140	1044	16.7	62.2	0.86
chr6	32815409	32815620	CpG: 18	211	18	126	17.1	59.7	0.98
chr6	32829257	32829499	CpG: 19	242	19	160	15.7	66.1	0.73
chr6	32848971	32849172	CpG: 17	201	17	121	16.9	60.2	0.94
chr6	32901990	32902388	CpG: 35	398	35	266	17.6	66.8	0.80
chr6	32938314	32938569	CpG: 18	255	18	147	14.1	57.6	0.88
chr6	32947001	32947282	CpG: 24	281	24	177	17.1	63.0	0.88
chr6	32982867	32983294	CpG: 47	427	47	302	22.0	70.7	0.91
chr6	33013567	33013908	CpG: 29	341	29	250	17.0	73.3	0.64
chr6	33014521	33014913	CpG: 51	392	51	299	26.0	76.3	0.92
chr6	33021347	33022291	CpG: 81	944	81	620	17.2	65.7	0.80
chr6	33025865	33026399	CpG: 41	534	41	370	15.4	69.3	0.64
chr6	33029137	33030190	CpG: 105	1053	105	746	19.9	70.8	0.80
chr6	33034586	33034832	CpG: 20	246	20	169	16.3	68.7	0.72
chr6	33069688	33071048	CpG: 97	1360	97	838	14.3	61.6	0.75
chr6	33092911	33093684	CpG: 53	773	53	444	13.7	57.4	0.84
chr6	33098262	33099139	CpG: 91	877	91	618	20.8	70.5	0.84
chr6	33110124	33110558	CpG: 32	434	32	261	14.7	60.1	0.83
chr6	33119887	33122323	CpG: 174	2436	174	1510	14.3	62.0	0.75
chr6	33134697	33135412	CpG: 58	715	58	468	16.2	65.5	0.77
chr6	33136440	33136781	CpG: 31	341	31	221	18.2	64.8	0.87
chr6	33138800	33139202	CpG: 48	402	48	307	23.9	76.4	1.02
chr6	33142318	33142593	CpG: 19	275	19	163	13.8	59.3	0.79
chr6	33143955	33144672	CpG: 62	717	62	461	17.3	64.3	0.90
chr6	33145963	33146234	CpG: 20	271	20	161	14.8	59.4	0.85
chr6	33199291	33199497	CpG: 17	206	17	136	16.5	66.0	0.77
chr6	33210972	33211210	CpG: 18	238	18	139	15.1	58.4	0.92
chr6	33212682	33213560	CpG: 92	878	92	580	21.0	66.1	0.97
chr6	33221881	33222136	CpG: 17	255	17	149	13.3	58.4	0.78
chr6	33231514	33232752	CpG: 123	1238	123	916	19.9	74.0	0.73
chr6	33239263	33239847	CpG: 49	584	49	375	16.8	64.2	0.81
chr6	33247178	33247494	CpG: 32	316	32	227	20.3	71.8	0.85
chr6	33249177	33249882	CpG: 100	705	100	550	28.4	78.0	0.95
chr6	33275632	33276116	CpG: 55	484	55	339	22.7	70.0	0.93
chr6	33323921	33324160	CpG: 21	239	21	167	17.6	69.9	0.72
chr6	33342731	33343212	CpG: 46	481	46	358	19.1	74.4	0.69
chr6	33346554	33346776	CpG: 23	222	23	184	20.7	82.9	0.61
chr6	33382478	33382746	CpG: 21	268	21	164	15.7	61.2	0.84
chr6	33392435	33392752	CpG: 28	317	28	202	17.7	63.7	0.88
chr6	33413873	33414133	CpG: 20	260	20	171	15.4	65.8	0.73
chr6	33414305	33414602	CpG: 34	297	34	212	22.9	71.4	0.91
chr6	33442025	33443317	CpG: 136	1292	136	943	21.1	73.0	0.79
chr6	33454518	33455149	CpG: 90	631	90	494	28.5	78.3	0.96
chr6	33509375	33509647	CpG: 20	272	20	175	14.7	64.3	0.72
chr6	33532431	33533107	CpG: 65	676	65	439	19.2	64.9	0.92
chr6	33592808	33593139	CpG: 32	331	32	230	19.3	69.5	0.80
chr6	33609466	33610409	CpG: 127	943	127	726	26.9	77.0	0.91
chr6	33653693	33654609	CpG: 74	916	74	637	16.2	69.5	0.67
chr6	33714231	33714496	CpG: 26	265	26	190	19.6	71.7	0.79
chr6	33797090	33797513	CpG: 33	423	33	271	15.6	64.1	0.77
chr6	33814860	33815079	CpG: 16	219	16	140	14.6	63.9	0.74
chr6	33838423	33838996	CpG: 53	573	53	416	18.5	72.6	0.70
chr6	33849461	33849687	CpG: 21	226	21	140	18.6	61.9	1.00
chr6	33857097	33857773	CpG: 45	676	45	423	13.3	62.6	0.69
chr6	33877796	33878052	CpG: 23	256	23	174	18.0	68.0	0.78
chr6	33967544	33969753	CpG: 230	2209	230	1582	20.8	71.6	0.81
chr6	33978290	33978764	CpG: 48	474	48	343	20.3	72.4	0.77
chr6	34020094	34020483	CpG: 40	389	40	271	20.6	69.7	0.85
chr6	34047734	34048132	CpG: 45	398	45	294	22.6	73.9	0.83
chr6	34058499	34062121	CpG: 365	3622	365	2564	20.2	70.8	0.81
chr6	34072338	34073278	CpG: 94	940	94	662	20.0	70.4	0.81
chr6	34086974	34087383	CpG: 34	409	34	245	16.6	59.9	0.93
chr6	34092698	34093046	CpG: 28	348	28	253	16.1	72.7	0.61
chr6	34215513	34216695	CpG: 158	1182	158	860	26.7	72.8	1.02
chr6	34249402	34250091	CpG: 53	689	53	445	15.4	64.6	0.74
chr6	34251164	34251384	CpG: 16	220	16	132	14.5	60.0	0.81
chr6	34261152	34261434	CpG: 24	282	24	202	17.0	71.6	0.67
chr6	34268791	34269065	CpG: 25	274	25	172	18.2	62.8	0.94
chr6	34288425	34288695	CpG: 21	270	21	169	15.6	62.6	0.81
chr6	34289480	34290440	CpG: 85	960	85	685	17.7	71.4	0.70
chr6	34350952	34351381	CpG: 50	429	50	304	23.3	70.9	0.97
chr6	34355385	34355652	CpG: 23	267	23	171	17.2	64.0	0.85
chr6	34368134	34368337	CpG: 18	203	18	145	17.7	71.4	0.70
chr6	34510556	34510818	CpG: 21	262	21	160	16.0	61.1	0.87
chr6	34520271	34520969	CpG: 68	698	68	496	19.5	71.1	0.81
chr6	34534417	34534691	CpG: 20	274	20	164	14.6	59.9	0.82
chr6	34535991	34536229	CpG: 17	238	17	140	14.3	58.8	0.84
chr6	34576000	34576271	CpG: 19	271	19	164	14.0	60.5	0.78
chr6	34579490	34580313	CpG: 60	823	60	452	14.6	54.9	0.97
chr6	34581578	34581802	CpG: 21	224	21	139	18.8	62.1	0.99
chr6	34600895	34601174	CpG: 21	279	21	169	15.1	60.6	0.83
chr6	34603002	34603225	CpG: 17	223	17	132	15.2	59.2	0.90
chr6	34603821	34604077	CpG: 19	256	19	142	14.8	55.5	0.97
chr6	34608774	34609783	CpG: 78	1009	78	718	15.5	71.2	0.61
chr6	34614548	34615347	CpG: 108	799	108	582	27.0	72.8	1.02
chr6	34640732	34640948	CpG: 17	216	17	124	15.7	57.4	0.97
chr6	34710642	34710926	CpG: 26	284	26	179	18.3	63.0	0.92
chr6	34711864	34712702	CpG: 84	838	84	614	20.0	73.3	0.76
chr6	34712964	34713207	CpG: 18	243	18	146	14.8	60.1	0.84
chr6	34758660	34758934	CpG: 23	274	23	170	16.8	62.0	0.88
chr6	34963233	34963930	CpG: 75	697	75	497	21.5	71.3	0.85
chr6	35005272	35005692	CpG: 48	420	48	311	22.9	74.0	0.84
chr6	35036396	35037848	CpG: 143	1452	143	1013	19.7	69.8	0.81
chr6	35082014	35083154	CpG: 114	1140	114	793	20.0	69.6	0.83
chr6	35140984	35141627	CpG: 58	643	58	437	18.0	68.0	0.82
chr6	35162951	35163840	CpG: 70	889	70	617	15.7	69.4	0.65
chr6	35165455	35165991	CpG: 70	536	70	400	26.1	74.6	0.99
chr6	35275178	35276065	CpG: 91	887	91	647	20.5	72.9	0.77
chr6	35291109	35292383	CpG: 121	1274	121	852	19.0	66.9	0.85
chr6	35309075	35309734	CpG: 56	659	56	457	17.0	69.3	0.71
chr6	35319358	35321571	CpG: 242	2213	242	1642	21.9	74.2	0.79
chr6	35334692	35335458	CpG: 56	766	56	536	14.6	70.0	0.63
chr6	35507596	35508845	CpG: 170	1249	170	911	27.2	72.9	1.03
chr6	35521041	35521315	CpG: 24	274	24	170	17.5	62.0	0.92
chr6	35548312	35548743	CpG: 52	431	52	308	24.1	71.5	0.95
chr6	35551753	35552540	CpG: 75	787	75	565	19.1	71.8	0.74
chr6	35569848	35570118	CpG: 19	270	19	158	14.1	58.5	0.83
chr6	35586198	35586434	CpG: 24	236	24	168	20.3	71.2	0.83
chr6	35596802	35597139	CpG: 42	337	42	255	24.9	75.7	0.87
chr6	35607289	35607490	CpG: 20	201	20	137	19.9	68.2	0.88
chr6	35625533	35625745	CpG: 26	212	26	161	24.5	75.9	0.86
chr6	35693859	35694114	CpG: 19	255	19	156	14.9	61.2	0.80
chr6	35740924	35741600	CpG: 91	676	91	528	26.9	78.1	0.89
chr6	35844704	35844947	CpG: 32	243	32	187	26.3	77.0	0.89
chr6	35847435	35848905	CpG: 119	1470	119	947	16.2	64.4	0.78
chr6	35850762	35850992	CpG: 17	230	17	136	14.8	59.1	0.85
chr6	35950578	35951167	CpG: 75	589	75	465	25.5	78.9	0.82
chr6	36016648	36017721	CpG: 129	1073	129	813	24.0	75.8	0.84
chr6	36032963	36033248	CpG: 24	285	24	178	16.8	62.5	0.88
chr6	36183471	36183685	CpG: 17	214	17	125	15.9	58.4	0.94
chr6	36184501	36184891	CpG: 34	390	34	285	17.4	73.1	0.65
chr6	36207789	36208520	CpG: 62	731	62	494	17.0	67.6	0.74
chr6	36243568	36243944	CpG: 46	376	46	244	24.5	64.9	1.16
chr6	36244636	36244871	CpG: 19	235	19	143	16.2	60.9	0.89
chr6	36263333	36264039	CpG: 88	706	88	481	24.9	68.1	1.09
chr6	36298486	36298715	CpG: 18	229	18	139	15.7	60.7	0.88
chr6	36367882	36368195	CpG: 40	313	40	222	25.6	70.9	1.03
chr6	36370112	36370348	CpG: 18	236	18	142	15.3	60.2	0.87
chr6	36404384	36404659	CpG: 24	275	24	165	17.5	60.0	0.98
chr6	36414774	36415279	CpG: 49	505	49	307	19.4	60.8	1.06
chr6	36416587	36416863	CpG: 24	276	24	167	17.4	60.5	0.95
chr6	36480886	36481087	CpG: 17	201	17	126	16.9	62.7	0.87
chr6	36481457	36481716	CpG: 33	259	33	192	25.5	74.1	0.96
chr6	36499112	36501341	CpG: 205	2229	205	1525	18.4	68.4	0.79
chr6	36504778	36505039	CpG: 23	261	23	176	17.6	67.4	0.78
chr6	36659703	36661630	CpG: 165	1927	165	1349	17.1	70.0	0.71
chr6	36695143	36695680	CpG: 47	537	47	339	17.5	63.1	0.88
chr6	36703365	36703648	CpG: 23	283	23	174	16.3	61.5	0.87
chr6	36706427	36706769	CpG: 37	342	37	240	21.6	70.2	0.88
chr6	36762161	36762494	CpG: 35	333	35	251	21.0	75.4	0.74
chr6	36782217	36782551	CpG: 35	334	35	238	21.0	71.3	0.83
chr6	36785126	36785424	CpG: 26	298	26	205	17.4	68.8	0.76
chr6	36808970	36809773	CpG: 98	803	98	603	24.4	75.1	0.87
chr6	36823839	36824120	CpG: 24	281	24	174	17.1	61.9	0.91
chr6	36868388	36868663	CpG: 23	275	23	174	16.7	63.3	0.84
chr6	36948896	36949190	CpG: 26	294	26	175	17.7	59.5	1.01
chr6	36988648	36988926	CpG: 20	278	20	171	14.4	61.5	0.77
chr6	36992840	36995201	CpG: 239	2361	239	1660	20.2	70.3	0.83
chr6	37045904	37046163	CpG: 20	259	20	183	15.4	70.7	0.62
chr6	37053004	37053269	CpG: 23	265	23	163	17.4	61.5	0.94
chr6	37081190	37081532	CpG: 29	342	29	237	17.0	69.3	0.71
chr6	37150769	37151043	CpG: 23	274	23	173	16.8	63.1	0.86
chr6	37177421	37178424	CpG: 85	1003	85	686	16.9	68.4	0.81
chr6	37244151	37244391	CpG: 23	240	23	151	19.2	62.9	0.98
chr6	37256573	37257093	CpG: 59	520	59	380	22.7	73.1	0.85
chr6	37323180	37323585	CpG: 30	405	30	257	14.8	63.5	0.79
chr6	37360797	37361550	CpG: 59	753	59	482	15.7	64.0	0.77
chr6	37473598	37473826	CpG: 17	228	17	157	14.9	68.9	0.72
chr6	37473927	37474384	CpG: 53	457	53	330	23.2	72.2	0.90
chr6	37475068	37475352	CpG: 29	284	29	198	20.4	69.7	0.84
chr6	37483230	37483822	CpG: 49	592	49	363	16.6	61.3	0.88
chr6	37521000	37524345	CpG: 318	3345	318	2255	19.0	67.4	0.84
chr6	37530547	37531013	CpG: 33	466	33	303	14.2	65.0	0.69
chr6	37575968	37576246	CpG: 22	278	22	172	15.8	61.9	0.84
chr6	37643701	37645108	CpG: 148	1407	148	1029	21.0	73.1	0.79
chr6	37985571	37985853	CpG: 23	282	23	171	16.3	60.6	0.90
chr6	38183464	38183749	CpG: 25	285	25	179	17.5	62.8	0.90
chr6	38463964	38464907	CpG: 101	943	101	639	21.4	67.8	0.94
chr6	38527372	38527771	CpG: 44	399	44	276	22.1	69.2	0.92
chr6	38539730	38540046	CpG: 34	316	34	235	21.5	74.4	0.78
chr6	38872916	38873607	CpG: 67	691	67	514	19.4	74.4	0.70
chr6	38939083	38939710	CpG: 63	627	63	424	20.1	67.6	0.88
chr6	39053461	39054161	CpG: 72	700	72	496	20.6	70.9	0.82
chr6	39088504	39088734	CpG: 16	230	16	138	13.9	60.0	0.80
chr6	39128304	39128546	CpG: 18	242	18	149	14.9	61.6	0.79
chr6	39137870	39138981	CpG: 127	1111	127	792	22.9	71.3	0.92
chr6	39279098	39279428	CpG: 27	330	27	196	16.4	59.4	0.93
chr6	39549493	39550127	CpG: 52	634	52	428	16.4	67.5	0.72
chr6	39614827	39615098	CpG: 20	271	20	163	14.8	60.1	0.82
chr6	39616689	39617180	CpG: 54	491	54	337	22.0	68.6	0.93
chr6	39728228	39728449	CpG: 17	221	17	144	15.4	65.2	0.76
chr6	39761415	39761862	CpG: 42	447	42	322	18.8	72.0	0.73
chr6	39906504	39906778	CpG: 24	274	24	171	17.5	62.4	0.91
chr6	40030204	40030470	CpG: 22	266	22	166	16.5	62.4	0.86
chr6	40219927	40220595	CpG: 52	668	52	466	15.6	69.8	0.64
chr6	40414687	40416024	CpG: 134	1337	134	900	20.0	67.3	0.89
chr6	40427363	40427677	CpG: 29	314	29	207	18.5	65.9	0.85
chr6	40856627	40857066	CpG: 39	439	39	313	17.8	71.3	0.70
chr6	40900799	40902497	CpG: 160	1698	160	1173	18.8	69.1	0.79
chr6	40929293	40930166	CpG: 71	873	71	515	16.3	59.0	0.94
chr6	40952533	40952764	CpG: 20	231	20	141	17.3	61.0	0.94
chr6	41200847	41204154	CpG: 261	3307	261	2083	15.8	63.0	0.80
chr6	41236150	41236810	CpG: 62	660	62	428	18.8	64.8	0.89
chr6	41238205	41238782	CpG: 46	577	46	382	15.9	66.2	0.73
chr6	41256839	41257894	CpG: 103	1055	103	787	19.5	74.6	0.71
chr6	41271871	41272422	CpG: 39	551	39	372	14.2	67.5	0.62
chr6	41299033	41299870	CpG: 80	837	80	566	19.1	67.6	0.85
chr6	41332860	41334597	CpG: 133	1737	133	1134	15.3	65.3	0.72
chr6	41374949	41377486	CpG: 254	2537	254	1776	20.0	70.0	0.82
chr6	41389555	41390189	CpG: 49	634	49	380	15.5	59.9	0.86
chr6	41422514	41422766	CpG: 19	252	19	133	15.1	52.8	1.08
chr6	41441935	41442216	CpG: 23	281	23	172	16.4	61.2	0.89
chr6	41465828	41467908	CpG: 172	2080	172	1427	16.5	68.6	0.71
chr6	41468239	41468483	CpG: 20	244	20	161	16.4	66.0	0.87
chr6	41481751	41482063	CpG: 23	312	23	211	14.7	67.6	0.68
chr6	41511495	41512406	CpG: 63	911	63	590	13.8	64.8	0.67
chr6	41562699	41564299	CpG: 181	1600	181	1206	22.6	75.4	0.80
chr6	41608221	41609492	CpG: 124	1271	124	913	19.5	71.8	0.77
chr6	41614701	41616400	CpG: 130	1699	130	1118	15.3	65.8	0.71
chr6	41616769	41617175	CpG: 32	406	32	238	15.8	58.6	0.94
chr6	41634771	41635237	CpG: 56	466	56	343	24.0	73.6	0.89
chr6	41638427	41638664	CpG: 19	237	19	144	16.0	60.8	0.89
chr6	41723525	41724157	CpG: 78	632	78	460	24.7	72.8	0.98
chr6	41747228	41747509	CpG: 24	281	24	175	17.1	62.3	0.90
chr6	41749690	41750385	CpG: 61	695	61	433	17.6	62.3	0.91
chr6	41753945	41754219	CpG: 20	274	20	168	14.6	61.3	0.79
chr6	41769568	41770532	CpG: 111	964	111	695	23.0	72.1	0.89
chr6	41817031	41817272	CpG: 19	241	19	147	15.8	61.0	0.87
chr6	41828549	41828774	CpG: 19	225	19	133	16.9	59.1	1.00
chr6	41842330	41842569	CpG: 16	239	16	146	13.4	61.1	0.74
chr6	41876764	41879125	CpG: 162	2361	162	1426	13.7	60.4	0.75
chr6	41932535	41933204	CpG: 75	669	75	484	22.4	72.3	0.86
chr6	41970376	41970996	CpG: 57	620	57	446	18.4	71.9	0.73
chr6	42006313	42006519	CpG: 19	206	19	144	18.4	69.9	0.77
chr6	42087588	42087995	CpG: 34	407	34	275	16.7	67.6	0.78
chr6	42091550	42091754	CpG: 17	204	17	137	16.7	67.2	0.81
chr6	42280043	42280276	CpG: 18	233	18	148	15.5	63.5	0.80
chr6	42280608	42281708	CpG: 122	1100	122	779	22.2	70.8	0.91
chr6	42371654	42371890	CpG: 19	236	19	144	16.1	61.0	0.88
chr6	42382666	42382936	CpG: 31	270	31	204	23.0	75.6	0.81
chr6	42392833	42393141	CpG: 29	308	29	217	18.8	70.5	0.79
chr6	42515074	42515786	CpG: 61	712	61	501	17.1	70.4	0.69
chr6	42530998	42531273	CpG: 23	275	23	171	16.7	62.2	0.87
chr6	42555856	42556622	CpG: 72	766	72	505	18.8	65.9	0.90
chr6	42568824	42569105	CpG: 22	281	22	173	15.7	61.6	0.84
chr6	42574165	42574985	CpG: 67	820	67	507	16.3	61.8	0.86
chr6	42575706	42576041	CpG: 33	335	33	227	19.7	67.8	0.87
chr6	42576602	42576808	CpG: 17	206	17	122	16.5	59.2	0.96
chr6	42610585	42612442	CpG: 195	1857	195	1233	21.0	66.4	0.98
chr6	42676571	42676778	CpG: 15	207	15	120	14.5	58.0	0.87
chr6	42706943	42707165	CpG: 18	222	18	134	16.2	60.4	0.91
chr6	42707779	42708350	CpG: 39	571	39	305	13.7	53.4	0.96
chr6	42719148	42719939	CpG: 64	791	64	501	16.2	63.3	0.81
chr6	42740257	42740831	CpG: 42	574	42	382	14.6	66.6	0.67
chr6	42754259	42754589	CpG: 27	330	27	240	16.4	72.7	0.62
chr6	42758446	42758956	CpG: 53	510	53	358	20.8	70.2	0.86
chr6	42784606	42784886	CpG: 25	280	25	181	17.9	64.6	0.87
chr6	42789527	42790218	CpG: 63	691	63	483	18.2	69.9	0.75
chr6	42807695	42808512	CpG: 81	817	81	587	19.8	71.8	0.77
chr6	42811837	42812043	CpG: 18	206	18	123	17.5	59.7	0.99
chr6	42813611	42813971	CpG: 40	360	40	261	22.2	72.5	0.85
chr6	42832862	42833118	CpG: 20	256	20	158	15.6	61.7	0.83
chr6	42842768	42843437	CpG: 59	669	59	441	17.6	65.9	0.86
chr6	42850539	42850865	CpG: 43	326	43	239	26.4	73.3	0.98
chr6	42882458	42883027	CpG: 50	569	50	402	17.6	70.7	0.73
chr6	42888271	42889174	CpG: 71	903	71	568	15.7	62.9	0.81
chr6	42904942	42906065	CpG: 123	1123	123	798	21.9	71.1	0.88
chr6	42980241	42980741	CpG: 38	500	38	300	15.2	60.0	0.85
chr6	42999735	43001316	CpG: 174	1581	174	1127	22.0	71.3	0.89
chr6	43003037	43003241	CpG: 18	204	18	147	17.6	72.1	0.68
chr6	43010771	43011044	CpG: 35	273	35	203	25.6	74.4	0.93
chr6	43057866	43058438	CpG: 74	572	74	430	25.9	75.2	0.92
chr6	43072165	43072674	CpG: 68	509	68	400	26.7	78.6	0.87
chr6	43075420	43075642	CpG: 16	222	16	146	14.4	65.8	0.70
chr6	43091641	43092095	CpG: 37	454	37	317	16.3	69.8	0.67
chr6	43098285	43098668	CpG: 39	383	39	267	20.4	69.7	0.85
chr6	43103871	43105344	CpG: 128	1473	128	997	17.4	67.7	0.77
chr6	43112713	43113072	CpG: 28	359	28	258	15.6	71.9	0.60
chr6	43113800	43114542	CpG: 82	742	82	563	22.1	75.9	0.80
chr6	43137620	43137860	CpG: 24	240	24	164	20.0	68.3	0.90
chr6	43197654	43199006	CpG: 171	1352	171	977	25.3	72.3	0.97
chr6	43253589	43254222	CpG: 51	633	51	438	16.1	69.2	0.67
chr6	43255517	43255753	CpG: 20	236	20	140	16.9	59.3	0.98
chr6	43256029	43256939	CpG: 66	910	66	563	14.5	61.9	0.76
chr6	43283397	43284734	CpG: 151	1337	151	964	22.6	72.1	0.87
chr6	43338222	43339554	CpG: 155	1332	155	984	23.3	73.9	0.86
chr6	43345479	43345888	CpG: 43	409	43	259	21.0	63.3	1.07
chr6	43404120	43405072	CpG: 100	952	100	647	21.0	68.0	0.94
chr6	43409215	43410646	CpG: 139	1431	139	1082	19.4	75.6	0.68
chr6	43444742	43444970	CpG: 17	228	17	138	14.9	60.5	0.84
chr6	43457786	43458686	CpG: 81	900	81	587	18.0	65.2	0.85
chr6	43464491	43464814	CpG: 30	323	30	207	18.6	64.1	0.90
chr6	43473710	43474362	CpG: 53	652	53	440	16.3	67.5	0.76
chr6	43474886	43475114	CpG: 17	228	17	134	14.9	58.8	0.87
chr6	43516268	43516615	CpG: 31	347	31	222	17.9	64.0	0.87
chr6	43541915	43542196	CpG: 21	281	21	172	14.9	61.2	0.82
chr6	43599408	43601628	CpG: 231	2220	231	1543	20.8	69.5	0.87
chr6	43829765	43830159	CpG: 32	394	32	288	16.2	73.1	0.61
chr6	43833891	43834883	CpG: 107	992	107	679	21.6	68.4	0.95
chr6	43906734	43907188	CpG: 57	454	57	338	25.1	74.4	0.91
chr6	43910029	43910267	CpG: 36	238	36	186	30.3	78.2	0.99
chr6	43960427	43961853	CpG: 143	1426	143	1030	20.1	72.2	0.78
chr6	43985244	43985499	CpG: 26	255	26	174	20.4	68.2	0.88
chr6	43986058	43986287	CpG: 18	229	18	156	15.7	68.1	0.68
chr6	44053633	44054047	CpG: 40	414	40	307	19.3	74.2	0.70
chr6	44057583	44058301	CpG: 81	718	81	532	22.6	74.1	0.88
chr6	44072114	44072393	CpG: 33	279	33	206	23.7	73.8	0.87
chr6	44080124	44082136	CpG: 143	2012	143	1258	14.2	62.5	0.73
chr6	44091112	44091900	CpG: 84	788	84	592	21.3	75.1	0.78
chr6	44099280	44099847	CpG: 66	567	66	424	23.3	74.8	0.84
chr6	44104531	44105268	CpG: 99	737	99	607	26.9	82.4	0.79
chr6	44108962	44109204	CpG: 17	242	17	148	14.0	61.2	0.78
chr6	44109473	44110869	CpG: 173	1396	173	1013	24.8	72.6	0.94
chr6	44120288	44120541	CpG: 24	253	24	167	19.0	66.0	0.88
chr6	44131380	44132121	CpG: 84	741	84	538	22.7	72.6	0.86
chr6	44147150	44147654	CpG: 46	504	46	328	18.3	65.1	0.86
chr6	44222165	44222787	CpG: 53	622	53	376	17.0	60.5	0.93
chr6	44247443	44247717	CpG: 22	274	22	169	16.1	61.7	0.85
chr6	44395853	44396054	CpG: 18	201	18	149	17.9	74.1	0.65
chr6	44480428	44480706	CpG: 25	278	25	175	18.0	62.9	0.92
chr6	44562308	44562785	CpG: 42	477	42	298	17.6	62.5	0.91
chr6	44684112	44684387	CpG: 24	275	24	171	17.5	62.2	0.91
chr6	44763471	44763733	CpG: 24	262	24	165	18.3	63.0	0.94
chr6	44897259	44897561	CpG: 23	302	23	178	15.2	58.9	0.89
chr6	45010995	45011229	CpG: 22	234	22	141	18.8	60.3	1.04
chr6	45212258	45213334	CpG: 102	1076	102	714	19.0	66.4	0.86
chr6	45254426	45255244	CpG: 60	818	60	527	14.7	64.4	0.71
chr6	45256500	45259014	CpG: 231	2514	231	1725	18.4	68.6	0.79
chr6	45498405	45499233	CpG: 84	828	84	583	20.3	70.4	0.83
chr6	45510188	45510404	CpG: 19	216	19	132	17.6	61.1	0.94
chr6	45850228	45851093	CpG: 85	865	85	606	19.7	70.1	0.80
chr6	45854489	45854770	CpG: 23	281	23	175	16.4	62.3	0.86
chr6	45965045	45965304	CpG: 38	259	38	188	29.3	72.6	1.12
chr6	46243544	46243787	CpG: 22	243	22	178	18.1	73.3	0.68
chr6	46328548	46329163	CpG: 84	615	84	482	27.3	78.4	0.90
chr6	46490454	46491102	CpG: 69	648	69	452	21.3	69.8	0.89
chr6	46525174	46526650	CpG: 140	1476	140	998	19.0	67.6	0.83
chr6	46572183	46573224	CpG: 92	1041	92	672	17.7	64.6	0.85
chr6	46612258	46612695	CpG: 39	437	39	322	17.8	73.7	0.66
chr6	46613360	46613564	CpG: 15	204	15	117	14.7	57.4	0.91
chr6	46939382	46939663	CpG: 22	281	22	173	15.7	61.6	0.84
chr6	47071814	47072030	CpG: 16	216	16	131	14.8	60.6	0.83
chr6	47145877	47147245	CpG: 129	1368	129	947	18.9	69.2	0.79
chr6	47216059	47216333	CpG: 23	274	23	170	16.8	62.0	0.88
chr6	47280999	47281620	CpG: 50	621	50	444	16.1	71.5	0.63
chr6	47308425	47308707	CpG: 23	282	23	176	16.3	62.4	0.85
chr6	47318236	47319219	CpG: 106	983	106	686	21.6	69.8	0.89
chr6	47600694	47600968	CpG: 24	274	24	170	17.5	62.0	0.92
chr6	47677352	47677613	CpG: 21	261	21	163	16.1	62.5	0.83
chr6	47824304	47824525	CpG: 17	221	17	137	15.4	62.0	0.81
chr6	47910170	47910810	CpG: 58	640	58	441	18.1	68.9	0.79
chr6	47920608	47920844	CpG: 21	236	21	142	17.8	60.2	1.03
chr6	48037152	48037418	CpG: 21	266	21	160	15.8	60.2	0.89
chr6	48152095	48152333	CpG: 17	238	17	137	14.3	57.6	0.88
chr6	48182387	48182622	CpG: 18	235	18	137	15.3	58.3	0.92
chr6	48204891	48205318	CpG: 30	427	30	248	14.1	58.1	0.84
chr6	48212999	48213707	CpG: 54	708	54	494	15.3	69.8	0.63
chr6	48253446	48253698	CpG: 21	252	21	152	16.7	60.3	0.94
chr6	48760594	48760828	CpG: 17	234	17	137	14.5	58.5	0.89
chr6	49305252	49305454	CpG: 20	202	20	122	19.8	60.4	1.10
chr6	49392730	49393601	CpG: 69	871	69	567	15.8	65.1	0.76
chr6	49464869	49465146	CpG: 24	277	24	171	17.3	61.7	0.92
chr6	49470474	49470796	CpG: 24	322	24	185	14.9	57.5	0.93
chr6	49776732	49777005	CpG: 20	273	20	161	14.7	59.0	0.88
chr6	50327788	50328062	CpG: 23	274	23	170	16.8	62.0	0.88
chr6	50551550	50551772	CpG: 20	222	20	133	18.0	59.9	1.02
chr6	50557657	50558537	CpG: 59	880	59	523	13.4	59.4	0.77
chr6	50567461	50567687	CpG: 26	226	26	155	23.0	68.6	1.01
chr6	50662324	50663129	CpG: 85	805	85	536	21.1	66.6	0.99
chr6	50666148	50666611	CpG: 41	463	41	325	17.7	70.2	0.76
chr6	50685681	50686033	CpG: 29	352	29	215	16.5	61.1	0.89
chr6	50688351	50688736	CpG: 38	385	38	254	19.7	66.0	0.91
chr6	50693221	50693472	CpG: 39	251	39	188	31.1	74.9	1.11
chr6	51234800	51235078	CpG: 26	278	26	176	18.7	63.3	0.94
chr6	51297392	51297701	CpG: 25	309	25	192	16.2	62.1	0.86
chr6	52123096	52123672	CpG: 54	576	54	356	18.8	61.8	0.99
chr6	52130854	52131127	CpG: 25	273	25	170	18.3	62.3	0.95
chr6	52145866	52146099	CpG: 21	233	21	158	18.0	67.8	0.79
chr6	52200716	52201969	CpG: 124	1253	124	886	19.8	70.7	0.84
chr6	52218457	52218696	CpG: 19	239	19	141	15.9	59.0	0.92
chr6	52222147	52222425	CpG: 25	278	25	175	18.0	62.9	0.92
chr6	52241955	52242173	CpG: 20	218	20	149	18.3	68.3	0.79
chr6	52258746	52259250	CpG: 50	504	50	334	19.8	66.3	0.90
chr6	52415219	52416335	CpG: 129	1116	129	831	23.1	74.5	0.83
chr6	52502881	52503593	CpG: 59	712	59	468	16.6	65.7	0.77
chr6	52509656	52509930	CpG: 28	274	28	192	20.4	70.1	0.86
chr6	52668634	52668866	CpG: 19	232	19	173	16.4	74.6	0.61
chr6	52834336	52834538	CpG: 19	202	19	143	18.8	70.8	0.76
chr6	52835171	52835394	CpG: 21	223	21	141	18.8	63.2	0.94
chr6	52835613	52835838	CpG: 16	225	16	131	14.2	58.2	0.85
chr6	52901084	52901669	CpG: 67	585	67	413	22.9	70.6	0.93
chr6	52904857	52905565	CpG: 76	708	76	524	21.5	74.0	0.78
chr6	52916799	52917072	CpG: 23	273	23	169	16.8	61.9	0.89
chr6	53044244	53044519	CpG: 21	275	21	169	15.3	61.5	0.83
chr6	53144756	53145862	CpG: 90	1106	90	800	16.3	72.3	0.62
chr6	53187688	53189115	CpG: 150	1427	150	946	21.0	66.3	0.96
chr6	53198965	53199741	CpG: 79	776	79	548	20.4	70.6	0.82
chr6	53384241	53385220	CpG: 126	979	126	715	25.7	73.0	0.97
chr6	53387849	53388198	CpG: 47	349	47	255	26.9	73.1	1.01
chr6	53388881	53389103	CpG: 18	222	18	134	16.2	60.4	0.90
chr6	53491454	53492211	CpG: 84	757	84	504	22.2	66.6	1.00
chr6	53569185	53569392	CpG: 16	207	16	122	15.5	58.9	0.91
chr6	53634404	53636122	CpG: 153	1718	153	1122	17.8	65.3	0.84
chr6	53652356	53652592	CpG: 22	236	22	148	18.6	62.7	0.97
chr6	53962904	53963183	CpG: 21	279	21	166	15.1	59.5	0.87
chr6	54417107	54417345	CpG: 19	238	19	143	16.0	60.1	0.91
chr6	54420865	54421143	CpG: 24	278	24	173	17.3	62.2	0.91
chr6	54686101	54686981	CpG: 74	880	74	575	16.8	65.3	0.80
chr6	54689500	54689781	CpG: 24	281	24	175	17.1	62.3	0.90
chr6	54691737	54692011	CpG: 21	274	21	169	15.3	61.7	0.81
chr6	54755492	54755773	CpG: 24	281	24	175	17.1	62.3	0.90
chr6	54801540	54801848	CpG: 26	308	26	187	16.9	60.7	0.92
chr6	54896139	54896371	CpG: 18	232	18	142	15.5	61.2	0.85
chr6	55013995	55014217	CpG: 15	222	15	131	13.5	59.0	0.78
chr6	55079449	55079683	CpG: 18	234	18	141	15.4	60.3	0.86
chr6	55208674	55208917	CpG: 20	243	20	147	16.5	60.5	0.90
chr6	55236822	55237107	CpG: 24	285	24	177	16.8	62.1	0.89
chr6	55373174	55373452	CpG: 26	278	26	175	18.7	62.9	0.96
chr6	55418201	55418561	CpG: 36	360	36	257	20.0	71.4	0.82
chr6	55419705	55419983	CpG: 21	278	21	174	15.1	62.6	0.78
chr6	55559068	55559286	CpG: 21	218	21	136	19.3	62.4	1.01
chr6	55631873	55632110	CpG: 18	237	18	140	15.2	59.1	0.89
chr6	55749456	55750412	CpG: 77	956	77	667	16.1	69.8	0.66
chr6	55760951	55761192	CpG: 18	241	18	142	14.9	58.9	0.87
chr6	55830909	55831183	CpG: 22	274	22	170	16.1	62.0	0.84
chr6	55947570	55947837	CpG: 20	267	20	164	15.0	61.4	0.81
chr6	55990997	55991219	CpG: 17	222	17	134	15.3	60.4	0.86
chr6	56004155	56004361	CpG: 17	206	17	119	16.5	57.8	1.00
chr6	56026187	56026468	CpG: 23	281	23	173	16.4	61.6	0.88
chr6	56088066	56088322	CpG: 19	256	19	172	14.8	67.2	0.66
chr6	56273653	56273879	CpG: 19	226	19	135	16.8	59.7	0.95
chr6	56274488	56274699	CpG: 31	211	31	162	29.4	76.8	1.03
chr6	56290730	56290942	CpG: 18	212	18	131	17.0	61.8	0.91
chr6	56383942	56384404	CpG: 38	462	38	297	16.5	64.3	0.80
chr6	56474535	56474851	CpG: 26	316	26	195	16.5	61.7	0.87
chr6	56553094	56553368	CpG: 24	274	24	171	17.5	62.4	0.91
chr6	56665414	56666223	CpG: 61	809	61	544	15.1	67.2	0.67
chr6	56677856	56678107	CpG: 21	251	21	153	16.7	61.0	0.91
chr6	56679210	56679484	CpG: 24	274	24	171	17.5	62.4	0.91
chr6	56684873	56685973	CpG: 118	1100	118	816	21.5	74.2	0.78
chr6	56716637	56716855	CpG: 16	218	16	131	14.7	60.1	0.84
chr6	56793122	56794557	CpG: 165	1435	165	1004	23.0	70.0	0.94
chr6	56838942	56839188	CpG: 17	246	17	165	13.8	67.1	0.62
chr6	56885393	56886179	CpG: 73	786	73	508	18.6	64.6	0.91
chr6	56928935	56929690	CpG: 74	755	74	494	19.6	65.4	0.94
chr6	57002497	57002771	CpG: 23	274	23	171	16.8	62.4	0.87
chr6	57011181	57011958	CpG: 91	777	91	556	23.4	71.6	0.92
chr6	57060624	57061539	CpG: 90	915	90	628	19.7	68.6	0.84
chr6	57213354	57213627	CpG: 24	273	24	168	17.6	61.5	0.94
chr6	57382141	57382414	CpG: 23	273	23	173	16.8	63.4	0.85
chr6	57417883	57418157	CpG: 25	274	25	172	18.2	62.8	0.94
chr6	57481341	57481570	CpG: 19	229	19	137	16.6	59.8	0.94
chr6	57620062	57620336	CpG: 24	274	24	171	17.5	62.4	0.91
chr6	57637079	57637619	CpG: 41	540	41	317	15.2	58.7	0.88
chr6	57658889	57659127	CpG: 22	238	22	144	18.5	60.5	1.03
chr6	57659833	57660373	CpG: 41	540	41	317	15.2	58.7	0.88
chr6	57692633	57692922	CpG: 35	289	35	201	24.2	69.6	1.01
chr6	57775537	57775854	CpG: 22	317	22	189	13.9	59.6	0.80
chr6	57798859	57799131	CpG: 23	272	23	164	16.9	60.3	0.94
chr6	57799938	57800337	CpG: 39	399	39	268	19.5	67.2	0.88
chr6	57831176	57831444	CpG: 22	268	22	161	16.4	60.1	0.92
chr6	58029521	58030269	CpG: 51	748	51	498	13.6	66.6	0.62
chr6	58219918	58220203	CpG: 25	285	25	182	17.5	63.9	0.88
chr6	61207192	61207470	CpG: 25	278	25	174	18.0	62.6	0.93
chr6	61324720	61324993	CpG: 21	273	21	172	15.4	63.0	0.78
chr6	61649237	61649510	CpG: 21	273	21	171	15.4	62.6	0.79
chr6	61860648	61860924	CpG: 24	276	24	171	17.4	62.0	0.92
chr6	61911830	61912043	CpG: 21	213	21	128	19.7	60.1	1.10
chr6	62023282	62023565	CpG: 24	283	24	175	17.0	61.8	0.90
chr6	62112982	62113245	CpG: 23	263	23	190	17.5	72.2	0.67
chr6	62350060	62350343	CpG: 24	283	24	175	17.0	61.8	0.90
chr6	62351447	62351721	CpG: 23	274	23	169	16.8	61.7	0.89
chr6	62771667	62771941	CpG: 23	274	23	170	16.8	62.0	0.88
chr6	63163285	63163527	CpG: 20	242	20	143	16.5	59.1	0.96
chr6	63430844	63431217	CpG: 45	373	45	269	24.1	72.1	0.93
chr6	63649675	63649956	CpG: 22	281	22	173	15.7	61.6	0.84
chr6	64111904	64112174	CpG: 23	270	23	165	17.0	61.1	0.92
chr6	64395101	64395337	CpG: 19	236	19	141	16.1	59.7	0.92
chr6	64419905	64420134	CpG: 18	229	18	127	15.7	55.5	1.06
chr6	64421082	64421336	CpG: 25	254	25	183	19.7	72.0	0.77
chr6	64536486	64536730	CpG: 20	244	20	151	16.4	61.9	0.87
chr6	64718180	64719765	CpG: 189	1585	189	1124	23.8	70.9	0.95
chr6	64771805	64772041	CpG: 20	236	20	146	16.9	61.9	0.93
chr6	64781516	64782491	CpG: 133	975	133	720	27.3	73.8	1.00
chr6	64973780	64974065	CpG: 20	285	20	173	14.0	60.7	0.77
chr6	65083641	65083872	CpG: 18	231	18	134	15.6	58.0	0.94
chr6	65456809	65457078	CpG: 20	269	20	161	14.9	59.9	0.84
chr6	65628700	65628974	CpG: 23	274	23	170	16.8	62.0	0.88
chr6	65655727	65655949	CpG: 19	222	19	131	17.1	59.0	1.00
chr6	65912433	65912645	CpG: 15	212	15	122	14.2	57.5	0.87
chr6	66112084	66112346	CpG: 23	262	23	163	17.6	62.2	0.92
chr6	66273528	66273773	CpG: 19	245	19	152	15.5	62.0	0.81
chr6	66455048	66455376	CpG: 28	328	28	192	17.1	58.5	1.00
chr6	66779046	66779448	CpG: 29	402	29	279	14.4	69.4	0.60
chr6	66851362	66851597	CpG: 18	235	18	142	15.3	60.4	0.87
chr6	66940095	66940453	CpG: 34	358	34	257	19.0	71.8	0.74
chr6	67096898	67097179	CpG: 22	281	22	173	15.7	61.6	0.85
chr6	67125889	67126125	CpG: 18	236	18	140	15.3	59.3	0.89
chr6	67157682	67158046	CpG: 30	364	30	254	16.5	69.8	0.68
chr6	67188294	67188530	CpG: 19	236	19	141	16.1	59.7	0.93
chr6	67252719	67253027	CpG: 27	308	27	208	17.5	67.5	0.81
chr6	67681430	67681700	CpG: 23	270	23	166	17.0	61.5	0.91
chr6	68105064	68105404	CpG: 29	340	29	247	17.1	72.6	0.65
chr6	68186801	68187014	CpG: 19	213	19	150	17.8	70.4	0.73
chr6	68212686	68212964	CpG: 26	278	26	176	18.7	63.3	0.94
chr6	68217913	68218145	CpG: 20	232	20	141	17.2	60.8	0.95
chr6	68228510	68228791	CpG: 22	281	22	173	15.7	61.6	0.84
chr6	68310693	68310906	CpG: 15	213	15	126	14.1	59.2	0.82
chr6	68312454	68312728	CpG: 25	274	25	175	18.2	63.9	0.91
chr6	68729121	68729386	CpG: 22	265	22	161	16.6	60.8	0.91
chr6	68758193	68758474	CpG: 23	281	23	174	16.4	61.9	0.87
chr6	68761270	68761544	CpG: 24	274	24	170	17.5	62.0	0.92
chr6	68989687	68989940	CpG: 20	253	20	180	15.8	71.1	0.63
chr6	69184671	69184903	CpG: 19	232	19	140	16.4	60.3	0.92
chr6	69200136	69200409	CpG: 24	273	24	174	17.6	63.7	0.87
chr6	69378095	69378326	CpG: 21	231	21	143	18.2	61.9	0.96
chr6	69709869	69710135	CpG: 23	266	23	166	17.3	62.4	0.90
chr6	69807131	69807405	CpG: 24	274	24	171	17.5	62.4	0.91
chr6	69812407	69813158	CpG: 90	751	90	514	24.0	68.4	1.05
chr6	69984770	69985043	CpG: 21	273	21	167	15.4	61.2	0.83
chr6	70110392	70110632	CpG: 23	240	23	150	19.2	62.5	1.00
chr6	70202637	70202915	CpG: 20	278	20	166	14.4	59.7	0.81
chr6	70815079	70815348	CpG: 21	269	21	168	15.6	62.5	0.81
chr6	70925331	70925612	CpG: 23	281	23	173	16.4	61.6	0.88
chr6	70976479	70977211	CpG: 53	732	53	471	14.5	64.3	0.70
chr6	71047213	71047809	CpG: 79	596	79	419	26.5	70.3	1.07
chr6	71076383	71076664	CpG: 23	281	23	175	16.4	62.3	0.86
chr6	71191138	71191564	CpG: 31	426	31	253	14.6	59.4	0.83
chr6	71462893	71463765	CpG: 61	872	61	561	14.0	64.3	0.68
chr6	71593749	71594677	CpG: 98	928	98	644	21.1	69.4	0.88
chr6	71747382	71747876	CpG: 47	494	47	345	19.0	69.8	0.78
chr6	71749532	71749805	CpG: 25	273	25	169	18.3	61.9	0.96
chr6	71808610	71808854	CpG: 21	244	21	180	17.2	73.8	0.64
chr6	71815552	71815842	CpG: 25	290	25	182	17.2	62.8	0.89
chr6	71848258	71849061	CpG: 96	803	96	594	23.9	74.0	0.88
chr6	72136204	72137976	CpG: 182	1772	182	1233	20.5	69.6	0.86
chr6	72248852	72249214	CpG: 26	362	26	215	14.4	59.4	0.82
chr6	72468841	72469844	CpG: 130	1003	130	785	25.9	78.3	0.85
chr6	72600299	72601547	CpG: 147	1248	147	871	23.6	69.8	0.97
chr6	72712978	72713263	CpG: 23	285	23	174	16.1	61.1	0.88
chr6	72725236	72725517	CpG: 25	281	25	176	17.8	62.6	0.92
chr6	72765618	72766234	CpG: 46	616	46	390	14.9	63.3	0.75
chr6	72769526	72769780	CpG: 24	254	24	173	18.9	68.1	0.82
chr6	72868138	72868345	CpG: 15	207	15	115	14.5	55.6	0.94
chr6	73042967	73043206	CpG: 21	239	21	146	17.6	61.1	0.96
chr6	73067500	73068232	CpG: 75	732	75	540	20.5	73.8	0.75
chr6	73117268	73117519	CpG: 24	251	24	159	19.1	63.3	0.97
chr6	73270990	73271416	CpG: 34	426	34	258	16.0	60.6	0.87
chr6	73359970	73360810	CpG: 99	840	99	573	23.6	68.2	1.02
chr6	73454881	73455118	CpG: 17	237	17	142	14.3	59.9	0.82
chr6	73663647	73663970	CpG: 22	323	22	193	13.6	59.8	0.78
chr6	73784062	73784299	CpG: 17	237	17	141	14.3	59.5	0.85
chr6	73797866	73800033	CpG: 183	2167	183	1441	16.9	66.5	0.77
chr6	73913228	73913506	CpG: 25	278	25	176	18.0	63.3	0.91
chr6	74015357	74015631	CpG: 24	274	24	172	17.5	62.8	0.90
chr6	74137945	74138187	CpG: 18	242	18	143	14.9	59.1	0.88
chr6	74170839	74171266	CpG: 32	427	32	256	15.0	60.0	0.84
chr6	74234739	74235012	CpG: 19	273	19	168	13.9	61.5	0.75
chr6	74334488	74335135	CpG: 54	647	54	395	16.7	61.1	0.90
chr6	74336665	74336942	CpG: 23	277	23	172	16.6	62.1	0.88
chr6	74378754	74378994	CpG: 20	240	20	148	16.7	61.7	0.91
chr6	74379190	74379467	CpG: 23	277	23	172	16.6	62.1	0.87
chr6	74382201	74382867	CpG: 51	666	51	436	15.3	65.5	0.71
chr6	74401293	74401745	CpG: 31	452	31	266	13.7	58.8	0.80
chr6	74439666	74439948	CpG: 43	282	43	219	30.5	77.7	1.01
chr6	74445499	74445889	CpG: 31	390	31	279	15.9	71.5	0.62
chr6	74466461	74466746	CpG: 23	285	23	179	16.1	62.8	0.83
chr6	74475738	74476375	CpG: 49	637	49	421	15.4	66.1	0.70
chr6	74477561	74477857	CpG: 22	296	22	182	14.9	61.5	0.79
chr6	74486345	74486970	CpG: 57	625	57	382	18.2	61.1	0.98
chr6	74491319	74491938	CpG: 56	619	56	409	18.1	66.1	0.83
chr6	74525553	74525791	CpG: 19	238	19	144	16.0	60.5	0.88
chr6	74530483	74531435	CpG: 68	952	68	603	14.3	63.3	0.72
chr6	74540268	74540535	CpG: 23	267	23	181	17.2	67.8	0.76
chr6	74546364	74546698	CpG: 38	334	38	223	22.8	66.8	1.02
chr6	74571405	74571859	CpG: 42	454	42	288	18.5	63.4	0.94
chr6	74587614	74587836	CpG: 18	222	18	135	16.2	60.8	0.89
chr6	74627121	74627401	CpG: 23	280	23	168	16.4	60.0	0.92
chr6	74627779	74628925	CpG: 100	1146	100	749	17.5	65.4	0.82
chr6	74637728	74638541	CpG: 67	813	67	445	16.5	54.7	1.10
chr6	74697343	74698878	CpG: 135	1535	135	962	17.6	62.7	0.90
chr6	74700643	74700921	CpG: 36	278	36	209	25.9	75.2	0.92
chr6	74731262	74731536	CpG: 24	274	24	171	17.5	62.4	0.91
chr6	74738717	74738953	CpG: 18	236	18	141	15.3	59.7	0.87
chr6	74740600	74740880	CpG: 21	280	21	167	15.0	59.6	0.88
chr6	74749568	74749956	CpG: 35	388	35	283	18.0	72.9	0.68
chr6	74762367	74762643	CpG: 24	276	24	169	17.4	61.2	0.94
chr6	74809755	74810040	CpG: 24	285	24	174	16.8	61.1	0.92
chr6	74831574	74832378	CpG: 100	804	100	597	24.9	74.3	0.91
chr6	74841786	74842035	CpG: 19	249	19	147	15.3	59.0	0.89
chr6	74873671	74874401	CpG: 61	730	61	460	16.7	63.0	0.85
chr6	74937792	74938066	CpG: 20	274	20	170	14.6	62.0	0.78
chr6	74972814	74973088	CpG: 23	274	23	171	16.8	62.4	0.88
chr6	75092860	75093213	CpG: 27	353	27	252	15.3	71.4	0.60
chr6	75136310	75136584	CpG: 23	274	23	169	16.8	61.7	0.89
chr6	75191328	75191607	CpG: 22	279	22	174	15.8	62.4	0.82
chr6	75431909	75432669	CpG: 53	760	53	515	13.9	67.8	0.61
chr6	75499954	75500235	CpG: 23	281	23	173	16.4	61.6	0.88
chr6	75973424	75973657	CpG: 20	233	20	142	17.2	60.9	0.94
chr6	75975979	75976386	CpG: 26	407	26	240	12.8	59.0	0.74
chr6	76002363	76002599	CpG: 19	236	19	143	16.1	60.6	0.89
chr6	76045230	76045498	CpG: 21	268	21	165	15.7	61.6	0.84
chr6	76099928	76100169	CpG: 18	241	18	142	14.9	58.9	0.89
chr6	76262340	76262548	CpG: 28	208	28	152	26.9	73.1	1.01
chr6	76272515	76272796	CpG: 22	281	22	173	15.7	61.6	0.84
chr6	76273783	76274057	CpG: 23	274	23	171	16.8	62.4	0.87
chr6	76379014	76379568	CpG: 43	554	43	370	15.5	66.8	0.70
chr6	76382139	76383821	CpG: 122	1682	122	1002	14.5	59.6	0.82
chr6	76461109	76461940	CpG: 74	831	74	522	17.8	62.8	0.91
chr6	76473347	76473563	CpG: 18	216	18	133	16.7	61.6	0.90
chr6	76498289	76498574	CpG: 26	285	26	178	18.2	62.5	0.95
chr6	76618337	76619431	CpG: 87	1094	87	793	15.9	72.5	0.61
chr6	76728901	76729119	CpG: 22	218	22	135	20.2	61.9	1.07
chr6	76776643	76776871	CpG: 18	228	18	140	15.8	61.4	0.86
chr6	76778472	76779705	CpG: 142	1233	142	872	23.0	70.7	0.95
chr6	76925598	76926428	CpG: 104	830	104	602	25.1	72.5	0.97
chr6	77062365	77062616	CpG: 20	251	20	154	15.9	61.4	0.86
chr6	77604036	77604265	CpG: 17	229	17	134	14.8	58.5	0.88
chr6	77656635	77656871	CpG: 20	236	20	144	16.9	61.0	0.93
chr6	77851433	77851717	CpG: 25	284	25	178	17.6	62.7	0.91
chr6	78053622	78053914	CpG: 24	292	24	178	16.4	61.0	0.89
chr6	78136107	78136324	CpG: 18	217	18	124	16.6	57.1	1.02
chr6	78303870	78304148	CpG: 22	278	22	172	15.8	61.9	0.83
chr6	78639974	78641835	CpG: 133	1861	133	1167	14.3	62.7	0.74
chr6	78754911	78755133	CpG: 20	222	20	136	18.0	61.3	0.97
chr6	78827419	78827906	CpG: 36	487	36	324	14.8	66.5	0.67
chr6	78876624	78876863	CpG: 18	239	18	142	15.1	59.4	0.87
chr6	79207169	79207557	CpG: 40	388	40	290	20.6	74.7	0.74
chr6	79230049	79230327	CpG: 25	278	25	174	18.0	62.6	0.93
chr6	79433647	79433926	CpG: 22	279	22	171	15.8	61.3	0.85
chr6	79624112	79624348	CpG: 22	236	22	144	18.6	61.0	1.03
chr6	79807119	79807334	CpG: 15	215	15	135	14.0	62.8	0.71
chr6	79818810	79819079	CpG: 23	269	23	166	17.1	61.7	0.91
chr6	80038483	80038757	CpG: 24	274	24	171	17.5	62.4	0.91
chr6	80045137	80045735	CpG: 47	598	47	379	15.7	63.4	0.78
chr6	80088315	80088702	CpG: 45	387	45	268	23.3	69.3	0.97
chr6	80254753	80256335	CpG: 198	1582	198	1114	25.0	70.4	1.02
chr6	80407267	80407521	CpG: 20	254	20	147	15.7	57.9	0.96
chr6	80411372	80412521	CpG: 86	1149	86	672	15.0	58.5	0.88
chr6	80742562	80743211	CpG: 52	649	52	423	16.0	65.2	0.75
chr6	80836662	80837147	CpG: 59	485	59	347	24.3	71.5	0.95
chr6	80975438	80975711	CpG: 26	273	26	171	19.0	62.6	0.98
chr6	81155423	81156272	CpG: 98	849	98	613	23.1	72.2	0.89
chr6	81212827	81213246	CpG: 39	419	39	265	18.6	63.2	0.94
chr6	81293641	81293922	CpG: 27	281	27	177	19.2	63.0	0.98
chr6	81309911	81310185	CpG: 24	274	24	171	17.5	62.4	0.91
chr6	81314809	81315376	CpG: 53	567	53	392	18.7	69.1	0.78
chr6	81517031	81517296	CpG: 21	265	21	163	15.8	61.5	0.86
chr6	81532207	81532481	CpG: 20	274	20	168	14.6	61.3	0.78
chr6	81687122	81687352	CpG: 20	230	20	140	17.4	60.9	0.95
chr6	81693511	81693792	CpG: 24	281	24	175	17.1	62.3	0.89
chr6	81867393	81867664	CpG: 22	271	22	163	16.2	60.1	0.91
chr6	82460040	82460282	CpG: 20	242	20	147	16.5	60.7	0.91
chr6	82851007	82851292	CpG: 24	285	24	178	16.8	62.5	0.88
chr6	82960780	82963450	CpG: 230	2670	230	1658	17.2	62.1	0.90
chr6	83088222	83088498	CpG: 24	276	24	173	17.4	62.7	0.90
chr6	83214047	83214314	CpG: 19	267	19	163	14.2	61.0	0.77
chr6	83277705	83277934	CpG: 20	229	20	142	17.5	62.0	0.92
chr6	83361502	83361737	CpG: 20	235	20	142	17.0	60.4	0.95
chr6	83372042	83372311	CpG: 22	269	22	165	16.4	61.3	0.88
chr6	83456677	83457185	CpG: 49	508	49	347	19.3	68.3	0.83
chr6	83457303	83457520	CpG: 15	217	15	135	13.8	62.2	0.73
chr6	83583145	83585048	CpG: 182	1903	182	1290	19.1	67.8	0.84
chr6	83614521	83614745	CpG: 20	224	20	132	17.9	58.9	1.03
chr6	83671155	83671429	CpG: 24	274	24	171	17.5	62.4	0.91
chr6	83778059	83778279	CpG: 17	220	17	128	15.5	58.2	0.92
chr6	84288660	84289052	CpG: 39	392	39	270	19.9	68.9	0.84
chr6	84290557	84291273	CpG: 74	716	74	506	20.7	70.7	0.85
chr6	84416119	84417300	CpG: 113	1181	113	826	19.1	69.9	0.79
chr6	84498816	84499275	CpG: 32	459	32	255	13.9	55.6	0.91
chr6	84506153	84506393	CpG: 21	240	21	148	17.5	61.7	0.95
chr6	84557216	84557610	CpG: 30	394	30	235	15.2	59.6	0.86
chr6	84628949	84629223	CpG: 21	274	21	167	15.3	60.9	0.83
chr6	84653899	84654485	CpG: 60	586	60	429	20.5	73.2	0.82
chr6	84843967	84844221	CpG: 18	254	18	149	14.2	58.7	0.84
chr6	84931122	84932902	CpG: 185	1780	185	1269	20.8	71.3	0.84
chr6	85026684	85027036	CpG: 26	352	26	206	14.8	58.5	0.87
chr6	85034945	85035219	CpG: 23	274	23	171	16.8	62.4	0.87
chr6	85076384	85077322	CpG: 93	938	93	624	19.8	66.5	0.90
chr6	85082827	85083183	CpG: 36	356	36	249	20.2	69.9	0.83
chr6	85245945	85246176	CpG: 18	231	18	136	15.6	58.9	0.91
chr6	85256929	85257819	CpG: 86	890	86	628	19.3	70.6	0.78
chr6	85413844	85414059	CpG: 17	215	17	125	15.8	58.1	0.96
chr6	85450692	85451304	CpG: 42	612	42	356	13.7	58.2	0.81
chr6	85559765	85560039	CpG: 23	274	23	170	16.8	62.0	0.88
chr6	85775449	85775726	CpG: 24	277	24	170	17.3	61.4	0.93
chr6	85782319	85782604	CpG: 25	285	25	175	17.5	61.4	0.94
chr6	85843719	85843953	CpG: 19	234	19	141	16.2	60.3	0.89
chr6	85889757	85890038	CpG: 22	281	22	173	15.7	61.6	0.84
chr6	85980229	85981659	CpG: 146	1430	146	937	20.4	65.5	0.96
chr6	85982897	85983188	CpG: 22	291	22	171	15.1	58.8	0.88
chr6	85990093	85992234	CpG: 188	2141	188	1353	17.6	63.2	0.88
chr6	86011517	86011791	CpG: 24	274	24	172	17.5	62.8	0.90
chr6	86068689	86068906	CpG: 16	217	16	126	14.7	58.1	0.88
chr6	86098376	86098642	CpG: 24	266	24	168	18.0	63.2	0.92
chr6	86503444	86503664	CpG: 19	220	19	142	17.3	64.5	1.02
chr6	86543113	86543315	CpG: 22	202	22	151	21.8	74.8	0.79
chr6	86598376	86598646	CpG: 22	270	22	164	16.3	60.7	0.90
chr6	86626584	86626802	CpG: 17	218	17	132	15.6	60.6	0.87
chr6	86666506	86667476	CpG: 105	970	105	665	21.6	68.6	0.92
chr6	86768864	86769094	CpG: 20	230	20	141	17.4	61.3	0.94
chr6	86770314	86770588	CpG: 21	274	21	163	15.3	59.5	0.87
chr6	86809519	86809777	CpG: 21	258	21	152	16.3	58.9	0.97
chr6	86810203	86811151	CpG: 108	948	108	652	22.8	68.8	0.97
chr6	86858671	86861034	CpG: 244	2363	244	1642	20.7	69.5	0.90
chr6	86861736	86862011	CpG: 22	275	22	168	16.0	61.1	0.86
chr6	86895110	86896275	CpG: 109	1165	109	718	18.7	61.6	0.99
chr6	87022055	87022295	CpG: 18	240	18	142	15.0	59.2	0.88
chr6	87715725	87716008	CpG: 23	283	23	174	16.3	61.5	0.87
chr6	87820423	87820697	CpG: 22	274	22	164	16.1	59.9	0.91
chr6	87958575	87958856	CpG: 24	281	24	175	17.1	62.3	0.90
chr6	88021034	88021268	CpG: 21	234	21	143	17.9	61.1	0.96
chr6	88146217	88146706	CpG: 45	489	45	330	18.4	67.5	0.81
chr6	88331228	88331619	CpG: 53	391	53	298	27.1	76.2	0.93
chr6	88360689	88361676	CpG: 90	987	90	653	18.2	66.2	0.83
chr6	88364080	88365257	CpG: 107	1177	107	778	18.2	66.1	0.83
chr6	88531249	88531521	CpG: 36	272	36	203	26.5	74.6	0.97
chr6	88616835	88617358	CpG: 55	523	55	359	21.0	68.6	0.89
chr6	88632000	88632275	CpG: 21	275	21	166	15.3	60.4	0.85
chr6	88680839	88681113	CpG: 21	274	21	161	15.3	58.8	0.89
chr6	88681409	88682243	CpG: 75	834	75	567	18.0	68.0	0.78
chr6	88798198	88798523	CpG: 35	325	35	211	21.5	64.9	1.03
chr6	88818882	88819163	CpG: 23	281	23	173	16.4	61.6	0.88
chr6	88852424	88852702	CpG: 23	278	23	172	16.5	61.9	0.87
chr6	88909756	88910782	CpG: 120	1026	120	696	23.4	67.8	1.04
chr6	88911628	88911875	CpG: 19	247	19	142	15.4	57.5	0.97
chr6	88916109	88916388	CpG: 24	279	24	173	17.2	62.0	0.90
chr6	88957520	88957877	CpG: 24	357	24	207	13.4	58.0	0.80
chr6	88959284	88960317	CpG: 79	1033	79	730	15.3	70.7	0.61
chr6	89052340	89052618	CpG: 21	278	21	170	15.1	61.2	0.82
chr6	89256052	89256639	CpG: 76	587	76	413	25.9	70.4	1.05
chr6	89347324	89347605	CpG: 24	281	24	176	17.1	62.6	0.89
chr6	89374170	89376222	CpG: 227	2052	227	1445	22.1	70.4	0.90
chr6	89481508	89481752	CpG: 19	244	19	144	15.6	59.0	0.91
chr6	89857848	89858113	CpG: 20	265	20	160	15.1	60.4	0.85
chr6	89922917	89923191	CpG: 24	274	24	171	17.5	62.4	0.91
chr6	90094436	90094673	CpG: 18	237	18	141	15.2	59.5	0.87
chr6	90171725	90172420	CpG: 67	695	67	444	19.3	63.9	0.97
chr6	90273685	90273963	CpG: 22	278	22	200	15.8	71.9	0.61
chr6	90289081	90290721	CpG: 158	1640	158	1132	19.3	69.0	0.81
chr6	90300586	90300822	CpG: 17	236	17	139	14.4	58.9	0.85
chr6	90326057	90327051	CpG: 134	994	134	752	27.0	75.7	0.95
chr6	90354582	90355475	CpG: 116	893	116	676	26.0	75.7	0.91
chr6	90374970	90375206	CpG: 22	236	22	146	18.6	61.9	1.00
chr6	90440109	90440536	CpG: 31	427	31	256	14.5	60.0	0.81
chr6	90550153	90550426	CpG: 22	273	22	169	16.1	61.9	0.86
chr6	90561691	90562537	CpG: 109	846	109	645	25.8	76.2	0.89
chr6	90620520	90622016	CpG: 169	1496	169	1089	22.6	72.8	0.86
chr6	90642393	90643277	CpG: 107	884	107	663	24.2	75.0	0.86
chr6	90847823	90848264	CpG: 44	441	44	292	20.0	66.2	0.91
chr6	91028777	91029694	CpG: 76	917	76	569	16.6	62.1	0.86
chr6	91039093	91039593	CpG: 38	500	38	320	15.2	64.0	0.76
chr6	91049487	91049716	CpG: 17	229	17	136	14.8	59.4	0.86
chr6	91095330	91095556	CpG: 17	226	17	136	15.0	60.2	0.85
chr6	91098241	91098826	CpG: 37	585	37	352	12.6	60.2	0.70
chr6	91099183	91099629	CpG: 35	446	35	294	15.7	65.9	0.73
chr6	91117593	91117855	CpG: 21	262	21	163	16.0	62.2	0.84
chr6	91159305	91159506	CpG: 17	201	17	117	16.9	58.2	1.03
chr6	91335185	91335469	CpG: 24	284	24	179	16.9	63.0	0.86
chr6	91401029	91401314	CpG: 26	285	26	179	18.2	62.8	0.94
chr6	91506662	91508811	CpG: 261	2149	261	1547	24.3	72.0	0.94
chr6	91797338	91798601	CpG: 99	1263	99	757	15.7	59.9	0.88
chr6	91822099	91822775	CpG: 69	676	69	479	20.4	70.9	0.81
chr6	92216649	92216958	CpG: 23	309	23	189	14.9	61.2	0.80
chr6	92264566	92264853	CpG: 24	287	24	175	16.7	61.0	0.90
chr6	93062677	93062951	CpG: 23	274	23	169	16.8	61.7	0.89
chr6	93309993	93310230	CpG: 20	237	20	143	16.9	60.3	0.96
chr6	93412592	93412875	CpG: 23	283	23	174	16.3	61.5	0.87
chr6	93562810	93563040	CpG: 18	230	18	138	15.7	60.0	0.89
chr6	93837663	93837944	CpG: 22	281	22	173	15.7	61.6	0.84
chr6	93935003	93935593	CpG: 53	590	53	429	18.0	72.7	0.68
chr6	93943199	93943473	CpG: 24	274	24	170	17.5	62.0	0.92
chr6	94078132	94078409	CpG: 23	277	23	171	16.6	61.7	0.88
chr6	94409706	94409974	CpG: 20	268	20	162	14.9	60.4	0.82
chr6	94503506	94503780	CpG: 24	274	24	172	17.5	62.8	0.90
chr6	94526901	94527179	CpG: 26	278	26	177	18.7	63.7	0.93
chr6	94628556	94631961	CpG: 247	3405	247	2016	14.5	59.2	0.83
chr6	94849137	94849564	CpG: 35	427	35	267	16.4	62.5	0.85
chr6	94858788	94859064	CpG: 22	276	22	166	15.9	60.1	0.89
chr6	94946540	94946772	CpG: 16	232	16	137	13.8	59.1	0.81
chr6	94965812	94966083	CpG: 22	271	22	162	16.2	59.8	0.93
chr6	94980499	94980735	CpG: 21	236	21	146	17.8	61.9	0.96
chr6	95013950	95014220	CpG: 21	270	21	166	15.6	61.5	0.84
chr6	95036623	95036897	CpG: 22	274	22	170	16.1	62.0	0.84
chr6	95054807	95055081	CpG: 22	274	22	169	16.1	61.7	0.85
chr6	95072648	95072897	CpG: 21	249	21	147	16.9	59.0	0.98
chr6	95083301	95083584	CpG: 23	283	23	172	16.3	60.8	0.88
chr6	95148836	95149113	CpG: 22	277	22	168	15.9	60.6	0.87
chr6	95409225	95409455	CpG: 16	230	16	134	13.9	58.3	0.83
chr6	95419304	95419731	CpG: 33	427	33	257	15.5	60.2	0.86
chr6	95557974	95558355	CpG: 26	381	26	204	13.6	53.5	0.95
chr6	95816346	95816627	CpG: 24	281	24	175	17.1	62.3	0.90
chr6	95840540	95840770	CpG: 19	230	19	140	16.5	60.9	0.90
chr6	95873270	95873551	CpG: 24	281	24	175	17.1	62.3	0.90
chr6	96039265	96039475	CpG: 19	210	19	122	18.1	58.1	1.08
chr6	96143119	96143404	CpG: 24	285	24	177	16.8	62.1	0.89
chr6	96157122	96157474	CpG: 26	352	26	208	14.8	59.1	0.85
chr6	96164138	96164419	CpG: 24	281	24	175	17.1	62.3	0.90
chr6	96207164	96207397	CpG: 18	233	18	135	15.5	57.9	0.94
chr6	96748315	96749116	CpG: 75	801	75	527	18.7	65.8	0.87
chr6	96773679	96773960	CpG: 24	281	24	175	17.1	62.3	0.90
chr6	96929455	96929690	CpG: 21	235	21	145	17.9	61.7	0.94
chr6	97078526	97078765	CpG: 17	239	17	139	14.2	58.2	0.88
chr6	97186455	97187199	CpG: 62	744	62	518	16.7	69.6	0.70
chr6	97213943	97214205	CpG: 20	262	20	160	15.3	61.1	0.83
chr6	97232202	97232474	CpG: 25	272	25	168	18.4	61.8	0.97
chr6	97293953	97294234	CpG: 20	281	20	169	14.2	60.1	0.80
chr6	97433156	97433513	CpG: 32	357	32	260	17.9	72.8	0.68
chr6	97549049	97549278	CpG: 20	229	20	139	17.5	60.7	0.97
chr6	97693531	97694120	CpG: 60	589	60	402	20.4	68.3	0.89
chr6	97791016	97791252	CpG: 19	236	19	144	16.1	61.0	0.88
chr6	98008744	98009696	CpG: 92	952	92	643	19.3	67.5	0.85
chr6	98022554	98022834	CpG: 22	280	22	165	15.7	58.9	0.92
chr6	98069191	98069911	CpG: 70	720	70	481	19.4	66.8	0.87
chr6	98096093	98096773	CpG: 79	680	79	476	23.2	70.0	0.97
chr6	98187430	98187655	CpG: 21	225	21	137	18.7	60.9	1.03
chr6	98230613	98230890	CpG: 23	277	23	170	16.6	61.4	0.89
chr6	98412248	98412828	CpG: 46	580	46	352	15.9	60.7	0.86
chr6	98456742	98457245	CpG: 53	503	53	335	21.1	66.6	0.97
chr6	98936477	98936702	CpG: 20	225	20	137	17.8	60.9	0.97
chr6	98977400	98977630	CpG: 19	230	19	140	16.5	60.9	0.90
chr6	99112872	99113104	CpG: 18	232	18	139	15.5	59.9	0.87
chr6	99370213	99370491	CpG: 24	278	24	174	17.3	62.6	0.89
chr6	99398491	99398727	CpG: 20	236	20	144	16.9	61.0	0.93
chr6	99417645	99417926	CpG: 23	281	23	174	16.4	61.9	0.87
chr6	99877474	99877825	CpG: 28	351	28	208	16.0	59.3	0.91
chr6	99998887	99999507	CpG: 50	620	50	404	16.1	65.2	0.78
chr6	100002256	100002531	CpG: 19	275	19	182	13.8	66.2	0.70
chr6	100005811	100010336	CpG: 357	4525	357	2887	15.8	63.8	0.78
chr6	100016773	100017265	CpG: 38	492	38	329	15.4	66.9	0.69
chr6	100017821	100018275	CpG: 43	454	43	323	18.9	71.1	0.75
chr6	100019244	100019820	CpG: 52	576	52	377	18.1	65.5	0.85
chr6	100022236	100022949	CpG: 51	713	51	489	14.3	68.6	0.61
chr6	100109877	100110158	CpG: 23	281	23	174	16.4	61.9	0.87
chr6	100121794	100122461	CpG: 85	667	85	505	25.5	75.7	0.92
chr6	100176729	100177010	CpG: 24	281	24	174	17.1	61.9	0.91
chr6	100302472	100302734	CpG: 25	262	25	165	19.1	63.0	0.98
chr6	100426411	100426647	CpG: 21	236	21	148	17.8	62.7	0.93
chr6	100493486	100493766	CpG: 23	280	23	165	16.4	58.9	0.95
chr6	100523695	100524436	CpG: 99	741	99	580	26.7	78.3	0.87
chr6	100568131	100568841	CpG: 54	710	54	422	15.2	59.4	0.88
chr6	100599194	100599772	CpG: 43	578	43	308	14.9	53.3	1.07
chr6	100657893	100658178	CpG: 24	285	24	178	16.8	62.5	0.88
chr6	100689279	100690432	CpG: 106	1153	106	749	18.4	65.0	0.88
chr6	100695278	100695482	CpG: 23	204	23	148	22.5	72.5	0.89
chr6	100742462	100743168	CpG: 61	706	61	444	17.3	62.9	0.88
chr6	100762011	100762715	CpG: 57	704	57	449	16.2	63.8	0.80
chr6	100762891	100763112	CpG: 16	221	16	146	14.5	66.1	0.66
chr6	100764223	100765045	CpG: 62	822	62	540	15.1	65.7	0.70
chr6	100776592	100777546	CpG: 83	954	83	627	17.4	65.7	0.81
chr6	100780263	100780565	CpG: 38	302	38	214	25.2	70.9	1.02
chr6	100781218	100781443	CpG: 21	225	21	152	18.7	67.6	0.82
chr6	100786555	100788236	CpG: 190	1681	190	1192	22.6	70.9	0.90
chr6	100791984	100792856	CpG: 75	872	75	568	17.2	65.1	0.82
chr6	100823559	100823929	CpG: 37	370	37	285	20.0	77.0	0.67
chr6	100997007	100997434	CpG: 33	427	33	257	15.5	60.2	0.86
chr6	101133006	101133279	CpG: 23	273	23	173	16.8	63.4	0.85
chr6	101167225	101167971	CpG: 67	746	67	492	18.0	66.0	0.83
chr6	101200263	101200540	CpG: 24	277	24	177	17.3	63.9	0.86
chr6	101222744	101223010	CpG: 20	266	20	163	15.0	61.3	0.81
chr6	101309731	101310005	CpG: 21	274	21	158	15.3	57.7	0.93
chr6	101339915	101340187	CpG: 19	272	19	166	14.0	61.0	0.76
chr6	101370228	101370656	CpG: 36	428	36	258	16.8	60.3	0.94
chr6	101402695	101402970	CpG: 27	275	27	191	19.6	69.5	0.85
chr6	101528610	101528957	CpG: 27	347	27	210	15.6	60.5	0.85
chr6	101576361	101576638	CpG: 24	277	24	174	17.3	62.8	0.89
chr6	101620891	101621130	CpG: 20	239	20	151	16.7	63.2	0.84
chr6	101621657	101621946	CpG: 23	289	23	184	15.9	63.7	0.79
chr6	101622964	101623505	CpG: 47	541	47	334	17.4	61.7	0.91
chr6	101629385	101629607	CpG: 24	222	24	149	21.6	67.1	0.98
chr6	101631338	101632566	CpG: 91	1228	91	791	14.8	64.4	0.71
chr6	101635090	101635324	CpG: 21	234	21	148	17.9	63.2	0.98
chr6	101637944	101639210	CpG: 108	1266	108	817	17.1	64.5	0.82
chr6	101640819	101641118	CpG: 25	299	25	182	16.7	60.9	0.94
chr6	101641475	101641756	CpG: 20	281	20	168	14.2	59.8	0.80
chr6	101643078	101643396	CpG: 31	318	31	212	19.5	66.7	0.88
chr6	101683408	101683626	CpG: 19	218	19	136	17.4	62.4	0.92
chr6	101782721	101782982	CpG: 19	261	19	156	14.6	59.8	0.82
chr6	102054759	102055463	CpG: 80	704	80	489	22.7	69.5	0.96
chr6	102111015	102111253	CpG: 18	238	18	140	15.1	58.8	0.91
chr6	102321687	102321968	CpG: 24	281	24	175	17.1	62.3	0.90
chr6	102489066	102489325	CpG: 18	259	18	153	13.9	59.1	0.82
chr6	102504853	102505127	CpG: 20	274	20	164	14.6	59.9	0.82
chr6	102567307	102567787	CpG: 53	480	53	334	22.1	69.6	0.91
chr6	102572648	102573017	CpG: 27	369	27	212	14.6	57.5	0.89
chr6	102575688	102576856	CpG: 79	1168	79	728	13.5	62.3	0.71
chr6	102720544	102720823	CpG: 25	279	25	174	17.9	62.4	0.93
chr6	102933615	102933884	CpG: 23	269	23	167	17.1	62.1	0.90
chr6	103038858	103039139	CpG: 23	281	23	174	16.4	61.9	0.87
chr6	103263374	103263617	CpG: 18	243	18	143	14.8	58.8	0.86
chr6	103725669	103725946	CpG: 23	277	23	176	16.6	63.5	0.83
chr6	103897296	103897648	CpG: 24	352	24	207	13.6	58.8	0.79
chr6	103952061	103952276	CpG: 20	215	20	129	18.6	60.0	1.06
chr6	104080237	104080580	CpG: 27	343	27	186	15.7	54.2	1.08
chr6	104085842	104086332	CpG: 43	490	43	354	17.6	72.2	0.67
chr6	104368077	104368351	CpG: 25	274	25	173	18.2	63.1	0.92
chr6	104407633	104407858	CpG: 18	225	18	135	16.0	60.0	0.91
chr6	104469557	104469947	CpG: 36	390	36	288	18.5	73.8	0.68
chr6	104596288	104596568	CpG: 22	280	22	171	15.7	61.1	0.86
chr6	104838753	104838984	CpG: 20	231	20	143	17.3	61.9	0.91
chr6	104884574	104884808	CpG: 21	234	21	144	17.9	61.5	0.95
chr6	104910732	104911006	CpG: 24	274	24	171	17.5	62.4	0.91
chr6	105042376	105042618	CpG: 17	242	17	141	14.0	58.3	0.84
chr6	105093123	105093401	CpG: 26	278	26	175	18.7	62.9	0.95
chr6	105470538	105470822	CpG: 24	284	24	175	16.9	61.6	0.91
chr6	105500962	105501237	CpG: 24	275	24	171	17.5	62.2	0.91
chr6	105537768	105538041	CpG: 24	273	24	170	17.6	62.3	0.92
chr6	105588610	105588846	CpG: 18	236	18	144	15.3	61.0	0.84
chr6	105622688	105623112	CpG: 36	424	36	315	17.0	74.3	0.62
chr6	105640699	105640980	CpG: 24	281	24	175	17.1	62.3	0.90
chr6	105665911	105666338	CpG: 35	427	35	262	16.4	61.4	0.88
chr6	105913748	105913972	CpG: 19	224	19	133	17.0	59.4	0.96
chr6	106035266	106036063	CpG: 88	797	88	566	22.1	71.0	0.89
chr6	106116330	106117685	CpG: 190	1355	190	1001	28.0	73.9	1.03
chr6	106129017	106129289	CpG: 29	272	29	165	21.3	60.7	1.16
chr6	106167105	106167920	CpG: 69	815	69	575	16.9	70.6	0.68
chr6	106291207	106291434	CpG: 15	227	15	131	13.2	57.7	0.80
chr6	106312036	106313508	CpG: 172	1472	172	1030	23.4	70.0	0.96
chr6	106355266	106355930	CpG: 102	664	102	505	30.7	76.1	1.07
chr6	106543272	106543517	CpG: 21	245	21	150	17.1	61.2	0.93
chr6	106578434	106579210	CpG: 104	776	104	594	26.8	76.5	0.92
chr6	106851029	106851304	CpG: 26	275	26	172	18.9	62.5	0.98
chr6	106954154	106954394	CpG: 17	240	17	147	14.2	61.2	0.77
chr6	107005318	107005548	CpG: 17	230	17	137	14.8	59.6	0.85
chr6	107029663	107030766	CpG: 88	1103	88	791	16.0	71.7	0.62
chr6	107104459	107104736	CpG: 20	277	20	169	14.4	61.0	0.79
chr6	107123285	107123521	CpG: 22	236	22	146	18.6	61.9	1.00
chr6	107156266	107156502	CpG: 18	236	18	139	15.3	58.9	0.91
chr6	107157158	107157819	CpG: 61	661	61	421	18.5	63.7	0.91
chr6	107162031	107162506	CpG: 39	475	39	292	16.4	61.5	0.87
chr6	107170024	107170949	CpG: 92	925	92	561	19.9	60.6	1.09
chr6	107262118	107262367	CpG: 30	249	30	174	24.1	69.9	1.00
chr6	107445562	107445952	CpG: 37	390	37	287	19.0	73.6	0.70
chr6	107497542	107497812	CpG: 21	270	21	162	15.6	60.0	0.87
chr6	107501474	107502090	CpG: 56	616	56	417	18.2	67.7	0.83
chr6	107536540	107537427	CpG: 91	887	91	639	20.5	72.0	0.79
chr6	107538192	107538395	CpG: 16	203	16	122	15.8	60.1	0.89
chr6	107539096	107539369	CpG: 25	273	25	169	18.3	61.9	0.96
chr6	107541873	107542111	CpG: 20	238	20	144	16.8	60.5	0.94
chr6	107612798	107613071	CpG: 21	273	21	169	15.4	61.9	0.81
chr6	107638652	107638915	CpG: 20	263	20	161	15.2	61.2	0.83
chr6	107657456	107657735	CpG: 25	279	25	175	17.9	62.7	0.92
chr6	107686844	107687330	CpG: 44	486	44	318	18.1	65.4	0.85
chr6	107688376	107689597	CpG: 119	1221	119	842	19.5	69.0	0.82
chr6	107807435	107807645	CpG: 17	210	17	126	16.2	60.0	0.92
chr6	107847059	107847309	CpG: 20	250	20	151	16.0	60.4	0.89
chr6	107847726	107847973	CpG: 21	247	21	152	17.0	61.5	0.91
chr6	107981876	107982173	CpG: 23	297	23	210	15.5	70.7	0.62
chr6	107992838	107993225	CpG: 34	387	34	284	17.6	73.4	0.65
chr6	108149405	108151943	CpG: 252	2538	252	1764	19.9	69.5	0.82
chr6	108189322	108189562	CpG: 22	240	22	144	18.3	60.0	1.04
chr6	108206610	108207402	CpG: 80	792	80	526	20.2	66.4	0.92
chr6	108208056	108208413	CpG: 29	357	29	206	16.2	57.7	0.99
chr6	108247613	108248902	CpG: 98	1289	98	819	15.2	63.5	0.76
chr6	108248982	108249218	CpG: 16	236	16	153	13.6	64.8	0.65
chr6	108293195	108295051	CpG: 264	1856	264	1412	28.4	76.1	0.99
chr6	108305471	108305705	CpG: 20	234	20	143	17.1	61.1	0.94
chr6	108393091	108393315	CpG: 18	224	18	135	16.1	60.3	0.92
chr6	108528045	108528282	CpG: 18	237	18	139	15.2	58.6	0.91
chr6	108543122	108543505	CpG: 30	383	30	275	15.7	71.8	0.61
chr6	108584518	108584792	CpG: 24	274	24	171	17.5	62.4	0.91
chr6	108637144	108637346	CpG: 16	202	16	117	15.8	57.9	0.95
chr6	108637961	108638182	CpG: 19	221	19	141	17.2	63.8	0.85
chr6	108638500	108639135	CpG: 50	635	50	408	15.7	64.3	0.77
chr6	108667795	108670462	CpG: 250	2667	250	1819	18.7	68.2	0.81
chr6	108812874	108814404	CpG: 169	1530	169	1095	22.1	71.6	0.88
chr6	108956744	108956984	CpG: 21	240	21	151	17.5	62.9	0.90
chr6	108980522	108981184	CpG: 55	662	55	456	16.6	68.9	0.70
chr6	109025886	109026280	CpG: 32	394	32	274	16.2	69.5	0.68
chr6	109038070	109038305	CpG: 19	235	19	138	16.2	58.7	0.94
chr6	109134859	109135654	CpG: 94	795	94	568	23.6	71.4	0.94
chr6	109251306	109252217	CpG: 96	911	96	648	21.1	71.1	0.84
chr6	109252491	109252718	CpG: 17	227	17	136	15.0	59.9	0.85
chr6	109291985	109292398	CpG: 38	413	38	268	18.4	64.9	0.90
chr6	109293870	109297081	CpG: 248	3211	248	2026	15.4	63.1	0.78
chr6	109310934	109311147	CpG: 23	213	23	165	21.6	77.5	0.72
chr6	109334427	109335462	CpG: 94	1035	94	673	18.2	65.0	0.87
chr6	109341574	109347313	CpG: 382	5739	382	3512	13.3	61.2	0.71
chr6	109351557	109351889	CpG: 26	332	26	223	15.7	67.2	0.71
chr6	109352618	109353223	CpG: 40	605	40	379	13.2	62.6	0.68
chr6	109353498	109353899	CpG: 40	401	40	273	20.0	68.1	0.86
chr6	109413524	109413803	CpG: 23	279	23	170	16.5	60.9	0.89
chr6	109437631	109438584	CpG: 105	953	105	667	22.0	70.0	0.90
chr6	109472159	109472596	CpG: 34	437	34	288	15.6	65.9	0.72
chr6	109493492	109493778	CpG: 25	286	25	177	17.5	61.9	0.93
chr6	109578524	109578809	CpG: 25	285	25	179	17.5	62.8	0.90
chr6	109655489	109655772	CpG: 21	283	21	172	14.8	60.8	0.83
chr6	109734981	109739543	CpG: 502	4562	502	3102	22.0	68.0	0.95
chr6	109762414	109762689	CpG: 23	275	23	170	16.7	61.8	0.89
chr6	109840912	109841159	CpG: 18	247	18	155	14.6	62.8	0.75
chr6	109896261	109896535	CpG: 25	274	25	171	18.2	62.4	0.94
chr6	110010944	110011194	CpG: 21	250	21	152	16.8	60.8	0.92
chr6	110025676	110026311	CpG: 62	635	62	447	19.5	70.4	0.79
chr6	110067321	110067564	CpG: 22	243	22	150	18.1	61.7	0.97
chr6	110186502	110187253	CpG: 91	751	91	543	24.2	72.3	0.93
chr6	110272464	110273651	CpG: 111	1187	111	779	18.7	65.6	0.87
chr6	110279788	110280019	CpG: 20	231	20	138	17.3	59.7	0.98
chr6	110428841	110429133	CpG: 27	292	27	181	18.5	62.0	0.97
chr6	110468283	110469064	CpG: 61	781	61	535	15.6	68.5	0.67
chr6	110559732	110560927	CpG: 120	1195	120	804	20.1	67.3	0.89
chr6	110585306	110585565	CpG: 21	259	21	158	16.2	61.0	0.89
chr6	110618230	110619439	CpG: 141	1209	141	868	23.3	71.8	0.91
chr6	110633029	110634480	CpG: 140	1451	140	1032	19.3	71.1	0.77
chr6	110660930	110661744	CpG: 99	814	99	649	24.3	79.7	0.80
chr6	110727725	110727998	CpG: 25	273	25	170	18.3	62.3	0.96
chr6	110766129	110766402	CpG: 22	273	22	166	16.1	60.8	0.88
chr6	110807725	110807959	CpG: 20	234	20	141	17.1	60.3	0.96
chr6	110862656	110862892	CpG: 20	236	20	143	16.9	60.6	0.94
chr6	110868440	110868655	CpG: 20	215	20	156	18.6	72.6	0.71
chr6	110869216	110869620	CpG: 31	404	31	267	15.3	66.1	0.70
chr6	111156608	111158510	CpG: 144	1902	144	1240	15.1	65.2	0.71
chr6	111357263	111358204	CpG: 104	941	104	660	22.1	70.1	0.91
chr6	111358847	111359059	CpG: 18	212	18	129	17.0	60.8	0.92
chr6	111363705	111363935	CpG: 20	230	20	141	17.4	61.3	0.94
chr6	111536127	111537106	CpG: 115	979	115	723	23.5	73.9	0.86
chr6	111578344	111578919	CpG: 42	575	42	376	14.6	65.4	0.69
chr6	111654615	111655505	CpG: 95	890	95	634	21.3	71.2	0.85
chr6	111777937	111778217	CpG: 21	280	21	169	15.0	60.4	0.84
chr6	111824379	111825191	CpG: 74	812	74	524	18.2	64.5	0.88
chr6	111983172	111983516	CpG: 27	344	27	201	15.7	58.4	0.92
chr6	111992916	111994314	CpG: 159	1398	159	967	22.7	69.2	0.97
chr6	112047791	112048025	CpG: 19	234	19	142	16.2	60.7	0.90
chr6	112052782	112054975	CpG: 185	2193	185	1368	16.9	62.4	0.87
chr6	112137063	112137629	CpG: 61	566	61	392	21.6	69.3	0.91
chr6	112152637	112152875	CpG: 20	238	20	143	16.8	60.1	0.96
chr6	112160235	112160895	CpG: 53	660	53	400	16.1	60.6	0.88
chr6	112162359	112162629	CpG: 21	270	21	166	15.6	61.5	0.84
chr6	112195765	112196724	CpG: 75	959	75	663	15.6	69.1	0.66
chr6	112208166	112208429	CpG: 21	263	21	162	16.0	61.6	0.85
chr6	112265825	112266883	CpG: 126	1058	126	784	23.8	74.1	0.87
chr6	112341718	112341992	CpG: 23	274	23	170	16.8	62.0	0.88
chr6	112440859	112441135	CpG: 22	276	22	166	15.9	60.1	0.89
chr6	112442256	112442903	CpG: 58	647	58	434	17.9	67.1	0.80
chr6	112494947	112495180	CpG: 16	233	16	139	13.7	59.7	0.78
chr6	112608161	112608398	CpG: 17	237	17	139	14.3	58.6	0.86
chr6	112665352	112667305	CpG: 223	1953	223	1367	22.8	70.0	0.93
chr6	112708683	112708902	CpG: 17	219	17	132	15.5	60.3	0.88
chr6	112789285	112789558	CpG: 21	273	21	163	15.4	59.7	0.88
chr6	112824848	112825094	CpG: 19	246	19	150	15.4	61.0	0.86
chr6	113055717	113056736	CpG: 140	1019	140	787	27.5	77.2	0.92
chr6	113065775	113065997	CpG: 20	222	20	137	18.0	61.7	0.96
chr6	113091728	113091971	CpG: 21	243	21	144	17.3	59.3	0.99
chr6	113145573	113145847	CpG: 24	274	24	172	17.5	62.8	0.90
chr6	113230661	113231262	CpG: 43	601	43	396	14.3	65.9	0.66
chr6	113270621	113271125	CpG: 49	504	49	319	19.4	63.3	0.97
chr6	113437323	113437715	CpG: 36	392	36	262	18.4	66.8	0.82
chr6	113523561	113523842	CpG: 26	281	26	176	18.5	62.6	0.95
chr6	113545969	113546189	CpG: 16	220	16	143	14.5	65.0	0.72
chr6	113550287	113550968	CpG: 65	681	65	466	19.1	68.4	0.82
chr6	113673082	113673357	CpG: 23	275	23	171	16.7	62.2	0.88
chr6	113711592	113712365	CpG: 55	773	55	530	14.2	68.6	0.61
chr6	113823520	113823794	CpG: 23	274	23	170	16.8	62.0	0.88
chr6	113872591	113873107	CpG: 50	516	50	381	19.4	73.8	0.71
chr6	113887087	113887379	CpG: 24	292	24	178	16.4	61.0	0.89
chr6	113996404	113996628	CpG: 19	224	19	134	17.0	59.8	0.95
chr6	114391230	114391458	CpG: 19	228	19	136	16.7	59.6	0.95
chr6	114409984	114410295	CpG: 25	311	25	190	16.1	61.1	0.87
chr6	114517847	114518086	CpG: 17	239	17	140	14.2	58.6	0.86
chr6	114583555	114583787	CpG: 17	232	17	137	14.7	59.1	0.86
chr6	114697915	114698146	CpG: 17	231	17	138	14.7	59.7	0.86
chr6	114927107	114927388	CpG: 23	281	23	174	16.4	61.9	0.87
chr6	114931322	114931596	CpG: 25	274	25	171	18.2	62.4	0.95
chr6	114999682	114999956	CpG: 23	274	23	169	16.8	61.7	0.89
chr6	115039038	115039527	CpG: 41	489	41	321	16.8	65.6	0.83
chr6	115041850	115042071	CpG: 20	221	20	141	18.1	63.8	0.89
chr6	115042787	115044740	CpG: 205	1953	205	1355	21.0	69.4	0.88
chr6	115115086	115115434	CpG: 25	348	25	234	14.4	67.2	0.64
chr6	115153332	115154688	CpG: 141	1356	141	955	20.8	70.4	0.84
chr6	115335061	115335279	CpG: 16	218	16	125	14.7	57.3	0.89
chr6	115525314	115526845	CpG: 162	1531	162	1104	21.2	72.1	0.82
chr6	115996110	115996348	CpG: 19	238	19	143	16.0	60.1	0.91
chr6	116159282	116159509	CpG: 20	227	20	137	17.6	60.4	0.97
chr6	116226209	116226490	CpG: 24	281	24	174	17.1	61.9	0.91
chr6	116359002	116359228	CpG: 21	226	21	133	18.6	58.8	1.07
chr6	117018096	117018483	CpG: 30	387	30	276	15.5	71.3	0.61
chr6	117072465	117072838	CpG: 30	373	30	266	16.1	71.3	0.63
chr6	117111827	117112092	CpG: 24	265	24	198	18.1	74.7	0.65
chr6	117136735	117137009	CpG: 24	274	24	171	17.5	62.4	0.91
chr6	117143515	117143909	CpG: 29	394	29	235	14.7	59.6	0.83
chr6	117242622	117242859	CpG: 21	237	21	145	17.7	61.2	0.97
chr6	117284495	117285204	CpG: 83	709	83	511	23.4	72.1	0.90
chr6	117426057	117426270	CpG: 16	213	16	124	15.0	58.2	0.94
chr6	117437724	117438185	CpG: 40	461	40	294	17.4	63.8	0.85
chr6	117461663	117461889	CpG: 20	226	20	139	17.7	61.5	0.94
chr6	117463313	117463993	CpG: 61	680	61	441	17.9	64.9	0.86
chr6	117554698	117555739	CpG: 123	1041	123	757	23.6	72.7	0.90
chr6	117556219	117556459	CpG: 19	240	19	146	15.8	60.8	0.87
chr6	117645625	117646236	CpG: 78	611	78	440	25.5	72.0	0.99
chr6	117710967	117711243	CpG: 23	276	23	170	16.7	61.6	0.88
chr6	117736505	117736783	CpG: 21	278	21	168	15.1	60.4	0.83
chr6	117748701	117748962	CpG: 26	261	26	175	19.9	67.0	0.90
chr6	117754783	117755482	CpG: 62	699	62	471	17.7	67.4	0.78
chr6	117864604	117865331	CpG: 67	727	67	462	18.4	63.5	0.91
chr6	117943103	117943306	CpG: 16	203	16	117	15.8	57.6	0.96
chr6	117948279	117949482	CpG: 112	1203	112	819	18.6	68.1	0.81
chr6	118000409	118000625	CpG: 19	216	19	127	17.6	58.8	1.02
chr6	118001982	118002260	CpG: 23	278	23	174	16.5	62.6	0.85
chr6	118060703	118061328	CpG: 61	625	61	452	19.5	72.3	0.75
chr6	118121544	118121782	CpG: 18	238	18	145	15.1	60.9	0.83
chr6	118198607	118198990	CpG: 37	383	37	283	19.3	73.9	0.71
chr6	118286102	118286394	CpG: 21	292	21	176	14.4	60.3	0.79
chr6	118365825	118366135	CpG: 26	310	26	192	16.8	61.9	0.88
chr6	118428776	118429086	CpG: 24	310	24	188	15.5	60.6	0.85
chr6	118447310	118447542	CpG: 20	232	20	154	17.2	66.4	0.78
chr6	118449208	118449882	CpG: 66	674	66	455	19.6	67.5	0.86
chr6	118454259	118455005	CpG: 97	746	97	565	26.0	75.7	0.94
chr6	118587917	118588132	CpG: 18	215	18	129	16.7	60.0	0.96
chr6	118618685	118618959	CpG: 24	274	24	171	17.5	62.4	0.91
chr6	118666603	118667748	CpG: 128	1145	128	823	22.4	71.9	0.87
chr6	118732175	118732608	CpG: 48	433	48	308	22.2	71.1	0.89
chr6	118786434	118787042	CpG: 55	608	55	398	18.1	65.5	0.84
chr6	118793013	118793249	CpG: 22	236	22	147	18.6	62.3	0.98
chr6	118859470	118860450	CpG: 111	980	111	679	22.7	69.3	0.95
chr6	118860537	118860773	CpG: 17	236	17	139	14.4	58.9	0.86
chr6	118870225	118870456	CpG: 16	231	16	133	13.9	57.6	0.85
chr6	118934875	118935320	CpG: 31	445	31	298	13.9	67.0	0.62
chr6	118974040	118974314	CpG: 22	274	22	170	16.1	62.0	0.84
chr6	119005685	119005959	CpG: 22	274	22	169	16.1	61.7	0.85
chr6	119087303	119087578	CpG: 21	275	21	169	15.3	61.5	0.82
chr6	119091144	119092907	CpG: 210	1763	210	1275	23.8	72.3	0.91
chr6	119104433	119104655	CpG: 22	222	22	146	19.8	65.8	1.01
chr6	119546325	119546587	CpG: 27	262	27	167	20.6	63.7	1.03
chr6	119833618	119833855	CpG: 17	237	17	143	14.3	60.3	0.81
chr6	119835656	119837101	CpG: 161	1445	161	1036	22.3	71.7	0.87
chr6	119971876	119972102	CpG: 22	226	22	141	19.5	62.4	1.03
chr6	120079707	120081136	CpG: 159	1429	159	965	22.3	67.5	0.98
chr6	120120329	120121109	CpG: 92	780	92	555	23.6	71.2	0.93
chr6	120201628	120201894	CpG: 22	266	22	193	16.5	72.6	0.64
chr6	120264122	120265254	CpG: 137	1132	137	808	24.2	71.4	0.95
chr6	120282557	120282838	CpG: 24	281	24	176	17.1	62.6	0.89
chr6	120322219	120322500	CpG: 24	281	24	175	17.1	62.3	0.90
chr6	120461531	120461805	CpG: 23	274	23	170	16.8	62.0	0.88
chr6	120534649	120536484	CpG: 209	1835	209	1327	22.8	72.3	0.87
chr6	120627092	120627647	CpG: 49	555	49	400	17.7	72.1	0.68
chr6	120823435	120823675	CpG: 18	240	18	140	15.0	58.3	0.90
chr6	121138546	121138820	CpG: 25	274	25	172	18.2	62.8	0.94
chr6	121282483	121282722	CpG: 18	239	18	137	15.1	57.3	0.95
chr6	121288445	121288711	CpG: 19	266	19	160	14.3	60.2	0.79
chr6	121422853	121423135	CpG: 23	282	23	174	16.3	61.7	0.87
chr6	121433448	121433733	CpG: 25	285	25	179	17.5	62.8	0.90
chr6	121547519	121547793	CpG: 22	274	22	169	16.1	61.7	0.86
chr6	121594259	121594533	CpG: 24	274	24	171	17.5	62.4	0.91
chr6	121912715	121912951	CpG: 18	236	18	142	15.3	60.2	0.86
chr6	121993445	121993716	CpG: 20	271	20	160	14.8	59.0	0.88
chr6	122349852	122350279	CpG: 32	427	32	257	15.0	60.2	0.83
chr6	122520869	122521143	CpG: 24	274	24	170	17.5	62.0	0.92
chr6	122521435	122521965	CpG: 47	530	47	326	17.7	61.5	0.94
chr6	122872349	122872837	CpG: 38	488	38	275	15.6	56.4	0.98
chr6	122916660	122917273	CpG: 42	613	42	413	13.7	67.4	0.60
chr6	122929497	122929703	CpG: 15	206	15	121	14.6	58.7	0.87
chr6	123303683	123303968	CpG: 25	285	25	179	17.5	62.8	0.90
chr6	123392652	123392940	CpG: 23	288	23	179	16.0	62.2	0.84
chr6	123402288	123402567	CpG: 22	279	22	169	15.8	60.6	0.86
chr6	123468835	123469225	CpG: 39	390	39	289	20.0	74.1	0.73
chr6	123587724	123588579	CpG: 102	855	102	592	23.9	69.2	1.00
chr6	123659930	123660263	CpG: 27	333	27	200	16.2	60.1	0.94
chr6	123670302	123670577	CpG: 23	275	23	173	16.7	62.9	0.85
chr6	123695068	123695310	CpG: 20	242	20	146	16.5	60.3	0.94
chr6	123798307	123799294	CpG: 87	987	87	626	17.6	63.4	0.88
chr6	123977436	123978026	CpG: 66	590	66	410	22.4	69.5	0.93
chr6	124011077	124011303	CpG: 17	226	17	133	15.0	58.8	0.89
chr6	124184264	124184976	CpG: 71	712	71	493	19.9	69.2	0.83
chr6	124630095	124630328	CpG: 18	233	18	140	15.5	60.1	0.86
chr6	124659891	124660218	CpG: 23	327	23	191	14.1	58.4	0.83
chr6	124879353	124879571	CpG: 17	218	17	132	15.6	60.6	0.89
chr6	124948265	124948541	CpG: 24	276	24	172	17.4	62.3	0.91
chr6	124990914	124992046	CpG: 152	1132	152	851	26.9	75.2	0.95
chr6	125326867	125327148	CpG: 23	281	23	175	16.4	62.3	0.86
chr6	125380214	125380476	CpG: 22	262	22	161	16.8	61.5	0.90
chr6	125585457	125585699	CpG: 19	242	19	149	15.7	61.6	0.84
chr6	125670299	125670517	CpG: 17	218	17	133	15.6	61.0	0.86
chr6	125710194	125710468	CpG: 24	274	24	171	17.5	62.4	0.91
chr6	125768498	125768779	CpG: 23	281	23	173	16.4	61.6	0.87
chr6	125851879	125852109	CpG: 20	230	20	141	17.4	61.3	0.94
chr6	125909180	125909449	CpG: 26	269	26	170	19.3	63.2	0.98
chr6	126149881	126151271	CpG: 161	1390	161	1044	23.2	75.1	0.82
chr6	126287564	126288054	CpG: 47	490	47	356	19.2	72.7	0.74
chr6	126288337	126288613	CpG: 24	276	24	170	17.4	61.6	0.93
chr6	126314270	126314484	CpG: 18	214	18	159	16.8	74.3	0.61
chr6	126341946	126342972	CpG: 85	1026	85	668	16.6	65.1	0.78
chr6	126392935	126393168	CpG: 17	233	17	139	14.6	59.7	0.83
chr6	126489887	126490416	CpG: 63	529	63	388	23.8	73.3	0.89
chr6	126551857	126552178	CpG: 31	321	31	214	19.3	66.7	0.87
chr6	126832967	126833284	CpG: 28	317	28	233	17.7	73.5	0.65
chr6	126936091	126938689	CpG: 240	2598	240	1673	18.5	64.4	0.89
chr6	126947703	126948200	CpG: 38	497	38	335	15.3	67.4	0.74
chr6	126958847	126959701	CpG: 66	854	66	585	15.5	68.5	0.66
chr6	126979066	126980011	CpG: 116	945	116	713	24.6	75.4	0.86
chr6	127145340	127146049	CpG: 77	709	77	490	21.7	69.1	0.91
chr6	127175001	127175539	CpG: 47	538	47	337	17.5	62.6	0.91
chr6	127215477	127215721	CpG: 18	244	18	147	14.8	60.2	0.83
chr6	127457560	127457837	CpG: 23	277	23	170	16.6	61.4	0.89
chr6	127506413	127506691	CpG: 26	278	26	175	18.7	62.9	0.96
chr6	127528566	127528818	CpG: 27	252	27	157	21.4	62.3	1.11
chr6	127735854	127736078	CpG: 20	224	20	140	17.9	62.5	0.95
chr6	127738564	127738838	CpG: 23	274	23	170	16.8	62.0	0.88
chr6	127811279	127811557	CpG: 23	278	23	173	16.5	62.2	0.86
chr6	127832084	127832469	CpG: 37	385	37	259	19.2	67.3	0.85
chr6	128307042	128308848	CpG: 160	1806	160	1179	17.7	65.3	0.84
chr6	128309329	128309536	CpG: 20	207	20	140	19.3	67.6	0.84
chr6	128402761	128402973	CpG: 17	212	17	125	16.0	59.0	0.93
chr6	128403518	128403907	CpG: 33	389	33	283	17.0	72.8	0.64
chr6	128455643	128456412	CpG: 91	769	91	557	23.7	72.4	0.91
chr6	128531991	128532554	CpG: 63	563	63	359	22.4	63.8	1.17
chr6	128622136	128622401	CpG: 20	265	20	157	15.1	59.2	0.88
chr6	128664068	128665138	CpG: 124	1070	124	723	23.2	67.6	1.02
chr6	128703709	128704036	CpG: 31	327	31	202	19.0	61.8	1.02
chr6	128704511	128705487	CpG: 101	976	101	706	20.7	72.3	0.80
chr6	128782259	128782577	CpG: 26	318	26	190	16.4	59.7	0.92
chr6	128892003	128892277	CpG: 24	274	24	169	17.5	61.7	0.93
chr6	128946451	128946682	CpG: 18	231	18	139	15.6	60.2	0.87
chr6	128987669	128987886	CpG: 18	217	18	132	16.6	60.8	0.92
chr6	129712152	129714120	CpG: 173	1968	173	1289	17.6	65.5	0.82
chr6	129723350	129723640	CpG: 22	290	22	173	15.2	59.7	0.86
chr6	129773550	129773922	CpG: 27	372	27	241	14.5	64.8	0.69
chr6	129861832	129862113	CpG: 24	281	24	174	17.1	61.9	0.91
chr6	130123161	130123367	CpG: 29	206	29	153	28.2	74.3	1.02
chr6	130191731	130192024	CpG: 24	293	24	178	16.4	60.8	0.89
chr6	130206394	130206605	CpG: 19	211	19	135	18.0	64.0	0.89
chr6	130245340	130245620	CpG: 22	280	22	164	15.7	58.6	0.93
chr6	130322851	130323125	CpG: 23	274	23	169	16.8	61.7	0.89
chr6	130366085	130366368	CpG: 23	283	23	169	16.3	59.7	0.92
chr6	130402932	130403199	CpG: 19	267	19	158	14.2	59.2	0.82
chr6	130502886	130503126	CpG: 23	240	23	150	19.2	62.5	1.00
chr6	130507048	130507321	CpG: 21	273	21	165	15.4	60.4	0.86
chr6	130871730	130872005	CpG: 22	275	22	167	16.0	60.7	0.88
chr6	130915137	130915372	CpG: 20	235	20	139	17.0	59.1	0.99
chr6	131186032	131186267	CpG: 18	235	18	138	15.3	58.7	0.91
chr6	131213832	131216097	CpG: 269	2265	269	1533	23.8	67.7	1.05
chr6	131252653	131252934	CpG: 22	281	22	172	15.7	61.2	0.85
chr6	131560052	131561374	CpG: 134	1322	134	939	20.3	71.0	0.81
chr6	131699438	131699712	CpG: 25	274	25	171	18.2	62.4	0.95
chr6	131833048	131833322	CpG: 22	274	22	169	16.1	61.7	0.86
chr6	131962073	131962286	CpG: 16	213	16	127	15.0	59.6	0.86
chr6	131986879	131987165	CpG: 24	286	24	178	16.8	62.2	0.89
chr6	131996520	131997825	CpG: 99	1305	99	902	15.2	69.1	0.64
chr6	132055602	132055878	CpG: 21	276	21	166	15.2	60.1	0.86
chr6	132110108	132110386	CpG: 25	278	25	175	18.0	62.9	0.92
chr6	132147465	132147746	CpG: 24	281	24	174	17.1	61.9	0.91
chr6	132257716	132258957	CpG: 144	1241	144	896	23.2	72.2	0.90
chr6	132326471	132326750	CpG: 22	279	22	168	15.8	60.2	0.89
chr6	132329665	132330458	CpG: 101	793	101	589	25.5	74.3	0.93
chr6	132730130	132730400	CpG: 23	270	23	167	17.0	61.9	0.90
chr6	132736440	132736721	CpG: 23	281	23	174	16.4	61.9	0.87
chr6	132754066	132754351	CpG: 22	285	22	172	15.4	60.4	0.87
chr6	132820313	132820517	CpG: 14	204	14	119	13.7	58.3	0.82
chr6	132822417	132822882	CpG: 42	465	42	308	18.1	66.2	0.84
chr6	133002529	133003365	CpG: 104	836	104	609	24.9	72.8	0.95
chr6	133145254	133145556	CpG: 21	302	21	194	13.9	64.2	0.68
chr6	133145724	133146464	CpG: 103	740	103	558	27.8	75.4	1.01
chr6	133535738	133535974	CpG: 21	236	21	143	17.8	60.6	0.99
chr6	133571537	133571811	CpG: 23	274	23	170	16.8	62.0	0.88
chr6	133580808	133581382	CpG: 43	574	43	343	15.0	59.8	0.85
chr6	133595944	133596752	CpG: 100	808	100	621	24.8	76.9	0.84
chr6	133707632	133708183	CpG: 56	551	56	406	20.3	73.7	0.76
chr6	133981250	133981525	CpG: 19	275	19	164	13.8	59.6	0.79
chr6	133992314	133992550	CpG: 18	236	18	138	15.3	58.5	0.90
chr6	133993364	133993683	CpG: 29	319	29	226	18.2	70.8	0.74
chr6	134008636	134009907	CpG: 89	1271	89	724	14.0	57.0	0.88
chr6	134021839	134022114	CpG: 21	275	21	165	15.3	60.0	0.86
chr6	134081171	134081433	CpG: 19	262	19	155	14.5	59.2	0.84
chr6	134086682	134086949	CpG: 22	267	22	166	16.5	62.2	0.86
chr6	134136893	134137133	CpG: 18	240	18	148	15.0	61.7	0.81
chr6	134239333	134239618	CpG: 25	285	25	179	17.5	62.8	0.90
chr6	134336592	134336903	CpG: 24	311	24	188	15.4	60.5	0.85
chr6	134393404	134393678	CpG: 24	274	24	171	17.5	62.4	0.91
chr6	134429850	134431350	CpG: 149	1500	149	994	19.9	66.3	0.90
chr6	134431465	134431669	CpG: 16	204	16	107	15.7	52.5	1.22
chr6	134545911	134546141	CpG: 18	230	18	139	15.7	60.4	0.86
chr6	134852840	134854483	CpG: 155	1643	155	1254	18.9	76.3	0.65
chr6	134934889	134935150	CpG: 19	261	19	162	14.6	62.1	0.77
chr6	135026731	135026954	CpG: 21	223	21	158	18.8	70.9	0.76
chr6	135047043	135047331	CpG: 25	288	25	180	17.4	62.5	0.90
chr6	135078235	135078814	CpG: 51	579	51	394	17.6	68.0	0.76
chr6	135080286	135080694	CpG: 31	408	31	263	15.2	64.5	0.76
chr6	135081555	135081947	CpG: 30	392	30	211	15.3	53.8	1.06
chr6	135084515	135084876	CpG: 31	361	31	245	17.2	67.9	0.77
chr6	135140103	135141730	CpG: 131	1627	131	1004	16.1	61.7	0.85
chr6	135151760	135152021	CpG: 21	261	21	151	16.1	57.9	1.00
chr6	135205583	135205855	CpG: 21	272	21	163	15.4	59.9	0.87
chr6	135320080	135320358	CpG: 24	278	24	174	17.3	62.6	0.89
chr6	135362736	135363755	CpG: 130	1019	130	733	25.5	71.9	0.99
chr6	135364333	135364553	CpG: 24	220	24	155	21.8	70.5	0.89
chr6	135364871	135365106	CpG: 17	235	17	140	14.5	59.6	0.83
chr6	135400184	135400458	CpG: 20	274	20	165	14.6	60.2	0.82
chr6	135407911	135408185	CpG: 24	274	24	171	17.5	62.4	0.91
chr6	135417024	135417253	CpG: 20	229	20	141	17.5	61.6	0.94
chr6	135456624	135456842	CpG: 16	218	16	129	14.7	59.2	0.85
chr6	135461487	135461720	CpG: 18	233	18	138	15.5	59.2	0.89
chr6	135505782	135506006	CpG: 21	224	21	148	18.8	66.1	0.86
chr6	135684470	135684744	CpG: 24	274	24	172	17.5	62.8	0.90
chr6	135939501	135939730	CpG: 16	229	16	137	14.0	59.8	0.79
chr6	136061018	136061298	CpG: 25	280	25	177	17.9	63.2	0.90
chr6	136093020	136093401	CpG: 42	381	42	285	22.0	74.8	0.79
chr6	136242862	136243318	CpG: 39	456	39	283	17.1	62.1	0.89
chr6	136369093	136371517	CpG: 228	2424	228	1602	18.8	66.1	0.87
chr6	136449411	136449624	CpG: 17	213	17	124	16.0	58.2	0.96
chr6	136453255	136453529	CpG: 23	274	23	169	16.8	61.7	0.89
chr6	136551879	136553043	CpG: 95	1164	95	842	16.3	72.3	0.63
chr6	136659968	136660249	CpG: 21	281	21	173	14.9	61.6	0.81
chr6	136685617	136686276	CpG: 84	659	84	470	25.5	71.3	1.01
chr6	136833258	136833530	CpG: 20	272	20	165	14.7	60.7	0.81
chr6	136959405	136959639	CpG: 19	234	19	141	16.2	60.3	0.90
chr6	137102762	137103036	CpG: 25	274	25	172	18.2	62.8	0.94
chr6	137219713	137219987	CpG: 24	274	24	171	17.5	62.4	0.91
chr6	137428920	137429124	CpG: 17	204	17	122	16.7	59.8	0.94
chr6	137437965	137438784	CpG: 59	819	59	483	14.4	59.0	0.84
chr6	137477122	137478259	CpG: 107	1137	107	680	18.8	59.8	1.05
chr6	137548750	137549273	CpG: 41	523	41	346	15.7	66.2	0.72
chr6	137590787	137591045	CpG: 21	258	21	161	16.3	62.4	0.85
chr6	137602117	137602395	CpG: 24	278	24	171	17.3	61.5	0.92
chr6	137673781	137674055	CpG: 23	274	23	169	16.8	61.7	0.89
chr6	137737880	137739199	CpG: 160	1319	160	959	24.3	72.7	0.92
chr6	137979719	137981409	CpG: 187	1690	187	1191	22.1	70.5	0.90
chr6	138010678	138011488	CpG: 91	810	91	556	22.5	68.6	0.96
chr6	138109356	138112483	CpG: 290	3127	290	2161	18.5	69.1	0.78
chr6	138178050	138178408	CpG: 34	358	34	218	19.0	60.9	1.04
chr6	138231943	138232770	CpG: 104	827	104	625	25.2	75.6	0.88
chr6	138407435	138408034	CpG: 62	599	62	407	20.7	67.9	0.90
chr6	138550643	138550898	CpG: 21	255	21	147	16.5	57.6	1.02
chr6	138566009	138566268	CpG: 23	259	23	158	17.8	61.0	0.97
chr6	138676651	138677513	CpG: 72	862	72	551	16.7	63.9	0.82
chr6	138681664	138682511	CpG: 81	847	81	579	19.1	68.4	0.82
chr6	138683785	138684534	CpG: 61	749	61	469	16.3	62.6	0.85
chr6	138685478	138686683	CpG: 96	1205	96	781	15.9	64.8	0.76
chr6	138910778	138911052	CpG: 23	274	23	168	16.8	61.3	0.91
chr6	139003784	139004062	CpG: 21	278	21	173	15.1	62.2	0.79
chr6	139052482	139052753	CpG: 22	271	22	165	16.2	60.9	0.89
chr6	139055109	139056425	CpG: 121	1316	121	861	18.4	65.4	0.86
chr6	139208412	139208656	CpG: 19	244	19	148	15.6	60.7	0.86
chr6	139211027	139211255	CpG: 17	228	17	134	14.9	58.8	0.89
chr6	139291288	139291566	CpG: 20	278	20	168	14.4	60.4	0.80
chr6	139295537	139296256	CpG: 94	719	94	518	26.1	72.0	1.01
chr6	139349888	139351064	CpG: 140	1176	140	841	23.8	71.5	0.93
chr6	139480341	139480570	CpG: 26	229	26	172	22.7	75.1	0.81
chr6	139591964	139593562	CpG: 146	1598	146	1091	18.3	68.3	0.79
chr6	139612696	139612941	CpG: 22	245	22	165	18.0	67.3	0.80
chr6	139655703	139655975	CpG: 24	272	24	173	17.6	63.6	0.88
chr6	139815156	139815431	CpG: 25	275	25	172	18.2	62.5	0.94
chr6	139846121	139846345	CpG: 16	224	16	136	14.3	60.7	0.79
chr6	139858931	139859205	CpG: 24	274	24	169	17.5	61.7	0.93
chr6	139880775	139882281	CpG: 191	1506	191	1151	25.4	76.4	0.87
chr6	139961850	139962410	CpG: 41	560	41	327	14.6	58.4	0.87
chr6	139984357	139984880	CpG: 45	523	45	358	17.2	68.5	0.74
chr6	140093851	140094132	CpG: 25	281	25	174	17.8	61.9	0.94
chr6	140175897	140176958	CpG: 133	1061	133	784	25.1	73.9	0.92
chr6	140217347	140218132	CpG: 93	785	93	577	23.7	73.5	0.90
chr6	140220510	140220788	CpG: 24	278	24	172	17.3	61.9	0.91
chr6	140323445	140324529	CpG: 166	1084	166	843	30.6	77.8	1.02
chr6	140355551	140355766	CpG: 16	215	16	133	14.9	61.9	0.79
chr6	140382395	140382625	CpG: 21	230	21	143	18.3	62.2	0.96
chr6	140556983	140559342	CpG: 189	2359	189	1514	16.0	64.2	0.78
chr6	140580639	140581049	CpG: 30	410	30	247	14.6	60.2	0.81
chr6	140697773	140698068	CpG: 21	295	21	162	14.2	54.9	0.97
chr6	140699936	140700209	CpG: 25	273	25	171	18.3	62.6	0.95
chr6	140741797	140742078	CpG: 25	281	25	177	17.8	63.0	0.91
chr6	140750133	140750376	CpG: 18	243	18	130	14.8	53.5	1.04
chr6	140803939	140804158	CpG: 16	219	16	133	14.6	60.7	0.82
chr6	140804643	140804918	CpG: 25	275	25	169	18.2	61.5	0.97
chr6	140846226	140846453	CpG: 19	227	19	136	16.7	59.9	0.94
chr6	140861339	140861614	CpG: 22	275	22	166	16.0	60.4	0.90
chr6	140862225	140862611	CpG: 27	386	27	227	14.0	58.8	0.82
chr6	140907802	140908074	CpG: 21	272	21	163	15.4	59.9	0.87
chr6	140910102	140910491	CpG: 29	389	29	273	14.9	70.2	0.61
chr6	141050431	141050716	CpG: 25	285	25	179	17.5	62.8	0.90
chr6	141113005	141113246	CpG: 21	241	21	148	17.4	61.4	0.95
chr6	141324245	141324524	CpG: 21	279	21	165	15.1	59.1	0.87
chr6	141331772	141332374	CpG: 61	602	61	445	20.3	73.9	0.74
chr6	141333365	141333595	CpG: 20	230	20	140	17.4	60.9	0.95
chr6	141789172	141789448	CpG: 21	276	21	168	15.2	60.9	0.83
chr6	141812989	141813269	CpG: 22	280	22	173	15.7	61.8	0.84
chr6	141862873	141863110	CpG: 20	237	20	142	16.9	59.9	0.96
chr6	141991566	141991783	CpG: 19	217	19	132	17.5	60.8	0.96
chr6	141997530	141997771	CpG: 21	241	21	147	17.4	61.0	0.96
chr6	142189630	142189913	CpG: 23	283	23	175	16.3	61.8	0.87
chr6	142333888	142334165	CpG: 23	277	23	169	16.6	61.0	0.90
chr6	142602677	142602911	CpG: 18	234	18	143	15.4	61.1	0.85
chr6	142635409	142635683	CpG: 23	274	23	171	16.8	62.4	0.87
chr6	142752183	142752407	CpG: 19	224	19	135	17.0	60.3	0.94
chr6	142804100	142804493	CpG: 33	393	33	290	16.8	73.8	0.62
chr6	142878684	142878962	CpG: 24	278	24	174	17.3	62.6	0.89
chr6	142931968	142932221	CpG: 19	253	19	151	15.0	59.7	0.85
chr6	142970116	142970384	CpG: 19	268	19	155	14.2	57.8	0.86
chr6	142982124	142982398	CpG: 24	274	24	171	17.5	62.4	0.91
chr6	143066768	143066997	CpG: 17	229	17	135	14.8	59.0	0.87
chr6	143146572	143146850	CpG: 26	278	26	176	18.7	63.3	0.94
chr6	143163334	143163609	CpG: 20	275	20	168	14.5	61.1	0.79
chr6	143243577	143243799	CpG: 18	222	18	135	16.2	60.8	0.89
chr6	143274261	143274900	CpG: 46	639	46	366	14.4	57.3	0.88
chr6	143320613	143321050	CpG: 33	437	33	265	15.1	60.6	0.83
chr6	143339145	143339413	CpG: 28	268	28	168	20.9	62.7	1.07
chr6	143493647	143494517	CpG: 91	870	91	628	20.9	72.2	0.80
chr6	143530449	143530673	CpG: 19	224	19	136	17.0	60.7	0.95
chr6	143812487	143812717	CpG: 20	230	20	141	17.4	61.3	0.94
chr6	144119069	144119698	CpG: 71	629	71	456	22.6	72.5	0.86
chr6	144136977	144140049	CpG: 305	3072	305	2120	19.9	69.0	0.84
chr6	144167008	144167286	CpG: 25	278	25	175	18.0	62.9	0.92
chr6	144252731	144253672	CpG: 99	941	99	662	21.0	70.4	0.87
chr6	144295953	144296183	CpG: 20	230	20	141	17.4	61.3	0.94
chr6	144642883	144643357	CpG: 47	474	47	307	19.8	64.8	0.95
chr6	144703660	144704214	CpG: 55	554	55	381	19.9	68.8	0.84
chr6	144704687	144704891	CpG: 16	204	16	117	15.7	57.4	0.96
chr6	144722203	144722482	CpG: 24	279	24	175	17.2	62.7	0.88
chr6	144729007	144730015	CpG: 126	1008	126	763	25.0	75.7	0.87
chr6	144805372	144805641	CpG: 22	269	22	171	16.4	63.6	0.82
chr6	144818632	144818872	CpG: 18	240	18	141	15.0	58.8	0.89
chr6	144822611	144822888	CpG: 26	277	26	175	18.8	63.2	0.95
chr6	144870664	144871228	CpG: 59	564	59	364	20.9	64.5	1.01
chr6	144949137	144949415	CpG: 24	278	24	172	17.3	61.9	0.91
chr6	145035586	145036314	CpG: 62	728	62	463	17.0	63.6	0.84
chr6	145119527	145119802	CpG: 24	275	24	166	17.5	60.4	0.98
chr6	145200492	145201423	CpG: 118	931	118	689	25.3	74.0	0.93
chr6	145256486	145257510	CpG: 117	1024	117	730	22.9	71.3	0.91
chr6	145287811	145289101	CpG: 92	1290	92	749	14.3	58.1	0.85
chr6	145342579	145343527	CpG: 107	948	107	674	22.6	71.1	0.90
chr6	145379316	145380187	CpG: 88	871	88	561	20.2	64.4	0.97
chr6	145408555	145409458	CpG: 75	903	75	555	16.6	61.5	0.88
chr6	145477418	145479772	CpG: 195	2354	195	1518	16.6	64.5	0.80
chr6	145541654	145541878	CpG: 18	224	18	136	16.1	60.7	0.88
chr6	145662840	145663531	CpG: 52	691	52	467	15.1	67.6	0.66
chr6	145687879	145688130	CpG: 21	251	21	183	16.7	72.9	0.63
chr6	145825914	145826153	CpG: 21	239	21	139	17.6	58.2	1.07
chr6	146927815	146928900	CpG: 132	1085	132	800	24.3	73.7	0.90
chr6	147007349	147008479	CpG: 126	1130	126	793	22.3	70.2	0.92
chr6	147156729	147157836	CpG: 85	1107	85	687	15.4	62.1	0.80
chr6	147176129	147176403	CpG: 24	274	24	170	17.5	62.0	0.92
chr6	147222337	147222718	CpG: 30	381	30	244	15.7	64.0	0.80
chr6	147627422	147627848	CpG: 43	426	43	285	20.2	66.9	0.90
chr6	147736566	147737511	CpG: 106	945	106	696	22.4	73.7	0.83
chr6	147792120	147792331	CpG: 24	211	24	139	22.7	65.9	1.07
chr6	148027475	148027711	CpG: 18	236	18	141	15.3	59.7	0.89
chr6	148162211	148162443	CpG: 21	232	21	137	18.1	59.1	1.07
chr6	148396966	148398001	CpG: 143	1035	143	783	27.6	75.7	0.97
chr6	148480518	148480792	CpG: 22	274	22	170	16.1	62.0	0.84
chr6	148522943	148523219	CpG: 22	276	22	169	15.9	61.2	0.86
chr6	148600239	148600477	CpG: 23	238	23	171	19.3	71.8	0.76
chr6	148700071	148702720	CpG: 242	2649	242	1735	18.3	65.5	0.85
chr6	148730760	148730997	CpG: 18	237	18	143	15.2	60.3	0.87
chr6	148859307	148859538	CpG: 19	231	19	143	16.5	61.9	0.87
chr6	149374741	149375790	CpG: 84	1049	84	757	16.0	72.2	0.62
chr6	149514748	149515017	CpG: 21	269	21	157	15.6	58.4	0.93
chr6	149530399	149530677	CpG: 22	278	22	169	15.8	60.8	0.87
chr6	149538546	149539590	CpG: 103	1044	103	681	19.7	65.2	0.93
chr6	149573148	149573426	CpG: 24	278	24	175	17.3	62.9	0.88
chr6	149756156	149756581	CpG: 44	425	44	293	20.7	68.9	0.87
chr6	149819877	149820155	CpG: 21	278	21	170	15.1	61.2	0.83
chr6	149822991	149823263	CpG: 21	272	21	162	15.4	59.6	0.88
chr6	149946612	149948439	CpG: 179	1827	179	1273	19.6	69.7	0.81
chr6	149959182	149959476	CpG: 24	294	24	169	16.3	57.5	1.00
chr6	150077042	150078504	CpG: 95	1462	95	839	13.0	57.4	1.60
chr6	150153305	150153572	CpG: 21	267	21	160	15.7	59.9	0.90
chr6	150192034	150192241	CpG: 18	207	18	122	17.4	58.9	1.02
chr6	150377594	150377868	CpG: 23	274	23	170	16.8	62.0	0.88
chr6	150408699	150408928	CpG: 17	229	17	139	14.8	60.7	0.82
chr6	150516725	150518220	CpG: 171	1495	171	1129	22.9	75.5	0.81
chr6	150650417	150651436	CpG: 124	1019	124	766	24.3	75.2	0.87
chr6	150656222	150656783	CpG: 53	561	53	378	18.9	67.4	0.83
chr6	150691856	150692346	CpG: 39	490	39	288	15.9	58.8	0.95
chr6	150745607	150746359	CpG: 76	752	76	478	20.2	63.6	1.01
chr6	150746672	150746904	CpG: 20	232	20	144	17.2	62.1	0.91
chr6	150765922	150766907	CpG: 119	985	119	719	24.2	73.0	0.91
chr6	150826077	150826339	CpG: 26	262	26	166	19.8	63.4	1.00
chr6	150848147	150848620	CpG: 53	473	53	336	22.4	71.0	0.89
chr6	150917305	150918081	CpG: 84	776	84	563	21.6	72.6	0.83
chr6	150918738	150919018	CpG: 26	280	26	175	18.6	62.5	0.96
chr6	150945965	150946408	CpG: 36	443	36	265	16.3	59.8	0.91
chr6	150949145	150949917	CpG: 92	772	92	543	23.8	70.3	0.96
chr6	150963968	150964391	CpG: 30	423	30	231	14.2	54.6	0.96
chr6	150985277	150986534	CpG: 106	1257	106	924	16.9	73.5	0.62
chr6	151062549	151063838	CpG: 173	1289	173	968	26.8	75.1	0.95
chr6	151122110	151122418	CpG: 27	308	27	215	17.5	69.8	0.72
chr6	151122782	151123083	CpG: 22	301	22	177	14.6	58.8	0.87
chr6	151124960	151125464	CpG: 40	504	40	352	15.9	69.8	0.65
chr6	151137777	151138477	CpG: 62	700	62	460	17.7	65.7	0.82
chr6	151140718	151141883	CpG: 83	1165	83	721	14.2	61.9	0.76
chr6	151153658	151154410	CpG: 63	752	63	495	16.8	65.8	0.78
chr6	151162889	151164722	CpG: 196	1833	196	1191	21.4	65.0	1.03
chr6	151179648	151179935	CpG: 22	287	22	175	15.3	61.0	0.85
chr6	151180805	151181026	CpG: 18	221	18	136	16.3	61.5	0.88
chr6	151189366	151190574	CpG: 90	1208	90	718	14.9	59.4	0.84
chr6	151204221	151205012	CpG: 75	791	75	529	19.0	66.9	0.85
chr6	151213764	151214516	CpG: 64	752	64	495	17.0	65.8	0.79
chr6	151237131	151237653	CpG: 51	522	51	367	19.5	70.3	0.79
chr6	151257082	151257292	CpG: 16	210	16	142	15.2	67.6	0.67
chr6	151268176	151268791	CpG: 60	615	60	424	19.5	68.9	0.83
chr6	151280559	151280785	CpG: 20	226	20	136	17.7	60.2	1.00
chr6	151284978	151285218	CpG: 17	240	17	141	14.2	58.8	0.85
chr6	151316455	151316678	CpG: 19	223	19	138	17.0	61.9	0.91
chr6	151341963	151343194	CpG: 141	1231	141	902	22.9	73.3	0.85
chr6	151351157	151351435	CpG: 23	278	23	173	16.5	62.2	0.87
chr6	151367680	151367956	CpG: 21	276	21	171	15.2	62.0	0.80
chr6	151418141	151418371	CpG: 16	230	16	137	13.9	59.6	0.80
chr6	151597187	151597412	CpG: 16	225	16	137	14.2	60.9	0.78
chr6	151707485	151708269	CpG: 60	784	60	530	15.3	67.6	0.67
chr6	151800278	151801520	CpG: 146	1242	146	905	23.5	72.9	0.89
chr6	151916381	151916661	CpG: 26	280	26	177	18.6	63.2	0.94
chr6	151937857	151938139	CpG: 22	282	22	173	15.6	61.3	0.84
chr6	151951092	151951315	CpG: 20	223	20	137	17.9	61.4	0.96
chr6	152066168	152067533	CpG: 173	1365	173	1040	25.3	76.2	0.87
chr6	152113788	152114016	CpG: 18	228	18	135	15.8	59.2	0.92
chr6	152291430	152291766	CpG: 25	336	25	207	14.9	61.6	0.78
chr6	152315614	152315884	CpG: 19	270	19	163	14.1	60.4	0.78
chr6	152440251	152440478	CpG: 16	227	16	144	14.1	63.4	0.70
chr6	152440768	152442034	CpG: 131	1266	131	882	20.7	69.7	0.86
chr6	152526117	152526407	CpG: 25	290	25	201	17.2	69.3	0.73
chr6	152528633	152529009	CpG: 27	376	27	219	14.4	58.2	0.87
chr6	152535278	152535516	CpG: 21	238	21	144	17.6	60.5	0.97
chr6	152542045	152542496	CpG: 42	451	42	317	18.6	70.3	0.76
chr6	152590545	152592405	CpG: 245	1860	245	1417	26.3	76.2	0.91
chr6	152652550	152653577	CpG: 96	1027	96	642	18.7	62.5	0.96
chr6	152694489	152695476	CpG: 98	987	98	634	19.9	64.2	0.96
chr6	152850475	152850742	CpG: 20	267	20	158	15.0	59.2	0.87
chr6	152886348	152886629	CpG: 24	281	24	175	17.1	62.3	0.90
chr6	153008918	153009867	CpG: 106	949	106	673	22.3	70.9	0.89
chr6	153307110	153307397	CpG: 25	287	25	176	17.4	61.3	0.94
chr6	153315914	153316150	CpG: 21	236	21	143	17.8	60.6	1.00
chr6	153503334	153503535	CpG: 26	201	26	136	25.9	67.7	1.14
chr6	153512985	153513275	CpG: 19	290	19	175	13.1	60.3	0.73
chr6	153525701	153525945	CpG: 20	244	20	149	16.4	61.1	0.92
chr6	153837958	153838649	CpG: 76	691	76	510	22.0	73.8	0.82
chr6	154009763	154009993	CpG: 19	230	19	135	16.5	58.7	0.98
chr6	154035668	154036057	CpG: 33	389	33	278	17.0	71.5	0.67
chr6	154077109	154077383	CpG: 25	274	25	172	18.2	62.8	0.94
chr6	154183572	154185137	CpG: 150	1565	150	1069	19.2	68.3	0.82
chr6	154192880	154193149	CpG: 20	269	20	162	14.9	60.2	0.83
chr6	154203697	154204483	CpG: 63	786	63	510	16.0	64.9	0.76
chr6	154332015	154333809	CpG: 185	1794	185	1243	20.6	69.3	0.86
chr6	154335781	154336172	CpG: 38	391	38	290	19.4	74.2	0.71
chr6	154375743	154375980	CpG: 18	237	18	140	15.2	59.1	0.89
chr6	154454053	154454272	CpG: 18	219	18	133	16.4	60.7	0.90
chr6	154991537	154991818	CpG: 24	281	24	175	17.1	62.3	0.90
chr6	155052810	155053084	CpG: 22	274	22	169	16.1	61.7	0.85
chr6	155181084	155181377	CpG: 22	293	22	176	15.0	60.1	0.83
chr6	155236280	155236520	CpG: 17	240	17	138	14.2	57.5	0.89
chr6	155241466	155241888	CpG: 34	422	34	267	16.1	63.3	0.81
chr6	155256105	155256341	CpG: 18	236	18	138	15.3	58.5	0.91
chr6	155621910	155622184	CpG: 23	274	23	170	16.8	62.0	0.88
chr6	155643862	155644102	CpG: 19	240	19	147	15.8	61.2	0.87
chr6	155710853	155712294	CpG: 142	1441	142	1001	19.7	69.5	0.82
chr6	155888805	155889701	CpG: 74	896	74	635	16.5	70.9	0.66
chr6	155890766	155890977	CpG: 16	211	16	127	15.2	60.2	0.87
chr6	155906797	155907029	CpG: 20	232	20	141	17.2	60.8	0.95
chr6	155926089	155926364	CpG: 24	275	24	171	17.5	62.2	0.91
chr6	155935049	155936266	CpG: 140	1217	140	888	23.0	73.0	0.86
chr6	156117637	156117950	CpG: 21	313	21	176	13.4	56.2	0.85
chr6	156196657	156198026	CpG: 153	1369	153	950	22.4	69.4	0.93
chr6	156420773	156421078	CpG: 22	305	22	186	14.4	61.0	0.94
chr6	156516108	156516772	CpG: 55	664	55	419	16.6	63.1	0.83
chr6	156565087	156565497	CpG: 35	410	35	297	17.1	72.4	0.65
chr6	156998873	156999147	CpG: 23	274	23	170	16.8	62.0	0.88
chr6	157035744	157035980	CpG: 19	236	19	144	16.1	61.0	0.88
chr6	157069024	157069451	CpG: 40	427	40	315	18.7	73.8	0.69
chr6	157192047	157192280	CpG: 18	233	18	137	15.5	58.8	0.92
chr6	157236544	157236970	CpG: 31	426	31	255	14.6	59.9	0.82
chr6	157315474	157315709	CpG: 17	235	17	144	14.5	61.3	0.79
chr6	157388257	157388531	CpG: 23	274	23	171	16.8	62.4	0.87
chr6	157532744	157533036	CpG: 24	292	24	179	16.4	61.3	0.88
chr6	157599110	157599586	CpG: 41	476	41	327	17.2	68.7	0.74
chr6	157791068	157791346	CpG: 23	278	23	173	16.5	62.2	0.86
chr6	157833317	157833607	CpG: 23	290	23	194	15.9	66.9	0.71
chr6	157889277	157889967	CpG: 101	690	101	512	29.3	74.2	1.08
chr6	157918562	157918818	CpG: 20	256	20	161	15.6	62.9	0.81
chr6	157922128	157922530	CpG: 39	402	39	279	19.4	69.4	0.81
chr6	157941415	157941653	CpG: 21	238	21	144	17.6	60.5	0.99
chr6	157979307	157982145	CpG: 369	2838	369	2109	26.0	74.3	0.94
chr6	158189736	158189970	CpG: 16	234	16	137	13.7	58.5	0.81
chr6	158223257	158224589	CpG: 150	1332	150	902	22.5	67.7	0.98
chr6	158349568	158351500	CpG: 175	1932	175	1540	18.1	79.7	0.93
chr6	158424932	158425134	CpG: 23	202	23	137	22.8	67.8	0.99
chr6	158439336	158440607	CpG: 128	1271	128	941	20.1	74.0	0.74
chr6	158480085	158481014	CpG: 113	929	113	697	24.3	75.0	0.88
chr6	158500187	158500427	CpG: 22	240	22	148	18.3	61.7	0.99
chr6	158564959	158566172	CpG: 79	1213	79	725	13.0	59.8	0.73
chr6	158622024	158624339	CpG: 270	2315	270	1697	23.3	73.3	0.87
chr6	158757535	158757775	CpG: 20	240	20	143	16.7	59.6	0.97
chr6	158778856	158779122	CpG: 23	266	23	166	17.3	62.4	0.90
chr6	158834792	158835236	CpG: 29	444	29	283	13.1	63.7	0.64
chr6	158914802	158915072	CpG: 26	270	26	199	19.3	73.7	0.74
chr6	159007401	159007676	CpG: 21	275	21	170	15.3	61.8	0.81
chr6	159068501	159069935	CpG: 202	1434	202	1123	28.2	78.3	0.93
chr6	159227236	159228608	CpG: 156	1372	156	995	22.7	72.5	0.87
chr6	159332840	159333247	CpG: 29	407	29	260	14.3	63.9	0.73
chr6	159413239	159414079	CpG: 84	840	84	585	20.0	69.6	0.83
chr6	159455102	159455566	CpG: 44	464	44	346	19.0	74.6	0.68
chr6	159462190	159462551	CpG: 24	361	24	199	13.3	55.1	0.90
chr6	159477074	159478439	CpG: 176	1365	176	1013	25.8	74.2	0.96
chr6	159533188	159533442	CpG: 18	254	18	153	14.2	60.2	0.79
chr6	159553246	159554434	CpG: 94	1188	94	861	15.8	72.5	0.60
chr6	159666107	159666344	CpG: 18	237	18	141	15.2	59.5	0.88
chr6	159700115	159700396	CpG: 23	281	23	173	16.4	61.6	0.88
chr6	159747472	159747914	CpG: 32	442	32	312	14.5	70.6	0.61
chr6	159757032	159757274	CpG: 17	242	17	145	14.0	59.9	0.80
chr6	159761234	159761530	CpG: 34	296	34	204	23.0	68.9	0.97
chr6	159780128	159780409	CpG: 23	281	23	173	16.4	61.6	0.87
chr6	159781167	159782624	CpG: 167	1457	167	1064	22.9	73.0	0.86
chr6	159804941	159805796	CpG: 119	855	119	645	27.8	75.4	0.98
chr6	159828690	159828925	CpG: 16	235	16	137	13.6	58.3	0.83
chr6	159889385	159890377	CpG: 102	992	102	701	20.6	70.7	0.82
chr6	159937073	159937364	CpG: 22	291	22	157	15.1	54.0	1.04
chr6	160028638	160028924	CpG: 24	286	24	174	16.8	60.8	0.92
chr6	160063493	160065187	CpG: 178	1694	178	1247	21.0	73.6	0.78
chr6	160115051	160115573	CpG: 62	522	62	353	23.8	67.6	1.04
chr6	160136647	160136921	CpG: 20	274	20	164	14.6	59.9	0.82
chr6	160185207	160185534	CpG: 26	327	26	207	15.9	63.3	0.83
chr6	160245044	160245872	CpG: 65	828	65	564	15.7	68.1	0.68
chr6	160339684	160339977	CpG: 21	293	21	189	14.3	64.5	0.70
chr6	160374650	160374950	CpG: 28	300	28	194	18.7	64.7	0.90
chr6	160414219	160415902	CpG: 188	1683	188	1188	22.3	70.6	0.90
chr6	160477794	160479958	CpG: 154	2164	154	1463	14.2	67.6	0.64
chr6	160491433	160491646	CpG: 16	213	16	124	15.0	58.2	0.89
chr6	160561363	160561646	CpG: 22	283	22	203	15.5	71.7	0.62
chr6	160749402	160749688	CpG: 25	286	25	177	17.5	61.9	0.92
chr6	160837721	160837994	CpG: 23	273	23	169	16.8	61.9	0.89
chr6	160938370	160939675	CpG: 134	1305	134	930	20.5	71.3	0.81
chr6	160972326	160973683	CpG: 151	1357	151	966	22.3	71.2	0.88
chr6	161007028	161008369	CpG: 125	1341	125	884	18.6	65.9	0.86
chr6	161034541	161036612	CpG: 176	2071	176	1272	17.0	61.4	0.91
chr6	161045733	161046080	CpG: 38	347	38	241	21.9	69.5	0.94
chr6	161214984	161216042	CpG: 148	1058	148	822	28.0	77.7	0.93
chr6	161251416	161252654	CpG: 99	1238	99	878	16.0	70.9	0.66
chr6	161337061	161337590	CpG: 43	529	43	356	16.3	67.3	0.74
chr6	161360738	161360970	CpG: 25	232	25	172	21.6	74.1	0.78
chr6	161379807	161380650	CpG: 55	843	55	543	13.0	64.4	0.63
chr6	161508293	161508617	CpG: 27	324	27	221	16.7	68.2	0.72
chr6	161597579	161599473	CpG: 196	1894	196	1318	20.7	69.6	0.86
chr6	161612830	161613299	CpG: 38	469	38	327	16.2	69.7	0.67
chr6	161759756	161759992	CpG: 21	236	21	145	17.8	61.4	0.97
chr6	161771907	161772405	CpG: 59	498	59	377	23.7	75.7	0.83
chr6	162026783	162027147	CpG: 36	364	36	263	19.8	72.3	0.77
chr6	162033102	162033438	CpG: 26	336	26	201	15.5	59.8	0.87
chr6	162108714	162108999	CpG: 23	285	23	173	16.1	60.7	0.89
chr6	162114945	162115501	CpG: 54	556	54	395	19.4	71.0	0.78
chr6	162289527	162289829	CpG: 34	302	34	227	22.5	75.2	0.80
chr6	162349831	162351018	CpG: 143	1187	143	853	24.1	71.9	0.94
chr6	162637278	162637550	CpG: 23	272	23	170	16.9	62.5	0.88
chr6	162725544	162725775	CpG: 20	231	20	147	17.3	63.6	0.88
chr6	162960396	162960632	CpG: 17	236	17	142	14.4	60.2	0.82
chr6	163004632	163005354	CpG: 70	722	70	458	19.4	63.4	1.25
chr6	163260469	163260695	CpG: 19	226	19	141	16.8	62.4	0.90
chr6	163399328	163399568	CpG: 22	240	22	149	18.3	62.1	0.97
chr6	163579475	163579760	CpG: 25	285	25	178	17.5	62.5	0.91
chr6	163701594	163702767	CpG: 97	1173	97	853	16.5	72.7	0.63
chr6	163975018	163975262	CpG: 18	244	18	142	14.8	58.2	0.90
chr6	164013421	164013700	CpG: 24	279	24	174	17.2	62.4	0.89
chr6	164083572	164083853	CpG: 23	281	23	173	16.4	61.6	0.88
chr6	164090347	164091114	CpG: 90	767	90	561	23.5	73.1	0.88
chr6	164207328	164207754	CpG: 32	426	32	259	15.0	60.8	0.82
chr6	164358691	164359000	CpG: 25	309	25	184	16.2	59.5	0.92
chr6	164409658	164409932	CpG: 25	274	25	171	18.2	62.4	0.95
chr6	164463534	164464135	CpG: 46	601	46	419	15.3	69.7	0.64
chr6	164494619	164494835	CpG: 17	216	17	133	15.7	61.6	0.86
chr6	164512746	164513398	CpG: 47	652	47	438	14.4	67.2	0.71
chr6	164636597	164636873	CpG: 23	276	23	170	16.7	61.6	0.89
chr6	164647211	164647493	CpG: 23	282	23	174	16.3	61.7	0.87
chr6	164750554	164750793	CpG: 17	239	17	142	14.2	59.4	0.82
chr6	164758037	164758316	CpG: 26	279	26	172	18.6	61.6	0.99
chr6	164778463	164781361	CpG: 389	2898	389	2116	26.8	73.0	1.01
chr6	164958860	164959134	CpG: 23	274	23	172	16.8	62.8	0.86
chr6	164987695	164987931	CpG: 18	236	18	140	15.3	59.3	0.88
chr6	164995176	164996014	CpG: 69	838	69	570	16.5	68.0	0.72
chr6	164996319	164996568	CpG: 23	249	23	155	18.5	62.2	0.96
chr6	165005964	165006231	CpG: 20	267	20	159	15.0	59.6	0.85
chr6	165036219	165036472	CpG: 18	253	18	158	14.2	62.5	0.73
chr6	165036575	165037032	CpG: 34	457	34	266	14.9	58.2	0.88
chr6	165199194	165199850	CpG: 49	656	49	444	14.9	67.7	0.65
chr6	165273519	165273765	CpG: 18	246	18	147	14.6	59.8	0.84
chr6	165336824	165337577	CpG: 52	753	52	449	13.8	59.6	0.78
chr6	165455668	165455928	CpG: 21	260	21	159	16.2	61.2	0.88
chr6	165501636	165501910	CpG: 24	274	24	170	17.5	62.0	0.92
chr6	165701798	165702133	CpG: 29	335	29	220	17.3	65.7	0.82
chr6	165728315	165728588	CpG: 23	273	23	167	16.8	61.2	0.91
chr6	165731178	165731459	CpG: 24	281	24	175	17.1	62.3	0.90
chr6	165759414	165759691	CpG: 20	277	20	170	14.4	61.4	0.78
chr6	165892165	165892439	CpG: 25	274	25	172	18.2	62.8	0.94
chr6	166051834	166052071	CpG: 19	237	19	143	16.0	60.3	0.90
chr6	166111071	166111311	CpG: 23	240	23	152	19.2	63.3	0.98
chr6	166131569	166131799	CpG: 21	230	21	141	18.3	61.3	0.99
chr6	166153538	166153778	CpG: 21	240	21	146	17.5	60.8	0.95
chr6	166265772	166266002	CpG: 18	230	18	134	15.7	58.3	0.95
chr6	166299334	166299540	CpG: 17	206	17	148	16.5	71.8	0.64
chr6	166334967	166335193	CpG: 18	226	18	137	15.9	60.6	0.88
chr6	166349114	166349335	CpG: 18	221	18	133	16.3	60.2	0.94
chr6	166700347	166700554	CpG: 32	207	32	153	30.9	73.9	1.21
chr6	166702543	166702824	CpG: 23	281	23	174	16.4	61.9	0.86
chr6	166776884	166777119	CpG: 20	235	20	145	17.0	61.7	0.92
chr6	167027024	167030894	CpG: 409	3870	409	2759	21.1	71.3	0.83
chr6	167079725	167079997	CpG: 20	272	20	169	14.7	62.1	0.77
chr6	167132755	167133181	CpG: 34	426	34	309	16.0	72.5	0.61
chr6	167172032	167172901	CpG: 89	869	89	632	20.5	72.7	0.86
chr6	167194493	167194859	CpG: 30	366	30	258	16.4	70.5	0.66
chr6	167222050	167223002	CpG: 79	952	79	684	16.6	71.8	0.66
chr6	167308622	167308918	CpG: 25	296	25	191	16.9	64.5	0.82
chr6	167356307	167357440	CpG: 86	1133	86	746	15.2	65.8	0.70
chr6	167376675	167377538	CpG: 70	863	70	531	16.2	61.5	0.87
chr6	167443301	167443580	CpG: 23	279	23	172	16.5	61.6	0.88
chr6	167461964	167462251	CpG: 26	287	26	178	18.1	62.0	0.95
chr6	167536287	167539278	CpG: 248	2991	248	1995	16.6	66.7	0.75
chr6	167600435	167600715	CpG: 23	280	23	172	16.4	61.4	0.89
chr6	167604774	167605047	CpG: 21	273	21	172	15.4	63.0	0.79
chr6	167617306	167617535	CpG: 16	229	16	134	14.0	58.5	0.84
chr6	167618563	167618843	CpG: 21	280	21	171	15.0	61.1	0.81
chr6	167622026	167623901	CpG: 128	1875	128	1129	13.7	60.2	0.75
chr6	167674586	167674924	CpG: 23	338	23	208	13.6	61.5	0.72
chr6	167683678	167685688	CpG: 212	2010	212	1483	21.1	73.8	0.78
chr6	167719243	167719941	CpG: 74	698	74	499	21.2	71.5	0.83
chr6	167738578	167738810	CpG: 17	232	17	140	14.7	60.3	0.84
chr6	167758799	167760898	CpG: 197	2099	197	1444	18.8	68.8	0.80
chr6	167770263	167770800	CpG: 51	537	51	395	19.0	73.6	0.70
chr6	167776651	167776881	CpG: 18	230	18	139	15.7	60.4	0.87
chr6	167789298	167789910	CpG: 48	612	48	397	15.7	64.9	0.75
chr6	167894973	167895254	CpG: 23	281	23	174	16.4	61.9	0.87
chr6	167928209	167928440	CpG: 18	231	18	138	15.6	59.7	0.88
chr6	167996978	167997236	CpG: 21	258	21	152	16.3	58.9	0.95
chr6	168004614	168006331	CpG: 177	1717	177	1193	20.6	69.5	0.87
chr6	168057641	168057895	CpG: 27	254	27	188	21.3	74.0	0.79
chr6	168089460	168089745	CpG: 24	285	24	179	16.8	62.8	0.87
chr6	168166636	168167578	CpG: 60	942	60	502	12.7	53.3	1.24
chr6	168245008	168245912	CpG: 73	904	73	624	16.2	69.0	0.68
chr6	168253597	168253831	CpG: 17	234	17	142	14.5	60.7	0.80
chr6	168281492	168285337	CpG: 321	3845	321	2272	16.7	59.1	0.99
chr6	168337943	168339856	CpG: 176	1913	176	1318	18.4	68.9	0.82
chr6	168363215	168363494	CpG: 24	279	24	173	17.2	62.0	0.90
chr6	168382189	168384184	CpG: 225	1995	225	1424	22.6	71.4	0.88
chr6	168476652	168476948	CpG: 21	296	21	190	14.2	64.2	0.69
chr6	168500097	168500370	CpG: 24	273	24	169	17.6	61.9	0.93
chr6	168556536	168556741	CpG: 17	205	17	117	16.6	57.1	1.04
chr6	168603100	168603309	CpG: 16	209	16	119	15.3	56.9	0.95
chr6	168677978	168678418	CpG: 47	440	47	304	21.4	69.1	1.09
chr6	168733675	168734301	CpG: 53	626	53	405	16.9	64.7	0.81
chr6	168803228	168804804	CpG: 129	1576	129	1130	16.4	71.7	0.77
chr6	168851296	168851801	CpG: 41	505	41	279	16.2	55.2	1.07
chr6	168991305	168991545	CpG: 17	240	17	149	14.2	62.1	0.82
chr6	168996202	168996479	CpG: 26	277	26	173	18.8	62.5	0.97
chr6	168999788	169000247	CpG: 32	459	32	294	13.9	64.1	0.68
chr6	169015929	169016430	CpG: 40	501	40	327	16.0	65.3	0.75
chr6	169134625	169135683	CpG: 74	1058	74	659	14.0	62.3	0.72
chr6	169159540	169159873	CpG: 23	333	23	197	13.8	59.2	0.80
chr6	169163589	169166086	CpG: 305	2497	305	1798	24.4	72.0	0.96
chr6	169289360	169289572	CpG: 17	212	17	131	16.0	61.8	0.85
chr6	169314414	169314723	CpG: 26	309	26	214	16.8	69.3	0.70
chr6	169316755	169317051	CpG: 26	296	26	198	17.6	66.9	0.81
chr6	169325035	169325263	CpG: 20	228	20	142	17.5	62.3	0.91
chr6	169328153	169328366	CpG: 15	213	15	141	14.1	66.2	0.64
chr6	169328585	169329577	CpG: 83	992	83	650	16.7	65.5	0.79
chr6	169335244	169335702	CpG: 33	458	33	328	14.4	71.6	0.62
chr6	169375890	169376439	CpG: 73	549	73	405	26.6	73.8	1.10
chr6	169389314	169389593	CpG: 20	279	20	174	14.3	62.4	0.74
chr6	169413296	169413588	CpG: 23	292	23	191	15.8	65.4	0.74
chr6	169416563	169417104	CpG: 43	541	43	339	15.9	62.7	0.82
chr6	169419810	169420053	CpG: 19	243	19	164	15.6	67.5	0.69
chr6	169442106	169442994	CpG: 98	888	98	655	22.1	73.8	0.81
chr6	169470370	169471071	CpG: 45	701	45	452	12.8	64.5	0.62
chr6	169497317	169497656	CpG: 25	339	25	211	14.7	62.2	0.79
chr6	169531477	169531987	CpG: 50	510	50	349	19.6	68.4	0.87
chr6	169553724	169553938	CpG: 16	214	16	146	15.0	68.2	0.75
chr6	169570610	169571466	CpG: 58	856	58	545	13.6	63.7	0.72
chr6	169574773	169574985	CpG: 18	212	18	131	17.0	61.8	0.90
chr6	169596204	169596525	CpG: 28	321	28	192	17.4	59.8	0.99
chr6	169625684	169625937	CpG: 22	253	22	140	17.4	55.3	1.27
chr6	169628078	169628410	CpG: 22	332	22	224	13.3	67.5	0.63
chr6	169629675	169629940	CpG: 20	265	20	158	15.1	59.6	0.88
chr6	169651614	169652094	CpG: 36	480	36	333	15.0	69.4	0.62
chr6	169653068	169653680	CpG: 49	612	49	384	16.0	62.7	0.82
chr6	169661769	169662781	CpG: 110	1012	110	741	21.7	73.2	0.82
chr6	169688481	169688702	CpG: 18	221	18	181	16.3	81.9	0.61
chr6	169708259	169708486	CpG: 18	227	18	146	15.9	64.3	0.78
chr6	169713582	169714085	CpG: 36	503	36	339	14.3	67.4	0.63
chr6	169726492	169726948	CpG: 34	456	34	251	14.9	55.0	1.26
chr6	169754969	169755183	CpG: 26	214	26	152	24.3	71.0	1.03
chr6	169756122	169756487	CpG: 49	365	49	265	26.8	72.6	1.16
chr6	169783882	169785544	CpG: 164	1662	164	1197	19.7	72.0	0.77
chr6	169861009	169861315	CpG: 27	306	27	193	17.6	63.1	0.89
chr6	169866204	169866485	CpG: 24	281	24	175	17.1	62.3	0.90
chr6	169878873	169879133	CpG: 19	260	19	162	14.6	62.3	0.77
chr6	169898825	169899608	CpG: 55	783	55	535	14.0	68.3	0.60
chr6	169914218	169915831	CpG: 133	1613	133	1065	16.5	66.0	0.77
chr6	169955515	169955833	CpG: 24	318	24	226	15.1	71.1	0.60
chr6	170042483	170042757	CpG: 23	274	23	171	16.8	62.4	0.87
chr6	170089844	170090243	CpG: 36	399	36	289	18.0	72.4	0.69
chr6	170171427	170172314	CpG: 102	887	102	657	23.0	74.1	0.94
chr6	170186096	170188211	CpG: 227	2115	227	1364	21.5	64.5	1.28
chr6	170190603	170190975	CpG: 26	372	26	239	14.0	64.2	0.69
chr6	170209639	170209931	CpG: 24	292	24	188	16.4	64.4	0.80
chr6	170233519	170233722	CpG: 27	203	27	132	26.6	65.0	1.26
chr6	170234962	170235455	CpG: 39	493	39	302	15.8	61.3	0.84
chr6	170258564	170259271	CpG: 73	707	73	454	20.7	64.2	1.16
chr6	170263140	170263574	CpG: 37	434	37	280	17.1	64.5	0.82
chr6	170281482	170281897	CpG: 29	415	29	253	14.0	61.0	0.78
chr6	170282609	170283269	CpG: 43	660	43	403	13.0	61.1	0.73
chr6	170375448	170376657	CpG: 136	1209	136	858	22.5	71.0	0.90
chr6	170416439	170416746	CpG: 23	307	23	185	15.0	60.3	0.86
chr6	170490931	170491463	CpG: 43	532	43	372	16.2	69.9	0.67
chr6	170518695	170519036	CpG: 31	341	31	227	18.2	66.6	0.82
chr6	170526446	170526747	CpG: 27	301	27	232	17.9	77.1	0.81
chr6	170573813	170574036	CpG: 20	223	20	140	17.9	62.8	0.91
chr6	170583275	170584339	CpG: 82	1064	82	697	15.4	65.5	0.72
chr6	170593618	170593835	CpG: 20	217	20	147	18.4	67.7	0.81
chr6	170601200	170601701	CpG: 42	501	42	312	16.8	62.3	0.87
chr6	170776710	170777131	CpG: 31	421	31	248	14.7	58.9	0.86
chr6	170778070	170779488	CpG: 105	1418	105	1034	14.8	72.9	0.64
chr6	170805859	170806178	CpG: 23	319	23	183	14.4	57.4	0.89
chr6	170930827	170931510	CpG: 64	683	64	455	18.7	66.6	0.86
chr6	170991771	170992052	CpG: 24	281	24	174	17.1	61.9	0.91
chr6	170998449	170998685	CpG: 21	236	21	145	17.8	61.4	0.96
chr6	171008378	171008593	CpG: 22	215	22	146	20.5	67.9	0.98
chr6	171012859	171013208	CpG: 25	349	25	189	14.3	54.2	0.99
chr6	171016116	171016672	CpG: 50	556	50	313	18.0	56.3	1.14
chr6	171016948	171017214	CpG: 24	266	24	167	18.0	62.8	0.93
chr6	171018846	171019084	CpG: 29	238	29	188	24.4	79.0	0.80
chr6	171021661	171021994	CpG: 27	333	27	214	16.2	64.3	0.79
chr6	171055480	171056877	CpG: 156	1397	156	982	22.3	70.3	0.91
chr6	171077320	171079154	CpG: 272	1834	272	1432	29.7	78.1	1.00
chr6	171105185	171106144	CpG: 101	959	101	659	21.1	68.7	0.89
chr6	171135800	171136006	CpG: 14	206	14	117	13.6	56.8	0.85
chr6	171143628	171144229	CpG: 46	601	46	367	15.3	61.1	0.83
chr6	171191873	171192124	CpG: 20	251	20	148	15.9	59.0	0.93
chr6	171288693	171288961	CpG: 19	268	19	162	14.2	60.4	0.78
chr6	171290356	171290905	CpG: 39	549	39	344	14.2	62.7	0.72
chr6	171292833	171293075	CpG: 20	242	20	168	16.5	69.4	0.70
chr6	171317794	171320200	CpG: 194	2406	194	1602	16.1	66.6	0.73
chr6	171323304	171323546	CpG: 18	242	18	167	14.9	69.0	0.65
chr6	171340383	171340585	CpG: 15	202	15	125	14.9	61.9	0.78
chr6	171378631	171380225	CpG: 148	1594	148	1133	18.6	71.1	0.73
chr6	171401859	171402171	CpG: 34	312	34	236	21.8	75.6	0.99
chr6	171432022	171432248	CpG: 17	226	17	140	15.0	61.9	0.78
chr6	171443735	171446056	CpG: 176	2321	176	1701	15.2	73.3	0.70
chr6	171452262	171452651	CpG: 35	389	35	263	18.0	67.6	0.87
chr6	171468704	171469035	CpG: 24	331	24	208	14.5	62.8	0.74
chr6	171494951	171496805	CpG: 159	1854	159	1251	17.2	67.5	0.76
chr6	171497802	171498109	CpG: 21	307	21	187	13.7	60.9	0.76
chr6	171498296	171498840	CpG: 47	544	47	335	17.3	61.6	0.95
chr6	171520950	171522475	CpG: 102	1525	102	1014	13.4	66.5	0.61
chr6	171532289	171532645	CpG: 26	356	26	217	14.6	61.0	0.79
chr6	171535076	171537083	CpG: 147	2007	147	1399	14.6	69.7	0.61
chr6	171547175	171547449	CpG: 25	274	25	172	18.2	62.8	0.94
chr6	171575994	171579757	CpG: 223	3763	223	2329	11.9	61.9	0.65
chr6	171580008	171580446	CpG: 27	438	27	269	12.3	61.4	0.69
chr6	171580561	171580799	CpG: 17	238	17	142	14.3	59.7	0.81
chr6	171581333	171581589	CpG: 20	256	20	156	15.6	60.9	0.86
chr6	171596297	171596866	CpG: 44	569	44	311	15.5	54.7	1.06
chr6	171605010	171606337	CpG: 119	1327	119	1080	17.9	81.4	0.71
chr6	171614996	171615307	CpG: 29	311	29	215	18.6	69.1	0.97
chr6	171619703	171619933	CpG: 20	230	20	141	17.4	61.3	0.95
chr6	171625780	171626403	CpG: 55	623	55	441	17.7	70.8	0.71
chr6	171633694	171633910	CpG: 15	216	15	135	13.9	62.5	0.73
chr6	171635824	171636068	CpG: 21	244	21	152	17.2	62.3	0.90
chr6	171639013	171639687	CpG: 46	674	46	402	13.6	59.6	0.77
chr6	171640193	171640511	CpG: 29	318	29	207	18.2	65.1	0.86
chr6	171641990	171642685	CpG: 53	695	53	468	15.3	67.3	0.67
chr6	171646852	171647105	CpG: 22	253	22	162	17.4	64.0	0.85
chr6	171647820	171656082	CpG: 617	8262	617	5139	14.9	62.2	0.77
chr6	171664841	171665810	CpG: 128	969	128	705	26.4	72.8	1.01
chr6	171735607	171736604	CpG: 77	997	77	635	15.4	63.7	0.77
chr6	171753124	171753559	CpG: 35	435	35	297	16.1	68.3	0.73
chr6	171792310	171792773	CpG: 55	463	55	331	23.8	71.5	1.00
chr6	171793953	171794762	CpG: 55	809	55	460	13.6	56.9	0.84
chr6	171817874	171818104	CpG: 23	230	23	140	20.0	60.9	1.16
chr6	171821303	171821972	CpG: 98	669	98	512	29.3	76.5	1.03
chr6	171827308	171827550	CpG: 18	242	18	168	14.9	69.4	0.62
chr6	171841394	171841656	CpG: 17	262	17	170	13.0	64.9	0.62
chr6	171850908	171851144	CpG: 16	236	16	157	13.6	66.5	0.66
chr6	171926587	171926943	CpG: 31	356	31	217	17.4	61.0	0.94
chr6	171927749	171928286	CpG: 43	537	43	342	16.0	63.7	0.79
chr6	171957725	171958364	CpG: 77	639	77	473	24.1	74.0	0.88
chr6	171983587	171983874	CpG: 22	287	22	163	15.3	56.8	1.02
chr6	171985861	171986239	CpG: 56	378	56	279	29.6	73.8	1.11
chr6	172086031	172086253	CpG: 15	222	15	125	13.5	56.3	0.98
chr6	172088462	172089611	CpG: 95	1149	95	835	16.5	72.7	0.63
chr6	172100539	172101199	CpG: 72	660	72	423	21.8	64.1	1.06
chr6	172121877	172123454	CpG: 304	1577	304	1269	38.6	80.5	1.22
chr7	3650	4933	CpG: 194	1283	194	974	30.2	75.9	1.07
chr7	65297	65736	CpG: 30	439	30	295	13.7	67.2	0.64
chr7	131231	131937	CpG: 58	706	58	448	16.4	63.5	0.82
chr7	182622	182890	CpG: 20	268	20	182	14.9	67.9	0.65
chr7	203239	203496	CpG: 19	257	19	169	14.8	65.8	0.85
chr7	203673	203907	CpG: 17	234	17	152	14.5	65.0	0.86
chr7	220713	220952	CpG: 17	239	17	151	14.2	63.2	0.71
chr7	249682	250701	CpG: 96	1019	96	666	18.8	65.4	0.89
chr7	260436	260702	CpG: 29	266	29	187	21.8	70.3	0.91
chr7	272173	272444	CpG: 21	271	21	195	15.5	72.0	0.65
chr7	279182	279792	CpG: 45	610	45	384	14.8	63.0	0.74
chr7	287017	287338	CpG: 26	321	26	217	16.2	67.6	0.71
chr7	292478	294466	CpG: 274	1988	274	1563	27.6	78.6	0.90
chr7	296141	296655	CpG: 35	514	35	327	13.6	63.6	0.67
chr7	305893	309688	CpG: 340	3795	340	2539	17.9	66.9	0.84
chr7	320155	320797	CpG: 46	642	46	433	14.3	67.4	0.63
chr7	324644	324855	CpG: 17	211	17	150	16.1	71.1	0.64
chr7	325066	325897	CpG: 74	831	74	554	17.8	66.7	0.81
chr7	331125	331392	CpG: 23	267	23	196	17.2	73.4	0.75
chr7	336549	336750	CpG: 15	201	15	136	14.9	67.7	0.76
chr7	344348	344637	CpG: 24	289	24	189	16.6	65.4	0.80
chr7	353256	353708	CpG: 30	452	30	280	13.3	61.9	0.70
chr7	354175	354398	CpG: 17	223	17	128	15.2	57.4	0.94
chr7	355207	356308	CpG: 82	1101	82	743	14.9	67.5	0.66
chr7	360023	360442	CpG: 38	419	38	278	18.1	66.3	0.83
chr7	366776	367072	CpG: 25	296	25	212	16.9	71.6	0.66
chr7	382553	383149	CpG: 49	596	49	362	16.4	60.7	0.89
chr7	388879	391049	CpG: 232	2170	232	1582	21.4	72.9	0.80
chr7	396377	396943	CpG: 53	566	53	414	18.7	73.1	1.11
chr7	401241	401452	CpG: 16	211	16	142	15.2	67.3	0.68
chr7	409997	410232	CpG: 20	235	20	146	17.0	62.1	0.92
chr7	421511	422081	CpG: 52	570	52	413	18.2	72.5	0.70
chr7	432366	432941	CpG: 54	575	54	427	18.8	74.3	0.68
chr7	433181	433799	CpG: 39	618	39	346	12.6	56.0	0.87
chr7	435906	436605	CpG: 66	699	66	515	18.9	73.7	0.74
chr7	446122	446555	CpG: 49	433	49	319	22.6	73.7	0.94
chr7	451233	451460	CpG: 19	227	19	132	16.7	58.1	1.01
chr7	453648	453854	CpG: 17	206	17	136	16.5	66.0	0.76
chr7	461111	461563	CpG: 35	452	35	280	15.5	61.9	0.81
chr7	464212	464430	CpG: 15	218	15	137	13.8	62.8	0.70
chr7	469252	469455	CpG: 16	203	16	143	15.8	70.4	0.64
chr7	469586	470506	CpG: 78	920	78	638	17.0	69.3	0.71
chr7	472567	472963	CpG: 32	396	32	258	16.2	65.2	0.76
chr7	475035	475343	CpG: 23	308	23	199	14.9	64.6	0.72
chr7	492584	492876	CpG: 23	292	23	181	15.8	62.0	0.82
chr7	511383	511870	CpG: 39	487	39	377	16.0	77.4	0.60
chr7	513907	514171	CpG: 20	264	20	174	15.2	65.9	0.71
chr7	520719	521206	CpG: 45	487	45	314	18.5	64.5	0.98
chr7	525108	525374	CpG: 19	266	19	162	14.3	60.9	0.84
chr7	529166	529591	CpG: 30	425	30	269	14.1	63.3	0.72
chr7	530630	530987	CpG: 25	357	25	234	14.0	65.5	0.66
chr7	533904	534307	CpG: 34	403	34	239	16.9	59.3	0.96
chr7	537159	537494	CpG: 26	335	26	218	15.5	65.1	0.74
chr7	540609	540954	CpG: 24	345	24	226	13.9	65.5	0.67
chr7	551795	552015	CpG: 16	220	16	148	14.5	67.3	0.65
chr7	554346	554608	CpG: 42	262	42	184	32.1	70.2	1.31
chr7	555169	555388	CpG: 18	219	18	160	16.4	73.1	0.64
chr7	561747	563346	CpG: 124	1599	124	1092	15.5	68.3	0.67
chr7	576257	576514	CpG: 23	257	23	184	17.9	71.6	0.70
chr7	593097	593780	CpG: 75	683	75	514	22.0	75.3	0.78
chr7	611792	612023	CpG: 22	231	22	153	19.0	66.2	0.88
chr7	617868	624186	CpG: 655	6318	655	4473	20.7	70.8	0.83
chr7	631143	631373	CpG: 21	230	21	145	18.3	63.0	0.95
chr7	643019	643275	CpG: 19	256	19	165	14.8	64.5	0.97
chr7	650240	650871	CpG: 44	631	44	421	13.9	66.7	0.63
chr7	654684	655122	CpG: 31	438	31	288	14.2	65.8	0.66
chr7	658115	658435	CpG: 27	320	27	198	16.9	61.9	0.89
chr7	661153	661391	CpG: 19	238	19	163	16.0	68.5	0.68
chr7	663185	663793	CpG: 49	608	49	404	16.1	66.4	0.73
chr7	672959	673172	CpG: 17	213	17	144	16.0	67.6	0.70
chr7	673327	673697	CpG: 33	370	33	261	17.8	70.5	0.72
chr7	674635	675834	CpG: 85	1199	85	765	14.2	63.8	0.70
chr7	678656	678888	CpG: 19	232	19	149	16.4	64.2	0.94
chr7	684280	684976	CpG: 48	696	48	431	13.8	61.9	0.73
chr7	695011	695310	CpG: 25	299	25	202	16.7	67.6	0.74
chr7	707356	707636	CpG: 22	280	22	186	15.7	66.4	0.71
chr7	708508	708791	CpG: 22	283	22	177	15.5	62.5	0.80
chr7	738743	739342	CpG: 97	599	97	470	32.4	78.5	1.36
chr7	743917	744132	CpG: 19	215	19	132	17.7	61.4	0.96
chr7	745322	745608	CpG: 25	286	25	181	17.5	63.3	0.88
chr7	773420	773904	CpG: 38	484	38	338	15.7	69.8	0.66
chr7	779458	779842	CpG: 26	384	26	254	13.5	66.1	0.62
chr7	814263	814712	CpG: 33	449	33	302	14.7	67.3	0.65
chr7	815187	815941	CpG: 101	754	101	611	26.8	81.0	0.86
chr7	818912	819123	CpG: 17	211	17	130	16.1	61.6	0.86
chr7	829543	830647	CpG: 142	1104	142	852	25.7	77.2	0.88
chr7	843697	844059	CpG: 29	362	29	245	16.0	67.7	0.70
chr7	855372	855794	CpG: 38	422	38	264	18.0	62.6	0.92
chr7	856576	857225	CpG: 53	649	53	372	16.3	57.3	1.00
chr7	857675	858040	CpG: 28	365	28	240	15.3	65.8	0.71
chr7	859803	860384	CpG: 41	581	41	376	14.1	64.7	0.68
chr7	870794	871719	CpG: 78	925	78	625	16.9	67.6	0.80
chr7	872001	872293	CpG: 23	292	23	195	15.8	66.8	0.71
chr7	877085	877850	CpG: 67	765	67	529	17.5	69.2	0.73
chr7	885147	886529	CpG: 159	1382	159	902	23.0	65.3	1.08
chr7	916410	916680	CpG: 20	270	20	166	14.8	61.5	0.79
chr7	918744	920475	CpG: 169	1731	169	1267	19.5	73.2	0.73
chr7	925985	926270	CpG: 23	285	23	178	16.1	62.5	0.83
chr7	950296	951028	CpG: 61	732	61	527	16.7	72.0	0.64
chr7	969103	969381	CpG: 22	278	22	164	15.8	59.0	0.91
chr7	979235	980470	CpG: 159	1235	159	929	25.7	75.2	0.94
chr7	981112	981339	CpG: 22	227	22	154	19.4	67.8	0.84
chr7	992774	994168	CpG: 138	1394	138	1008	19.8	72.3	1.15
chr7	995063	995609	CpG: 40	546	40	352	14.7	64.5	0.71
chr7	995917	996164	CpG: 19	247	19	150	15.4	60.7	0.83
chr7	996952	997437	CpG: 37	485	37	324	15.3	66.8	1.20
chr7	999160	999777	CpG: 56	617	56	421	18.2	68.2	0.78
chr7	1000514	1000801	CpG: 30	287	30	198	20.9	69.0	0.88
chr7	1007029	1007262	CpG: 17	233	17	153	14.6	65.7	0.68
chr7	1007887	1008214	CpG: 23	327	23	217	14.1	66.4	0.67
chr7	1012838	1013136	CpG: 29	298	29	218	19.5	73.2	0.73
chr7	1013769	1014541	CpG: 82	772	82	564	21.2	73.1	0.80
chr7	1025025	1025652	CpG: 47	627	47	423	15.0	67.5	0.68
chr7	1026540	1026847	CpG: 22	307	22	203	14.3	66.1	0.66
chr7	1031428	1031707	CpG: 20	279	20	193	14.3	69.2	0.60
chr7	1039253	1039689	CpG: 31	436	31	330	14.2	75.7	0.63
chr7	1042446	1042882	CpG: 34	436	34	301	15.6	69.0	0.67
chr7	1050982	1051282	CpG: 22	300	22	210	14.7	70.0	0.60
chr7	1058763	1059936	CpG: 172	1173	172	945	29.3	80.6	0.91
chr7	1072520	1072919	CpG: 31	399	31	255	15.5	63.9	0.76
chr7	1079943	1080916	CpG: 90	973	90	673	18.5	69.2	0.78
chr7	1089381	1089593	CpG: 22	212	22	150	20.8	70.8	0.83
chr7	1089966	1090254	CpG: 23	288	23	203	16.0	70.5	0.64
chr7	1091527	1091755	CpG: 19	228	19	160	16.7	70.2	0.69
chr7	1092137	1092510	CpG: 36	373	36	273	19.3	73.2	0.72
chr7	1094825	1095685	CpG: 75	860	75	601	17.4	69.9	0.84
chr7	1104977	1105456	CpG: 36	479	36	331	15.0	69.1	0.64
chr7	1111303	1111801	CpG: 58	498	58	324	23.3	65.1	1.11
chr7	1113754	1114101	CpG: 29	347	29	182	16.7	52.4	1.51
chr7	1114281	1114484	CpG: 14	203	14	137	13.8	67.5	0.62
chr7	1117747	1118096	CpG: 30	349	30	251	17.2	71.9	0.68
chr7	1121020	1121990	CpG: 66	970	66	644	13.6	66.4	0.67
chr7	1124888	1125237	CpG: 30	349	30	239	17.2	68.5	0.73
chr7	1127856	1128326	CpG: 40	470	40	313	17.0	66.6	0.77
chr7	1132291	1133604	CpG: 142	1313	142	978	21.6	74.5	0.78
chr7	1141249	1141517	CpG: 27	268	27	187	20.1	69.8	0.98
chr7	1146193	1146427	CpG: 27	234	27	184	23.1	78.6	0.81
chr7	1149392	1149953	CpG: 66	561	66	434	23.5	77.4	0.79
chr7	1155535	1155875	CpG: 24	340	24	214	14.1	62.9	0.71
chr7	1162763	1163311	CpG: 49	548	49	363	17.9	66.2	0.82
chr7	1164392	1165022	CpG: 51	630	51	418	16.2	66.3	0.92
chr7	1170586	1171301	CpG: 60	715	60	479	16.8	67.0	0.75
chr7	1174446	1175969	CpG: 122	1523	122	1001	16.0	65.7	0.76
chr7	1178552	1179324	CpG: 92	772	92	580	23.8	75.1	1.07
chr7	1185205	1185514	CpG: 28	309	28	215	18.1	69.6	0.75
chr7	1186860	1187301	CpG: 33	441	33	275	15.0	62.4	0.77
chr7	1191844	1192176	CpG: 29	332	29	223	17.5	67.2	0.78
chr7	1196860	1197536	CpG: 56	676	56	436	16.6	64.5	0.81
chr7	1198200	1198422	CpG: 19	222	19	147	17.1	66.2	0.78
chr7	1200979	1201227	CpG: 21	248	21	167	16.9	67.3	0.76
chr7	1203409	1203710	CpG: 22	301	22	181	14.6	60.1	0.84
chr7	1206382	1206698	CpG: 26	316	26	219	16.5	69.3	0.69
chr7	1214331	1215458	CpG: 89	1127	89	761	15.8	67.5	0.70
chr7	1218154	1218460	CpG: 21	306	21	195	13.7	63.7	0.68
chr7	1220525	1222067	CpG: 128	1542	128	902	16.6	58.5	1.03
chr7	1240528	1241176	CpG: 76	648	76	478	23.5	73.8	0.86
chr7	1247070	1247418	CpG: 26	348	26	213	14.9	61.2	0.80
chr7	1259117	1260414	CpG: 123	1297	123	896	19.0	69.1	0.81
chr7	1266254	1266495	CpG: 17	241	17	146	14.1	60.6	0.80
chr7	1275802	1276084	CpG: 24	282	24	180	17.0	63.8	0.84
chr7	1318878	1319211	CpG: 28	333	28	231	16.8	69.4	0.70
chr7	1331556	1332450	CpG: 90	894	90	622	20.1	69.6	0.84
chr7	1333167	1333435	CpG: 31	268	31	196	23.1	73.1	0.89
chr7	1337223	1350918	CpG: 1052	13695	1052	8477	15.4	61.9	0.80
chr7	1351893	1352094	CpG: 15	201	15	124	14.9	61.7	0.79
chr7	1354076	1355712	CpG: 158	1636	158	1139	19.3	69.6	0.80
chr7	1363760	1363975	CpG: 17	215	17	150	15.8	69.8	0.71
chr7	1386825	1387696	CpG: 60	871	60	524	13.8	60.2	0.77
chr7	1397157	1397477	CpG: 28	320	28	235	17.5	73.4	0.76
chr7	1399975	1400479	CpG: 34	504	34	337	13.5	66.9	0.60
chr7	1400831	1401658	CpG: 67	827	67	484	16.2	58.5	0.95
chr7	1408414	1408697	CpG: 21	283	21	172	14.8	60.8	0.80
chr7	1422788	1423228	CpG: 34	440	34	289	15.5	65.7	0.72
chr7	1429600	1429841	CpG: 19	241	19	160	15.8	66.4	0.72
chr7	1434167	1434999	CpG: 64	832	64	553	15.4	66.5	0.70
chr7	1438184	1438420	CpG: 19	236	19	145	16.1	61.4	0.88
chr7	1441738	1442215	CpG: 40	477	40	289	16.8	60.6	0.91
chr7	1479835	1480655	CpG: 75	820	75	594	18.3	72.4	0.74
chr7	1495173	1495402	CpG: 20	229	20	175	17.5	76.4	0.62
chr7	1498455	1498704	CpG: 18	249	18	150	14.5	60.2	0.80
chr7	1514836	1515137	CpG: 22	301	22	188	14.6	62.5	0.78
chr7	1519165	1519395	CpG: 21	230	21	173	18.3	75.2	0.65
chr7	1522673	1522955	CpG: 27	282	27	177	19.1	62.8	1.02
chr7	1523970	1524347	CpG: 46	377	46	271	24.4	71.9	0.95
chr7	1532223	1532540	CpG: 28	317	28	202	17.7	63.7	0.89
chr7	1545422	1545769	CpG: 29	347	29	240	16.7	69.2	0.70
chr7	1555193	1556812	CpG: 123	1619	123	1119	15.2	69.1	0.64
chr7	1564270	1564472	CpG: 17	202	17	139	16.8	68.8	0.71
chr7	1571072	1572103	CpG: 111	1031	111	770	21.5	74.7	0.79
chr7	1586271	1586548	CpG: 26	277	26	199	18.8	71.8	0.74
chr7	1586852	1587076	CpG: 21	224	21	160	18.8	71.4	0.74
chr7	1587653	1588240	CpG: 41	587	41	396	14.0	67.5	0.61
chr7	1591658	1591963	CpG: 27	305	27	217	17.7	71.1	0.73
chr7	1596060	1596495	CpG: 41	435	41	299	18.9	68.7	0.80
chr7	1599009	1599386	CpG: 30	377	30	267	15.9	70.8	0.64
chr7	1599843	1600130	CpG: 21	287	21	197	14.6	68.6	0.62
chr7	1605063	1606179	CpG: 76	1116	76	740	13.6	66.3	0.64
chr7	1606760	1607072	CpG: 24	312	24	221	15.4	70.8	0.62
chr7	1608253	1608654	CpG: 30	401	30	275	15.0	68.6	0.65
chr7	1609176	1610044	CpG: 60	868	60	557	13.8	64.2	0.67
chr7	1610776	1611507	CpG: 54	731	54	509	14.8	69.6	0.62
chr7	1615708	1616963	CpG: 140	1255	140	895	22.3	71.3	0.88
chr7	1628474	1628710	CpG: 18	236	18	143	15.3	60.6	0.85
chr7	1642665	1643628	CpG: 151	963	151	785	31.4	81.5	0.97
chr7	1648228	1648485	CpG: 23	257	23	166	17.9	64.6	0.86
chr7	1656546	1656837	CpG: 26	291	26	197	17.9	67.7	0.79
chr7	1659732	1660185	CpG: 34	453	34	310	15.0	68.4	0.64
chr7	1662879	1663512	CpG: 45	633	45	439	14.2	69.4	0.63
chr7	1681544	1682726	CpG: 121	1182	121	790	20.5	66.8	0.92
chr7	1714573	1714792	CpG: 17	219	17	147	15.5	67.1	0.69
chr7	1716492	1716717	CpG: 20	225	20	154	17.8	68.4	0.76
chr7	1731936	1732741	CpG: 65	805	65	562	16.1	69.8	0.66
chr7	1733207	1733677	CpG: 36	470	36	302	15.3	64.3	0.74
chr7	1759598	1759890	CpG: 24	292	24	179	16.4	61.3	0.88
chr7	1765409	1765690	CpG: 23	281	23	174	16.4	61.9	0.87
chr7	1776749	1783410	CpG: 639	6661	639	4803	19.2	72.1	0.74
chr7	1826367	1826627	CpG: 19	260	19	171	14.6	65.8	0.71
chr7	1856774	1859858	CpG: 264	3084	264	2116	17.1	68.6	0.73
chr7	1882361	1882798	CpG: 36	437	36	260	16.5	59.5	0.94
chr7	1930182	1930838	CpG: 61	656	61	423	18.6	64.5	0.89
chr7	1938983	1939208	CpG: 16	225	16	142	14.2	63.1	0.72
chr7	1939663	1940227	CpG: 40	564	40	337	14.2	59.8	0.80
chr7	1942289	1942520	CpG: 18	231	18	148	15.6	64.1	0.77
chr7	1958448	1958709	CpG: 30	261	30	161	23.0	61.7	1.24
chr7	1962733	1962949	CpG: 20	216	20	139	18.5	64.4	0.90
chr7	1969400	1969761	CpG: 28	361	28	228	15.5	63.2	0.80
chr7	1975793	1976090	CpG: 23	297	23	204	15.5	68.7	0.67
chr7	1981571	1981835	CpG: 24	264	24	182	18.2	68.9	0.77
chr7	1982946	1983152	CpG: 17	206	17	123	16.5	59.7	1.16
chr7	1983505	1984287	CpG: 53	782	53	456	13.6	58.3	1.02
chr7	1986860	1987108	CpG: 19	248	19	167	15.3	67.3	0.70
chr7	2013293	2013501	CpG: 18	208	18	133	17.3	63.9	0.86
chr7	2025006	2025209	CpG: 15	203	15	130	14.8	64.0	0.72
chr7	2029789	2030194	CpG: 35	405	35	252	17.3	62.2	0.90
chr7	2042392	2042722	CpG: 26	330	26	220	15.8	66.7	0.78
chr7	2044064	2045394	CpG: 127	1330	127	999	19.1	75.1	1.16
chr7	2045757	2046054	CpG: 25	297	25	200	16.8	67.3	0.75
chr7	2049085	2049808	CpG: 49	723	49	424	13.6	58.6	0.79
chr7	2051388	2051594	CpG: 20	206	20	146	19.4	70.9	0.78
chr7	2052416	2052800	CpG: 30	384	30	258	15.6	67.2	0.74
chr7	2059645	2059928	CpG: 20	283	20	193	14.1	68.2	0.61
chr7	2066948	2067156	CpG: 18	208	18	140	17.3	67.3	0.77
chr7	2082840	2083306	CpG: 36	466	36	297	15.5	63.7	0.79
chr7	2101974	2102389	CpG: 33	415	33	274	15.9	66.0	0.74
chr7	2104137	2104347	CpG: 17	210	17	150	16.2	71.4	0.63
chr7	2118501	2118706	CpG: 16	205	16	136	15.6	66.3	0.71
chr7	2127986	2128312	CpG: 28	326	28	226	17.2	69.3	0.72
chr7	2133829	2134053	CpG: 18	224	18	155	16.1	69.2	0.68
chr7	2163680	2163968	CpG: 25	288	25	196	17.4	68.1	0.79
chr7	2173668	2174358	CpG: 70	690	70	378	20.3	54.8	1.36
chr7	2181079	2181380	CpG: 22	301	22	201	14.6	66.8	0.68
chr7	2190366	2190780	CpG: 32	414	32	252	15.5	60.9	0.85
chr7	2216855	2217168	CpG: 22	313	22	207	14.1	66.1	0.64
chr7	2226521	2226778	CpG: 18	257	18	152	14.0	59.1	0.80
chr7	2228608	2229181	CpG: 41	573	41	395	14.3	68.9	0.61
chr7	2259653	2260087	CpG: 30	434	30	272	13.8	62.7	0.71
chr7	2269565	2269865	CpG: 44	300	44	210	29.3	70.0	1.36
chr7	2274856	2275643	CpG: 61	787	61	554	15.5	70.4	0.63
chr7	2280869	2281107	CpG: 17	238	17	142	14.3	59.7	0.82
chr7	2345819	2346665	CpG: 95	846	95	617	22.5	72.9	0.85
chr7	2347127	2347339	CpG: 18	212	18	126	17.0	59.4	0.97
chr7	2355145	2355888	CpG: 78	743	78	548	21.0	73.8	0.77
chr7	2367059	2367359	CpG: 23	300	23	211	15.3	70.3	0.62
chr7	2370135	2371031	CpG: 72	896	72	613	16.1	68.4	0.69
chr7	2371457	2371853	CpG: 29	396	29	247	14.6	62.4	0.77
chr7	2392070	2392940	CpG: 106	870	106	529	24.4	60.8	1.37
chr7	2425150	2425430	CpG: 21	280	21	172	15.0	61.4	0.80
chr7	2426417	2426687	CpG: 20	270	20	162	14.8	60.0	0.84
chr7	2427413	2428289	CpG: 101	876	101	654	23.1	74.7	0.84
chr7	2449013	2449276	CpG: 21	263	21	162	16.0	61.6	0.85
chr7	2467481	2469027	CpG: 168	1546	168	1030	21.7	66.6	0.98
chr7	2493580	2494112	CpG: 38	532	38	331	14.3	62.2	0.74
chr7	2497145	2497371	CpG: 19	226	19	158	16.8	69.9	0.76
chr7	2498778	2499055	CpG: 24	277	24	177	17.3	63.9	0.86
chr7	2515675	2515942	CpG: 24	267	24	168	18.0	62.9	0.92
chr7	2516572	2517791	CpG: 142	1219	142	886	23.3	72.7	0.89
chr7	2545995	2547557	CpG: 146	1562	146	990	18.7	63.4	0.94
chr7	2557394	2557668	CpG: 24	274	24	171	17.5	62.4	0.91
chr7	2571295	2571531	CpG: 18	236	18	141	15.3	59.7	0.87
chr7	2573654	2573876	CpG: 17	222	17	151	15.3	68.0	0.66
chr7	2632063	2633746	CpG: 207	1683	207	1259	24.6	74.8	0.88
chr7	2637389	2637835	CpG: 35	446	35	305	15.7	68.4	0.68
chr7	2644829	2645339	CpG: 52	510	52	356	20.4	69.8	0.86
chr7	2647529	2648673	CpG: 89	1144	89	823	15.6	71.9	0.60
chr7	2651902	2652248	CpG: 29	346	29	239	16.8	69.1	0.70
chr7	2657106	2657442	CpG: 25	336	25	229	14.9	68.2	0.64
chr7	2668684	2669558	CpG: 82	874	82	615	18.8	70.4	0.76
chr7	2672470	2673168	CpG: 99	698	99	535	28.4	76.6	0.97
chr7	2690402	2691884	CpG: 189	1482	189	1002	25.5	67.6	1.19
chr7	2697182	2697524	CpG: 49	342	49	283	28.7	82.7	0.98
chr7	2706005	2706206	CpG: 16	201	16	135	15.9	67.2	0.71
chr7	2706915	2707162	CpG: 22	247	22	160	17.8	64.8	0.85
chr7	2719416	2719657	CpG: 20	241	20	172	16.6	71.4	0.65
chr7	2739130	2739401	CpG: 20	271	20	165	14.8	60.9	0.81
chr7	2745036	2745817	CpG: 94	781	94	582	24.1	74.5	0.92
chr7	2760464	2761197	CpG: 72	733	72	536	19.6	73.1	0.75
chr7	2771825	2772095	CpG: 24	270	24	189	17.8	70.0	0.73
chr7	2773951	2774197	CpG: 23	246	23	179	18.7	72.8	0.72
chr7	2775223	2775637	CpG: 34	414	34	298	16.4	72.0	0.71
chr7	2778432	2779220	CpG: 63	788	63	516	16.0	65.5	0.80
chr7	2792713	2793093	CpG: 44	380	44	270	23.2	71.1	0.96
chr7	2801571	2802281	CpG: 90	710	90	552	25.4	77.7	0.84
chr7	2805786	2806026	CpG: 17	240	17	139	14.2	57.9	0.86
chr7	2813867	2814316	CpG: 34	449	34	303	15.1	67.5	0.68
chr7	2816174	2816447	CpG: 22	273	22	192	16.1	70.3	0.65
chr7	2831914	2832167	CpG: 21	253	21	162	16.6	64.0	0.81
chr7	2835846	2836062	CpG: 15	216	15	130	13.9	60.2	0.78
chr7	2848356	2848567	CpG: 16	211	16	146	15.2	69.2	0.63
chr7	2876355	2876613	CpG: 20	258	20	181	15.5	70.2	0.63
chr7	2902656	2903000	CpG: 28	344	28	203	16.3	59.0	0.94
chr7	2945037	2945274	CpG: 17	237	17	139	14.3	58.6	0.87
chr7	2957228	2958254	CpG: 142	1026	142	763	27.7	74.4	1.00
chr7	3013316	3013605	CpG: 22	289	22	175	15.2	60.6	0.84
chr7	3020207	3020434	CpG: 19	227	19	151	16.7	66.5	0.80
chr7	3042027	3042389	CpG: 33	362	33	233	18.2	64.4	0.89
chr7	3100214	3100447	CpG: 18	233	18	150	15.5	64.4	0.79
chr7	3148240	3148641	CpG: 26	401	26	227	13.0	56.6	0.81
chr7	3157056	3157396	CpG: 35	340	35	264	20.6	77.6	0.73
chr7	3164628	3164906	CpG: 23	278	23	173	16.5	62.2	0.86
chr7	3300964	3301198	CpG: 19	234	19	140	16.2	59.8	0.93
chr7	3313545	3313820	CpG: 21	275	21	164	15.3	59.6	0.87
chr7	3415006	3416381	CpG: 226	1375	226	1090	32.9	79.3	1.05
chr7	3793788	3794011	CpG: 18	223	18	136	16.1	61.0	0.89
chr7	3890125	3890390	CpG: 20	265	20	162	15.1	61.1	0.83
chr7	3894171	3894452	CpG: 22	281	22	176	15.7	62.6	0.82
chr7	4225391	4225615	CpG: 19	224	19	146	17.0	65.2	0.83
chr7	4232831	4233084	CpG: 21	253	21	161	16.6	63.6	0.83
chr7	4246618	4246890	CpG: 24	272	24	179	17.6	65.8	0.82
chr7	4380209	4381357	CpG: 79	1148	79	765	13.8	66.6	0.64
chr7	4381778	4382194	CpG: 48	416	48	298	23.1	71.6	0.93
chr7	4424851	4425161	CpG: 25	310	25	199	16.1	64.2	0.83
chr7	4611215	4611486	CpG: 21	271	21	167	15.5	61.6	0.82
chr7	4613624	4613976	CpG: 28	352	28	252	15.9	71.6	0.62
chr7	4634812	4635019	CpG: 14	207	14	123	13.5	59.4	0.78
chr7	4740643	4741466	CpG: 61	823	61	572	14.8	69.5	0.61
chr7	4758817	4759684	CpG: 114	867	114	639	26.3	73.7	0.97
chr7	4799205	4800347	CpG: 168	1142	168	903	29.4	79.1	0.96
chr7	4835373	4835608	CpG: 21	235	21	147	17.9	62.6	0.92
chr7	4842255	4842823	CpG: 43	568	43	362	15.1	63.7	0.75
chr7	4862389	4862633	CpG: 19	244	19	169	15.6	69.3	0.66
chr7	4864339	4864565	CpG: 18	226	18	147	15.9	65.0	0.75
chr7	4871695	4872103	CpG: 35	408	35	275	17.2	67.4	0.76
chr7	4872323	4872620	CpG: 24	297	24	191	16.2	64.3	0.78
chr7	4876108	4876860	CpG: 71	752	71	523	18.9	69.5	0.78
chr7	4878195	4878498	CpG: 25	303	25	196	16.5	64.7	0.80
chr7	4879420	4879798	CpG: 33	378	33	273	17.5	72.2	0.67
chr7	4880341	4880599	CpG: 22	258	22	157	17.1	60.9	0.92
chr7	4884439	4884665	CpG: 21	226	21	143	18.6	63.3	0.93
chr7	4885364	4885638	CpG: 24	274	24	171	17.5	62.4	0.91
chr7	4892602	4893125	CpG: 56	523	56	364	21.4	69.6	0.88
chr7	4901082	4901673	CpG: 44	591	44	412	14.9	69.7	0.62
chr7	4901941	4902256	CpG: 24	315	24	216	15.2	68.6	0.65
chr7	4902692	4902921	CpG: 18	229	18	159	15.7	69.4	0.65
chr7	4905920	4906125	CpG: 16	205	16	146	15.6	71.2	0.62
chr7	4909324	4910057	CpG: 65	733	65	518	17.7	70.7	0.72
chr7	4925771	4926776	CpG: 87	1005	87	688	17.3	68.5	0.83
chr7	4933561	4933783	CpG: 20	222	20	157	18.0	70.7	0.72
chr7	4934429	4934737	CpG: 25	308	25	202	16.2	65.6	0.76
chr7	4944480	4944869	CpG: 25	389	25	227	12.9	58.4	0.77
chr7	4951675	4952666	CpG: 75	991	75	690	15.1	69.6	0.62
chr7	4953595	4953800	CpG: 22	205	22	154	21.5	75.1	0.77
chr7	4978907	4979324	CpG: 51	417	51	299	24.5	71.7	0.97
chr7	4992115	4992343	CpG: 18	228	18	141	15.8	61.8	0.85
chr7	5000272	5001141	CpG: 103	869	103	664	23.7	76.4	0.81
chr7	5075873	5076767	CpG: 102	894	102	658	22.8	73.6	0.85
chr7	5091659	5092587	CpG: 116	928	116	677	25.0	73.0	0.95
chr7	5163581	5164510	CpG: 85	929	85	647	18.3	69.6	0.77
chr7	5189783	5190251	CpG: 37	468	37	325	15.8	69.4	0.67
chr7	5192483	5192686	CpG: 16	203	16	122	15.8	60.1	0.89
chr7	5201053	5201331	CpG: 26	278	26	158	18.7	56.8	1.17
chr7	5203546	5203784	CpG: 18	238	18	144	15.1	60.5	0.83
chr7	5238794	5239408	CpG: 47	614	47	379	15.3	61.7	0.80
chr7	5262030	5262375	CpG: 28	345	28	241	16.2	69.9	0.67
chr7	5278312	5278632	CpG: 23	320	23	191	14.4	59.7	0.81
chr7	5307781	5308465	CpG: 90	684	90	525	26.3	76.8	0.90
chr7	5345050	5345435	CpG: 28	385	28	235	14.5	61.0	0.78
chr7	5345877	5346239	CpG: 30	362	30	240	16.6	66.3	0.77
chr7	5356756	5357152	CpG: 28	396	28	234	14.1	59.1	0.82
chr7	5400653	5401696	CpG: 120	1043	120	800	23.0	76.7	0.78
chr7	5414537	5414919	CpG: 39	382	39	267	20.4	69.9	0.84
chr7	5416738	5417066	CpG: 26	328	26	231	15.9	70.4	0.64
chr7	5418208	5418418	CpG: 17	210	17	148	16.2	70.5	0.66
chr7	5420362	5420662	CpG: 23	300	23	211	15.3	70.3	0.63
chr7	5420813	5421052	CpG: 18	239	18	160	15.1	66.9	0.70
chr7	5421628	5421845	CpG: 17	217	17	142	15.7	65.4	0.75
chr7	5425623	5426024	CpG: 34	401	34	263	17.0	65.6	0.79
chr7	5426765	5427142	CpG: 29	377	29	257	15.4	68.2	0.66
chr7	5438705	5438934	CpG: 20	229	20	155	17.5	67.7	0.78
chr7	5450335	5450953	CpG: 64	618	64	446	20.7	72.2	0.80
chr7	5469384	5469633	CpG: 22	249	22	153	17.7	61.4	0.95
chr7	5473933	5474361	CpG: 32	428	32	266	15.0	62.1	0.79
chr7	5478668	5479667	CpG: 86	999	86	688	17.2	68.9	0.73
chr7	5488728	5489045	CpG: 29	317	29	225	18.3	71.0	0.73
chr7	5491801	5492266	CpG: 40	465	40	344	17.2	74.0	0.63
chr7	5505513	5507095	CpG: 188	1582	188	1193	23.8	75.4	0.84
chr7	5536544	5547289	CpG: 806	10745	806	6769	15.0	63.0	0.76
chr7	5551485	5551721	CpG: 17	236	17	143	14.4	60.6	0.81
chr7	5584567	5584894	CpG: 22	327	22	186	13.5	56.9	0.84
chr7	5588555	5588947	CpG: 31	392	31	248	15.8	63.3	0.82
chr7	5592325	5592558	CpG: 19	233	19	146	16.3	62.7	0.85
chr7	5596842	5597062	CpG: 16	220	16	142	14.5	64.5	0.70
chr7	5599283	5599530	CpG: 23	247	23	159	18.6	64.4	0.91
chr7	5604302	5604606	CpG: 23	304	23	203	15.1	66.8	0.68
chr7	5605839	5606093	CpG: 19	254	19	167	15.0	65.7	0.69
chr7	5615654	5615937	CpG: 20	283	20	172	14.1	60.8	0.78
chr7	5617845	5619455	CpG: 131	1610	131	1082	16.3	67.2	0.73
chr7	5631056	5631664	CpG: 62	608	62	411	20.4	67.6	0.90
chr7	5635787	5636006	CpG: 18	219	18	135	16.4	61.6	0.89
chr7	5646954	5648486	CpG: 204	1532	204	1141	26.6	74.5	0.97
chr7	5672544	5674431	CpG: 164	1887	164	1321	17.4	70.0	0.71
chr7	5679693	5680543	CpG: 58	850	58	543	13.6	63.9	0.67
chr7	5681204	5681748	CpG: 38	544	38	335	14.0	61.6	0.74
chr7	5687615	5687995	CpG: 34	380	34	259	17.9	68.2	0.79
chr7	5694171	5694438	CpG: 19	267	19	158	14.2	59.2	0.83
chr7	5706752	5707103	CpG: 26	351	26	198	14.8	56.4	0.96
chr7	5709978	5712453	CpG: 284	2475	284	1797	22.9	72.6	0.87
chr7	5718213	5718436	CpG: 17	223	17	128	15.2	57.4	0.94
chr7	5720847	5721083	CpG: 19	236	19	157	16.1	66.5	0.76
chr7	5722822	5723041	CpG: 21	219	21	147	19.2	67.1	0.85
chr7	5725003	5725239	CpG: 22	236	22	167	18.6	70.8	0.76
chr7	5725556	5725883	CpG: 25	327	25	224	15.3	68.5	0.67
chr7	5840859	5841094	CpG: 17	235	17	138	14.5	58.7	0.87
chr7	5853750	5854425	CpG: 51	675	51	457	15.1	67.7	0.66
chr7	5898276	5899248	CpG: 120	972	120	715	24.7	73.6	0.93
chr7	5909378	5909970	CpG: 41	592	41	335	13.9	56.6	0.87
chr7	5911654	5911986	CpG: 32	332	32	243	19.3	73.2	0.72
chr7	5912689	5912940	CpG: 18	251	18	132	14.3	52.6	1.07
chr7	5925622	5925937	CpG: 23	315	23	191	14.6	60.6	0.80
chr7	5940958	5941196	CpG: 23	238	23	167	19.3	70.2	0.79
chr7	5944276	5944489	CpG: 17	213	17	126	16.0	59.2	0.93
chr7	5965110	5965724	CpG: 48	614	48	378	15.6	61.6	0.83
chr7	6016294	6016869	CpG: 62	575	62	403	21.6	70.1	0.90
chr7	6078433	6078638	CpG: 17	205	17	123	16.6	60.0	0.95
chr7	6088209	6088542	CpG: 36	333	36	243	21.6	73.0	0.81
chr7	6126530	6127491	CpG: 89	961	89	636	18.5	66.2	0.85
chr7	6176594	6177153	CpG: 66	559	66	402	23.6	71.9	0.93
chr7	6177403	6177653	CpG: 19	250	19	150	15.2	60.0	0.87
chr7	6178919	6179156	CpG: 20	237	20	147	16.9	62.0	0.90
chr7	6200512	6201082	CpG: 64	570	64	398	22.5	69.8	0.93
chr7	6201473	6201744	CpG: 21	271	21	169	15.5	62.4	0.80
chr7	6223516	6225062	CpG: 194	1546	194	1155	25.1	74.7	0.90
chr7	6242809	6243024	CpG: 15	215	15	129	14.0	60.0	0.78
chr7	6273158	6274423	CpG: 141	1265	141	908	22.3	71.8	0.87
chr7	6278240	6278476	CpG: 16	236	16	151	13.6	64.0	0.66
chr7	6283877	6284267	CpG: 29	390	29	258	14.9	66.2	0.68
chr7	6285141	6285427	CpG: 20	286	20	190	14.0	66.4	0.65
chr7	6289675	6290463	CpG: 65	788	65	517	16.5	65.6	0.78
chr7	6391082	6392286	CpG: 138	1204	138	881	22.9	73.2	0.88
chr7	6467354	6468860	CpG: 132	1506	132	947	17.5	62.9	0.88
chr7	6493579	6494489	CpG: 123	910	123	686	27.0	75.4	0.95
chr7	6521581	6521814	CpG: 17	233	17	146	14.6	62.7	0.76
chr7	6540715	6541162	CpG: 55	447	55	329	24.6	73.6	0.93
chr7	6566739	6567443	CpG: 71	704	71	466	20.2	66.2	0.93
chr7	6577680	6577963	CpG: 20	283	20	154	14.1	54.4	0.97
chr7	6602694	6603527	CpG: 106	833	106	632	25.5	75.9	0.88
chr7	6622623	6623206	CpG: 61	583	61	424	20.9	72.7	0.84
chr7	6623403	6623716	CpG: 23	313	23	212	14.7	67.7	0.79
chr7	6628144	6628387	CpG: 21	243	21	168	17.3	69.1	0.72
chr7	6645700	6646284	CpG: 78	584	78	441	26.7	75.5	0.94
chr7	6650089	6650753	CpG: 68	664	68	473	20.5	71.2	0.82
chr7	6655560	6656026	CpG: 40	466	40	338	17.2	72.5	0.65
chr7	6664067	6664309	CpG: 18	242	18	144	14.9	59.5	0.87
chr7	6670196	6670590	CpG: 47	394	47	298	23.9	75.6	0.85
chr7	6696453	6696812	CpG: 38	359	38	262	21.2	73.0	0.80
chr7	6708870	6709777	CpG: 117	907	117	679	25.8	74.9	0.92
chr7	6726437	6727509	CpG: 87	1072	87	749	16.2	69.9	0.67
chr7	6734296	6735411	CpG: 135	1115	135	870	24.2	78.0	0.80
chr7	6741430	6742250	CpG: 107	820	107	611	26.1	74.5	0.94
chr7	6756014	6757111	CpG: 153	1097	153	881	27.9	80.3	0.87
chr7	6771497	6774791	CpG: 405	3294	405	2368	24.6	71.9	0.95
chr7	6783056	6783628	CpG: 76	572	76	453	26.6	79.2	0.86
chr7	6825330	6826179	CpG: 98	849	98	613	23.1	72.2	0.90
chr7	6848134	6848398	CpG: 23	264	23	164	17.4	62.1	0.91
chr7	6848778	6849673	CpG: 78	895	78	616	17.4	68.8	0.74
chr7	6853353	6853635	CpG: 23	282	23	174	16.3	61.7	0.86
chr7	6873144	6873477	CpG: 37	333	37	244	22.2	73.3	0.83
chr7	6883042	6883247	CpG: 17	205	17	123	16.6	60.0	0.95
chr7	6890870	6891075	CpG: 16	205	16	121	15.6	59.0	0.91
chr7	6945065	6945649	CpG: 61	584	61	405	20.9	69.3	0.89
chr7	6973822	6975108	CpG: 120	1286	120	921	18.7	71.6	0.73
chr7	7054298	7054504	CpG: 16	206	16	135	15.5	65.5	0.73
chr7	7301595	7302549	CpG: 112	954	112	699	23.5	73.3	0.88
chr7	7346648	7346884	CpG: 22	236	22	147	18.6	62.3	0.98
chr7	7378403	7378688	CpG: 25	285	25	170	17.5	59.6	1.00
chr7	7426928	7427158	CpG: 21	230	21	142	18.3	61.7	0.97
chr7	7492913	7493178	CpG: 20	265	20	161	15.1	60.8	0.83
chr7	7584291	7584718	CpG: 33	427	33	259	15.5	60.7	0.84
chr7	7684562	7685213	CpG: 91	651	91	504	28.0	77.4	0.94
chr7	7758032	7758871	CpG: 69	839	69	511	16.4	60.9	0.90
chr7	7795499	7795773	CpG: 23	274	23	170	16.8	62.0	0.88
chr7	8007624	8007864	CpG: 19	240	19	146	15.8	60.8	0.87
chr7	8086982	8088386	CpG: 166	1404	166	1028	23.6	73.2	0.89
chr7	8174204	8174490	CpG: 23	286	23	176	16.1	61.5	0.86
chr7	8380003	8381224	CpG: 126	1221	126	873	20.6	71.5	0.81
chr7	8422304	8422615	CpG: 29	311	29	193	18.6	62.1	0.98
chr7	8527273	8527551	CpG: 27	278	27	176	19.4	63.3	0.98
chr7	8554600	8556660	CpG: 156	2060	156	1318	15.1	64.0	0.75
chr7	8563435	8564223	CpG: 71	788	71	491	18.0	62.3	0.94
chr7	8564593	8565172	CpG: 38	579	38	323	13.1	55.8	0.84
chr7	8582639	8582924	CpG: 24	285	24	179	16.8	62.8	0.87
chr7	8831525	8831815	CpG: 26	290	26	183	17.9	63.1	0.92
chr7	9010972	9011608	CpG: 52	636	52	430	16.4	67.6	0.72
chr7	9036100	9036375	CpG: 22	275	22	167	16.0	60.7	0.88
chr7	9098918	9099146	CpG: 18	228	18	141	15.8	61.8	0.84
chr7	9385188	9385472	CpG: 23	284	23	176	16.2	62.0	0.85
chr7	9402422	9402697	CpG: 20	275	20	166	14.5	60.4	0.82
chr7	9449498	9449779	CpG: 23	281	23	174	16.4	61.9	0.87
chr7	9531814	9532119	CpG: 25	305	25	185	16.4	60.7	0.90
chr7	9751829	9752211	CpG: 40	382	40	286	20.9	74.9	0.75
chr7	9847982	9848263	CpG: 25	281	25	174	17.8	61.9	0.94
chr7	9851599	9851830	CpG: 17	231	17	136	14.7	58.9	0.90
chr7	9856457	9857011	CpG: 57	554	57	399	20.6	72.0	0.79
chr7	10047722	10047958	CpG: 18	236	18	140	15.3	59.3	0.88
chr7	10190338	10190615	CpG: 25	277	25	177	18.1	63.9	0.90
chr7	10243761	10244031	CpG: 21	270	21	165	15.6	61.1	0.84
chr7	10448296	10448576	CpG: 21	280	21	168	15.0	60.0	0.84
chr7	10698890	10699170	CpG: 21	280	21	169	15.0	60.4	0.83
chr7	10741218	10741452	CpG: 18	234	18	135	15.4	57.7	0.93
chr7	10784471	10784737	CpG: 27	266	27	170	20.3	63.9	1.01
chr7	10910273	10910678	CpG: 31	405	31	267	15.3	65.9	0.73
chr7	11070954	11071242	CpG: 38	288	38	211	26.4	73.3	1.00
chr7	11104234	11104851	CpG: 54	617	54	389	17.5	63.0	0.88
chr7	11298359	11298621	CpG: 17	262	17	158	13.0	60.3	0.73
chr7	11320790	11321180	CpG: 30	390	30	230	15.4	59.0	0.89
chr7	11705457	11705725	CpG: 19	268	19	160	14.2	59.7	0.81
chr7	11908824	11909105	CpG: 24	281	24	171	17.1	60.9	0.93
chr7	11962679	11963116	CpG: 48	437	48	305	22.0	69.8	0.90
chr7	12115515	12115754	CpG: 21	239	21	147	17.6	61.5	0.95
chr7	12150017	12150299	CpG: 23	282	23	170	16.3	60.3	0.91
chr7	12242495	12242834	CpG: 33	339	33	237	19.5	69.9	0.80
chr7	12341981	12342523	CpG: 61	542	61	381	22.5	70.3	0.91
chr7	12534432	12534974	CpG: 45	542	45	353	16.6	65.1	0.80
chr7	12551817	12552091	CpG: 23	274	23	170	16.8	62.0	0.88
chr7	12628395	12628621	CpG: 18	226	18	135	15.9	59.7	0.89
chr7	12687232	12687767	CpG: 58	535	58	408	21.7	76.3	0.75
chr7	12701626	12702296	CpG: 64	670	64	441	19.1	65.8	0.88
chr7	12809136	12809368	CpG: 18	232	18	136	15.5	58.6	0.92
chr7	12817604	12818696	CpG: 119	1092	119	756	21.8	69.2	0.92
chr7	12842622	12842885	CpG: 26	263	26	175	19.8	66.5	0.92
chr7	12915632	12915906	CpG: 20	274	20	165	14.6	60.2	0.83
chr7	13025273	13025502	CpG: 19	229	19	138	16.6	60.3	0.93
chr7	13031764	13032168	CpG: 28	404	28	238	13.9	58.9	0.81
chr7	13103557	13103831	CpG: 23	274	23	170	16.8	62.0	0.88
chr7	13326181	13326394	CpG: 17	213	17	129	16.0	60.6	0.89
chr7	13582222	13582656	CpG: 34	434	34	255	15.7	58.8	0.91
chr7	13853428	13853671	CpG: 19	243	19	141	15.6	58.0	0.95
chr7	13867934	13868159	CpG: 17	225	17	136	15.1	60.4	0.84
chr7	13897641	13898005	CpG: 29	364	29	221	15.9	60.7	0.87
chr7	13918749	13918984	CpG: 21	235	21	143	17.9	60.9	0.99
chr7	13938257	13938634	CpG: 30	377	30	224	15.9	59.4	0.90
chr7	13951151	13951429	CpG: 24	278	24	176	17.3	63.3	0.87
chr7	13985030	13985297	CpG: 20	267	20	159	15.0	59.6	0.86
chr7	13994097	13994333	CpG: 20	236	20	147	16.9	62.3	0.90
chr7	13998184	13998407	CpG: 19	223	19	137	17.0	61.4	0.92
chr7	14121785	14122000	CpG: 18	215	18	132	16.7	61.4	0.89
chr7	14123372	14123620	CpG: 21	248	21	154	16.9	62.1	0.88
chr7	14134828	14135339	CpG: 37	511	37	288	14.5	56.4	0.92
chr7	14320422	14320696	CpG: 23	274	23	170	16.8	62.0	0.88
chr7	14409991	14410216	CpG: 19	225	19	133	16.9	59.1	0.97
chr7	14444277	14444674	CpG: 32	397	32	238	16.1	59.9	0.90
chr7	14523929	14524202	CpG: 22	273	22	170	16.1	62.3	0.84
chr7	14822257	14822493	CpG: 21	236	21	148	17.8	62.7	0.91
chr7	14829234	14829517	CpG: 24	283	24	177	17.0	62.5	0.88
chr7	14986603	14986879	CpG: 18	276	18	163	13.0	59.1	0.76
chr7	15210205	15210482	CpG: 21	277	21	168	15.2	60.6	0.83
chr7	15221347	15221933	CpG: 45	586	45	342	15.4	58.4	0.91
chr7	15277603	15277883	CpG: 25	280	25	176	17.9	62.9	0.91
chr7	15529688	15530027	CpG: 42	339	42	253	24.8	74.6	0.91
chr7	15625971	15626247	CpG: 25	276	25	175	18.1	63.4	0.91
chr7	15680685	15680994	CpG: 28	309	28	190	18.1	61.5	0.97
chr7	15742045	15742290	CpG: 22	245	22	144	18.0	58.8	1.07
chr7	15976835	15977071	CpG: 19	236	19	146	16.1	61.9	0.86
chr7	16073557	16073915	CpG: 24	358	24	204	13.4	57.0	0.83
chr7	16346214	16346641	CpG: 32	427	32	254	15.0	59.5	0.85
chr7	16457106	16457388	CpG: 23	282	23	174	16.3	61.7	0.87
chr7	16491681	16491936	CpG: 18	255	18	150	14.1	58.8	0.83
chr7	16550697	16551382	CpG: 81	685	81	520	23.6	75.9	0.82
chr7	16579720	16579944	CpG: 18	224	18	134	16.1	59.8	0.91
chr7	16656333	16656755	CpG: 35	422	35	257	16.6	60.9	0.90
chr7	16774313	16776438	CpG: 158	2125	158	1328	14.9	62.5	0.76
chr7	16883252	16884165	CpG: 91	913	91	620	19.9	67.9	0.89
chr7	16948002	16948271	CpG: 22	269	22	165	16.4	61.3	0.88
chr7	16980686	16981005	CpG: 26	319	26	219	16.3	68.7	0.69
chr7	17294923	17295197	CpG: 22	274	22	168	16.1	61.3	0.86
chr7	17298757	17298977	CpG: 18	220	18	135	16.4	61.4	0.89
chr7	17338278	17338525	CpG: 19	247	19	138	15.4	55.9	1.00
chr7	17401873	17402147	CpG: 25	274	25	171	18.2	62.4	0.95
chr7	17428168	17429220	CpG: 128	1052	128	768	24.3	73.0	0.92
chr7	17467248	17467527	CpG: 20	279	20	168	14.3	60.2	0.80
chr7	17467708	17467938	CpG: 21	230	21	141	18.3	61.3	0.98
chr7	17492205	17492438	CpG: 19	233	19	148	16.3	63.5	0.93
chr7	18069841	18070609	CpG: 82	768	82	514	21.4	66.9	0.95
chr7	18107153	18107371	CpG: 17	218	17	127	15.6	58.3	0.96
chr7	18130385	18130677	CpG: 25	292	25	178	17.1	61.0	0.93
chr7	18215969	18217063	CpG: 133	1094	133	778	24.3	71.1	0.98
chr7	18363033	18363311	CpG: 24	278	24	170	17.3	61.2	0.93
chr7	18607995	18608205	CpG: 16	210	16	127	15.2	60.5	0.84
chr7	18637090	18637329	CpG: 17	239	17	140	14.2	58.6	0.86
chr7	18875389	18875675	CpG: 20	286	20	175	14.0	61.2	0.76
chr7	18947037	18947307	CpG: 20	270	20	165	14.8	61.1	0.80
chr7	19018138	19018416	CpG: 21	278	21	168	15.1	60.4	0.84
chr7	19034633	19034867	CpG: 19	234	19	140	16.2	59.8	0.93
chr7	19230779	19231057	CpG: 24	278	24	174	17.3	62.6	0.89
chr7	19236194	19236578	CpG: 34	384	34	241	17.7	62.8	0.91
chr7	19237245	19237630	CpG: 26	385	26	204	13.5	53.0	0.96
chr7	19242280	19242661	CpG: 36	381	36	246	18.9	64.6	0.92
chr7	19246363	19248355	CpG: 201	1992	201	1388	20.2	69.7	0.83
chr7	19274534	19275346	CpG: 57	812	57	508	14.0	62.6	0.73
chr7	19324550	19324852	CpG: 24	302	24	181	15.9	59.9	0.89
chr7	19375426	19375810	CpG: 32	384	32	278	16.7	72.4	0.64
chr7	19641370	19641595	CpG: 18	225	18	134	16.0	59.6	0.93
chr7	19643904	19644142	CpG: 21	238	21	147	17.6	61.8	0.95
chr7	19821841	19822115	CpG: 24	274	24	171	17.5	62.4	0.91
chr7	19843244	19843708	CpG: 44	464	44	287	19.0	61.9	1.00
chr7	19881394	19881672	CpG: 25	278	25	174	18.0	62.6	0.93
chr7	19907378	19907814	CpG: 29	436	29	255	13.3	58.5	0.79
chr7	20057479	20057749	CpG: 20	270	20	164	14.8	60.7	0.81
chr7	20064170	20064377	CpG: 18	207	18	128	17.4	61.8	0.94
chr7	20179352	20179580	CpG: 19	228	19	138	16.7	60.5	0.93
chr7	20189010	20189292	CpG: 23	282	23	173	16.3	61.3	0.88
chr7	20465325	20466826	CpG: 138	1501	138	1009	18.4	67.2	0.82
chr7	20488574	20488858	CpG: 27	284	27	178	19.0	62.7	0.98
chr7	20672220	20672494	CpG: 21	274	21	168	15.3	61.3	0.82
chr7	20856657	20856922	CpG: 22	265	22	163	16.6	61.5	0.89
chr7	20905425	20905649	CpG: 17	224	17	133	15.2	59.4	0.90
chr7	20912641	20912943	CpG: 21	302	21	196	13.9	64.9	0.68
chr7	20913860	20914938	CpG: 97	1078	97	710	18.0	65.9	0.85
chr7	20919736	20922095	CpG: 232	2359	232	1623	19.7	68.8	0.84
chr7	20926999	20927289	CpG: 29	290	29	187	20.0	64.5	0.97
chr7	20933983	20934802	CpG: 105	819	105	647	25.6	79.0	0.83
chr7	20939381	20939615	CpG: 18	234	18	141	15.4	60.3	0.86
chr7	20971836	20972102	CpG: 23	266	23	166	17.3	62.4	0.91
chr7	20974984	20975224	CpG: 19	240	19	145	15.8	60.4	0.88
chr7	21080886	21081126	CpG: 19	240	19	148	15.8	61.7	0.87
chr7	21180047	21180329	CpG: 21	282	21	172	14.9	61.0	0.81
chr7	21536086	21536300	CpG: 15	214	15	125	14.0	58.4	0.84
chr7	21542606	21542879	CpG: 25	273	25	172	18.3	63.0	0.93
chr7	21563166	21564432	CpG: 125	1266	125	876	19.7	69.2	0.82
chr7	21597521	21597903	CpG: 31	382	31	275	16.2	72.0	0.63
chr7	21678970	21679840	CpG: 86	870	86	603	19.8	69.3	0.83
chr7	21863239	21863461	CpG: 16	222	16	131	14.4	59.0	0.84
chr7	22081741	22082512	CpG: 85	771	85	552	22.0	71.6	0.86
chr7	22167805	22168052	CpG: 22	247	22	142	17.8	57.5	1.13
chr7	22192171	22192449	CpG: 21	278	21	166	15.1	59.7	0.86
chr7	22219172	22219621	CpG: 39	449	39	308	17.4	68.6	0.75
chr7	22226836	22227088	CpG: 20	252	20	186	15.9	73.8	0.60
chr7	22409392	22409628	CpG: 19	236	19	144	16.1	61.0	0.89
chr7	22426580	22426854	CpG: 23	274	23	170	16.8	62.0	0.88
chr7	22492536	22493472	CpG: 117	936	117	714	25.0	76.3	0.87
chr7	22494611	22494872	CpG: 21	261	21	157	16.1	60.2	0.91
chr7	22635814	22636291	CpG: 46	477	46	324	19.3	67.9	0.85
chr7	22664318	22664523	CpG: 16	205	16	118	15.6	57.6	0.94
chr7	22801079	22801677	CpG: 48	598	48	418	16.1	69.9	0.68
chr7	22921204	22921453	CpG: 19	249	19	146	15.3	58.6	0.89
chr7	22936257	22937211	CpG: 74	954	74	683	15.5	71.6	0.61
chr7	22957108	22957438	CpG: 26	330	26	193	15.8	58.5	0.93
chr7	22958711	22958935	CpG: 25	224	25	140	22.3	62.5	1.14
chr7	22978317	22978571	CpG: 19	254	19	150	15.0	59.1	0.87
chr7	22990661	22991593	CpG: 87	932	87	626	18.7	67.2	0.83
chr7	23149895	23150927	CpG: 97	1032	97	724	18.8	70.2	0.77
chr7	23172297	23172724	CpG: 31	427	31	257	14.5	60.2	0.80
chr7	23242118	23242944	CpG: 78	826	78	537	18.9	65.0	0.89
chr7	23318311	23318885	CpG: 55	574	55	365	19.2	63.6	0.95
chr7	23342463	23343069	CpG: 73	606	73	439	24.1	72.4	0.92
chr7	23380112	23380385	CpG: 25	273	25	173	18.3	63.4	0.92
chr7	23384040	23384388	CpG: 40	348	40	244	23.0	70.1	0.94
chr7	23435618	23436085	CpG: 53	467	53	322	22.7	69.0	0.95
chr7	23551602	23552007	CpG: 40	405	40	265	19.8	65.4	1.03
chr7	23593192	23593424	CpG: 19	232	19	136	16.4	58.6	0.96
chr7	23604977	23606505	CpG: 153	1528	153	1103	20.0	72.2	0.77
chr7	23610330	23611208	CpG: 87	878	87	600	19.8	68.3	0.85
chr7	23626787	23627479	CpG: 55	692	55	447	15.9	64.6	0.78
chr7	23651847	23652087	CpG: 18	240	18	141	15.0	58.8	0.89
chr7	23670468	23671530	CpG: 89	1062	89	665	16.8	62.6	0.86
chr7	23725343	23725893	CpG: 44	550	44	340	16.0	61.8	0.85
chr7	23729210	23729446	CpG: 18	236	18	141	15.3	59.7	0.86
chr7	23736033	23736279	CpG: 17	246	17	148	13.8	60.2	0.78
chr7	23736474	23737296	CpG: 98	822	98	584	23.8	71.0	0.95
chr7	23794835	23795050	CpG: 20	215	20	132	18.6	61.4	1.00
chr7	23819283	23819670	CpG: 50	387	50	294	25.8	76.0	0.92
chr7	23820031	23820341	CpG: 28	310	28	201	18.1	64.8	0.89
chr7	24043677	24043888	CpG: 17	211	17	119	16.1	56.4	1.06
chr7	24044250	24044526	CpG: 29	276	29	206	21.0	74.6	0.75
chr7	24376523	24376766	CpG: 21	243	21	145	17.3	59.7	0.99
chr7	24377393	24377662	CpG: 21	269	21	160	15.6	59.5	0.89
chr7	24378788	24379078	CpG: 25	290	25	179	17.2	61.7	0.92
chr7	24421933	24423455	CpG: 122	1522	122	994	16.0	65.3	0.75
chr7	24446992	24447267	CpG: 23	275	23	171	16.7	62.2	0.87
chr7	24683711	24683992	CpG: 24	281	24	174	17.1	61.9	0.91
chr7	24711004	24712278	CpG: 171	1274	171	970	26.8	76.1	0.95
chr7	24776364	24776639	CpG: 24	275	24	172	17.5	62.5	0.90
chr7	24894929	24895875	CpG: 106	946	106	685	22.4	72.4	0.86
chr7	25035355	25035629	CpG: 25	274	25	172	18.2	62.8	0.94
chr7	25088457	25088691	CpG: 18	234	18	139	15.4	59.4	0.89
chr7	25117382	25118638	CpG: 134	1256	134	902	21.3	71.8	0.83
chr7	25119396	25119903	CpG: 43	507	43	309	17.0	60.9	0.92
chr7	25182698	25183086	CpG: 30	388	30	236	15.5	60.8	0.84
chr7	25228085	25228361	CpG: 19	276	19	159	13.8	57.6	0.83
chr7	25260199	25260887	CpG: 73	688	73	450	21.2	65.4	1.00
chr7	25315059	25315763	CpG: 71	704	71	508	20.2	72.2	0.78
chr7	25738605	25738847	CpG: 23	242	23	150	19.0	62.0	0.99
chr7	25879302	25879660	CpG: 29	358	29	210	16.2	58.7	0.94
chr7	25987780	25988439	CpG: 78	659	78	489	23.7	74.2	0.86
chr7	25992299	25992743	CpG: 40	444	40	275	18.0	61.9	0.99
chr7	25994055	25994591	CpG: 39	536	39	334	14.6	62.3	0.77
chr7	25997942	25998293	CpG: 31	351	31	233	17.7	66.4	0.80
chr7	26085858	26087166	CpG: 123	1308	123	923	18.8	70.6	0.76
chr7	26283078	26283314	CpG: 18	236	18	146	15.3	61.9	0.80
chr7	26283485	26284067	CpG: 58	582	58	471	19.9	80.9	0.61
chr7	26287641	26288703	CpG: 144	1062	144	808	27.1	76.1	0.94
chr7	26335476	26338120	CpG: 263	2644	263	1729	19.9	65.4	0.94
chr7	26387753	26388025	CpG: 20	272	20	167	14.7	61.4	0.78
chr7	26413285	26413523	CpG: 17	238	17	144	14.3	60.5	0.80
chr7	26413798	26414047	CpG: 21	249	21	155	16.9	62.2	0.91
chr7	26425928	26426202	CpG: 24	274	24	171	17.5	62.4	0.91
chr7	26427517	26427998	CpG: 63	481	63	357	26.2	74.2	0.96
chr7	26471471	26471733	CpG: 27	262	27	167	20.6	63.7	1.03
chr7	26474065	26474353	CpG: 19	288	19	160	13.2	55.6	0.86
chr7	26511812	26512957	CpG: 126	1145	126	798	22.0	69.7	0.91
chr7	26533793	26534781	CpG: 113	988	113	694	22.9	70.2	0.93
chr7	26645146	26645382	CpG: 16	236	16	138	13.6	58.5	0.81
chr7	26651636	26651910	CpG: 23	274	23	170	16.8	62.0	0.88
chr7	27000051	27000935	CpG: 64	884	64	539	14.5	61.0	0.78
chr7	27034377	27034601	CpG: 18	224	18	127	16.1	56.7	1.02
chr7	27115637	27115915	CpG: 25	278	25	175	18.0	62.9	0.92
chr7	27128264	27128591	CpG: 23	327	23	188	14.1	57.5	0.88
chr7	27223783	27224651	CpG: 77	868	77	553	17.7	63.7	0.88
chr7	27230380	27230586	CpG: 17	206	17	125	16.5	60.7	0.90
chr7	27231622	27233016	CpG: 116	1394	116	910	16.6	65.3	0.79
chr7	27239459	27239757	CpG: 24	298	24	186	16.1	62.4	0.83
chr7	27242347	27242878	CpG: 48	531	48	351	18.1	66.1	0.83
chr7	27243866	27244666	CpG: 67	800	67	545	16.8	68.1	0.73
chr7	27246176	27246695	CpG: 56	519	56	365	21.6	70.3	0.91
chr7	27249472	27250072	CpG: 60	600	60	439	20.0	73.2	0.75
chr7	27251365	27251792	CpG: 33	427	33	272	15.5	63.7	0.76
chr7	27258446	27258785	CpG: 24	339	24	205	14.2	60.5	0.79
chr7	27260178	27260457	CpG: 32	279	32	174	22.9	62.4	1.23
chr7	27265934	27267000	CpG: 119	1066	119	781	22.3	73.3	0.83
chr7	27275391	27275873	CpG: 47	482	47	337	19.5	69.9	0.82
chr7	27278970	27281909	CpG: 215	2939	215	1743	14.6	59.3	0.84
chr7	27283276	27284041	CpG: 69	765	69	482	18.0	63.0	0.91
chr7	27286646	27287487	CpG: 71	841	71	529	16.9	62.9	0.85
chr7	27290854	27291199	CpG: 38	345	38	223	22.0	64.6	1.05
chr7	27291973	27292939	CpG: 101	966	101	627	20.9	64.9	1.00
chr7	27294554	27294886	CpG: 28	332	28	213	16.9	64.2	0.82
chr7	27296033	27297332	CpG: 93	1299	93	813	14.3	62.6	0.73
chr7	27300291	27302846	CpG: 202	2555	202	1566	15.8	61.3	0.84
chr7	27305261	27306143	CpG: 76	882	76	602	17.2	68.3	0.74
chr7	27308806	27310786	CpG: 199	1980	199	1336	20.1	67.5	0.88
chr7	27315699	27316221	CpG: 45	522	45	300	17.2	57.5	1.04
chr7	27319978	27320985	CpG: 96	1007	96	626	19.1	62.2	0.99
chr7	27321439	27322018	CpG: 41	579	41	362	14.2	62.5	0.73
chr7	27323909	27325431	CpG: 97	1522	97	939	12.7	61.7	0.68
chr7	27328193	27329485	CpG: 114	1292	114	854	17.6	66.1	0.81
chr7	27335083	27336681	CpG: 188	1598	188	1151	23.5	72.0	0.91
chr7	27340908	27341675	CpG: 69	767	69	489	18.0	63.8	0.89
chr7	27349054	27350208	CpG: 84	1154	84	748	14.6	64.8	0.69
chr7	27356478	27356844	CpG: 43	366	43	272	23.5	74.3	0.85
chr7	27361535	27361870	CpG: 40	335	40	235	23.9	70.1	0.98
chr7	27371415	27371986	CpG: 55	571	55	404	19.3	70.8	0.77
chr7	27375308	27375832	CpG: 51	524	51	370	19.5	70.6	0.78
chr7	27378453	27379503	CpG: 86	1050	86	684	16.4	65.1	0.78
chr7	27379775	27379981	CpG: 17	206	17	128	16.5	62.1	0.86
chr7	27381006	27382604	CpG: 136	1598	136	1087	17.0	68.0	0.74
chr7	27387486	27388564	CpG: 89	1078	89	704	16.5	65.3	0.77
chr7	27553419	27553636	CpG: 19	217	19	134	17.5	61.8	0.94
chr7	27611128	27611358	CpG: 20	230	20	139	17.4	60.4	0.97
chr7	27779051	27779325	CpG: 23	274	23	169	16.8	61.7	0.89
chr7	27798979	27799610	CpG: 66	631	66	433	20.9	68.6	0.89
chr7	27799962	27800210	CpG: 18	248	18	148	14.5	59.7	0.82
chr7	27812511	27812747	CpG: 19	236	19	140	16.1	59.3	0.93
chr7	27876363	27877398	CpG: 88	1035	88	655	17.0	63.3	0.88
chr7	28113824	28114057	CpG: 17	233	17	136	14.6	58.4	0.87
chr7	28124910	28125341	CpG: 36	431	36	318	16.7	73.8	0.62
chr7	28316792	28318290	CpG: 197	1498	197	1191	26.3	79.5	0.83
chr7	28443932	28444207	CpG: 24	275	24	172	17.5	62.5	0.90
chr7	28546420	28547732	CpG: 132	1312	132	882	20.1	67.2	0.89
chr7	28698171	28698471	CpG: 66	300	66	216	44.0	72.0	1.98
chr7	28913539	28913814	CpG: 24	275	24	169	17.5	61.5	0.94
chr7	28975864	28976517	CpG: 57	653	57	451	17.5	69.1	0.73
chr7	28986303	28986532	CpG: 17	229	17	126	14.8	55.0	1.01
chr7	28991384	28991989	CpG: 53	605	53	417	17.5	68.9	0.74
chr7	29053796	29054023	CpG: 23	227	23	143	20.3	63.0	1.03
chr7	29086851	29087079	CpG: 19	228	19	143	16.7	62.7	0.87
chr7	29093138	29096448	CpG: 328	3310	328	2274	19.8	68.7	0.85
chr7	29206272	29206501	CpG: 20	229	20	142	17.5	62.0	0.93
chr7	29238882	29239102	CpG: 15	220	15	127	13.6	57.7	0.83
chr7	29283074	29283354	CpG: 25	280	25	175	17.9	62.5	0.93
chr7	29331898	29333240	CpG: 139	1342	139	960	20.7	71.5	0.81
chr7	29371708	29371974	CpG: 24	266	24	167	18.0	62.8	0.93
chr7	29401035	29402007	CpG: 75	972	75	686	15.4	70.6	0.62
chr7	29431739	29432013	CpG: 25	274	25	173	18.2	63.1	0.92
chr7	29575190	29575468	CpG: 23	278	23	174	16.5	62.6	0.86
chr7	29620747	29620983	CpG: 19	236	19	139	16.1	58.9	0.96
chr7	29700551	29700828	CpG: 25	277	25	174	18.1	62.8	0.92
chr7	29701212	29701494	CpG: 21	282	21	164	14.9	58.2	0.88
chr7	29701706	29702958	CpG: 105	1252	105	779	16.8	62.2	0.87
chr7	29703992	29704455	CpG: 42	463	42	318	18.1	68.7	0.77
chr7	29717741	29718073	CpG: 25	332	25	190	15.1	57.2	0.92
chr7	29787119	29787565	CpG: 33	446	33	301	14.8	67.5	0.69
chr7	29822395	29823643	CpG: 160	1248	160	922	25.6	73.9	0.94
chr7	29944048	29944918	CpG: 112	870	112	666	25.7	76.6	0.88
chr7	30021660	30022430	CpG: 53	770	53	534	13.8	69.4	0.66
chr7	30124450	30124724	CpG: 21	274	21	168	15.3	61.3	0.83
chr7	30126342	30127911	CpG: 165	1569	165	1081	21.0	68.9	0.89
chr7	30153387	30153623	CpG: 20	236	20	144	16.9	61.0	0.94
chr7	30164485	30164751	CpG: 19	266	19	155	14.3	58.3	0.85
chr7	30165828	30166666	CpG: 100	838	100	605	23.9	72.2	0.92
chr7	30272265	30274206	CpG: 224	1941	224	1396	23.1	71.9	0.89
chr7	30421994	30423718	CpG: 242	1724	242	1312	28.1	76.1	0.97
chr7	30557753	30558063	CpG: 23	310	23	188	14.8	60.6	0.81
chr7	30576960	30577387	CpG: 33	427	33	256	15.5	60.0	0.86
chr7	30616055	30616694	CpG: 70	639	70	447	21.9	70.0	0.90
chr7	30633697	30633963	CpG: 23	266	23	167	17.3	62.8	0.89
chr7	30641996	30643086	CpG: 80	1090	80	708	14.7	65.0	0.70
chr7	30728169	30728454	CpG: 25	285	25	179	17.5	62.8	0.90
chr7	30732099	30733047	CpG: 91	948	91	616	19.2	65.0	0.94
chr7	30779990	30780417	CpG: 35	427	35	260	16.4	60.9	0.89
chr7	30819340	30820413	CpG: 112	1073	112	764	20.9	71.2	0.82
chr7	30884147	30884425	CpG: 22	278	22	171	15.8	61.5	0.85
chr7	30908884	30909583	CpG: 66	699	66	492	18.9	70.4	0.76
chr7	30957568	30957842	CpG: 22	274	22	169	16.1	61.7	0.85
chr7	30995142	30995393	CpG: 24	251	24	160	19.1	63.7	0.96
chr7	31131943	31132168	CpG: 22	225	22	167	19.6	74.2	0.72
chr7	31168617	31168905	CpG: 24	288	24	179	16.7	62.2	0.88
chr7	31189749	31191110	CpG: 150	1361	150	995	22.0	73.1	0.83
chr7	31330742	31330965	CpG: 22	223	22	156	19.7	70.0	0.81
chr7	31473915	31474612	CpG: 69	697	69	507	19.8	72.7	0.75
chr7	31655246	31655557	CpG: 31	311	31	226	19.9	72.7	0.76
chr7	31736191	31736427	CpG: 17	236	17	142	14.4	60.2	0.81
chr7	32209387	32210234	CpG: 84	847	84	572	19.8	67.5	0.87
chr7	32236891	32237169	CpG: 26	278	26	177	18.7	63.7	0.93
chr7	32325007	32325288	CpG: 24	281	24	175	17.1	62.3	0.90
chr7	32437862	32438615	CpG: 83	753	83	531	22.0	70.5	0.89
chr7	32480689	32480955	CpG: 24	266	24	167	18.0	62.8	0.93
chr7	32516217	32516457	CpG: 19	240	19	150	15.8	62.5	0.84
chr7	32567097	32567611	CpG: 57	514	57	370	22.2	72.0	0.86
chr7	32603859	32604110	CpG: 23	251	23	152	18.3	60.6	1.00
chr7	32629315	32629708	CpG: 34	393	34	234	17.3	59.5	0.98
chr7	32634386	32635093	CpG: 71	707	71	516	20.1	73.0	0.78
chr7	32740026	32740302	CpG: 23	276	23	170	16.7	61.6	0.89
chr7	32828026	32828336	CpG: 22	310	22	182	14.2	58.7	0.83
chr7	32867543	32868829	CpG: 167	1286	167	954	26.0	74.2	0.94
chr7	32890389	32890670	CpG: 24	281	24	172	17.1	61.2	0.93
chr7	32901464	32901952	CpG: 40	488	40	340	16.4	69.7	0.75
chr7	33030715	33031963	CpG: 188	1248	188	970	30.1	77.7	1.01
chr7	33045441	33045719	CpG: 25	278	25	174	18.0	62.6	0.92
chr7	33081928	33082855	CpG: 103	927	103	678	22.2	73.1	0.84
chr7	33096714	33097573	CpG: 104	859	104	633	24.2	73.7	0.90
chr7	33098720	33098953	CpG: 21	233	21	142	18.0	60.9	1.00
chr7	33136416	33136697	CpG: 20	281	20	171	14.2	60.9	0.79
chr7	33201927	33202896	CpG: 102	969	102	664	21.1	68.5	0.90
chr7	33248567	33249277	CpG: 103	710	103	552	29.0	77.7	0.97
chr7	33268621	33269190	CpG: 48	569	48	377	16.9	66.3	0.77
chr7	33283458	33283736	CpG: 24	278	24	174	17.3	62.6	0.89
chr7	33358890	33359280	CpG: 35	390	35	288	17.9	73.8	0.66
chr7	33503887	33504161	CpG: 25	274	25	172	18.2	62.8	0.94
chr7	33572059	33572274	CpG: 16	215	16	120	14.9	55.8	0.99
chr7	33667242	33667534	CpG: 25	292	25	180	17.1	61.6	0.90
chr7	34043794	34045640	CpG: 160	1846	160	1239	17.3	67.1	0.77
chr7	34053772	34054000	CpG: 17	228	17	136	14.9	59.6	0.85
chr7	34218703	34218999	CpG: 28	296	28	185	18.9	62.5	0.98
chr7	34301078	34301344	CpG: 20	266	20	163	15.0	61.3	0.81
chr7	34345811	34346013	CpG: 18	202	18	119	17.8	58.9	1.03
chr7	34590617	34590853	CpG: 17	236	17	142	14.4	60.2	0.81
chr7	34626870	34627073	CpG: 18	203	18	125	17.7	61.6	0.96
chr7	34842879	34843131	CpG: 22	252	22	157	17.5	62.3	0.91
chr7	34950158	34950388	CpG: 18	230	18	139	15.7	60.4	0.87
chr7	35047052	35047294	CpG: 22	242	22	148	18.2	61.2	0.97
chr7	35177197	35178869	CpG: 213	1672	213	1206	25.5	72.1	0.99
chr7	35265501	35265710	CpG: 15	209	15	120	14.4	57.4	0.89
chr7	35326823	35328040	CpG: 99	1217	99	767	16.3	63.0	0.83
chr7	35394451	35396140	CpG: 139	1689	139	1079	16.5	63.9	0.81
chr7	35398387	35399684	CpG: 111	1297	111	840	17.1	64.8	0.81
chr7	35400101	35400322	CpG: 19	221	19	139	17.2	62.9	0.87
chr7	35402359	35403197	CpG: 63	838	63	534	15.0	63.7	0.74
chr7	35436926	35437198	CpG: 21	272	21	168	15.4	61.8	0.82
chr7	35451668	35451942	CpG: 21	274	21	166	15.3	60.6	0.84
chr7	35453673	35453951	CpG: 25	278	25	174	18.0	62.6	0.93
chr7	35595579	35596068	CpG: 47	489	47	328	19.2	67.1	0.88
chr7	35616248	35616459	CpG: 15	211	15	127	14.2	60.2	0.81
chr7	35678274	35678633	CpG: 34	359	34	241	18.9	67.1	0.87
chr7	35827320	35827692	CpG: 26	372	26	206	14.0	55.4	0.91
chr7	35835368	35836353	CpG: 102	985	102	697	20.7	70.8	0.83
chr7	35909506	35909780	CpG: 23	274	23	186	16.8	67.9	0.73
chr7	35941523	35942983	CpG: 145	1460	145	988	19.9	67.7	0.88
chr7	36108371	36109514	CpG: 89	1143	89	781	15.6	68.3	0.67
chr7	36112356	36112766	CpG: 50	410	50	312	24.4	76.1	0.85
chr7	36123678	36123935	CpG: 23	257	23	187	17.9	72.8	0.68
chr7	36293719	36294805	CpG: 120	1086	120	790	22.1	72.7	0.84
chr7	36337544	36338355	CpG: 66	811	66	572	16.3	70.5	0.65
chr7	36353577	36353843	CpG: 22	266	22	164	16.5	61.7	0.88
chr7	36377448	36377777	CpG: 40	329	40	236	24.3	71.7	0.95
chr7	36508024	36508669	CpG: 87	645	87	479	27.0	74.3	0.98
chr7	36530909	36531465	CpG: 59	556	59	382	21.2	68.7	0.90
chr7	36576090	36576364	CpG: 24	274	24	171	17.5	62.4	0.91
chr7	37114082	37114465	CpG: 32	383	32	273	16.7	71.3	0.66
chr7	37432526	37433872	CpG: 109	1346	109	984	16.2	73.1	0.61
chr7	37524591	37524831	CpG: 19	240	19	145	15.8	60.4	0.89
chr7	37588102	37589497	CpG: 150	1395	150	976	21.5	70.0	0.94
chr7	37610061	37610372	CpG: 27	311	27	188	17.4	60.5	0.96
chr7	37632392	37632666	CpG: 26	274	26	199	19.0	72.6	0.72
chr7	37758179	37758421	CpG: 19	242	19	143	15.7	59.1	0.90
chr7	37787989	37788211	CpG: 17	222	17	131	15.3	59.0	0.89
chr7	37871996	37872217	CpG: 18	221	18	130	16.3	58.8	0.96
chr7	37937573	37937846	CpG: 22	273	22	172	16.1	63.0	0.82
chr7	38057055	38057988	CpG: 91	933	91	631	19.5	67.6	0.86
chr7	38061749	38062479	CpG: 70	730	70	519	19.2	71.1	0.76
chr7	38318879	38319347	CpG: 46	468	46	306	19.7	65.4	0.92
chr7	38382994	38383273	CpG: 22	279	22	171	15.8	61.3	0.85
chr7	38468245	38468654	CpG: 38	409	38	292	18.6	71.4	0.76
chr7	38590310	38590584	CpG: 24	274	24	171	17.5	62.4	0.91
chr7	38595486	38595756	CpG: 23	270	23	166	17.0	61.5	0.91
chr7	38787492	38788214	CpG: 98	722	98	554	27.1	76.7	0.93
chr7	38876821	38877102	CpG: 24	281	24	174	17.1	61.9	0.91
chr7	39132965	39133351	CpG: 36	386	36	273	18.7	70.7	0.75
chr7	39170219	39170531	CpG: 24	312	24	181	15.4	58.0	0.92
chr7	39571523	39572299	CpG: 58	776	58	472	14.9	60.8	0.81
chr7	39710030	39710304	CpG: 22	274	22	169	16.1	61.7	0.85
chr7	39723718	39724318	CpG: 55	600	55	371	18.3	61.8	0.96
chr7	39760765	39760990	CpG: 17	225	17	132	15.1	58.7	0.89
chr7	39767209	39767466	CpG: 32	257	32	193	24.9	75.1	0.91
chr7	39780502	39781751	CpG: 127	1249	127	891	20.3	71.3	0.81
chr7	39890804	39891217	CpG: 36	413	36	271	17.4	65.6	0.81
chr7	39911645	39912027	CpG: 30	382	30	274	15.7	71.7	0.61
chr7	39951447	39951678	CpG: 17	231	17	161	14.7	69.7	0.62
chr7	39966040	39966318	CpG: 26	278	26	177	18.7	63.7	0.93
chr7	39987379	39987631	CpG: 19	252	19	153	15.1	60.7	0.85
chr7	39988022	39988296	CpG: 24	274	24	172	17.5	62.8	0.90
chr7	39990769	39991106	CpG: 60	337	60	274	35.6	81.3	1.20
chr7	40106823	40109513	CpG: 290	2690	290	1915	21.6	71.2	0.85
chr7	40291739	40292876	CpG: 109	1137	109	766	19.2	67.4	0.84
chr7	40721871	40722166	CpG: 22	295	22	175	14.9	59.3	0.86
chr7	41056155	41056611	CpG: 32	456	32	255	14.0	55.9	0.91
chr7	41516280	41516565	CpG: 25	285	25	178	17.5	62.5	0.91
chr7	41863965	41864249	CpG: 26	284	26	188	18.3	66.2	0.84
chr7	41959321	41959593	CpG: 20	272	20	163	14.7	59.9	0.84
chr7	42123818	42124872	CpG: 105	1054	105	727	19.9	69.0	0.85
chr7	42386251	42386528	CpG: 37	277	37	189	26.7	68.2	1.16
chr7	42394709	42396556	CpG: 219	1847	219	1322	23.7	71.6	0.94
chr7	42651852	42652059	CpG: 19	207	19	139	18.4	67.1	0.83
chr7	42765818	42766092	CpG: 24	274	24	171	17.5	62.4	0.91
chr7	42864395	42864672	CpG: 24	277	24	172	17.3	62.1	0.91
chr7	43015430	43015676	CpG: 18	246	18	148	14.6	60.2	0.84
chr7	43046258	43046736	CpG: 41	478	41	288	17.2	60.3	0.95
chr7	43069761	43070450	CpG: 87	689	87	525	25.3	76.2	0.88
chr7	43090165	43090830	CpG: 50	665	50	393	15.0	59.1	0.86
chr7	43217286	43217637	CpG: 25	351	25	205	14.2	58.4	0.84
chr7	43270601	43271922	CpG: 125	1321	125	918	18.9	69.5	0.78
chr7	43407197	43407511	CpG: 24	314	24	200	15.3	63.7	0.76
chr7	43477387	43477673	CpG: 26	286	26	181	18.2	63.3	0.93
chr7	43574708	43574934	CpG: 20	226	20	134	17.7	59.3	1.01
chr7	43590190	43590464	CpG: 23	274	23	170	16.8	62.0	0.88
chr7	43602819	43603552	CpG: 68	733	68	500	18.6	68.2	0.80
chr7	43740870	43741831	CpG: 123	961	123	710	25.6	73.9	0.95
chr7	43811140	43811370	CpG: 17	230	17	137	14.8	59.6	0.84
chr7	43844399	43844665	CpG: 27	266	27	170	20.3	63.9	1.01
chr7	43887329	43887995	CpG: 64	666	64	410	19.2	61.6	1.01
chr7	43903172	43903411	CpG: 19	239	19	143	15.9	59.8	0.90
chr7	43916494	43917511	CpG: 110	1017	110	736	21.6	72.4	0.83
chr7	43997609	43997846	CpG: 17	237	17	141	14.3	59.5	0.83
chr7	44027246	44028170	CpG: 85	924	85	633	18.4	68.5	0.79
chr7	44064279	44065153	CpG: 114	874	114	675	26.1	77.2	0.88
chr7	44084507	44085101	CpG: 74	594	74	429	24.9	72.2	0.96
chr7	44177193	44177772	CpG: 58	579	58	376	20.0	64.9	0.96
chr7	44197779	44198026	CpG: 20	247	20	167	16.2	67.6	0.72
chr7	44198492	44199343	CpG: 82	851	82	612	19.3	71.9	0.75
chr7	44203002	44203783	CpG: 71	781	71	543	18.2	69.5	0.76
chr7	44223644	44224014	CpG: 27	370	27	234	14.6	63.2	0.74
chr7	44240729	44241582	CpG: 98	853	98	598	23.0	70.1	0.97
chr7	44262650	44263438	CpG: 83	788	83	596	21.1	75.6	0.79
chr7	44271156	44271434	CpG: 24	278	24	190	17.3	68.3	0.75
chr7	44272089	44272433	CpG: 31	344	31	219	18.0	63.7	0.90
chr7	44281784	44282654	CpG: 95	870	95	612	21.8	70.3	0.89
chr7	44303726	44305139	CpG: 129	1413	129	976	18.3	69.1	0.78
chr7	44359406	44360044	CpG: 57	638	57	446	17.9	69.9	0.77
chr7	44378658	44378912	CpG: 25	254	25	171	19.7	67.3	0.88
chr7	44397947	44398226	CpG: 23	279	23	202	16.5	72.4	0.68
chr7	44468931	44469536	CpG: 65	605	65	428	21.5	70.7	0.86
chr7	44484252	44485391	CpG: 175	1139	175	906	30.7	79.5	0.98
chr7	44586275	44586549	CpG: 21	274	21	168	15.3	61.3	0.82
chr7	44615552	44615783	CpG: 20	231	20	142	17.3	61.5	0.93
chr7	44650077	44650693	CpG: 60	616	60	412	19.5	66.9	0.87
chr7	44733376	44734039	CpG: 68	663	68	435	20.5	65.6	0.96
chr7	44741450	44742534	CpG: 97	1084	97	713	17.9	65.8	0.83
chr7	44753018	44753254	CpG: 22	236	22	144	18.6	61.0	1.02
chr7	44765927	44766152	CpG: 18	225	18	134	16.0	59.6	0.93
chr7	44766617	44767375	CpG: 97	758	97	542	25.6	71.5	1.05
chr7	44865233	44865507	CpG: 22	274	22	170	16.1	62.0	0.84
chr7	44908851	44910063	CpG: 143	1212	143	928	23.6	76.6	0.81
chr7	44922275	44922627	CpG: 31	352	31	248	17.6	70.5	0.72
chr7	44955922	44956263	CpG: 26	341	26	199	15.2	58.4	0.92
chr7	44956678	44957750	CpG: 151	1072	151	774	28.2	72.2	1.08
chr7	44970081	44970323	CpG: 20	242	20	149	16.5	61.6	0.89
chr7	45008154	45009255	CpG: 117	1101	117	724	21.3	65.8	0.99
chr7	45013623	45013859	CpG: 18	236	18	142	15.3	60.2	0.86
chr7	45014328	45014605	CpG: 20	277	20	167	14.4	60.3	0.81
chr7	45031283	45032567	CpG: 101	1284	101	926	15.7	72.1	0.60
chr7	45044857	45046267	CpG: 188	1410	188	988	26.7	70.1	1.11
chr7	45076579	45076854	CpG: 23	275	23	171	16.7	62.2	0.88
chr7	45122858	45123679	CpG: 81	821	81	601	19.7	73.2	0.74
chr7	45146724	45147392	CpG: 63	668	63	430	18.9	64.4	0.91
chr7	45152884	45153280	CpG: 38	396	38	302	19.2	76.3	0.66
chr7	45160147	45161233	CpG: 126	1086	126	814	23.2	75.0	0.85
chr7	45249189	45249990	CpG: 75	801	75	585	18.7	73.0	0.70
chr7	45250999	45251276	CpG: 21	277	21	170	15.2	61.4	0.82
chr7	45272191	45272758	CpG: 56	567	56	367	19.8	64.7	0.96
chr7	45318359	45318985	CpG: 59	626	59	467	18.8	74.6	0.68
chr7	45512744	45513018	CpG: 25	274	25	172	18.2	62.8	0.94
chr7	45734496	45736614	CpG: 231	2118	231	1500	21.8	70.8	0.87
chr7	45803380	45803665	CpG: 24	285	24	178	16.8	62.5	0.88
chr7	45888652	45889041	CpG: 33	389	33	278	17.0	71.5	0.66
chr7	45897987	45898267	CpG: 22	280	22	170	15.7	60.7	0.86
chr7	45930331	45930893	CpG: 64	562	64	388	22.8	69.0	0.96
chr7	46050122	46050782	CpG: 74	660	74	476	22.4	72.1	0.88
chr7	46082252	46083462	CpG: 143	1210	143	872	23.6	72.1	0.91
chr7	46114830	46115094	CpG: 19	264	19	156	14.4	59.1	0.84
chr7	46345163	46345428	CpG: 19	265	19	158	14.3	59.6	0.82
chr7	46488320	46488605	CpG: 26	285	26	180	18.2	63.2	0.93
chr7	46961808	46962058	CpG: 20	250	20	151	16.0	60.4	0.89
chr7	46997962	46998197	CpG: 16	235	16	139	13.6	59.1	0.80
chr7	47087856	47088130	CpG: 24	274	24	170	17.5	62.0	0.92
chr7	47214095	47214928	CpG: 88	833	88	562	21.1	67.5	0.94
chr7	47218935	47219154	CpG: 20	219	20	135	18.3	61.6	0.99
chr7	47271059	47271333	CpG: 25	274	25	171	18.2	62.4	0.95
chr7	47415489	47415987	CpG: 58	498	58	375	23.3	75.3	0.83
chr7	47673431	47673693	CpG: 25	262	25	165	19.1	63.0	0.97
chr7	47686742	47687023	CpG: 25	281	25	176	17.8	62.6	0.92
chr7	47698968	47699869	CpG: 95	901	95	625	21.1	69.4	0.88
chr7	47743774	47744593	CpG: 101	819	101	615	24.7	75.1	0.92
chr7	47755230	47755458	CpG: 18	228	18	134	15.8	58.8	0.93
chr7	47790738	47791129	CpG: 33	391	33	283	16.9	72.4	0.65
chr7	47793098	47793373	CpG: 24	275	24	171	17.5	62.2	0.91
chr7	47818608	47818882	CpG: 21	274	21	167	15.3	60.9	0.84
chr7	47857472	47857738	CpG: 23	266	23	165	17.3	62.0	0.91
chr7	48084461	48084960	CpG: 42	499	42	345	16.8	69.1	0.72
chr7	48121186	48122093	CpG: 69	907	69	629	15.2	69.3	0.63
chr7	48141465	48142039	CpG: 59	574	59	397	20.6	69.2	0.88
chr7	48143898	48144128	CpG: 20	230	20	139	17.4	60.4	0.97
chr7	48164428	48164701	CpG: 23	273	23	169	16.8	61.9	0.89
chr7	48197483	48198630	CpG: 104	1147	104	774	18.1	67.5	0.80
chr7	48217160	48217422	CpG: 21	262	21	158	16.0	60.3	0.90
chr7	48250683	48252598	CpG: 156	1915	156	1241	16.3	64.8	0.78
chr7	48334726	48335003	CpG: 24	277	24	172	17.3	62.1	0.91
chr7	48365611	48366004	CpG: 45	393	45	295	22.9	75.1	0.82
chr7	48457165	48457451	CpG: 23	286	23	178	16.1	62.2	0.85
chr7	48588481	48588759	CpG: 22	278	22	172	15.8	61.9	0.83
chr7	48617483	48617875	CpG: 37	392	37	268	18.9	68.4	0.82
chr7	48989261	48989538	CpG: 23	277	23	172	16.6	62.1	0.87
chr7	49008868	49009250	CpG: 48	382	48	282	25.1	73.8	0.92
chr7	49085242	49085622	CpG: 50	380	50	278	26.3	73.2	0.99
chr7	49178897	49179171	CpG: 24	274	24	171	17.5	62.4	0.91
chr7	49189463	49189737	CpG: 25	274	25	172	18.2	62.8	0.94
chr7	49300140	49300402	CpG: 23	262	23	162	17.6	61.8	0.93
chr7	49523561	49523825	CpG: 22	264	22	163	16.7	61.7	0.88
chr7	49615766	49616095	CpG: 26	329	26	199	15.8	60.5	0.88
chr7	49673530	49673807	CpG: 23	277	23	167	16.6	60.3	0.92
chr7	49846886	49847312	CpG: 33	426	33	256	15.5	60.1	0.86
chr7	49934469	49937213	CpG: 291	2744	291	1932	21.2	70.4	0.86
chr7	50053139	50053415	CpG: 22	276	22	169	15.9	61.2	0.86
chr7	50057983	50058268	CpG: 23	285	23	177	16.1	62.1	0.85
chr7	50138009	50138253	CpG: 19	244	19	151	15.6	61.9	0.82
chr7	50254140	50254489	CpG: 42	349	42	245	24.1	70.2	0.98
chr7	50320378	50320593	CpG: 24	215	24	159	22.3	74.0	0.82
chr7	50464510	50466134	CpG: 213	1624	213	1189	26.2	73.2	0.99
chr7	50561085	50561919	CpG: 79	834	79	545	18.9	65.3	0.90
chr7	50611144	50612186	CpG: 94	1042	94	689	18.0	66.1	0.83
chr7	50629258	50629471	CpG: 20	213	20	139	18.8	65.3	0.88
chr7	50943232	50944351	CpG: 132	1119	132	803	23.6	71.8	0.92
chr7	50953734	50955151	CpG: 197	1417	197	1068	27.8	75.4	0.99
chr7	51060258	51060568	CpG: 24	310	24	184	15.5	59.4	0.88
chr7	51364441	51364671	CpG: 20	230	20	141	17.4	61.3	0.94
chr7	51476873	51478807	CpG: 195	1934	195	1352	20.2	69.9	0.83
chr7	51547837	51548068	CpG: 17	231	17	162	14.7	70.1	0.61
chr7	51550107	51550400	CpG: 23	293	23	208	15.7	71.0	0.68
chr7	51639830	51640067	CpG: 20	237	20	143	16.9	60.3	0.94
chr7	51785597	51785879	CpG: 22	282	22	174	15.6	61.7	0.84
chr7	51808178	51808463	CpG: 24	285	24	179	16.8	62.8	0.87
chr7	51967198	51967586	CpG: 36	388	36	292	18.6	75.3	0.66
chr7	51967964	51968177	CpG: 15	213	15	119	14.1	55.9	0.93
chr7	52035301	52035525	CpG: 19	224	19	137	17.0	61.2	0.92
chr7	52062289	52062690	CpG: 35	401	35	290	17.5	72.3	0.67
chr7	52367937	52368222	CpG: 22	285	22	176	15.4	61.8	0.83
chr7	52416797	52417074	CpG: 25	277	25	172	18.1	62.1	0.94
chr7	52434631	52435429	CpG: 59	798	59	550	14.8	68.9	0.62
chr7	52462814	52463030	CpG: 17	216	17	121	15.7	56.0	1.03
chr7	52896456	52896730	CpG: 24	274	24	170	17.5	62.0	0.92
chr7	52901894	52902168	CpG: 24	274	24	171	17.5	62.4	0.91
chr7	53193739	53194043	CpG: 23	304	23	185	15.1	60.9	0.82
chr7	53290247	53290521	CpG: 22	274	22	169	16.1	61.7	0.86
chr7	53349164	53349386	CpG: 20	222	20	138	18.0	62.2	0.93
chr7	53381002	53381343	CpG: 32	341	32	225	18.8	66.0	0.87
chr7	53576421	53576694	CpG: 25	273	25	169	18.3	61.9	0.96
chr7	53656725	53657114	CpG: 35	389	35	284	18.0	73.0	0.68
chr7	54235852	54236130	CpG: 21	278	21	170	15.1	61.2	0.82
chr7	54702014	54702420	CpG: 47	406	47	274	23.2	67.5	1.02
chr7	54704604	54704838	CpG: 29	234	29	171	24.8	73.1	0.94
chr7	54706334	54707078	CpG: 88	744	88	559	23.7	75.1	0.84
chr7	54784379	54784610	CpG: 17	231	17	138	14.7	59.7	0.84
chr7	54824018	54824718	CpG: 59	700	59	473	16.9	67.6	0.74
chr7	54827555	54828547	CpG: 82	992	82	720	16.5	72.6	0.63
chr7	54857658	54857869	CpG: 24	211	24	153	22.7	72.5	0.87
chr7	54918814	54919421	CpG: 63	607	63	414	20.8	68.2	0.90
chr7	54992966	54994377	CpG: 96	1411	96	866	13.6	61.4	0.72
chr7	55048506	55048832	CpG: 23	326	23	203	14.1	62.3	0.73
chr7	55093105	55093364	CpG: 28	259	28	197	21.6	76.1	0.93
chr7	55164494	55164850	CpG: 31	356	31	254	17.4	71.3	0.69
chr7	55165189	55165660	CpG: 35	471	35	316	14.9	67.1	0.67
chr7	55178368	55180332	CpG: 225	1964	225	1422	22.9	72.4	0.88
chr7	55411457	55411731	CpG: 23	274	23	171	16.8	62.4	0.87
chr7	55415038	55416429	CpG: 120	1391	120	954	17.3	68.6	0.74
chr7	55471947	55472800	CpG: 64	853	64	597	15.0	70.0	0.61
chr7	55503470	55503766	CpG: 20	296	20	193	13.5	65.2	0.64
chr7	55503880	55505625	CpG: 143	1745	143	1169	16.4	67.0	0.74
chr7	55525784	55526908	CpG: 146	1124	146	808	26.0	71.9	1.01
chr7	55551379	55551647	CpG: 22	268	22	166	16.4	61.9	0.87
chr7	55562439	55563661	CpG: 102	1222	102	896	16.7	73.3	0.62
chr7	55609492	55609870	CpG: 47	378	47	289	24.9	76.5	0.85
chr7	55685481	55685780	CpG: 21	299	21	174	14.0	58.2	0.85
chr7	55731866	55733188	CpG: 163	1322	163	988	24.7	74.7	0.89
chr7	55891061	55891440	CpG: 26	379	26	227	13.7	59.9	0.77
chr7	55901276	55901565	CpG: 20	289	20	198	13.8	68.5	0.60
chr7	55910261	55910535	CpG: 23	274	23	174	16.8	63.5	0.85
chr7	55925354	55925632	CpG: 25	278	25	175	18.0	62.9	0.92
chr7	55990127	55990389	CpG: 21	262	21	161	16.0	61.5	0.86
chr7	56008863	56009090	CpG: 16	227	16	135	14.1	59.5	0.81
chr7	56017849	56018121	CpG: 25	272	25	174	18.4	64.0	0.91
chr7	56026538	56026777	CpG: 21	239	21	144	17.6	60.3	0.99
chr7	56047491	56048130	CpG: 85	639	85	475	26.6	74.3	0.98
chr7	56092388	56092669	CpG: 24	281	24	175	17.1	62.3	0.90
chr7	56111467	56112800	CpG: 98	1333	98	802	14.7	60.2	0.83
chr7	56124141	56124998	CpG: 113	857	113	669	26.4	78.1	0.87
chr7	56183818	56184043	CpG: 19	225	19	135	16.9	60.0	0.97
chr7	56194370	56194645	CpG: 22	275	22	166	16.0	60.4	0.89
chr7	56211186	56212104	CpG: 105	918	105	644	22.9	70.2	0.93
chr7	56223909	56225083	CpG: 88	1174	88	699	15.0	59.5	0.86
chr7	56266034	56266520	CpG: 49	486	49	312	20.2	64.2	0.98
chr7	56275747	56276335	CpG: 63	588	63	416	21.4	70.7	0.86
chr7	56331938	56332832	CpG: 97	894	97	666	21.7	74.5	0.81
chr7	56367287	56367552	CpG: 21	265	21	160	15.8	60.4	0.88
chr7	56388340	56388570	CpG: 25	230	25	163	21.7	70.9	0.89
chr7	56405020	56405301	CpG: 24	281	24	174	17.1	61.9	0.91
chr7	56444593	56444867	CpG: 24	274	24	170	17.5	62.0	0.92
chr7	56446373	56446690	CpG: 49	317	49	237	30.9	74.8	1.11
chr7	56453682	56453942	CpG: 20	260	20	157	15.4	60.4	0.85
chr7	56526427	56526630	CpG: 15	203	15	144	14.8	70.9	0.64
chr7	56527137	56527409	CpG: 20	272	20	190	14.7	69.9	0.63
chr7	56527761	56528010	CpG: 17	249	17	172	13.7	69.1	0.63
chr7	56680048	56680553	CpG: 38	505	38	324	15.0	64.2	0.73
chr7	56715591	56715795	CpG: 18	204	18	134	17.6	65.7	0.91
chr7	56716170	56716395	CpG: 20	225	20	144	17.8	64.0	0.87
chr7	56732982	56733212	CpG: 20	230	20	135	17.4	58.7	1.05
chr7	56758608	56758893	CpG: 24	285	24	178	16.8	62.5	0.88
chr7	56801425	56801636	CpG: 15	211	15	131	14.2	62.1	0.76
chr7	56810568	56810842	CpG: 25	274	25	163	18.2	59.5	1.03
chr7	57013692	57014047	CpG: 42	355	42	275	23.7	77.5	0.88
chr7	57039037	57039259	CpG: 19	222	19	158	17.1	71.2	0.74
chr7	57042382	57042791	CpG: 30	409	30	282	14.7	68.9	0.67
chr7	57044220	57044629	CpG: 28	409	28	281	13.7	68.7	0.64
chr7	57045879	57046467	CpG: 39	588	39	404	13.3	68.7	0.61
chr7	57047896	57048305	CpG: 29	409	29	282	14.2	68.9	0.66
chr7	57049734	57050143	CpG: 29	409	29	282	14.2	68.9	0.66
chr7	57051476	57051885	CpG: 29	409	29	281	14.2	68.7	0.66
chr7	57053314	57053723	CpG: 29	409	29	281	14.2	68.7	0.66
chr7	57055296	57055705	CpG: 29	409	29	282	14.2	68.9	0.66
chr7	57057143	57057552	CpG: 30	409	30	279	14.7	68.2	0.70
chr7	57059072	57059294	CpG: 19	222	19	154	17.1	69.4	0.79
chr7	57060731	57061140	CpG: 30	409	30	278	14.7	68.0	0.70
chr7	57062660	57062882	CpG: 19	222	19	154	17.1	69.4	0.79
chr7	57111509	57111712	CpG: 18	203	18	119	17.7	58.6	1.03
chr7	57119207	57119665	CpG: 51	458	51	290	22.3	63.3	1.11
chr7	57185631	57186363	CpG: 100	732	100	586	27.3	80.1	0.85
chr7	57228472	57228705	CpG: 19	233	19	142	16.3	60.9	0.90
chr7	57233017	57233223	CpG: 15	206	15	136	14.6	66.0	0.67
chr7	57239164	57239369	CpG: 15	205	15	143	14.6	69.8	0.63
chr7	57246069	57246445	CpG: 29	376	29	244	15.4	64.9	0.73
chr7	57257106	57257580	CpG: 50	474	50	345	21.1	72.8	0.80
chr7	57336070	57336285	CpG: 15	215	15	128	14.0	59.5	0.79
chr7	57423173	57423512	CpG: 22	339	22	219	13.0	64.6	0.62
chr7	57446428	57447045	CpG: 54	617	54	423	17.5	68.6	0.76
chr7	57500195	57500693	CpG: 39	498	39	327	15.7	65.7	0.73
chr7	57522772	57523046	CpG: 23	274	23	170	16.8	62.0	0.88
chr7	57600624	57600905	CpG: 22	281	22	174	15.7	61.9	0.83
chr7	57647563	57648626	CpG: 70	1063	70	656	13.2	61.7	0.71
chr7	57667971	57668910	CpG: 114	939	114	703	24.3	74.9	0.87
chr7	57728597	57728870	CpG: 20	273	20	180	14.7	65.9	0.67
chr7	57873597	57874110	CpG: 40	513	40	366	15.6	71.3	0.61
chr7	57890843	57891315	CpG: 37	472	37	300	15.7	63.6	0.78
chr7	57895149	57895552	CpG: 31	403	31	269	15.4	66.7	0.69
chr7	57897594	57897965	CpG: 29	371	29	237	15.6	63.9	0.77
chr7	57970940	57971225	CpG: 24	285	24	178	16.8	62.5	0.88
chr7	58016532	58016914	CpG: 28	382	28	248	14.7	64.9	0.70
chr7	58063867	58064220	CpG: 26	353	26	226	14.7	64.0	0.72
chr7	58066182	58066463	CpG: 29	281	29	190	20.6	67.6	0.90
chr7	58079859	58080372	CpG: 40	513	40	366	15.6	71.3	0.61
chr7	58112350	58113717	CpG: 152	1367	152	887	22.2	64.9	1.11
chr7	58242680	58242961	CpG: 21	281	21	171	14.9	60.9	0.82
chr7	58330019	58331788	CpG: 169	1769	169	1129	19.1	63.8	0.98
chr7	58582539	58585166	CpG: 289	2627	289	1789	22.0	68.1	1.02
chr7	58622745	58624235	CpG: 178	1490	178	1030	23.9	69.1	1.06
chr7	58658974	58660787	CpG: 186	1813	186	1173	20.5	64.7	1.03
chr7	58848293	58849513	CpG: 101	1220	101	762	16.6	62.5	0.90
chr7	58903352	58904572	CpG: 101	1220	101	762	16.6	62.5	0.90
chr7	59098483	59100297	CpG: 186	1814	186	1174	20.5	64.7	1.03
chr7	59135043	59136538	CpG: 180	1495	180	1035	24.1	69.2	1.06
chr7	59141074	59141366	CpG: 23	292	23	177	15.8	60.6	0.86
chr7	59262721	59267675	CpG: 396	4954	396	2953	16.0	59.6	0.93
chr7	59330729	59331155	CpG: 32	426	32	255	15.0	59.9	0.84
chr7	59373311	59374881	CpG: 158	1570	158	1017	20.1	64.8	1.00
chr7	59939826	59941044	CpG: 130	1218	130	832	21.3	68.3	0.93
chr7	59975278	59977340	CpG: 195	2062	195	1346	18.9	65.3	0.91
chr7	60168939	60169222	CpG: 22	283	22	177	15.5	62.5	0.81
chr7	60293716	60293940	CpG: 19	224	19	134	17.0	59.8	0.95
chr7	64253073	64253541	CpG: 49	468	49	328	20.9	70.1	0.85
chr7	64267019	64267524	CpG: 40	505	40	329	15.8	65.1	0.76
chr7	64313056	64313717	CpG: 76	661	76	501	23.0	75.8	0.80
chr7	64353227	64353553	CpG: 25	326	25	193	15.3	59.2	0.88
chr7	64407027	64407303	CpG: 22	276	22	166	15.9	60.1	0.89
chr7	64547973	64548176	CpG: 16	203	16	134	15.8	66.0	0.73
chr7	64548407	64548809	CpG: 55	402	55	303	27.4	75.4	0.97
chr7	64552465	64552766	CpG: 27	301	27	197	17.9	65.4	0.87
chr7	64592832	64593133	CpG: 27	301	27	197	17.9	65.4	0.87
chr7	64596789	64597191	CpG: 55	402	55	303	27.4	75.4	0.97
chr7	64597422	64597625	CpG: 16	203	16	134	15.8	66.0	0.73
chr7	64757091	64757565	CpG: 49	474	49	343	20.7	72.4	0.80
chr7	64768226	64768602	CpG: 29	376	29	244	15.4	64.9	0.73
chr7	64781411	64781651	CpG: 18	240	18	159	15.0	66.2	0.69
chr7	64785970	64786203	CpG: 20	233	20	143	17.2	61.4	0.93
chr7	64828296	64829025	CpG: 101	729	101	587	27.7	80.5	0.86
chr7	64894969	64895427	CpG: 51	458	51	290	22.3	63.3	1.11
chr7	64951948	64952224	CpG: 21	276	21	193	15.2	69.9	0.70
chr7	64953638	64954047	CpG: 30	409	30	285	14.7	69.7	0.67
chr7	64955413	64955822	CpG: 31	409	31	286	15.2	69.9	0.68
chr7	64957188	64957597	CpG: 32	409	32	286	15.6	69.9	0.70
chr7	64959011	64959420	CpG: 31	409	31	285	15.2	69.7	0.69
chr7	64960834	64961243	CpG: 29	409	29	283	14.2	69.2	0.65
chr7	64964478	64964887	CpG: 31	409	31	283	15.2	69.2	0.70
chr7	64966301	64966673	CpG: 28	372	28	258	15.1	69.4	0.70
chr7	64968028	64968437	CpG: 29	409	29	285	14.2	69.7	0.65
chr7	64969707	64970079	CpG: 28	372	28	259	15.1	69.6	0.69
chr7	64971678	64971917	CpG: 20	239	20	168	16.7	70.3	0.76
chr7	64996506	64996780	CpG: 23	274	23	169	16.8	61.7	0.90
chr7	64997522	64998496	CpG: 116	974	116	741	23.8	76.1	0.84
chr7	65082018	65082491	CpG: 41	473	41	354	17.3	74.8	0.62
chr7	65108629	65108996	CpG: 30	367	30	240	16.3	65.4	0.79
chr7	65128393	65128657	CpG: 19	264	19	160	14.4	60.6	0.81
chr7	65134102	65134588	CpG: 36	486	36	293	14.8	60.3	0.84
chr7	65138956	65139668	CpG: 70	712	70	490	19.7	68.8	0.83
chr7	65171020	65171242	CpG: 20	222	20	136	18.0	61.3	0.97
chr7	65245114	65245824	CpG: 52	710	52	421	14.6	59.3	0.83
chr7	65253489	65253810	CpG: 23	321	23	189	14.3	58.9	0.83
chr7	65307950	65308595	CpG: 64	645	64	464	19.8	71.9	0.77
chr7	65389533	65391323	CpG: 164	1790	164	1264	18.3	70.6	0.74
chr7	65400152	65400484	CpG: 23	332	23	216	13.9	65.1	0.66
chr7	65438145	65438426	CpG: 22	281	22	174	15.7	61.9	0.84
chr7	65514672	65515457	CpG: 58	785	58	467	14.8	59.5	0.85
chr7	65671894	65672235	CpG: 24	341	24	227	14.1	66.6	0.64
chr7	65675928	65676197	CpG: 19	269	19	162	14.1	60.2	0.79
chr7	65717569	65717848	CpG: 23	279	23	173	16.5	62.0	0.86
chr7	65761224	65761858	CpG: 51	634	51	428	16.1	67.5	0.71
chr7	65777034	65778104	CpG: 99	1070	99	728	18.5	68.0	0.82
chr7	65784486	65785047	CpG: 45	561	45	375	16.0	66.8	0.72
chr7	65788208	65788483	CpG: 22	275	22	165	16.0	60.0	0.90
chr7	65790108	65790338	CpG: 31	230	31	177	27.0	77.0	0.91
chr7	65804728	65804959	CpG: 20	231	20	142	17.3	61.5	0.94
chr7	65873818	65874097	CpG: 23	279	23	192	16.5	68.8	0.70
chr7	65905234	65905456	CpG: 21	222	21	138	18.9	62.2	1.02
chr7	65919281	65919563	CpG: 21	282	21	169	14.9	59.9	0.84
chr7	65944150	65944356	CpG: 18	206	18	146	17.5	70.9	0.71
chr7	65991765	65992614	CpG: 62	849	62	582	14.6	68.6	0.62
chr7	66001849	66002216	CpG: 26	367	26	226	14.2	61.6	0.76
chr7	66021199	66021422	CpG: 16	223	16	135	14.3	60.5	0.79
chr7	66043387	66043640	CpG: 19	253	19	157	15.0	62.1	0.88
chr7	66078743	66079000	CpG: 19	257	19	162	14.8	63.0	0.74
chr7	66088471	66089619	CpG: 82	1148	82	721	14.3	62.8	0.72
chr7	66095243	66095970	CpG: 64	727	64	514	17.6	70.7	0.70
chr7	66104022	66104231	CpG: 16	209	16	124	15.3	59.3	0.90
chr7	66153614	66154324	CpG: 62	710	62	512	17.5	72.1	0.67
chr7	66162421	66162698	CpG: 26	277	26	173	18.8	62.5	0.97
chr7	66239247	66239974	CpG: 54	727	54	499	14.9	68.6	0.63
chr7	66244167	66245235	CpG: 132	1068	132	830	24.7	77.7	0.84
chr7	66281054	66281430	CpG: 35	376	35	266	18.6	70.7	0.76
chr7	66286983	66287543	CpG: 45	560	45	384	16.1	68.6	0.69
chr7	66329234	66329498	CpG: 40	264	40	191	30.3	72.3	1.24
chr7	66346932	66347737	CpG: 87	805	87	566	21.6	70.3	0.88
chr7	66382675	66382949	CpG: 20	274	20	167	14.6	60.9	0.80
chr7	66393572	66393846	CpG: 23	274	23	170	16.8	62.0	0.88
chr7	66398972	66399253	CpG: 24	281	24	175	17.1	62.3	0.90
chr7	66445782	66446409	CpG: 57	627	57	454	18.2	72.4	0.70
chr7	66457972	66458545	CpG: 56	573	56	401	19.5	70.0	0.80
chr7	66463623	66464350	CpG: 57	727	57	497	15.7	68.4	0.67
chr7	66479998	66480202	CpG: 18	204	18	145	17.6	71.1	0.71
chr7	66502615	66502855	CpG: 18	240	18	144	15.0	60.0	0.85
chr7	66577899	66578128	CpG: 19	229	19	137	16.6	59.8	0.95
chr7	66584556	66584785	CpG: 22	229	22	160	19.2	69.9	0.79
chr7	66726855	66728287	CpG: 171	1432	171	990	23.9	69.1	1.02
chr7	66772517	66773491	CpG: 102	974	102	692	20.9	71.0	0.83
chr7	66790923	66791187	CpG: 40	264	40	191	30.3	72.3	1.24
chr7	66869442	66870416	CpG: 102	974	102	693	20.9	71.1	0.83
chr7	66972873	66973636	CpG: 76	763	76	525	19.9	68.8	0.84
chr7	66986505	66986883	CpG: 35	378	35	266	18.5	70.4	0.77
chr7	66992456	66993014	CpG: 46	558	46	383	16.5	68.6	0.70
chr7	67069493	67069770	CpG: 24	277	24	174	17.3	62.8	0.89
chr7	67095081	67096175	CpG: 143	1094	143	861	26.1	78.7	0.86
chr7	67203877	67204446	CpG: 66	569	66	420	23.2	73.8	0.86
chr7	67266176	67266781	CpG: 47	605	47	382	15.5	63.1	0.78
chr7	67297643	67298204	CpG: 63	561	63	410	22.5	73.1	0.84
chr7	67336863	67337299	CpG: 52	436	52	299	23.9	68.6	1.03
chr7	67351133	67351341	CpG: 17	208	17	124	16.3	59.6	0.93
chr7	67355347	67355588	CpG: 17	241	17	143	14.1	59.3	0.82
chr7	67422568	67422809	CpG: 18	241	18	144	14.9	59.8	0.85
chr7	67427068	67428048	CpG: 106	980	106	714	21.6	72.9	0.83
chr7	67514541	67514968	CpG: 30	427	30	255	14.1	59.7	0.79
chr7	67598521	67599573	CpG: 82	1052	82	767	15.6	72.9	0.64
chr7	67603526	67603752	CpG: 19	226	19	138	16.8	61.1	0.94
chr7	67633117	67633634	CpG: 47	517	47	350	18.2	67.7	0.79
chr7	67634914	67635132	CpG: 17	218	17	131	15.6	60.1	0.88
chr7	67694063	67694477	CpG: 48	414	48	308	23.2	74.4	0.84
chr7	67713127	67713980	CpG: 73	853	73	548	17.1	64.2	0.83
chr7	67724682	67726081	CpG: 125	1399	125	897	17.9	64.1	0.87
chr7	67775821	67776941	CpG: 104	1120	104	810	18.6	72.3	0.71
chr7	67811115	67812117	CpG: 104	1002	104	691	20.8	69.0	0.88
chr7	67833827	67834581	CpG: 60	754	60	522	15.9	69.2	0.66
chr7	67841370	67841610	CpG: 18	240	18	139	15.0	57.9	0.92
chr7	67848007	67848991	CpG: 113	984	113	729	23.0	74.1	0.84
chr7	67873418	67875081	CpG: 152	1663	152	1073	18.3	64.5	0.88
chr7	67901402	67902689	CpG: 136	1287	136	882	21.1	68.5	0.90
chr7	67959932	67961252	CpG: 141	1320	141	909	21.4	68.9	0.90
chr7	68040136	68040462	CpG: 26	326	26	192	16.0	58.9	0.93
chr7	68064190	68064727	CpG: 58	537	58	369	21.6	68.7	0.92
chr7	68121653	68121921	CpG: 21	268	21	183	15.7	68.3	0.71
chr7	68123459	68124299	CpG: 69	840	69	615	16.4	73.2	0.66
chr7	68140639	68141493	CpG: 104	854	104	596	24.4	69.8	1.00
chr7	68214798	68215489	CpG: 63	691	63	428	18.2	61.9	0.95
chr7	68216543	68216793	CpG: 26	250	26	160	20.8	64.0	1.03
chr7	68456806	68457026	CpG: 15	220	15	132	13.6	60.0	0.76
chr7	68468458	68468736	CpG: 26	278	26	173	18.7	62.2	0.97
chr7	68505861	68506088	CpG: 22	227	22	136	19.4	59.9	1.09
chr7	68521893	68523239	CpG: 111	1346	111	830	16.5	61.7	0.87
chr7	68544305	68544586	CpG: 23	281	23	174	16.4	61.9	0.87
chr7	68560149	68560374	CpG: 18	225	18	134	16.0	59.6	0.91
chr7	68584319	68584833	CpG: 61	514	61	387	23.7	75.3	0.84
chr7	68604366	68604629	CpG: 19	263	19	157	14.4	59.7	0.82
chr7	68899365	68899629	CpG: 21	264	21	159	15.9	60.2	0.88
chr7	69264766	69265039	CpG: 20	273	20	165	14.7	60.4	0.81
chr7	69294670	69294902	CpG: 18	232	18	141	15.5	60.8	0.86
chr7	69450996	69451369	CpG: 31	373	31	273	16.6	73.2	0.62
chr7	69661595	69661833	CpG: 17	238	17	145	14.3	60.9	0.81
chr7	70176630	70176838	CpG: 18	208	18	124	17.3	59.6	0.99
chr7	70462953	70463230	CpG: 21	277	21	167	15.2	60.3	0.84
chr7	70516112	70516385	CpG: 22	273	22	167	16.1	61.2	0.88
chr7	70523215	70523451	CpG: 20	236	20	141	16.9	59.7	0.97
chr7	70560753	70561032	CpG: 20	279	20	173	14.3	62.0	0.75
chr7	70616776	70617249	CpG: 40	473	40	341	16.9	72.1	0.65
chr7	70820171	70822834	CpG: 279	2663	279	1848	21.0	69.4	0.87
chr7	70834428	70834709	CpG: 24	281	24	175	17.1	62.3	0.89
chr7	70856956	70857193	CpG: 20	237	20	143	16.9	60.3	0.96
chr7	70859565	70859839	CpG: 19	274	19	163	13.9	59.5	0.79
chr7	70869585	70869853	CpG: 22	268	22	163	16.4	60.8	0.90
chr7	71385038	71385312	CpG: 23	274	23	170	16.8	62.0	0.88
chr7	71420219	71420646	CpG: 32	427	32	256	15.0	60.0	0.84
chr7	71653713	71653998	CpG: 26	285	26	179	18.2	62.8	0.93
chr7	71819496	71820118	CpG: 76	622	76	449	24.4	72.2	0.94
chr7	71854899	71855137	CpG: 18	238	18	153	15.1	64.3	0.78
chr7	71917413	71919340	CpG: 255	1927	255	1418	26.5	73.6	0.98
chr7	71977534	71977805	CpG: 20	271	20	162	14.8	59.8	0.84
chr7	72013561	72014653	CpG: 92	1092	92	741	16.8	67.9	0.74
chr7	72032229	72032503	CpG: 20	274	20	167	14.6	60.9	0.80
chr7	72241992	72242234	CpG: 18	242	18	145	14.9	59.9	0.84
chr7	72255745	72256150	CpG: 33	405	33	294	16.3	72.6	0.62
chr7	72320279	72320567	CpG: 24	288	24	178	16.7	61.8	0.89
chr7	72349429	72351583	CpG: 249	2154	249	1519	23.1	70.5	0.93
chr7	72355378	72355622	CpG: 22	244	22	152	18.0	62.3	0.95
chr7	72458869	72459080	CpG: 16	211	16	128	15.2	60.7	0.83
chr7	72955165	72955410	CpG: 21	245	21	135	17.1	55.1	1.16
chr7	72955913	72956303	CpG: 39	390	39	288	20.0	73.8	0.73
chr7	73244597	73244873	CpG: 23	276	23	172	16.7	62.3	0.87
chr7	73554052	73556047	CpG: 198	1995	198	1428	19.8	71.6	0.78
chr7	73766093	73766329	CpG: 17	236	17	140	14.4	59.3	0.84
chr7	73837895	73838181	CpG: 22	286	22	177	15.4	61.9	0.82
chr7	74052062	74052538	CpG: 43	476	43	312	18.1	65.5	0.84
chr7	74053386	74053969	CpG: 56	583	56	367	19.2	63.0	0.97
chr7	74107472	74108463	CpG: 92	991	92	676	18.6	68.2	0.80
chr7	74152200	74152475	CpG: 19	275	19	162	13.8	58.9	0.80
chr7	74153062	74153943	CpG: 116	881	116	621	26.3	70.5	1.06
chr7	74170940	74171484	CpG: 39	544	39	357	14.3	65.6	0.70
chr7	74182342	74183162	CpG: 77	820	77	539	18.8	65.7	0.88
chr7	74190628	74190901	CpG: 20	273	20	166	14.7	60.8	0.80
chr7	74197381	74198340	CpG: 77	959	77	625	16.1	65.2	0.76
chr7	74204165	74204499	CpG: 44	334	44	258	26.3	77.2	0.89
chr7	74233456	74234621	CpG: 105	1165	105	744	18.0	63.9	0.88
chr7	74354683	74355959	CpG: 147	1276	147	921	23.0	72.2	0.90
chr7	74434827	74436123	CpG: 128	1296	128	931	19.8	71.8	0.78
chr7	74497781	74498239	CpG: 34	458	34	301	14.8	65.7	0.73
chr7	74503826	74504146	CpG: 24	320	24	218	15.0	68.1	0.65
chr7	74508336	74509127	CpG: 73	791	73	507	18.5	64.1	0.93
chr7	74512987	74513603	CpG: 48	616	48	433	15.6	70.3	0.63
chr7	74524512	74524805	CpG: 22	293	22	204	15.0	69.6	0.62
chr7	74527972	74528878	CpG: 83	906	83	595	18.3	65.7	0.85
chr7	74577875	74578509	CpG: 64	634	64	433	20.2	68.3	0.87
chr7	74624545	74624977	CpG: 38	432	38	305	17.6	70.6	0.71
chr7	74634097	74636196	CpG: 226	2099	226	1480	21.5	70.5	0.87
chr7	74721770	74723248	CpG: 157	1478	157	1011	21.2	68.4	0.91
chr7	74757550	74758390	CpG: 111	840	111	643	26.4	76.5	0.91
chr7	74771146	74771364	CpG: 18	218	18	141	16.5	64.7	0.79
chr7	74778590	74779823	CpG: 120	1233	120	851	19.5	69.0	0.83
chr7	74781004	74781285	CpG: 20	281	20	162	14.2	57.7	0.87
chr7	74808035	74808269	CpG: 20	234	20	159	17.1	67.9	0.74
chr7	74824105	74825534	CpG: 122	1429	122	980	17.1	68.6	0.74
chr7	74844196	74844426	CpG: 17	230	17	139	14.8	60.4	0.82
chr7	74848669	74849175	CpG: 60	506	60	387	23.7	76.5	0.81
chr7	74867947	74869290	CpG: 139	1343	139	943	20.7	70.2	0.85
chr7	74883711	74885709	CpG: 166	1998	166	1217	16.6	60.9	0.92
chr7	74919975	74920791	CpG: 99	816	99	616	24.3	75.5	0.85
chr7	74939133	74940285	CpG: 108	1152	108	798	18.8	69.3	0.78
chr7	74969926	74971662	CpG: 164	1736	164	1213	18.9	69.9	0.78
chr7	74976756	74977037	CpG: 24	281	24	174	17.1	61.9	0.91
chr7	74998031	74998846	CpG: 67	815	67	558	16.4	68.5	0.70
chr7	75031999	75032610	CpG: 47	611	47	393	15.4	64.3	0.74
chr7	75056558	75056856	CpG: 26	298	26	209	17.4	70.1	0.71
chr7	75231149	75231357	CpG: 20	208	20	147	19.2	70.7	0.81
chr7	75270620	75270854	CpG: 18	234	18	142	15.4	60.7	0.84
chr7	75286385	75287590	CpG: 128	1205	128	918	21.2	76.2	0.74
chr7	75375934	75377023	CpG: 137	1089	137	809	25.2	74.3	0.92
chr7	75403941	75404222	CpG: 24	281	24	174	17.1	61.9	0.91
chr7	75456357	75457195	CpG: 89	838	89	572	21.2	68.3	0.91
chr7	75491401	75492171	CpG: 95	770	95	589	24.7	76.5	0.85
chr7	75508705	75508947	CpG: 17	242	17	163	14.0	67.4	0.62
chr7	75540737	75541261	CpG: 51	524	51	361	19.5	68.9	0.83
chr7	75578190	75578470	CpG: 25	280	25	186	17.9	66.4	0.82
chr7	75655735	75656927	CpG: 116	1192	116	893	19.5	74.9	0.69
chr7	75682761	75683056	CpG: 27	295	27	204	18.3	69.2	0.77
chr7	75808775	75809092	CpG: 40	317	40	245	25.2	77.3	0.86
chr7	75839624	75839900	CpG: 21	276	21	167	15.2	60.5	0.84
chr7	75848649	75848918	CpG: 22	269	22	160	16.4	59.5	0.93
chr7	75858909	75859112	CpG: 18	203	18	119	17.7	58.6	1.07
chr7	75859505	75861034	CpG: 204	1529	204	1138	26.7	74.4	0.96
chr7	75887905	75888287	CpG: 30	382	30	222	15.7	58.1	0.95
chr7	75900294	75900530	CpG: 18	236	18	143	15.3	60.6	0.86
chr7	75990305	75991601	CpG: 129	1296	129	931	19.9	71.8	0.79
chr7	76053109	76054095	CpG: 105	986	105	678	21.3	68.8	0.90
chr7	76092231	76093373	CpG: 101	1142	101	730	17.7	63.9	0.87
chr7	76166673	76167888	CpG: 144	1215	144	886	23.7	72.9	0.91
chr7	76277332	76278083	CpG: 81	751	81	524	21.6	69.8	0.89
chr7	76296287	76297282	CpG: 108	995	108	689	21.7	69.2	0.91
chr7	76360621	76361917	CpG: 130	1296	130	932	20.1	71.9	0.79
chr7	76440756	76442029	CpG: 147	1273	147	918	23.1	72.1	0.90
chr7	76645973	76647137	CpG: 104	1164	104	744	17.9	63.9	0.88
chr7	76676091	76676425	CpG: 44	334	44	258	26.3	77.2	0.89
chr7	76682250	76683212	CpG: 78	962	78	625	16.2	65.0	0.77
chr7	76689697	76689970	CpG: 20	273	20	166	14.7	60.8	0.80
chr7	76697435	76698255	CpG: 76	820	76	539	18.5	65.7	0.87
chr7	76709060	76709613	CpG: 41	553	41	365	14.8	66.0	0.73
chr7	76729484	76730264	CpG: 105	780	105	558	26.9	71.5	1.05
chr7	76760977	76761251	CpG: 23	274	23	166	16.8	60.6	0.92
chr7	76772839	76773723	CpG: 75	884	75	597	17.0	67.5	0.75
chr7	76814597	76815533	CpG: 89	936	89	654	19.0	69.9	0.79
chr7	76840977	76841199	CpG: 15	222	15	127	13.5	57.2	0.84
chr7	76847008	76847307	CpG: 25	299	25	208	16.7	69.6	0.71
chr7	76926000	76926947	CpG: 102	947	102	701	21.5	74.0	0.80
chr7	77025827	77026843	CpG: 114	1016	114	767	22.4	75.5	0.80
chr7	77123084	77123299	CpG: 17	215	17	137	15.8	63.7	0.80
chr7	77123449	77123748	CpG: 21	299	21	176	14.0	58.9	0.81
chr7	77165979	77166572	CpG: 57	593	57	429	19.2	72.3	0.73
chr7	77202233	77203243	CpG: 103	1010	103	704	20.4	69.7	0.84
chr7	77281606	77282413	CpG: 74	807	74	592	18.3	73.4	0.68
chr7	77313466	77313689	CpG: 16	223	16	130	14.3	58.3	0.87
chr7	77335259	77335985	CpG: 60	726	60	512	16.5	70.5	0.67
chr7	77437786	77438180	CpG: 39	394	39	294	19.8	74.6	0.72
chr7	77454036	77455006	CpG: 83	970	83	609	17.1	62.8	0.87
chr7	77489197	77489697	CpG: 54	500	54	389	21.6	77.8	0.74
chr7	77522458	77522917	CpG: 49	459	49	327	21.4	71.2	0.88
chr7	77538908	77539144	CpG: 17	236	17	144	14.4	61.0	0.79
chr7	77547242	77547916	CpG: 60	674	60	475	17.8	70.5	0.73
chr7	77553363	77553637	CpG: 24	274	24	170	17.5	62.0	0.92
chr7	77554665	77555099	CpG: 60	434	60	327	27.6	75.3	0.98
chr7	77567858	77568061	CpG: 16	203	16	153	15.8	75.4	0.61
chr7	77568907	77570651	CpG: 189	1744	189	1284	21.7	73.6	0.85
chr7	77589844	77591130	CpG: 108	1286	108	828	16.8	64.4	0.81
chr7	77596093	77596351	CpG: 19	258	19	141	14.7	54.7	0.99
chr7	77596933	77597456	CpG: 45	523	45	379	17.2	72.5	0.66
chr7	77603471	77603756	CpG: 24	285	24	177	16.8	62.1	0.89
chr7	77605546	77606064	CpG: 46	518	46	361	17.8	69.7	0.75
chr7	77617042	77617251	CpG: 23	209	23	134	22.0	64.1	1.09
chr7	77645783	77647154	CpG: 134	1371	134	973	19.5	71.0	0.78
chr7	77667416	77667830	CpG: 40	414	40	304	19.3	73.4	0.72
chr7	77680681	77681486	CpG: 97	805	97	598	24.1	74.3	0.89
chr7	77685138	77685571	CpG: 40	433	40	314	18.5	72.5	0.71
chr7	77687991	77688226	CpG: 22	235	22	167	18.7	71.1	0.75
chr7	77743403	77743677	CpG: 20	274	20	161	14.6	58.8	0.86
chr7	77750054	77750665	CpG: 65	611	65	447	21.3	73.2	0.82
chr7	77828456	77829402	CpG: 85	946	85	652	18.0	68.9	0.76
chr7	77905555	77906443	CpG: 109	888	109	610	24.5	68.7	1.04
chr7	77989856	77990093	CpG: 19	237	19	146	16.0	61.6	0.88
chr7	78024800	78025074	CpG: 20	274	20	168	14.6	61.3	0.79
chr7	78113351	78113625	CpG: 23	274	23	170	16.8	62.0	0.88
chr7	78231971	78232245	CpG: 20	274	20	162	14.6	59.1	0.85
chr7	78238581	78239191	CpG: 65	610	65	447	21.3	73.3	0.82
chr7	78279089	78279315	CpG: 19	226	19	153	16.8	67.7	0.73
chr7	78372790	78373189	CpG: 40	399	40	279	20.1	69.9	0.83
chr7	78381735	78382008	CpG: 24	273	24	168	17.6	61.5	0.94
chr7	78512571	78512848	CpG: 24	277	24	172	17.3	62.1	0.91
chr7	78666598	78667747	CpG: 123	1149	123	835	21.4	72.7	0.81
chr7	78785191	78786659	CpG: 125	1468	125	1104	17.0	75.2	0.60
chr7	78788522	78789928	CpG: 146	1406	146	1010	20.8	71.8	0.82
chr7	78861507	78861778	CpG: 22	271	22	164	16.2	60.5	0.89
chr7	78938043	78938318	CpG: 21	275	21	169	15.3	61.5	0.82
chr7	78943259	78943469	CpG: 16	210	16	127	15.2	60.5	0.86
chr7	78948002	78949093	CpG: 109	1091	109	765	20.0	70.1	0.81
chr7	79049941	79051460	CpG: 139	1519	139	992	18.3	65.3	0.86
chr7	79074848	79075122	CpG: 24	274	24	170	17.5	62.0	0.93
chr7	79236555	79236791	CpG: 21	236	21	145	17.8	61.4	0.97
chr7	79270972	79272064	CpG: 142	1092	142	807	26.0	73.9	0.95
chr7	79292209	79292596	CpG: 30	387	30	257	15.5	66.4	0.70
chr7	79328434	79328715	CpG: 23	281	23	175	16.4	62.3	0.86
chr7	79356147	79356386	CpG: 17	239	17	144	14.2	60.3	0.80
chr7	79359789	79360063	CpG: 23	274	23	170	16.8	62.0	0.88
chr7	79372897	79373171	CpG: 24	274	24	172	17.5	62.8	0.90
chr7	79461133	79461407	CpG: 21	274	21	168	15.3	61.3	0.82
chr7	79615113	79615324	CpG: 17	211	17	126	16.1	59.7	0.92
chr7	79788034	79788312	CpG: 25	278	25	175	18.0	62.9	0.92
chr7	79888436	79888670	CpG: 18	234	18	140	15.4	59.8	0.89
chr7	79907609	79907845	CpG: 19	236	19	144	16.1	61.0	0.88
chr7	79980520	79980794	CpG: 24	274	24	171	17.5	62.4	0.91
chr7	79991661	79992054	CpG: 29	393	29	218	14.8	55.5	0.97
chr7	80065442	80065679	CpG: 18	237	18	146	15.2	61.6	0.82
chr7	80075226	80075475	CpG: 19	249	19	153	15.3	61.4	0.83
chr7	80155164	80155436	CpG: 22	272	22	169	16.2	62.1	0.85
chr7	80474866	80475103	CpG: 19	237	19	140	16.0	59.1	0.93
chr7	80487318	80487628	CpG: 24	310	24	188	15.5	60.6	0.85
chr7	80546725	80546926	CpG: 15	201	15	113	14.9	56.2	0.99
chr7	80620380	80620650	CpG: 22	270	22	165	16.3	61.1	0.88
chr7	80704052	80704366	CpG: 26	314	26	204	16.6	65.0	0.79
chr7	80704661	80704914	CpG: 20	253	20	165	15.8	65.2	0.78
chr7	80705410	80706337	CpG: 79	927	79	615	17.0	66.3	0.82
chr7	80748794	80749073	CpG: 22	279	22	167	15.8	59.9	0.89
chr7	80751763	80752044	CpG: 23	281	23	176	16.4	62.6	0.85
chr7	80787794	80788068	CpG: 25	274	25	173	18.2	63.1	0.93
chr7	80820564	80820845	CpG: 23	281	23	175	16.4	62.3	0.86
chr7	80991031	80991459	CpG: 38	428	38	313	17.8	73.1	0.66
chr7	81019668	81020059	CpG: 36	391	36	287	18.4	73.4	0.68
chr7	81158265	81158502	CpG: 19	237	19	139	16.0	58.6	0.94
chr7	81229478	81229695	CpG: 18	217	18	160	16.6	73.7	0.62
chr7	81268292	81268570	CpG: 21	278	21	170	15.1	61.2	0.82
chr7	81308907	81309133	CpG: 17	226	17	137	15.0	60.6	0.85
chr7	81385803	81386899	CpG: 135	1096	135	801	24.6	73.1	0.94
chr7	81473784	81473988	CpG: 16	204	16	117	15.7	57.4	0.97
chr7	81580289	81580569	CpG: 24	280	24	174	17.1	62.1	0.90
chr7	81790713	81790990	CpG: 22	277	22	169	15.9	61.0	0.86
chr7	81844607	81844847	CpG: 21	240	21	149	17.5	62.1	0.94
chr7	82170349	82170769	CpG: 59	420	59	309	28.1	73.6	1.04
chr7	82191156	82191442	CpG: 22	286	22	173	15.4	60.5	0.86
chr7	82210294	82210524	CpG: 20	230	20	142	17.4	61.7	0.93
chr7	82325600	82325820	CpG: 17	220	17	132	15.5	60.0	0.87
chr7	82379210	82379450	CpG: 17	240	17	145	14.2	60.4	0.80
chr7	82394200	82394662	CpG: 38	462	38	340	16.5	73.6	0.61
chr7	82540754	82540990	CpG: 21	236	21	146	17.8	61.9	0.95
chr7	82625650	82625924	CpG: 22	274	22	170	16.1	62.0	0.84
chr7	82640815	82641089	CpG: 21	274	21	164	15.3	59.9	0.87
chr7	82689208	82689593	CpG: 34	385	34	283	17.7	73.5	0.65
chr7	82863134	82863461	CpG: 25	327	25	204	15.3	62.4	0.84
chr7	83350710	83350988	CpG: 25	278	25	176	18.0	63.3	0.91
chr7	83573109	83573345	CpG: 21	236	21	145	17.8	61.4	0.96
chr7	83693959	83695458	CpG: 168	1499	168	1027	22.4	68.5	0.96
chr7	83765481	83765705	CpG: 20	224	20	135	17.9	60.3	1.00
chr7	83856126	83856407	CpG: 21	281	21	170	14.9	60.5	0.82
chr7	83893437	83893711	CpG: 23	274	23	170	16.8	62.0	0.88
chr7	83946599	83946837	CpG: 20	238	20	151	16.8	63.4	0.86
chr7	83978377	83978651	CpG: 23	274	23	170	16.8	62.0	0.88
chr7	84275439	84275681	CpG: 21	242	21	140	17.4	57.9	1.04
chr7	84344754	84344991	CpG: 17	237	17	138	14.3	58.2	0.88
chr7	84376117	84376552	CpG: 32	435	32	292	14.7	67.1	0.66
chr7	84413577	84414315	CpG: 81	738	81	526	22.0	71.3	0.88
chr7	84505934	84506168	CpG: 18	234	18	140	15.4	59.8	0.90
chr7	84568743	84569024	CpG: 24	281	24	175	17.1	62.3	0.90
chr7	84615114	84615395	CpG: 23	281	23	174	16.4	61.9	0.87
chr7	84684900	84685174	CpG: 24	274	24	171	17.5	62.4	0.91
chr7	84820547	84820821	CpG: 24	274	24	171	17.5	62.4	0.91
chr7	84889287	84889561	CpG: 22	274	22	169	16.1	61.7	0.86
chr7	84923782	84924164	CpG: 31	382	31	276	16.2	72.3	0.62
chr7	84989631	84989922	CpG: 21	291	21	172	14.4	59.1	0.83
chr7	85000029	85000297	CpG: 29	268	29	178	21.6	66.4	0.98
chr7	85185989	85186265	CpG: 21	276	21	165	15.2	59.8	0.86
chr7	85203370	85203581	CpG: 17	211	17	127	16.1	60.2	0.90
chr7	85274127	85274403	CpG: 21	276	21	165	15.2	59.8	0.87
chr7	85305670	85305963	CpG: 20	293	20	179	13.7	61.1	0.73
chr7	85312813	85313240	CpG: 33	427	33	253	15.5	59.3	0.89
chr7	85349144	85349418	CpG: 25	274	25	171	18.2	62.4	0.95
chr7	85371711	85371990	CpG: 25	279	25	174	17.9	62.4	0.93
chr7	85400320	85400610	CpG: 24	290	24	170	16.6	58.6	0.97
chr7	85568377	85568655	CpG: 24	278	24	171	17.3	61.5	0.92
chr7	85702963	85703240	CpG: 23	277	23	175	16.6	63.2	0.84
chr7	86130212	86130771	CpG: 60	559	60	420	21.5	75.1	0.76
chr7	86179646	86179920	CpG: 20	274	20	167	14.6	60.9	0.80
chr7	86189754	86190083	CpG: 31	329	31	241	18.8	73.3	0.71
chr7	86333405	86333730	CpG: 29	325	29	198	17.8	60.9	0.98
chr7	86435856	86436738	CpG: 65	882	65	564	14.7	63.9	0.72
chr7	86573008	86573234	CpG: 16	226	16	137	14.2	60.6	0.79
chr7	86585248	86585490	CpG: 21	242	21	144	17.4	59.5	0.98
chr7	87309694	87309967	CpG: 22	273	22	165	16.1	60.4	0.89
chr7	87442460	87442731	CpG: 22	271	22	161	16.2	59.4	0.94
chr7	87454172	87454453	CpG: 21	281	21	175	14.9	62.3	0.79
chr7	87480013	87480286	CpG: 23	273	23	173	16.8	63.4	0.85
chr7	87532251	87532524	CpG: 22	273	22	200	16.1	73.3	0.61
chr7	87572081	87572355	CpG: 24	274	24	171	17.5	62.4	0.91
chr7	87577201	87577482	CpG: 23	281	23	176	16.4	62.6	0.85
chr7	87690503	87690895	CpG: 35	392	35	292	17.9	74.5	0.65
chr7	87775445	87775720	CpG: 22	275	22	168	16.0	61.1	0.87
chr7	88036204	88036696	CpG: 45	492	45	311	18.3	63.2	0.92
chr7	88236108	88236338	CpG: 19	230	19	140	16.5	60.9	0.90
chr7	88289723	88290118	CpG: 30	395	30	237	15.2	60.0	0.85
chr7	88309305	88309846	CpG: 82	541	82	438	30.3	81.0	0.93
chr7	88337910	88338188	CpG: 24	278	24	174	17.3	62.6	0.89
chr7	88402252	88402822	CpG: 64	570	64	403	22.5	70.7	0.90
chr7	88469246	88470359	CpG: 114	1113	114	757	20.5	68.0	0.90
chr7	88486891	88487171	CpG: 24	280	24	165	17.1	58.9	0.99
chr7	88493826	88494063	CpG: 20	237	20	144	16.9	60.8	0.93
chr7	88595038	88595386	CpG: 36	348	36	249	20.7	71.6	0.81
chr7	88725177	88725759	CpG: 73	582	73	439	25.1	75.4	0.90
chr7	88828504	88828782	CpG: 22	278	22	172	15.8	61.9	0.84
chr7	88850023	88850362	CpG: 34	339	34	232	20.1	68.4	0.86
chr7	88850531	88850732	CpG: 15	201	15	114	14.9	56.7	0.93
chr7	88874756	88875040	CpG: 23	284	23	173	16.2	60.9	0.88
chr7	88877522	88879010	CpG: 140	1488	140	1015	18.8	68.2	0.82
chr7	88881332	88881573	CpG: 20	241	20	147	16.6	61.0	0.91
chr7	89125698	89127091	CpG: 140	1393	140	926	20.1	66.5	0.91
chr7	89143175	89143456	CpG: 23	281	23	173	16.4	61.6	0.88
chr7	89183946	89185174	CpG: 113	1228	113	795	18.4	64.7	0.89
chr7	89241338	89241619	CpG: 23	281	23	171	16.4	60.9	0.89
chr7	89288431	89288660	CpG: 19	229	19	137	16.6	59.8	0.94
chr7	89446034	89446302	CpG: 20	268	20	157	14.9	58.6	0.89
chr7	89470178	89470769	CpG: 66	591	66	427	22.3	72.3	0.86
chr7	89660490	89660764	CpG: 23	274	23	169	16.8	61.7	0.89
chr7	89694656	89694929	CpG: 22	273	22	171	16.1	62.6	0.83
chr7	90009809	90010604	CpG: 71	795	71	566	17.9	71.2	0.71
chr7	90120742	90121015	CpG: 25	273	25	169	18.3	61.9	0.96
chr7	90148766	90149002	CpG: 18	236	18	143	15.3	60.6	0.86
chr7	90466198	90466435	CpG: 19	237	19	140	16.0	59.1	0.94
chr7	90593677	90593943	CpG: 27	266	27	169	20.3	63.5	1.02
chr7	90691691	90691927	CpG: 20	236	20	144	16.9	61.0	0.93
chr7	90752439	90752669	CpG: 18	230	18	135	15.7	58.7	0.93
chr7	91369050	91370194	CpG: 99	1144	99	724	17.3	63.3	0.87
chr7	91404688	91405202	CpG: 49	514	49	353	19.1	68.7	0.82
chr7	91459804	91460482	CpG: 72	678	72	492	21.2	72.6	0.81
chr7	91493315	91493849	CpG: 42	534	42	350	15.7	65.5	0.73
chr7	91569194	91569714	CpG: 56	520	56	376	21.5	72.3	0.82
chr7	91582517	91583089	CpG: 48	572	48	422	16.8	73.8	0.62
chr7	91594763	91595005	CpG: 23	242	23	146	19.0	60.3	1.04
chr7	91641128	91641402	CpG: 22	274	22	168	16.1	61.3	0.86
chr7	91674938	91675172	CpG: 17	234	17	138	14.5	59.0	0.86
chr7	91753968	91754253	CpG: 23	285	23	177	16.1	62.1	0.85
chr7	91844044	91845320	CpG: 155	1276	155	923	24.3	72.3	0.93
chr7	91847003	91847277	CpG: 23	274	23	169	16.8	61.7	0.89
chr7	92122636	92122917	CpG: 22	281	22	173	15.7	61.6	0.84
chr7	92512097	92515213	CpG: 282	3116	282	2032	18.1	65.2	0.85
chr7	92828050	92828307	CpG: 19	257	19	154	14.8	59.9	0.83
chr7	92831195	92831606	CpG: 31	411	31	246	15.1	59.9	0.85
chr7	92866440	92866652	CpG: 15	212	15	125	14.2	59.0	0.83
chr7	92868133	92868347	CpG: 16	214	16	123	15.0	57.5	0.93
chr7	92868729	92869114	CpG: 34	385	34	284	17.7	73.8	0.65
chr7	92872951	92873172	CpG: 18	221	18	137	16.3	62.0	0.86
chr7	92940930	92941205	CpG: 21	275	21	169	15.3	61.5	0.82
chr7	92990113	92990391	CpG: 26	278	26	176	18.7	63.3	0.94
chr7	93038683	93038886	CpG: 16	203	16	121	15.8	59.6	0.89
chr7	93121976	93122406	CpG: 35	430	35	259	16.3	60.2	0.93
chr7	93181955	93182317	CpG: 42	362	42	257	23.2	71.0	0.92
chr7	93254295	93254573	CpG: 24	278	24	174	17.3	62.6	0.89
chr7	93375060	93376332	CpG: 115	1272	115	851	18.1	66.9	0.81
chr7	93384583	93384978	CpG: 40	395	40	290	20.3	73.4	0.75
chr7	93420305	93420719	CpG: 42	414	42	278	20.3	67.1	0.90
chr7	93486754	93487824	CpG: 90	1070	90	723	16.8	67.6	0.74
chr7	93502357	93502631	CpG: 24	274	24	171	17.5	62.4	0.91
chr7	93688700	93689396	CpG: 82	696	82	528	23.6	75.9	0.82
chr7	93769450	93770368	CpG: 90	918	90	583	19.6	63.5	0.97
chr7	93786212	93786962	CpG: 64	750	64	522	17.1	69.6	0.71
chr7	93816574	93816855	CpG: 23	281	23	174	16.4	61.9	0.87
chr7	93831699	93832512	CpG: 77	813	77	554	18.9	68.1	0.82
chr7	94074876	94079062	CpG: 335	4186	335	2658	16.0	63.5	0.80
chr7	94285511	94285738	CpG: 22	227	22	164	19.4	72.2	0.75
chr7	94300739	94301024	CpG: 23	285	23	177	16.1	62.1	0.85
chr7	94479066	94479306	CpG: 17	240	17	139	14.2	57.9	0.87
chr7	94564370	94564645	CpG: 24	275	24	171	17.5	62.2	0.91
chr7	94817109	94817405	CpG: 28	296	28	217	18.9	73.3	0.71
chr7	94833704	94834055	CpG: 29	351	29	211	16.5	60.1	0.92
chr7	94970467	94970707	CpG: 19	240	19	143	15.8	59.6	0.91
chr7	95025823	95026060	CpG: 19	237	19	146	16.0	61.6	0.86
chr7	95126703	95127521	CpG: 70	818	70	544	17.1	66.5	0.78
chr7	95240019	95240490	CpG: 41	471	41	291	17.4	61.8	0.91
chr7	95248021	95248300	CpG: 26	279	26	202	18.6	72.4	0.72
chr7	95440020	95440301	CpG: 24	281	24	174	17.1	61.9	0.91
chr7	95446659	95446937	CpG: 25	278	25	175	18.0	62.9	0.92
chr7	95564966	95565240	CpG: 24	274	24	171	17.5	62.4	0.91
chr7	95745587	95746596	CpG: 108	1009	108	757	21.4	75.0	0.76
chr7	95891467	95893139	CpG: 114	1672	114	1008	13.6	60.3	0.75
chr7	95900176	95900431	CpG: 19	255	19	158	14.9	62.0	0.78
chr7	95941391	95941647	CpG: 23	256	23	186	18.0	72.7	0.68
chr7	96143404	96144032	CpG: 90	628	90	491	28.7	78.2	0.94
chr7	96157031	96157243	CpG: 16	212	16	124	15.1	58.5	0.90
chr7	96204029	96204293	CpG: 21	264	21	160	15.9	60.6	0.87
chr7	96336708	96336982	CpG: 24	274	24	172	17.5	62.8	0.90
chr7	96425322	96425600	CpG: 23	278	23	173	16.5	62.2	0.86
chr7	96484104	96484334	CpG: 20	230	20	142	17.4	61.7	0.92
chr7	96560612	96560814	CpG: 19	202	19	144	18.8	71.3	0.74
chr7	96632395	96632958	CpG: 58	563	58	377	20.6	67.0	0.92
chr7	96670910	96671246	CpG: 41	336	41	261	24.4	77.7	0.83
chr7	96764011	96764233	CpG: 15	222	15	139	13.5	62.6	0.69
chr7	96832348	96833039	CpG: 60	691	60	453	17.4	65.6	0.82
chr7	96900071	96900356	CpG: 23	285	23	176	16.1	61.8	0.85
chr7	96915035	96915289	CpG: 23	254	23	157	18.1	61.8	0.97
chr7	96968480	96968761	CpG: 24	281	24	174	17.1	61.9	0.91
chr7	97008246	97008987	CpG: 78	741	78	544	21.1	73.4	0.78
chr7	97310137	97310413	CpG: 21	276	21	167	15.2	60.5	0.84
chr7	97375868	97376142	CpG: 24	274	24	171	17.5	62.4	0.91
chr7	97557362	97558219	CpG: 82	857	82	619	19.1	72.2	0.73
chr7	97945147	97945608	CpG: 39	461	39	282	16.9	61.2	0.92
chr7	97967369	97967643	CpG: 22	274	22	168	16.1	61.3	0.86
chr7	98015857	98016058	CpG: 19	201	19	124	18.9	61.7	1.01
chr7	98123125	98123406	CpG: 25	281	25	178	17.8	63.3	0.89
chr7	98231727	98232144	CpG: 30	417	30	262	14.4	62.8	0.73
chr7	98234967	98235260	CpG: 31	293	31	196	21.2	66.9	0.95
chr7	98235766	98236354	CpG: 78	588	78	446	26.5	75.9	0.99
chr7	98246144	98246957	CpG: 60	813	60	546	14.8	67.2	0.71
chr7	98248182	98248594	CpG: 30	412	30	256	14.6	62.1	0.76
chr7	98250586	98251916	CpG: 110	1330	110	841	16.5	63.2	0.83
chr7	98252328	98252611	CpG: 20	283	20	177	14.1	62.5	0.74
chr7	98253826	98254558	CpG: 57	732	57	461	15.6	63.0	0.80
chr7	98347153	98347576	CpG: 49	423	49	269	23.2	63.6	1.15
chr7	98389774	98390127	CpG: 30	353	30	249	17.0	70.5	0.68
chr7	98413626	98413892	CpG: 24	266	24	168	18.0	63.2	0.92
chr7	98765247	98765521	CpG: 24	274	24	171	17.5	62.4	0.91
chr7	98843238	98843665	CpG: 33	427	33	257	15.5	60.2	0.86
chr7	98961372	98963258	CpG: 137	1886	137	1139	14.5	60.4	0.80
chr7	99101936	99102672	CpG: 74	736	74	488	20.1	66.3	0.92
chr7	99113770	99114033	CpG: 24	263	24	160	18.3	60.8	1.00
chr7	99157984	99158638	CpG: 71	654	71	491	21.7	75.1	0.78
chr7	99166028	99166334	CpG: 26	306	26	218	17.0	71.2	0.67
chr7	99168673	99168908	CpG: 19	235	19	161	16.2	68.5	0.70
chr7	99189276	99189749	CpG: 34	473	34	303	14.4	64.1	0.72
chr7	99200491	99200717	CpG: 17	226	17	134	15.0	59.3	0.87
chr7	99202087	99202593	CpG: 51	506	51	358	20.2	70.8	0.82
chr7	99336895	99337714	CpG: 101	819	101	608	24.7	74.2	0.93
chr7	99401605	99401855	CpG: 20	250	20	157	16.0	62.8	0.81
chr7	99424234	99424641	CpG: 35	407	35	256	17.2	62.9	0.87
chr7	99435473	99436023	CpG: 48	550	48	362	17.5	65.8	0.81
chr7	99440519	99442831	CpG: 170	2312	170	1600	14.7	69.2	0.63
chr7	99482521	99483295	CpG: 81	774	81	554	20.9	71.6	0.82
chr7	99511887	99513001	CpG: 141	1114	141	856	25.3	76.8	0.86
chr7	99520957	99521238	CpG: 21	281	21	172	14.9	61.2	0.81
chr7	99624369	99624689	CpG: 23	320	23	185	14.4	57.8	0.86
chr7	99631789	99632376	CpG: 74	587	74	455	25.2	77.5	0.86
chr7	99701522	99701929	CpG: 40	407	40	289	19.7	71.0	0.87
chr7	99722980	99723216	CpG: 20	236	20	143	16.9	60.6	0.96
chr7	99799865	99800139	CpG: 23	274	23	171	16.8	62.4	0.87
chr7	99848165	99850119	CpG: 237	1954	237	1417	24.3	72.5	0.93
chr7	100052512	100052780	CpG: 20	268	20	161	14.9	60.1	0.84
chr7	100080261	100080474	CpG: 16	213	16	129	15.0	60.6	0.84
chr7	100102732	100103767	CpG: 112	1035	112	769	21.6	74.3	0.80
chr7	100111713	100112663	CpG: 125	950	125	726	26.3	76.4	0.92
chr7	100186492	100186785	CpG: 20	293	20	178	13.7	60.8	0.77
chr7	100188438	100188654	CpG: 17	216	17	139	15.7	64.4	0.77
chr7	100215131	100215332	CpG: 18	201	18	140	17.9	69.7	0.74
chr7	100244683	100244912	CpG: 22	229	22	136	19.2	59.4	1.11
chr7	100245359	100245749	CpG: 28	390	28	242	14.4	62.1	0.75
chr7	100268793	100269006	CpG: 18	213	18	127	16.9	59.6	0.99
chr7	100292449	100292684	CpG: 21	235	21	145	17.9	61.7	0.96
chr7	100376738	100377638	CpG: 136	900	136	711	30.2	79.0	0.97
chr7	100461449	100461691	CpG: 18	242	18	145	14.9	59.9	0.85
chr7	100554118	100554353	CpG: 17	235	17	141	14.5	60.0	0.83
chr7	100564506	100565246	CpG: 80	740	80	502	21.6	67.8	0.95
chr7	100612703	100614445	CpG: 164	1742	164	1261	18.8	72.4	0.72
chr7	100631435	100632200	CpG: 80	765	80	531	20.9	69.4	0.88
chr7	100646955	100648137	CpG: 99	1182	99	759	16.8	64.2	0.81
chr7	100658245	100658567	CpG: 22	322	22	195	13.7	60.6	0.75
chr7	100665214	100666448	CpG: 96	1234	96	887	15.6	71.9	0.60
chr7	100677377	100678170	CpG: 91	793	91	568	23.0	71.6	0.89
chr7	100704707	100704908	CpG: 19	201	19	139	18.9	69.2	0.80
chr7	100711063	100711341	CpG: 21	278	21	171	15.1	61.5	0.81
chr7	100711580	100712144	CpG: 52	564	52	378	18.4	67.0	0.86
chr7	100713218	100713489	CpG: 22	271	22	168	16.2	62.0	0.86
chr7	100738000	100738237	CpG: 20	237	20	144	16.9	60.8	0.93
chr7	100738558	100739547	CpG: 78	989	78	619	15.8	62.6	0.82
chr7	100743435	100744249	CpG: 61	814	61	516	15.0	63.4	0.76
chr7	100782064	100782449	CpG: 29	385	29	254	15.1	66.0	0.70
chr7	100791221	100791520	CpG: 26	299	26	196	17.4	65.6	0.81
chr7	100797582	100798830	CpG: 101	1248	101	800	16.2	64.1	0.79
chr7	100819525	100819759	CpG: 29	234	29	172	24.8	73.5	0.94
chr7	100837362	100837709	CpG: 30	347	30	253	17.3	72.9	0.65
chr7	100855848	100856589	CpG: 67	741	67	491	18.1	66.3	0.83
chr7	101076544	101076790	CpG: 19	246	19	140	15.4	56.9	0.97
chr7	101117591	101117900	CpG: 24	309	24	186	15.5	60.2	0.86
chr7	101158480	101159174	CpG: 76	694	76	482	21.9	69.5	0.91
chr7	101237092	101237391	CpG: 28	299	28	199	18.7	66.6	0.85
chr7	101254986	101255679	CpG: 65	693	65	470	18.8	67.8	0.82
chr7	101290817	101291084	CpG: 19	267	19	157	14.2	58.8	0.83
chr7	101315702	101315976	CpG: 22	274	22	168	16.1	61.3	0.86
chr7	101320992	101321926	CpG: 81	934	81	598	17.3	64.0	0.85
chr7	101328575	101329062	CpG: 57	487	57	343	23.4	70.4	0.97
chr7	101336669	101336926	CpG: 19	257	19	157	14.8	61.1	0.81
chr7	101340305	101342001	CpG: 166	1696	166	1158	19.6	68.3	0.84
chr7	101361616	101361895	CpG: 19	279	19	170	13.6	60.9	0.74
chr7	101366710	101368036	CpG: 124	1326	124	922	18.7	69.5	0.79
chr7	101371323	101371557	CpG: 20	234	20	137	17.1	58.5	1.02
chr7	101388423	101388813	CpG: 32	390	32	254	16.4	65.1	0.77
chr7	101397986	101398821	CpG: 94	835	94	596	22.5	71.4	0.89
chr7	101411055	101411730	CpG: 85	675	85	514	25.2	76.1	0.88
chr7	101416920	101417770	CpG: 74	850	74	557	17.4	65.5	0.83
chr7	101511179	101512359	CpG: 136	1180	136	848	23.1	71.9	0.90
chr7	101530673	101530946	CpG: 23	273	23	172	16.8	63.0	0.86
chr7	101575700	101576651	CpG: 92	951	92	630	19.3	66.2	0.88
chr7	101621645	101622205	CpG: 49	560	49	413	17.5	73.8	0.65
chr7	101668259	101670457	CpG: 199	2198	199	1422	18.1	64.7	0.87
chr7	101675717	101676708	CpG: 102	991	102	716	20.6	72.3	0.80
chr7	101717763	101718011	CpG: 20	248	20	178	16.1	71.8	0.63
chr7	101718906	101719237	CpG: 28	331	28	231	16.9	69.8	0.69
chr7	101723146	101724082	CpG: 114	936	114	728	24.4	77.8	0.81
chr7	101733633	101734051	CpG: 47	418	47	312	22.5	74.6	0.81
chr7	101766208	101766435	CpG: 17	227	17	134	15.0	59.0	0.89
chr7	101777825	101778092	CpG: 19	267	19	160	14.2	59.9	0.80
chr7	101778898	101779922	CpG: 98	1024	98	720	19.1	70.3	0.85
chr7	101809595	101810706	CpG: 105	1111	105	760	18.9	68.4	0.81
chr7	101813608	101814746	CpG: 113	1138	113	823	19.9	72.3	0.76
chr7	101825861	101827085	CpG: 104	1224	104	834	17.0	68.1	0.74
chr7	101827415	101827682	CpG: 18	267	18	163	13.5	61.0	0.73
chr7	101844072	101846110	CpG: 150	2038	150	1388	14.7	68.1	0.64
chr7	101852052	101853113	CpG: 87	1061	87	700	16.4	66.0	0.76
chr7	101860969	101861181	CpG: 18	212	18	147	17.0	69.3	0.72
chr7	101866728	101867016	CpG: 28	288	28	207	19.4	71.9	0.77
chr7	101873107	101874132	CpG: 90	1025	90	669	17.6	65.3	0.82
chr7	101877975	101878179	CpG: 15	204	15	115	14.7	56.4	0.93
chr7	101896239	101896607	CpG: 48	368	48	275	26.1	74.7	0.94
chr7	101913331	101916459	CpG: 265	3128	265	2186	16.9	69.9	0.70
chr7	101927343	101927610	CpG: 20	267	20	174	15.0	65.2	0.75
chr7	101933637	101934708	CpG: 168	1071	168	876	31.4	81.8	0.94
chr7	101944641	101944889	CpG: 19	248	19	147	15.3	59.3	0.88
chr7	101945456	101946664	CpG: 110	1208	110	811	18.2	67.1	0.81
chr7	101960548	101961126	CpG: 63	578	63	441	21.8	76.3	0.78
chr7	101977387	101977639	CpG: 21	252	21	153	16.7	60.7	0.90
chr7	101985040	101985588	CpG: 44	548	44	329	16.1	60.0	0.94
chr7	102016874	102017155	CpG: 22	281	22	173	15.7	61.6	0.84
chr7	102057987	102058246	CpG: 18	259	18	156	13.9	60.2	0.78
chr7	102063759	102063979	CpG: 24	220	24	150	21.8	68.2	0.94
chr7	102066888	102068089	CpG: 130	1201	130	882	21.6	73.4	0.81
chr7	102077448	102077659	CpG: 24	211	24	141	22.7	66.8	1.03
chr7	102092234	102093081	CpG: 79	847	79	594	18.7	70.1	0.77
chr7	102106236	102106624	CpG: 32	388	32	284	16.5	73.2	0.64
chr7	102114857	102115876	CpG: 114	1019	114	684	22.4	67.1	0.99
chr7	102126906	102127132	CpG: 18	226	18	142	15.9	62.8	0.87
chr7	102129210	102130618	CpG: 130	1408	130	981	18.5	69.7	0.76
chr7	102132444	102132828	CpG: 28	384	28	251	14.6	65.4	0.68
chr7	102133325	102133666	CpG: 25	341	25	232	14.7	68.0	0.63
chr7	102134680	102137408	CpG: 275	2728	275	1956	20.2	71.7	0.78
chr7	102209158	102209388	CpG: 20	230	20	141	17.4	61.3	0.94
chr7	102212872	102213801	CpG: 77	929	77	655	16.6	70.5	0.67
chr7	102270698	102271755	CpG: 89	1057	89	737	16.8	69.7	0.70
chr7	102411613	102411949	CpG: 33	336	33	235	19.6	69.9	0.80
chr7	102414717	102415591	CpG: 75	874	75	621	17.2	71.1	0.68
chr7	102476973	102477920	CpG: 83	947	83	671	17.5	70.9	0.72
chr7	102485439	102488532	CpG: 314	3093	314	2156	20.3	69.7	0.84
chr7	102494936	102496447	CpG: 128	1511	128	1034	16.9	68.4	0.73
chr7	102497211	102497427	CpG: 20	216	20	150	18.5	69.4	0.78
chr7	102502774	102503168	CpG: 57	394	57	298	28.9	75.6	1.02
chr7	102525232	102525908	CpG: 66	676	66	490	19.5	72.5	0.75
chr7	102540478	102541210	CpG: 68	732	68	534	18.6	73.0	0.72
chr7	102555737	102556394	CpG: 54	657	54	468	16.4	71.2	0.66
chr7	102567742	102568670	CpG: 65	928	65	617	14.0	66.5	0.64
chr7	102568918	102569158	CpG: 20	240	20	143	16.7	59.6	0.95
chr7	102571343	102571579	CpG: 17	236	17	141	14.4	59.7	0.83
chr7	102575384	102575987	CpG: 50	603	50	377	16.6	62.5	0.85
chr7	102590881	102591157	CpG: 19	276	19	165	13.8	59.8	0.78
chr7	102606836	102607158	CpG: 25	322	25	186	15.5	57.8	0.95
chr7	102623143	102623858	CpG: 62	715	62	502	17.3	70.2	0.70
chr7	102625857	102627057	CpG: 92	1200	92	780	15.3	65.0	0.73
chr7	102631697	102632408	CpG: 59	711	59	488	16.6	68.6	0.70
chr7	102644976	102645470	CpG: 56	494	56	345	22.7	69.8	0.94
chr7	102672060	102672451	CpG: 30	391	30	278	15.3	71.1	0.61
chr7	102683784	102685340	CpG: 159	1556	159	1141	20.4	73.3	0.77
chr7	102765468	102765848	CpG: 31	380	31	230	16.3	60.5	0.91
chr7	103008207	103008469	CpG: 31	262	31	193	23.7	73.7	0.90
chr7	103014347	103014628	CpG: 24	281	24	174	17.1	61.9	0.91
chr7	103063509	103064077	CpG: 54	568	54	370	19.0	65.1	0.92
chr7	103134343	103137992	CpG: 444	3649	444	2635	24.3	72.2	0.93
chr7	103142152	103142392	CpG: 18	240	18	144	15.0	60.0	0.85
chr7	103236356	103236579	CpG: 20	223	20	123	17.9	55.2	1.19
chr7	103292265	103292476	CpG: 15	211	15	126	14.2	59.7	0.82
chr7	103512342	103513208	CpG: 66	866	66	547	15.2	63.2	0.77
chr7	103556189	103556590	CpG: 29	401	29	262	14.5	65.3	0.68
chr7	103565269	103566238	CpG: 120	969	120	738	24.8	76.2	0.86
chr7	103603616	103605202	CpG: 181	1586	181	1204	22.8	75.9	0.80
chr7	103610432	103610663	CpG: 22	231	22	139	19.0	60.2	1.05
chr7	103617898	103618670	CpG: 108	772	108	560	28.0	72.5	1.06
chr7	103638343	103639155	CpG: 91	812	91	556	22.4	68.5	0.96
chr7	103681194	103681819	CpG: 70	625	70	458	22.4	73.3	0.84
chr7	103713681	103714228	CpG: 51	547	51	356	18.6	65.1	0.88
chr7	103750703	103751532	CpG: 96	829	96	648	23.2	78.2	0.76
chr7	103775109	103775566	CpG: 37	457	37	323	16.2	70.7	0.65
chr7	103782305	103782964	CpG: 83	659	83	481	25.2	73.0	0.95
chr7	103796166	103796765	CpG: 61	599	61	399	20.4	66.6	0.94
chr7	103811295	103811542	CpG: 20	247	20	166	16.2	67.2	0.73
chr7	103811793	103812712	CpG: 84	919	84	648	18.3	70.5	0.74
chr7	103829429	103829786	CpG: 29	357	29	248	16.2	69.5	0.70
chr7	103834924	103835611	CpG: 74	687	74	517	21.5	75.3	0.76
chr7	103878195	103878452	CpG: 23	257	23	146	17.9	56.8	1.13
chr7	103889745	103890335	CpG: 57	590	57	387	19.3	65.6	0.92
chr7	103910436	103910683	CpG: 20	247	20	166	16.2	67.2	0.73
chr7	103910934	103911853	CpG: 84	919	84	649	18.3	70.6	0.73
chr7	103928558	103928915	CpG: 29	357	29	248	16.2	69.5	0.70
chr7	103934053	103934740	CpG: 74	687	74	517	21.5	75.3	0.76
chr7	103971570	103971827	CpG: 23	257	23	146	17.9	56.8	1.13
chr7	103983124	103983714	CpG: 56	590	56	383	19.0	64.9	0.92
chr7	104003752	104003999	CpG: 20	247	20	166	16.2	67.2	0.73
chr7	104004465	104005169	CpG: 73	704	73	514	20.7	73.0	0.78
chr7	104063698	104064310	CpG: 52	612	52	404	17.0	66.0	0.79
chr7	104150324	104150604	CpG: 25	280	25	177	17.9	63.2	0.90
chr7	104389775	104390684	CpG: 100	909	100	656	22.0	72.2	0.86
chr7	104464070	104464795	CpG: 85	725	85	504	23.4	69.5	0.97
chr7	104535324	104535597	CpG: 22	273	22	166	16.1	60.8	0.88
chr7	104594299	104595515	CpG: 101	1216	101	772	16.6	63.5	0.83
chr7	104611861	104612145	CpG: 34	284	34	195	23.9	68.7	1.02
chr7	104658854	104659334	CpG: 41	480	41	316	17.1	65.8	0.79
chr7	104759704	104760126	CpG: 28	422	28	260	13.3	61.6	0.70
chr7	104760338	104760834	CpG: 62	496	62	368	25.0	74.2	0.91
chr7	104835399	104835683	CpG: 24	284	24	175	16.9	61.6	0.90
chr7	105303097	105304292	CpG: 165	1195	165	894	27.6	74.8	0.99
chr7	105385673	105385947	CpG: 22	274	22	197	16.1	71.9	0.62
chr7	105386773	105386988	CpG: 19	215	19	122	17.7	56.7	1.15
chr7	105396468	105396754	CpG: 24	286	24	178	16.8	62.2	0.88
chr7	105488146	105488386	CpG: 22	240	22	148	18.3	61.7	0.98
chr7	105548763	105549036	CpG: 20	273	20	166	14.7	60.8	0.80
chr7	105642598	105643774	CpG: 111	1176	111	826	18.9	70.2	0.77
chr7	105679771	105680056	CpG: 24	285	24	178	16.8	62.5	0.88
chr7	105723240	105723487	CpG: 17	247	17	142	13.8	57.5	0.85
chr7	105734886	105735163	CpG: 23	277	23	169	16.6	61.0	0.90
chr7	105803399	105803630	CpG: 19	231	19	139	16.5	60.2	0.92
chr7	105861260	105861541	CpG: 24	281	24	175	17.1	62.3	0.90
chr7	105877567	105877878	CpG: 24	311	24	191	15.4	61.4	0.83
chr7	105980905	105981179	CpG: 23	274	23	169	16.8	61.7	0.89
chr7	106225832	106226107	CpG: 23	275	23	168	16.7	61.1	0.91
chr7	106228567	106228836	CpG: 20	269	20	165	14.9	61.3	0.80
chr7	106254997	106255374	CpG: 32	377	32	274	17.0	72.7	0.64
chr7	106255940	106256208	CpG: 23	268	23	154	17.2	57.5	1.07
chr7	106289485	106289759	CpG: 24	274	24	171	17.5	62.4	0.91
chr7	106298595	106299106	CpG: 45	511	45	338	17.6	66.1	0.81
chr7	106327379	106329226	CpG: 147	1847	147	1180	15.9	63.9	0.78
chr7	106543878	106544130	CpG: 19	252	19	145	15.1	57.5	0.92
chr7	106559128	106559640	CpG: 41	512	41	315	16.0	61.5	0.85
chr7	106601647	106601921	CpG: 23	274	23	170	16.8	62.0	0.88
chr7	106605417	106605698	CpG: 24	281	24	175	17.1	62.3	0.90
chr7	106615955	106616181	CpG: 22	226	22	160	19.5	70.8	0.78
chr7	106699126	106699657	CpG: 38	531	38	307	14.3	57.8	0.87
chr7	106700216	106700456	CpG: 19	240	19	144	15.8	60.0	0.89
chr7	106701997	106703633	CpG: 223	1636	223	1252	27.3	76.5	0.95
chr7	106719618	106720215	CpG: 47	597	47	351	15.7	58.8	0.92
chr7	106724764	106725801	CpG: 83	1037	83	742	16.0	71.6	0.63
chr7	106727691	106727928	CpG: 20	237	20	142	16.9	59.9	0.96
chr7	106759936	106760171	CpG: 19	235	19	143	16.2	60.9	0.90
chr7	106774189	106774467	CpG: 19	278	19	168	13.7	60.4	0.76
chr7	106774804	106775078	CpG: 24	274	24	170	17.5	62.0	0.92
chr7	106806755	106807027	CpG: 24	272	24	170	17.6	62.5	0.91
chr7	106835731	106836638	CpG: 111	907	111	676	24.5	74.5	0.89
chr7	106837234	106837461	CpG: 19	227	19	132	16.7	58.1	1.00
chr7	106846216	106846569	CpG: 30	353	30	237	17.0	67.1	0.77
chr7	106897285	106897597	CpG: 37	312	37	235	23.7	75.3	0.87
chr7	106907701	106907931	CpG: 19	230	19	140	16.5	60.9	0.90
chr7	106981590	106981864	CpG: 23	274	23	170	16.8	62.0	0.88
chr7	106984987	106985270	CpG: 21	283	21	173	14.8	61.1	0.81
chr7	107191248	107192368	CpG: 109	1120	109	763	19.5	68.1	0.84
chr7	107199392	107199673	CpG: 23	281	23	174	16.4	61.9	0.87
chr7	107239136	107239410	CpG: 25	274	25	169	18.2	61.7	0.97
chr7	107271180	107271703	CpG: 51	523	51	383	19.5	73.2	0.73
chr7	107284428	107284816	CpG: 30	388	30	230	15.5	59.3	0.89
chr7	107324987	107325194	CpG: 19	207	19	150	18.4	72.5	0.71
chr7	107427051	107428096	CpG: 124	1045	124	759	23.7	72.6	0.91
chr7	107516117	107516346	CpG: 19	229	19	137	16.6	59.8	0.94
chr7	107582973	107583250	CpG: 22	277	22	170	15.9	61.4	0.85
chr7	107599627	107600954	CpG: 157	1327	157	995	23.7	75.0	0.85
chr7	107859529	107859759	CpG: 19	230	19	138	16.5	60.0	0.95
chr7	107975986	107977157	CpG: 142	1171	142	857	24.3	73.2	0.91
chr7	108183648	108184673	CpG: 79	1025	79	639	15.4	62.3	0.79
chr7	108191972	108192253	CpG: 23	281	23	174	16.4	61.9	0.87
chr7	108357637	108357845	CpG: 16	208	16	118	15.4	56.7	0.98
chr7	108358430	108358777	CpG: 36	347	36	257	20.7	74.1	0.76
chr7	108360453	108361405	CpG: 122	952	122	731	25.6	76.8	0.87
chr7	108485068	108485936	CpG: 80	868	80	604	18.4	69.6	0.86
chr7	108557566	108557798	CpG: 20	232	20	141	17.2	60.8	0.94
chr7	108879715	108880398	CpG: 59	683	59	457	17.3	66.9	0.77
chr7	108895943	108896674	CpG: 85	731	85	522	23.3	71.4	0.91
chr7	108976903	108978114	CpG: 110	1211	110	823	18.2	68.0	0.79
chr7	109047638	109047882	CpG: 22	244	22	150	18.0	61.5	0.98
chr7	109061647	109063011	CpG: 98	1364	98	827	14.4	60.6	0.79
chr7	109147976	109148212	CpG: 20	236	20	146	16.9	61.9	0.90
chr7	109165968	109166789	CpG: 64	821	64	575	15.6	70.0	0.64
chr7	109182501	109182775	CpG: 24	274	24	172	17.5	62.8	0.90
chr7	109199357	109199590	CpG: 17	233	17	137	14.6	58.8	0.86
chr7	109201817	109202103	CpG: 24	286	24	179	16.8	62.6	0.87
chr7	109209234	109209738	CpG: 51	504	51	343	20.2	68.1	0.89
chr7	109319596	109321859	CpG: 183	2263	183	1457	16.2	64.4	0.78
chr7	109444740	109445025	CpG: 24	285	24	174	16.8	61.1	0.92
chr7	109451549	109451788	CpG: 17	239	17	140	14.2	58.6	0.85
chr7	109507363	109507722	CpG: 27	359	27	212	15.0	59.1	0.86
chr7	109779607	109781412	CpG: 205	1805	205	1323	22.7	73.3	0.85
chr7	109850394	109851256	CpG: 78	862	78	565	18.1	65.5	0.84
chr7	109893948	109895070	CpG: 99	1122	99	737	17.6	65.7	0.83
chr7	109981897	109982170	CpG: 28	273	28	202	20.5	74.0	0.75
chr7	110037011	110037292	CpG: 24	281	24	174	17.1	61.9	0.91
chr7	110224169	110224400	CpG: 18	231	18	138	15.6	59.7	0.89
chr7	110235350	110235619	CpG: 25	269	25	168	18.6	62.5	0.96
chr7	110274821	110275049	CpG: 20	228	20	142	17.5	62.3	0.93
chr7	110722430	110722704	CpG: 24	274	24	169	17.5	61.7	0.94
chr7	111557746	111558021	CpG: 23	275	23	171	16.7	62.2	0.87
chr7	111766627	111766908	CpG: 24	281	24	175	17.1	62.3	0.90
chr7	111791772	111792052	CpG: 24	280	24	176	17.1	62.9	0.88
chr7	111848442	111848708	CpG: 23	266	23	164	17.3	61.7	0.93
chr7	111881447	111881757	CpG: 24	310	24	190	15.5	61.3	0.83
chr7	112030918	112031210	CpG: 24	292	24	177	16.4	60.6	0.90
chr7	112220976	112221262	CpG: 24	286	24	173	16.8	60.5	0.93
chr7	112367432	112367711	CpG: 23	279	23	170	16.5	60.9	0.90
chr7	112397409	112397684	CpG: 21	275	21	168	15.3	61.1	0.83
chr7	112567532	112567890	CpG: 28	358	28	212	15.6	59.2	0.89
chr7	112602013	112602287	CpG: 24	274	24	171	17.5	62.4	0.91
chr7	112739637	112739874	CpG: 18	237	18	140	15.2	59.1	0.90
chr7	112764138	112764380	CpG: 20	242	20	148	16.5	61.2	0.88
chr7	112880348	112880952	CpG: 77	604	77	457	25.5	75.7	0.90
chr7	112900255	112900643	CpG: 34	388	34	280	17.5	72.2	0.67
chr7	112934574	112934848	CpG: 24	274	24	171	17.5	62.4	0.91
chr7	112935045	112935321	CpG: 20	276	20	167	14.5	60.5	0.81
chr7	113046615	113047116	CpG: 44	501	44	330	17.6	65.9	0.83
chr7	113177912	113178190	CpG: 25	278	25	174	18.0	62.6	0.93
chr7	113281674	113281966	CpG: 22	292	22	176	15.1	60.3	0.83
chr7	113428064	113428342	CpG: 23	278	23	175	16.5	62.9	0.84
chr7	113524104	113525139	CpG: 107	1035	107	694	20.7	67.1	0.92
chr7	113527048	113527283	CpG: 19	235	19	141	16.2	60.0	0.91
chr7	113709604	113710414	CpG: 106	810	106	575	26.2	71.0	1.08
chr7	113768398	113769688	CpG: 117	1290	117	837	18.1	64.9	0.86
chr7	113869440	113870340	CpG: 68	900	68	627	15.1	69.7	0.62
chr7	113940152	113940413	CpG: 23	261	23	164	17.6	62.8	0.90
chr7	114108210	114108796	CpG: 62	586	62	389	21.2	66.4	0.98
chr7	114175999	114176279	CpG: 23	280	23	174	16.4	62.1	0.87
chr7	114179519	114179753	CpG: 16	234	16	139	13.7	59.4	0.80
chr7	114258509	114259093	CpG: 51	584	51	393	17.5	67.3	0.78
chr7	114443452	114443681	CpG: 17	229	17	137	14.8	59.8	0.84
chr7	114583141	114583360	CpG: 17	219	17	129	15.5	58.9	0.89
chr7	114678378	114678642	CpG: 20	264	20	156	15.2	59.1	0.87
chr7	114858290	114858555	CpG: 23	265	23	166	17.4	62.6	0.90
chr7	114913027	114913416	CpG: 45	389	45	290	23.1	74.6	0.83
chr7	114938116	114938382	CpG: 22	266	22	165	16.5	62.0	0.87
chr7	115063752	115064071	CpG: 28	319	28	195	17.6	61.1	0.95
chr7	115179692	115179968	CpG: 20	276	20	162	14.5	58.7	0.87
chr7	115284953	115285193	CpG: 18	240	18	141	15.0	58.8	0.89
chr7	115321306	115321542	CpG: 20	236	20	143	16.9	60.6	0.95
chr7	115390834	115391047	CpG: 16	213	16	116	15.0	54.5	1.03
chr7	115391650	115392032	CpG: 40	382	40	284	20.9	74.3	0.76
chr7	115399686	115402557	CpG: 249	2871	249	1803	17.3	62.8	0.88
chr7	115449294	115449524	CpG: 21	230	21	141	18.3	61.3	0.98
chr7	115559650	115559929	CpG: 25	279	25	176	17.9	63.1	0.91
chr7	115776637	115776914	CpG: 24	277	24	168	17.3	60.6	0.94
chr7	116161414	116161651	CpG: 19	237	19	145	16.0	61.2	0.88
chr7	116236879	116237904	CpG: 97	1025	97	697	18.9	68.0	0.84
chr7	116752333	116752894	CpG: 38	561	38	325	13.5	57.9	0.82
chr7	116754327	116754557	CpG: 18	230	18	139	15.7	60.4	0.86
chr7	116965563	116965836	CpG: 23	273	23	173	16.8	63.4	0.85
chr7	116975539	116975818	CpG: 23	279	23	167	16.5	59.9	0.93
chr7	117073981	117074252	CpG: 20	271	20	163	14.8	60.1	0.83
chr7	117081479	117081715	CpG: 20	236	20	143	16.9	60.6	0.95
chr7	117144422	117144700	CpG: 24	278	24	174	17.3	62.6	0.89
chr7	117149102	117149335	CpG: 17	233	17	141	14.6	60.5	0.82
chr7	117246227	117246499	CpG: 22	272	22	160	16.2	58.8	0.95
chr7	117496958	117497437	CpG: 40	479	40	349	16.7	72.9	0.63
chr7	117525306	117525964	CpG: 85	658	85	489	25.8	74.3	0.95
chr7	117724021	117724248	CpG: 18	227	18	135	15.9	59.5	0.90
chr7	117757519	117757789	CpG: 22	270	22	174	16.3	64.4	0.80
chr7	117814553	117815366	CpG: 95	813	95	602	23.4	74.0	0.85
chr7	117839681	117841838	CpG: 159	2157	159	1368	14.7	63.4	0.73
chr7	117851724	117852005	CpG: 23	281	23	173	16.4	61.6	0.88
chr7	117953379	117954029	CpG: 48	650	48	434	14.8	66.8	0.66
chr7	117986879	117987653	CpG: 97	774	97	573	25.1	74.0	0.94
chr7	118028225	118028499	CpG: 22	274	22	169	16.1	61.7	0.86
chr7	118039184	118039459	CpG: 23	275	23	165	16.7	60.0	0.93
chr7	118177561	118178290	CpG: 93	729	93	553	25.5	75.9	0.90
chr7	118181395	118181655	CpG: 19	260	19	157	14.6	60.4	0.82
chr7	118268311	118269440	CpG: 143	1129	143	795	25.3	70.4	1.03
chr7	118386250	118386489	CpG: 20	239	20	142	16.7	59.4	0.96
chr7	118395652	118395873	CpG: 17	221	17	132	15.4	59.7	0.87
chr7	118547776	118548046	CpG: 25	270	25	163	18.5	60.4	1.02
chr7	118638124	118640087	CpG: 158	1963	158	1264	16.1	64.4	0.78
chr7	118740621	118740894	CpG: 22	273	22	166	16.1	60.8	0.88
chr7	118742684	118742947	CpG: 33	263	33	185	25.1	70.3	1.03
chr7	118756855	118757129	CpG: 22	274	22	169	16.1	61.7	0.85
chr7	118794866	118795166	CpG: 27	300	27	208	18.0	69.3	0.84
chr7	118871888	118872162	CpG: 24	274	24	171	17.5	62.4	0.91
chr7	119055728	119056002	CpG: 23	274	23	170	16.8	62.0	0.88
chr7	119110641	119110924	CpG: 24	283	24	174	17.0	61.5	0.91
chr7	119188604	119189527	CpG: 128	923	128	687	27.7	74.4	1.00
chr7	119286168	119286411	CpG: 19	243	19	149	15.6	61.3	0.86
chr7	119499666	119500167	CpG: 58	501	58	325	23.2	64.9	1.10
chr7	119529806	119530399	CpG: 43	593	43	359	14.5	60.5	0.80
chr7	119556607	119556888	CpG: 24	281	24	175	17.1	62.3	0.90
chr7	119679487	119679761	CpG: 24	274	24	173	17.5	63.1	0.88
chr7	119986248	119986538	CpG: 22	290	22	172	15.2	59.3	0.87
chr7	120173988	120174394	CpG: 53	406	53	312	26.1	76.8	0.88
chr7	120313954	120314192	CpG: 18	238	18	145	15.1	60.9	0.84
chr7	120363054	120363284	CpG: 17	230	17	142	14.8	61.7	0.79
chr7	120675231	120675505	CpG: 23	274	23	170	16.8	62.0	0.88
chr7	120902214	120902439	CpG: 20	225	20	137	17.8	60.9	0.97
chr7	121222264	121222528	CpG: 20	264	20	160	15.2	60.6	0.83
chr7	121265767	121266117	CpG: 25	350	25	202	14.3	57.7	0.88
chr7	121266904	121267295	CpG: 33	391	33	281	16.9	71.9	0.66
chr7	121296800	121297081	CpG: 24	281	24	175	17.1	62.3	0.90
chr7	121546022	121546296	CpG: 25	274	25	172	18.2	62.8	0.93
chr7	121588182	121589225	CpG: 102	1043	102	690	19.6	66.2	0.90
chr7	121590404	121590827	CpG: 32	423	32	242	15.1	57.2	0.93
chr7	122172411	122173511	CpG: 107	1100	107	739	19.5	67.2	0.86
chr7	122265875	122266620	CpG: 74	745	74	456	19.9	61.2	1.07
chr7	122375311	122375667	CpG: 37	356	37	268	20.8	75.3	0.73
chr7	122376262	122376477	CpG: 17	215	17	124	15.8	57.7	0.98
chr7	122556449	122556728	CpG: 24	279	24	171	17.2	61.3	0.93
chr7	122644849	122646005	CpG: 81	1156	81	689	14.0	59.6	0.79
chr7	122711091	122711941	CpG: 106	850	106	649	24.9	76.4	0.87
chr7	122964542	122964816	CpG: 22	274	22	169	16.1	61.7	0.85
chr7	122982463	122982748	CpG: 25	285	25	180	17.5	63.2	0.90
chr7	123162098	123162327	CpG: 22	229	22	141	19.2	61.6	1.03
chr7	123183163	123183436	CpG: 21	273	21	168	15.4	61.5	0.83
chr7	123188837	123189702	CpG: 89	865	89	576	20.6	66.6	0.94
chr7	123267855	123268129	CpG: 20	274	20	166	14.6	60.6	0.80
chr7	123296736	123297009	CpG: 20	273	20	170	14.7	62.3	0.76
chr7	123456177	123456391	CpG: 17	214	17	130	15.9	60.7	0.87
chr7	123459812	123460539	CpG: 64	727	64	461	17.6	63.4	0.89
chr7	123554467	123554894	CpG: 32	427	32	256	15.0	60.0	0.84
chr7	123600419	123600846	CpG: 31	427	31	256	14.5	60.0	0.81
chr7	123615910	123616552	CpG: 53	642	53	436	16.5	67.9	0.72
chr7	123617874	123618125	CpG: 22	251	22	182	17.5	72.5	0.69
chr7	123619782	123622151	CpG: 161	2369	161	1405	13.6	59.3	0.77
chr7	123626165	123626842	CpG: 55	677	55	447	16.2	66.0	0.75
chr7	123632475	123633278	CpG: 68	803	68	507	16.9	63.1	0.85
chr7	123685128	123685341	CpG: 15	213	15	124	14.1	58.2	0.84
chr7	123715718	123715942	CpG: 22	224	22	140	19.6	62.5	1.04
chr7	124049717	124050001	CpG: 23	284	23	176	16.2	62.0	0.86
chr7	124137129	124137407	CpG: 25	278	25	175	18.0	62.9	0.92
chr7	124202260	124203471	CpG: 133	1211	133	845	22.0	69.8	0.90
chr7	124222740	124223058	CpG: 22	318	22	175	13.8	55.0	0.93
chr7	124276775	124277025	CpG: 20	250	20	156	16.0	62.4	0.83
chr7	124352743	124353010	CpG: 21	267	21	162	15.7	60.7	0.87
chr7	124367036	124367310	CpG: 23	274	23	171	16.8	62.4	0.87
chr7	124505604	124505882	CpG: 23	278	23	173	16.5	62.2	0.86
chr7	124844659	124844970	CpG: 24	311	24	190	15.4	61.1	0.83
chr7	124849444	124849943	CpG: 44	499	44	343	17.6	68.7	0.75
chr7	124851184	124851974	CpG: 53	790	53	524	13.4	66.3	0.76
chr7	124874374	124874639	CpG: 21	265	21	156	15.8	58.9	0.95
chr7	124928082	124928359	CpG: 21	277	21	165	15.2	59.6	0.86
chr7	124948602	124948824	CpG: 17	222	17	134	15.3	60.4	0.85
chr7	125016645	125016881	CpG: 20	236	20	142	16.9	60.2	0.96
chr7	125065084	125066308	CpG: 139	1224	139	864	22.7	70.6	0.91
chr7	125079904	125080444	CpG: 52	540	52	393	19.3	72.8	0.73
chr7	125116946	125117195	CpG: 18	249	18	149	14.5	59.8	0.82
chr7	125226224	125226502	CpG: 25	278	25	174	18.0	62.6	0.93
chr7	125254037	125254273	CpG: 17	236	17	137	14.4	58.1	0.88
chr7	125302077	125302294	CpG: 18	217	18	133	16.6	61.3	0.89
chr7	125313615	125313896	CpG: 23	281	23	174	16.4	61.9	0.87
chr7	125331832	125332110	CpG: 22	278	22	169	15.8	60.8	0.87
chr7	125348728	125350356	CpG: 180	1628	180	1180	22.1	72.5	0.84
chr7	125381856	125382060	CpG: 15	204	15	113	14.7	55.4	0.98
chr7	125397609	125397833	CpG: 16	224	16	131	14.3	58.5	0.85
chr7	126081473	126081731	CpG: 19	258	19	163	14.7	63.2	0.75
chr7	126081999	126083746	CpG: 134	1747	134	1132	15.3	64.8	0.73
chr7	126104361	126104644	CpG: 25	283	25	173	17.7	61.1	0.95
chr7	126247232	126247549	CpG: 32	317	32	208	20.2	65.6	0.94
chr7	126376548	126376821	CpG: 20	273	20	165	14.7	60.4	0.81
chr7	126659799	126660074	CpG: 24	275	24	170	17.5	61.8	0.93
chr7	126879128	126879376	CpG: 19	248	19	150	15.3	60.5	0.86
chr7	127308967	127309197	CpG: 19	230	19	140	16.5	60.9	0.90
chr7	127500850	127501124	CpG: 23	274	23	170	16.8	62.0	0.88
chr7	127607886	127608095	CpG: 17	209	17	125	16.3	59.8	0.91
chr7	127708329	127708559	CpG: 18	230	18	138	15.7	60.0	0.88
chr7	127708982	127709270	CpG: 26	288	26	181	18.1	62.8	0.93
chr7	128118491	128118819	CpG: 32	328	32	241	19.5	73.5	0.73
chr7	128524107	128524385	CpG: 25	278	25	174	18.0	62.6	0.93
chr7	128562919	128565824	CpG: 258	2905	258	1845	17.8	63.5	0.88
chr7	128659273	128659863	CpG: 77	590	77	433	26.1	73.4	0.99
chr7	128696011	128696212	CpG: 15	201	15	117	14.9	58.2	0.90
chr7	128703473	128704703	CpG: 162	1230	162	914	26.3	74.3	0.96
chr7	128896825	128897575	CpG: 76	750	76	499	20.3	66.5	0.92
chr7	128899383	128900664	CpG: 124	1281	124	886	19.4	69.2	0.81
chr7	128963276	128964180	CpG: 84	904	84	600	18.6	66.4	0.85
chr7	129098356	129098629	CpG: 24	273	24	167	17.6	61.2	0.95
chr7	129291809	129292091	CpG: 24	282	24	170	17.0	60.3	0.95
chr7	129342785	129344480	CpG: 235	1695	235	1276	27.7	75.3	0.98
chr7	129415099	129416174	CpG: 97	1075	97	714	18.0	66.4	0.82
chr7	129416579	129416853	CpG: 23	274	23	170	16.8	62.0	0.88
chr7	129419398	129419616	CpG: 14	218	14	150	12.8	68.8	0.77
chr7	129419888	129420141	CpG: 16	253	16	173	12.6	68.4	0.77
chr7	129447184	129448541	CpG: 102	1357	102	863	15.0	63.6	0.75
chr7	129478117	129480289	CpG: 185	2172	185	1477	17.0	68.0	0.74
chr7	129512765	129513277	CpG: 39	512	39	338	15.2	66.0	0.70
chr7	129552162	129552787	CpG: 67	625	67	445	21.4	71.2	0.85
chr7	129582268	129583603	CpG: 91	1335	91	846	13.6	63.4	0.68
chr7	129583754	129583964	CpG: 17	210	17	152	16.2	72.4	0.62
chr7	129600771	129601047	CpG: 22	276	22	169	15.9	61.2	0.86
chr7	129625780	129626050	CpG: 19	270	19	163	14.1	60.4	0.79
chr7	129655416	129655829	CpG: 37	413	37	259	17.9	62.7	0.91
chr7	129662628	129664318	CpG: 167	1690	167	1261	19.8	74.6	0.71
chr7	129672956	129673764	CpG: 101	808	101	609	25.0	75.4	0.95
chr7	129684253	129684534	CpG: 24	281	24	175	17.1	62.3	0.89
chr7	129689623	129689889	CpG: 20	266	20	163	15.0	61.3	0.82
chr7	129717239	129717996	CpG: 107	757	107	586	28.3	77.4	0.94
chr7	129721198	129722187	CpG: 98	989	98	690	19.8	69.8	0.81
chr7	129722677	129722954	CpG: 24	277	24	172	17.3	62.1	0.91
chr7	129767408	129767927	CpG: 60	519	60	350	23.1	67.4	1.02
chr7	129774615	129775502	CpG: 61	887	61	598	13.8	67.4	0.61
chr7	129788398	129789043	CpG: 57	645	57	410	17.7	63.6	0.88
chr7	129801448	129801726	CpG: 24	278	24	174	17.3	62.6	0.89
chr7	129842652	129844448	CpG: 199	1796	199	1345	22.2	74.9	0.79
chr7	129989431	129989725	CpG: 24	294	24	182	16.3	61.9	0.86
chr7	130001147	130002028	CpG: 68	881	68	606	15.4	68.8	0.65
chr7	130009537	130009941	CpG: 32	404	32	255	15.8	63.1	0.80
chr7	130051210	130051787	CpG: 62	577	62	396	21.5	68.6	0.92
chr7	130102982	130104103	CpG: 104	1121	104	827	18.6	73.8	0.68
chr7	130108917	130109191	CpG: 24	274	24	171	17.5	62.4	0.91
chr7	130110093	130110371	CpG: 22	278	22	172	15.8	61.9	0.84
chr7	130110640	130111085	CpG: 44	445	44	317	19.8	71.2	0.79
chr7	130143079	130144034	CpG: 118	955	118	705	24.7	73.8	0.91
chr7	130155158	130155849	CpG: 48	691	48	463	13.9	67.0	0.62
chr7	130166931	130167181	CpG: 24	250	24	176	19.2	70.4	0.78
chr7	130167383	130167602	CpG: 19	219	19	150	17.4	68.5	0.76
chr7	130175510	130176149	CpG: 59	639	59	401	18.5	62.8	0.97
chr7	130182079	130183074	CpG: 112	995	112	752	22.5	75.6	0.79
chr7	130203501	130204228	CpG: 75	727	75	553	20.6	76.1	0.77
chr7	130223282	130223775	CpG: 47	493	47	367	19.1	74.4	0.70
chr7	130228135	130229521	CpG: 108	1386	108	948	15.6	68.4	0.67
chr7	130250690	130251628	CpG: 91	938	91	678	19.4	72.3	0.75
chr7	130274974	130275255	CpG: 22	281	22	172	15.7	61.2	0.85
chr7	130367329	130368173	CpG: 60	844	60	517	14.2	61.3	0.77
chr7	130368842	130369046	CpG: 16	204	16	123	15.7	60.3	0.86
chr7	130400372	130400650	CpG: 24	278	24	174	17.3	62.6	0.89
chr7	130439166	130440813	CpG: 138	1647	138	1084	16.8	65.8	0.78
chr7	130457547	130458162	CpG: 78	615	78	471	25.4	76.6	0.87
chr7	130482153	130482457	CpG: 41	304	41	229	27.0	75.3	0.96
chr7	130501300	130502432	CpG: 126	1132	126	849	22.3	75.0	0.80
chr7	130513059	130513283	CpG: 18	224	18	133	16.1	59.4	0.93
chr7	130537408	130538743	CpG: 117	1335	117	894	17.5	67.0	0.78
chr7	130653236	130653473	CpG: 19	237	19	139	16.0	58.6	0.94
chr7	130746852	130748124	CpG: 115	1272	115	840	18.1	66.0	0.84
chr7	130750836	130751072	CpG: 17	236	17	139	14.4	58.9	0.85
chr7	130763922	130764203	CpG: 23	281	23	173	16.4	61.6	0.87
chr7	130789127	130790124	CpG: 84	997	84	715	16.9	71.7	0.66
chr7	130815266	130816262	CpG: 118	996	118	734	23.7	73.7	0.87
chr7	130829802	130830065	CpG: 19	263	19	161	14.4	61.2	0.79
chr7	130924523	130925719	CpG: 150	1196	150	892	25.1	74.6	0.90
chr7	130976329	130976842	CpG: 44	513	44	361	17.2	70.4	0.69
chr7	130986540	130986808	CpG: 26	268	26	170	19.4	63.4	0.98
chr7	131075510	131076080	CpG: 54	570	54	399	18.9	70.0	0.77
chr7	131091579	131095801	CpG: 375	4222	375	2909	17.8	68.9	0.75
chr7	131096247	131096651	CpG: 32	404	32	249	15.8	61.6	0.83
chr7	131097150	131097892	CpG: 51	742	51	403	13.7	54.3	0.93
chr7	131098789	131099177	CpG: 36	388	36	271	18.6	69.8	0.77
chr7	131138657	131139604	CpG: 74	947	74	668	15.6	70.5	0.65
chr7	131265547	131266405	CpG: 86	858	86	607	20.0	70.7	0.80
chr7	131364505	131364871	CpG: 27	366	27	226	14.8	61.7	0.80
chr7	131383612	131384206	CpG: 52	594	52	402	17.5	67.7	0.77
chr7	131454031	131455154	CpG: 81	1123	81	763	14.4	67.9	0.63
chr7	131517791	131518030	CpG: 20	239	20	140	16.7	58.6	1.00
chr7	131518696	131518974	CpG: 25	278	25	170	18.0	61.2	0.96
chr7	131543420	131543811	CpG: 33	391	33	282	16.9	72.1	0.65
chr7	131599092	131599377	CpG: 24	285	24	177	16.8	62.1	0.89
chr7	131627083	131627319	CpG: 20	236	20	143	16.9	60.6	0.95
chr7	131695393	131695608	CpG: 19	215	19	137	17.7	63.7	0.87
chr7	131754417	131755061	CpG: 58	644	58	438	18.0	68.0	0.79
chr7	131799897	131800681	CpG: 65	784	65	528	16.6	67.3	0.75
chr7	131804619	131806991	CpG: 184	2372	184	1454	15.5	61.3	0.83
chr7	131891009	131891629	CpG: 43	620	43	360	13.9	58.1	0.82
chr7	131982532	131983441	CpG: 111	909	111	673	24.4	74.0	0.89
chr7	132047361	132048893	CpG: 191	1532	191	1083	24.9	70.7	1.00
chr7	132158608	132158882	CpG: 23	274	23	170	16.8	62.0	0.88
chr7	132353651	132353930	CpG: 24	279	24	170	17.2	60.9	0.94
chr7	132376305	132376696	CpG: 33	391	33	287	16.9	73.4	0.63
chr7	132423106	132425859	CpG: 243	2753	243	1803	17.7	65.5	0.83
chr7	132427437	132427786	CpG: 34	349	34	254	19.5	72.8	0.77
chr7	132440249	132440530	CpG: 23	281	23	172	16.4	61.2	0.89
chr7	132459948	132460152	CpG: 15	204	15	115	14.7	56.4	0.94
chr7	132479082	132479348	CpG: 21	266	21	166	15.8	62.4	0.82
chr7	132491531	132491760	CpG: 17	229	17	134	14.8	58.5	0.88
chr7	132640231	132640512	CpG: 23	281	23	174	16.4	61.9	0.87
chr7	132645346	132646076	CpG: 74	730	74	508	20.3	69.6	0.86
chr7	132873314	132874654	CpG: 153	1340	153	980	22.8	73.1	0.85
chr7	132875500	132875813	CpG: 24	313	24	208	15.3	66.5	0.71
chr7	133074434	133074724	CpG: 26	290	26	208	17.9	71.7	0.71
chr7	133129732	133130006	CpG: 25	274	25	177	18.2	64.6	0.89
chr7	133227913	133228421	CpG: 66	508	66	389	26.0	76.6	0.89
chr7	133235661	133235872	CpG: 15	211	15	123	14.2	58.3	0.85
chr7	133264121	133264443	CpG: 35	322	35	222	21.7	68.9	0.92
chr7	133897003	133899056	CpG: 223	2053	223	1462	21.7	71.2	0.86
chr7	134219379	134219586	CpG: 15	207	15	116	14.5	56.0	0.95
chr7	134220100	134220491	CpG: 37	391	37	288	18.9	73.7	0.70
chr7	134239101	134239322	CpG: 16	221	16	124	14.5	56.1	0.95
chr7	134403276	134403863	CpG: 54	587	54	388	18.4	66.1	0.84
chr7	134498529	134499176	CpG: 47	647	47	440	14.5	68.0	0.63
chr7	134572598	134572841	CpG: 18	243	18	141	14.8	58.0	0.90
chr7	135031717	135031957	CpG: 20	240	20	147	16.7	61.2	0.91
chr7	135216322	135216564	CpG: 22	242	22	148	18.2	61.2	0.97
chr7	135218049	135218332	CpG: 23	283	23	158	16.3	55.8	1.05
chr7	135433875	135434105	CpG: 21	230	21	144	18.3	62.6	0.95
chr7	135435363	135435591	CpG: 17	228	17	144	14.9	63.2	0.75
chr7	135624582	135625357	CpG: 75	775	75	534	19.4	68.9	0.82
chr7	135766400	135767348	CpG: 93	948	93	652	19.6	68.8	0.83
chr7	136164860	136165085	CpG: 21	225	21	139	18.7	61.8	1.01
chr7	136294145	136294768	CpG: 61	623	61	409	19.6	65.7	0.91
chr7	136478039	136478799	CpG: 85	760	85	555	22.4	73.0	0.85
chr7	136518995	136519769	CpG: 87	774	87	558	22.5	72.1	0.87
chr7	136521155	136521432	CpG: 23	277	23	171	16.6	61.7	0.88
chr7	136541444	136541779	CpG: 27	335	27	217	16.1	64.8	0.79
chr7	136554190	136555028	CpG: 66	838	66	529	15.8	63.1	0.79
chr7	136633103	136633382	CpG: 24	279	24	175	17.2	62.7	0.88
chr7	136817042	136817784	CpG: 58	742	58	464	15.6	62.5	0.80
chr7	136961880	136962117	CpG: 20	237	20	146	16.9	61.6	0.91
chr7	136969606	136970049	CpG: 55	443	55	327	24.8	73.8	0.91
chr7	136970976	136971239	CpG: 19	263	19	161	14.4	61.2	0.77
chr7	137150857	137151066	CpG: 15	209	15	122	14.4	58.4	0.86
chr7	137284303	137284734	CpG: 41	431	41	289	19.0	67.1	0.86
chr7	137477126	137477409	CpG: 24	283	24	176	17.0	62.2	0.89
chr7	137897955	137898236	CpG: 21	281	21	172	14.9	61.2	0.81
chr7	137939249	137939525	CpG: 23	276	23	168	16.7	60.9	0.91
chr7	137993872	137994146	CpG: 24	274	24	171	17.5	62.4	0.91
chr7	138026400	138026674	CpG: 27	274	27	174	19.7	63.5	0.99
chr7	138089625	138089853	CpG: 21	228	21	138	18.4	60.5	1.01
chr7	138140904	138141214	CpG: 23	310	23	187	14.8	60.3	0.82
chr7	138178792	138181132	CpG: 157	2340	157	1491	13.4	63.7	0.66
chr7	138282451	138282768	CpG: 20	317	20	187	12.6	59.0	1.38
chr7	138283050	138283262	CpG: 14	212	14	123	13.2	58.0	1.65
chr7	138411342	138411579	CpG: 18	237	18	144	15.2	60.8	0.85
chr7	138473814	138474106	CpG: 20	292	20	188	13.7	64.4	0.66
chr7	138490897	138491114	CpG: 19	217	19	128	17.5	59.0	1.01
chr7	138501468	138501712	CpG: 17	244	17	144	13.9	59.0	0.80
chr7	138577215	138577521	CpG: 24	306	24	194	15.7	63.4	0.78
chr7	138587148	138587422	CpG: 24	274	24	171	17.5	62.4	0.91
chr7	138593155	138593385	CpG: 20	230	20	140	17.4	60.9	0.97
chr7	138868035	138868305	CpG: 22	270	22	166	16.3	61.5	0.87
chr7	139079622	139079896	CpG: 24	274	24	171	17.5	62.4	0.91
chr7	139155470	139156726	CpG: 137	1256	137	909	21.8	72.4	0.83
chr7	139288968	139289206	CpG: 17	238	17	143	14.3	60.1	0.81
chr7	139311080	139311845	CpG: 63	765	63	495	16.5	64.7	0.79
chr7	139320244	139320525	CpG: 20	281	20	171	14.2	60.9	0.78
chr7	139455547	139455786	CpG: 23	239	23	177	19.2	74.1	0.71
chr7	139456666	139456914	CpG: 18	248	18	135	14.5	54.4	1.02
chr7	139464915	139465136	CpG: 18	221	18	133	16.3	60.2	0.91
chr7	139667306	139667523	CpG: 18	217	18	133	16.6	61.3	0.90
chr7	139703419	139703655	CpG: 19	236	19	145	16.1	61.4	0.88
chr7	139750263	139750479	CpG: 16	216	16	143	14.8	66.2	0.68
chr7	139769616	139770972	CpG: 162	1356	162	987	23.9	72.8	0.90
chr7	139772056	139772330	CpG: 25	274	25	172	18.2	62.8	0.94
chr7	139976670	139977573	CpG: 74	903	74	628	16.4	69.5	0.95
chr7	140180814	140181023	CpG: 17	209	17	130	16.3	62.2	0.85
chr7	140182384	140182652	CpG: 29	268	29	180	21.6	67.2	0.96
chr7	140293868	140295129	CpG: 163	1261	163	967	25.9	76.7	0.89
chr7	140348206	140349181	CpG: 112	975	112	719	23.0	73.7	0.85
chr7	140370506	140370744	CpG: 19	238	19	143	16.0	60.1	0.91
chr7	140404131	140404332	CpG: 17	201	17	120	16.9	59.7	0.98
chr7	140410382	140410604	CpG: 16	222	16	131	14.4	59.0	0.83
chr7	140413891	140414760	CpG: 75	869	75	608	17.3	70.0	0.71
chr7	140421648	140423143	CpG: 121	1495	121	966	16.2	64.6	0.78
chr7	140446923	140447134	CpG: 24	211	24	135	22.7	64.0	1.11
chr7	140508809	140509066	CpG: 20	257	20	155	15.6	60.3	0.87
chr7	140543975	140545497	CpG: 169	1522	169	1056	22.2	69.4	0.92
chr7	140645187	140645424	CpG: 16	237	16	140	13.5	59.1	0.78
chr7	140653390	140654833	CpG: 117	1443	117	810	16.2	56.1	1.03
chr7	140672419	140674012	CpG: 160	1593	160	1053	20.1	66.1	0.92
chr7	140738214	140738499	CpG: 24	285	24	175	16.8	61.4	0.91
chr7	140795929	140797261	CpG: 136	1332	136	950	20.4	71.3	0.80
chr7	140813362	140814009	CpG: 51	647	51	396	15.8	61.2	0.85
chr7	140833387	140834240	CpG: 66	853	66	586	15.5	68.7	0.66
chr7	140835709	140836042	CpG: 29	333	29	199	17.4	59.8	0.98
chr7	140836867	140837857	CpG: 130	990	130	765	26.3	77.3	0.88
chr7	141029772	141030008	CpG: 16	236	16	133	13.6	56.4	0.86
chr7	141090402	141091989	CpG: 208	1587	208	1195	26.2	75.3	0.94
chr7	141203446	141203712	CpG: 21	266	21	163	15.8	61.3	0.85
chr7	141263901	141264575	CpG: 56	674	56	477	16.6	70.8	0.92
chr7	141375766	141377145	CpG: 158	1379	158	942	22.9	68.3	0.99
chr7	141427842	141428768	CpG: 72	926	72	655	15.6	70.7	0.62
chr7	141489163	141491249	CpG: 304	2086	304	1556	29.1	74.6	1.05
chr7	141543822	141545110	CpG: 126	1288	126	887	19.6	68.9	0.83
chr7	141547746	141548012	CpG: 26	266	26	170	19.5	63.9	0.97
chr7	141584927	141585417	CpG: 43	490	43	365	17.6	74.5	0.63
chr7	141606058	141606327	CpG: 24	269	24	177	17.8	65.8	0.82
chr7	141712287	141712810	CpG: 58	523	58	398	22.2	76.1	0.78
chr7	141724522	141724803	CpG: 23	281	23	173	16.4	61.6	0.88
chr7	141745270	141746000	CpG: 52	730	52	494	14.2	67.7	0.62
chr7	141748806	141749043	CpG: 18	237	18	145	15.2	61.2	0.83
chr7	141749498	141749989	CpG: 48	491	48	350	19.6	71.3	0.77
chr7	141752559	141752801	CpG: 20	242	20	145	16.5	59.9	0.95
chr7	141780679	141780960	CpG: 25	281	25	174	17.8	61.9	0.95
chr7	141792599	141793777	CpG: 129	1178	129	825	21.9	70.0	0.89
chr7	141794587	141794830	CpG: 18	243	18	145	14.8	59.7	0.84
chr7	141853847	141854160	CpG: 22	313	22	184	14.1	58.8	0.81
chr7	141871721	141871998	CpG: 23	277	23	170	16.6	61.4	0.89
chr7	141948236	141948472	CpG: 18	236	18	143	15.3	60.6	0.85
chr7	141954217	141955513	CpG: 160	1296	160	978	24.7	75.5	0.88
chr7	141967081	141967323	CpG: 17	242	17	145	14.0	59.9	0.80
chr7	141986940	141987818	CpG: 110	878	110	674	25.1	76.8	0.85
chr7	142010790	142011734	CpG: 102	944	102	659	21.6	69.8	0.95
chr7	142046069	142046335	CpG: 23	266	23	166	17.3	62.4	0.90
chr7	142101203	142101477	CpG: 24	274	24	170	17.5	62.0	0.92
chr7	142220008	142220244	CpG: 21	236	21	145	17.8	61.4	0.96
chr7	142238399	142239351	CpG: 112	952	112	689	23.5	72.4	0.90
chr7	142314398	142314671	CpG: 20	273	20	170	14.7	62.3	0.76
chr7	142328867	142329332	CpG: 36	465	36	281	15.5	60.4	0.85
chr7	142381802	142382196	CpG: 30	394	30	237	15.2	60.2	0.85
chr7	142386763	142388965	CpG: 234	2202	234	1544	21.3	70.1	0.87
chr7	142729840	142730110	CpG: 22	270	22	165	16.3	61.1	0.88
chr7	142812185	142812415	CpG: 18	230	18	139	15.7	60.4	0.87
chr7	142867062	142867532	CpG: 61	470	61	359	26.0	76.4	0.92
chr7	142985680	142985953	CpG: 23	273	23	173	16.8	63.4	0.85
chr7	143017177	143018239	CpG: 136	1062	136	822	25.6	77.4	0.86
chr7	143054030	143054419	CpG: 34	389	34	230	17.5	59.1	1.03
chr7	143107678	143107898	CpG: 21	220	21	145	19.1	65.9	0.91
chr7	143123714	143123988	CpG: 21	274	21	166	15.3	60.6	0.85
chr7	143242043	143242469	CpG: 33	426	33	256	15.5	60.1	0.86
chr7	143301401	143301712	CpG: 24	311	24	189	15.4	60.8	0.84
chr7	143522526	143522762	CpG: 18	236	18	141	15.3	59.7	0.87
chr7	143582511	143582797	CpG: 24	286	24	178	16.8	62.2	0.87
chr7	143697824	143698089	CpG: 19	265	19	162	14.3	61.1	0.77
chr7	143931957	143932569	CpG: 43	612	43	400	14.1	65.4	0.66
chr7	144015298	144015580	CpG: 22	282	22	172	15.6	61.0	0.85
chr7	144152597	144153282	CpG: 68	685	68	488	19.9	71.2	0.80
chr7	144209942	144211249	CpG: 124	1307	124	911	19.0	69.7	0.78
chr7	144379113	144379394	CpG: 26	281	26	176	18.5	62.6	0.95
chr7	144497939	144498175	CpG: 21	236	21	147	17.8	62.3	0.94
chr7	144643362	144644125	CpG: 81	763	81	534	21.2	70.0	0.87
chr7	144700845	144701204	CpG: 34	359	34	248	18.9	69.1	0.81
chr7	144717177	144718493	CpG: 154	1316	154	1001	23.4	76.1	0.81
chr7	144735803	144737503	CpG: 165	1700	165	1227	19.4	72.2	0.74
chr7	144764000	144764357	CpG: 37	357	37	278	20.7	77.9	0.72
chr7	144769398	144769667	CpG: 19	269	19	164	14.1	61.0	0.78
chr7	144778662	144778908	CpG: 19	246	19	134	15.4	54.5	1.09
chr7	144779776	144780166	CpG: 40	390	40	290	20.5	74.4	0.74
chr7	144783183	144783445	CpG: 22	262	22	161	16.8	61.5	0.92
chr7	144866275	144867087	CpG: 72	812	72	569	17.7	70.1	0.73
chr7	144979714	144980485	CpG: 72	771	72	536	18.7	69.5	0.78
chr7	145117040	145117811	CpG: 72	771	72	536	18.7	69.5	0.78
chr7	145165420	145165905	CpG: 36	485	36	325	14.8	67.0	0.66
chr7	145182137	145182696	CpG: 48	559	48	374	17.2	66.9	0.77
chr7	145220155	145220403	CpG: 21	248	21	148	16.9	59.7	0.98
chr7	145231167	145231408	CpG: 18	241	18	141	14.9	58.5	0.90
chr7	145275828	145276094	CpG: 27	266	27	170	20.3	63.9	1.01
chr7	145356033	145356255	CpG: 18	222	18	133	16.2	59.9	0.91
chr7	145361587	145361809	CpG: 20	222	20	135	18.0	60.8	0.98
chr7	145475953	145476488	CpG: 59	535	59	400	22.1	74.8	0.79
chr7	145476711	145476949	CpG: 17	238	17	143	14.3	60.1	0.80
chr7	145529350	145529587	CpG: 20	237	20	144	16.9	60.8	0.94
chr7	145534724	145534962	CpG: 17	238	17	143	14.3	60.1	0.80
chr7	145535197	145535732	CpG: 59	535	59	400	22.1	74.8	0.79
chr7	145583585	145584210	CpG: 54	625	54	470	17.3	75.2	0.61
chr7	145641010	145641246	CpG: 20	236	20	144	16.9	61.0	0.93
chr7	145844855	145845129	CpG: 24	274	24	171	17.5	62.4	0.91
chr7	146016463	146016955	CpG: 66	492	66	368	26.8	74.8	0.96
chr7	146017155	146017412	CpG: 20	257	20	155	15.6	60.3	0.86
chr7	146124559	146124794	CpG: 16	235	16	139	13.6	59.1	0.79
chr7	146170865	146171106	CpG: 18	241	18	145	14.9	60.2	0.84
chr7	146240087	146240323	CpG: 21	236	21	144	17.8	61.0	0.97
chr7	146265948	146266225	CpG: 23	277	23	175	16.6	63.2	0.84
chr7	146540588	146541136	CpG: 46	548	46	399	16.8	72.8	0.63
chr7	146552752	146553057	CpG: 23	305	23	178	15.1	58.4	0.89
chr7	146816276	146816550	CpG: 24	274	24	169	17.5	61.7	0.93
chr7	146835132	146835361	CpG: 20	229	20	138	17.5	60.3	0.97
chr7	146877413	146877948	CpG: 55	535	55	400	20.6	74.8	0.74
chr7	146930103	146930344	CpG: 21	241	21	147	17.4	61.0	0.97
chr7	146932648	146932986	CpG: 27	338	27	214	16.0	63.3	0.89
chr7	146964747	146964994	CpG: 19	247	19	146	15.4	59.1	0.90
chr7	147107290	147107586	CpG: 25	296	25	179	16.9	60.5	0.93
chr7	147140450	147140720	CpG: 19	270	19	161	14.1	59.6	0.81
chr7	147199219	147199529	CpG: 25	310	25	187	16.1	60.3	0.89
chr7	147295992	147297040	CpG: 92	1048	92	701	17.6	66.9	0.78
chr7	147398260	147398500	CpG: 20	240	20	148	16.7	61.7	0.90
chr7	147511085	147511359	CpG: 25	274	25	169	18.2	61.7	0.97
chr7	147560890	147561172	CpG: 23	282	23	179	16.3	63.5	0.82
chr7	147583951	147584181	CpG: 21	230	21	142	18.3	61.7	0.97
chr7	147649946	147650174	CpG: 17	228	17	135	14.9	59.2	0.86
chr7	147660788	147661014	CpG: 18	226	18	138	15.9	61.1	0.89
chr7	148023129	148023730	CpG: 40	601	40	350	13.3	58.2	0.81
chr7	148086304	148086600	CpG: 23	296	23	182	15.5	61.5	0.82
chr7	148240931	148241168	CpG: 18	237	18	143	15.2	60.3	0.86
chr7	148328410	148328684	CpG: 23	274	23	170	16.8	62.0	0.88
chr7	148442820	148443116	CpG: 22	296	22	183	14.9	61.8	0.79
chr7	148526492	148526776	CpG: 24	284	24	176	16.9	62.0	0.90
chr7	148649798	148650028	CpG: 20	230	20	141	17.4	61.3	0.93
chr7	148838130	148838376	CpG: 21	246	21	152	17.1	61.8	0.91
chr7	148961824	148962060	CpG: 20	236	20	146	16.9	61.9	0.91
chr7	148981914	148982731	CpG: 64	817	64	567	15.7	69.4	0.65
chr7	149028223	149028650	CpG: 29	427	29	253	13.6	59.3	0.78
chr7	149387825	149388047	CpG: 17	222	17	133	15.3	59.9	0.88
chr7	149408590	149408800	CpG: 16	210	16	119	15.2	56.7	0.95
chr7	149519309	149519663	CpG: 33	354	33	242	18.6	68.4	0.80
chr7	149543921	149544143	CpG: 19	222	19	160	17.1	72.1	0.68
chr7	149627390	149627790	CpG: 32	400	32	279	16.0	69.8	0.66
chr7	149633778	149633990	CpG: 16	212	16	127	15.1	59.9	0.86
chr7	149658303	149658581	CpG: 26	278	26	176	18.7	63.3	0.95
chr7	149880234	149881806	CpG: 213	1572	213	1196	27.1	76.1	0.94
chr7	149964811	149965186	CpG: 34	375	34	249	18.1	66.4	0.84
chr7	150014953	150015226	CpG: 24	273	24	168	17.6	61.5	0.94
chr7	150025401	150025672	CpG: 22	271	22	168	16.2	62.0	0.86
chr7	150065182	150067545	CpG: 287	2363	287	1647	24.3	69.7	1.00
chr7	150110522	150110825	CpG: 22	303	22	175	14.5	57.8	0.89
chr7	150123180	150123469	CpG: 30	289	30	196	20.8	67.8	0.92
chr7	150125117	150125398	CpG: 23	281	23	174	16.4	61.9	0.87
chr7	150131270	150131695	CpG: 35	425	35	310	16.5	72.9	0.62
chr7	150148627	150148865	CpG: 18	238	18	143	15.1	60.1	0.87
chr7	150151303	150151582	CpG: 19	279	19	166	13.6	59.5	0.78
chr7	150165378	150165654	CpG: 29	276	29	212	21.0	76.8	0.71
chr7	150177583	150177849	CpG: 24	266	24	168	18.0	63.2	0.93
chr7	150210080	150211194	CpG: 122	1114	122	783	21.9	70.3	0.89
chr7	150220805	150221193	CpG: 35	388	35	281	18.0	72.4	0.69
chr7	150226855	150227088	CpG: 17	233	17	140	14.6	60.1	0.83
chr7	150246272	150246516	CpG: 17	244	17	142	13.9	58.2	0.85
chr7	150247708	150248117	CpG: 39	409	39	296	19.1	72.4	0.74
chr7	150252994	150254224	CpG: 87	1230	87	815	14.1	66.3	0.64
chr7	150271152	150271384	CpG: 19	232	19	141	16.4	60.8	0.90
chr7	150272465	150273645	CpG: 122	1180	122	863	20.7	73.1	0.77
chr7	150283925	150284179	CpG: 18	254	18	143	14.2	56.3	0.92
chr7	150286240	150287105	CpG: 68	865	68	539	15.7	62.3	0.81
chr7	150305577	150305902	CpG: 22	325	22	183	13.5	56.3	0.87
chr7	150307545	150308939	CpG: 127	1394	127	973	18.2	69.8	0.75
chr7	150309224	150309485	CpG: 25	261	25	151	19.2	57.9	1.17
chr7	150328989	150330291	CpG: 161	1302	161	950	24.7	73.0	0.94
chr7	150331156	150331369	CpG: 17	213	17	127	16.0	59.6	0.90
chr7	150373013	150373418	CpG: 31	405	31	216	15.3	53.3	1.08
chr7	150376093	150376491	CpG: 31	398	31	236	15.6	59.3	0.90
chr7	150377159	150378016	CpG: 98	857	98	641	22.9	74.8	0.83
chr7	150390874	150391106	CpG: 17	232	17	139	14.7	59.9	0.84
chr7	150401964	150402204	CpG: 18	240	18	142	15.0	59.2	0.87
chr7	150405720	150406585	CpG: 94	865	94	625	21.7	72.3	0.83
chr7	150407658	150407944	CpG: 22	286	22	187	15.4	65.4	0.73
chr7	150421351	150421848	CpG: 58	497	58	357	23.3	71.8	0.92
chr7	150443582	150444615	CpG: 139	1033	139	780	26.9	75.5	0.94
chr7	150463436	150464064	CpG: 51	628	51	455	16.2	72.5	0.62
chr7	150466760	150467356	CpG: 63	596	63	426	21.1	71.5	0.84
chr7	150476337	150476863	CpG: 48	526	48	352	18.3	66.9	0.83
chr7	150597036	150597298	CpG: 30	262	30	159	22.9	60.7	1.28
chr7	150603432	150603706	CpG: 22	274	22	168	16.1	61.3	0.86
chr7	150604157	150605066	CpG: 96	909	96	619	21.1	68.1	0.92
chr7	150613305	150614653	CpG: 132	1348	132	919	19.6	68.2	0.85
chr7	150641321	150642840	CpG: 217	1519	217	1192	28.6	78.5	0.93
chr7	150656147	150656847	CpG: 76	700	76	496	21.7	70.9	0.87
chr7	150678912	150680034	CpG: 155	1122	155	888	27.6	79.1	0.88
chr7	150805971	150807018	CpG: 125	1047	125	787	23.9	75.2	0.85
chr7	150874424	150874854	CpG: 46	430	46	310	21.4	72.1	0.84
chr7	150895683	150897176	CpG: 156	1493	156	1053	20.9	70.5	0.84
chr7	150901489	150901801	CpG: 24	312	24	197	15.4	63.1	0.83
chr7	150946484	150948053	CpG: 169	1569	169	1105	21.5	70.4	0.88
chr7	150953557	150955875	CpG: 194	2318	194	1711	16.7	73.8	0.65
chr7	150972102	150972588	CpG: 66	486	66	367	27.2	75.5	0.95
chr7	151020061	151020855	CpG: 91	794	91	567	22.9	71.4	0.90
chr7	151043529	151043774	CpG: 20	245	20	156	16.3	63.7	0.81
chr7	151055384	151056407	CpG: 129	1023	129	745	25.2	72.8	0.96
chr7	151225550	151227614	CpG: 207	2064	207	1443	20.1	69.9	0.83
chr7	151269943	151270223	CpG: 25	280	25	172	17.9	61.4	0.96
chr7	151397804	151399428	CpG: 116	1624	116	1047	14.3	64.5	0.69
chr7	151428481	151428759	CpG: 21	278	21	174	15.1	62.6	0.78
chr7	151501114	151501916	CpG: 83	802	83	563	20.7	70.2	0.84
chr7	151518621	151520194	CpG: 112	1573	112	1093	14.2	69.5	0.61
chr7	151546419	151547601	CpG: 138	1182	138	844	23.4	71.4	0.92
chr7	151550006	151551301	CpG: 137	1295	137	908	21.2	70.1	0.87
chr7	151557042	151558119	CpG: 107	1077	107	761	19.9	70.7	0.80
chr7	151574869	151576462	CpG: 174	1593	174	1161	21.8	72.9	0.82
chr7	151583141	151584203	CpG: 111	1062	111	715	20.9	67.3	0.95
chr7	151585939	151586765	CpG: 96	826	96	608	23.2	73.6	0.86
chr7	151602166	151602444	CpG: 25	278	25	175	18.0	62.9	0.92
chr7	151663926	151664159	CpG: 18	233	18	139	15.5	59.7	0.88
chr7	151700825	151701045	CpG: 15	220	15	130	13.6	59.1	0.80
chr7	151893236	151893840	CpG: 44	604	44	419	14.6	69.4	0.63
chr7	151938906	151939174	CpG: 24	268	24	168	17.9	62.7	0.92
chr7	151971076	151971331	CpG: 20	255	20	155	15.7	60.8	0.88
chr7	151972481	151973878	CpG: 128	1397	128	1021	18.3	73.1	0.69
chr7	152030091	152030413	CpG: 25	322	25	215	15.5	66.8	0.70
chr7	152123766	152124694	CpG: 63	928	63	593	13.6	63.9	0.67
chr7	152128590	152128863	CpG: 23	273	23	214	16.8	78.4	0.62
chr7	152130892	152131422	CpG: 81	530	81	414	30.6	78.1	1.01
chr7	152147389	152148162	CpG: 87	773	87	572	22.5	74.0	0.84
chr7	152150529	152152344	CpG: 172	1815	172	1310	19.0	72.2	0.74
chr7	152181793	152182163	CpG: 26	370	26	246	14.1	66.5	0.64
chr7	152186384	152187368	CpG: 85	984	85	675	17.3	68.6	0.74
chr7	152191344	152192440	CpG: 121	1096	121	783	22.1	71.4	0.87
chr7	152201171	152202016	CpG: 58	845	58	522	13.7	61.8	0.72
chr7	152217099	152217302	CpG: 16	203	16	134	15.8	66.0	0.72
chr7	152222003	152222382	CpG: 33	379	33	264	17.4	69.7	0.72
chr7	152223977	152224520	CpG: 62	543	62	393	22.8	72.4	0.87
chr7	152230923	152231427	CpG: 49	504	49	330	19.4	65.5	0.91
chr7	152232392	152233298	CpG: 89	906	89	654	19.6	72.2	0.77
chr7	152253336	152256910	CpG: 269	3574	269	2448	15.1	68.5	0.65
chr7	152259098	152261059	CpG: 232	1961	232	1473	23.7	75.1	0.85
chr7	152287604	152288928	CpG: 206	1324	206	1068	31.1	80.7	0.96
chr7	152293005	152293237	CpG: 21	232	21	158	18.1	68.1	0.86
chr7	152294066	152294305	CpG: 19	239	19	168	15.9	70.3	0.69
chr7	152295922	152296767	CpG: 74	845	74	590	17.5	69.8	0.73
chr7	152298657	152299476	CpG: 77	819	77	568	18.8	69.4	0.78
chr7	152339968	152341517	CpG: 180	1549	180	1149	23.2	74.2	0.85
chr7	152345771	152346171	CpG: 36	400	36	248	18.0	62.0	0.98
chr7	152346837	152347998	CpG: 105	1161	105	812	18.1	69.9	0.78
chr7	152377558	152377986	CpG: 42	428	42	293	19.6	68.5	0.85
chr7	152399910	152400569	CpG: 61	659	61	436	18.5	66.2	0.90
chr7	152405420	152406183	CpG: 87	763	87	543	22.8	71.2	0.90
chr7	152410683	152410903	CpG: 19	220	19	147	17.3	66.8	0.77
chr7	152418338	152419068	CpG: 68	730	68	537	18.6	73.6	0.69
chr7	152421387	152422530	CpG: 119	1143	119	804	20.8	70.3	0.85
chr7	152424708	152425314	CpG: 80	606	80	475	26.4	78.4	0.86
chr7	152450150	152450599	CpG: 56	449	56	324	24.9	72.2	0.96
chr7	152476639	152477102	CpG: 38	463	38	335	16.4	72.4	0.63
chr7	152477729	152477957	CpG: 17	228	17	133	14.9	58.3	0.89
chr7	152514551	152515037	CpG: 65	486	65	371	26.7	76.3	0.92
chr7	152554204	152555278	CpG: 109	1074	109	765	20.3	71.2	0.80
chr7	152568597	152568919	CpG: 25	322	25	229	15.5	71.1	0.61
chr7	152581998	152583562	CpG: 157	1564	157	1143	20.1	73.1	0.75
chr7	152604869	152605089	CpG: 18	220	18	146	16.4	66.4	0.74
chr7	152612681	152613021	CpG: 37	340	37	248	21.8	72.9	0.83
chr7	152620849	152621725	CpG: 77	876	77	582	17.6	66.4	0.80
chr7	152691816	152693649	CpG: 225	1833	225	1283	24.5	70.0	1.00
chr7	152694391	152694626	CpG: 19	235	19	145	16.2	61.7	0.87
chr7	152775625	152776182	CpG: 71	557	71	390	25.5	70.0	1.12
chr7	152782666	152783004	CpG: 22	338	22	192	13.0	56.8	0.82
chr7	152804329	152805655	CpG: 159	1326	159	971	24.0	73.2	0.89
chr7	152897164	152897736	CpG: 38	572	38	374	13.3	65.4	0.63
chr7	152955486	152955850	CpG: 43	364	43	263	23.6	72.3	0.91
chr7	153048503	153050848	CpG: 233	2345	233	1597	19.9	68.1	0.86
chr7	153067406	153068054	CpG: 52	648	52	467	16.0	72.1	1.10
chr7	153104851	153105067	CpG: 16	216	16	129	14.8	59.7	0.84
chr7	153117342	153117612	CpG: 21	270	21	168	15.6	62.2	0.83
chr7	153128787	153129021	CpG: 19	234	19	141	16.2	60.3	0.91
chr7	153167753	153167986	CpG: 19	233	19	141	16.3	60.5	0.91
chr7	153198170	153199080	CpG: 113	910	113	671	24.8	73.7	0.92
chr7	153301402	153302478	CpG: 93	1076	93	700	17.3	65.1	0.82
chr7	153304158	153304445	CpG: 21	287	21	188	14.6	65.5	0.72
chr7	153337201	153337475	CpG: 24	274	24	171	17.5	62.4	0.91
chr7	153539651	153539897	CpG: 31	246	31	179	25.2	72.8	0.95
chr7	153558223	153558506	CpG: 25	283	25	178	17.7	62.9	0.90
chr7	153608029	153609922	CpG: 278	1893	278	1456	29.4	76.9	0.99
chr7	153636543	153637927	CpG: 170	1384	170	1020	24.6	73.7	0.92
chr7	153640864	153641094	CpG: 18	230	18	139	15.7	60.4	0.90
chr7	153711673	153712092	CpG: 42	419	42	310	20.0	74.0	0.73
chr7	153714077	153714366	CpG: 22	289	22	170	15.2	58.8	0.89
chr7	153835981	153836256	CpG: 24	275	24	171	17.5	62.2	0.91
chr7	153849475	153849916	CpG: 51	441	51	318	23.1	72.1	0.93
chr7	153916099	153916446	CpG: 30	347	30	208	17.3	59.9	0.97
chr7	153932918	153933689	CpG: 97	771	97	565	25.2	73.3	0.94
chr7	154037103	154037380	CpG: 23	277	23	169	16.6	61.0	0.90
chr7	154067114	154067414	CpG: 21	300	21	197	14.0	65.7	0.75
chr7	154067512	154067760	CpG: 29	248	29	192	23.4	77.4	0.78
chr7	154076562	154077016	CpG: 37	454	37	286	16.3	63.0	0.82
chr7	154097982	154098215	CpG: 20	233	20	153	17.2	65.7	0.81
chr7	154098409	154099371	CpG: 92	962	92	695	19.1	72.2	0.74
chr7	154534801	154535039	CpG: 21	238	21	148	17.6	62.2	0.92
chr7	154758200	154758474	CpG: 26	274	26	172	19.0	62.8	0.97
chr7	154922630	154924254	CpG: 115	1624	115	1049	14.2	64.6	0.68
chr7	154961095	154961325	CpG: 21	230	21	143	18.3	62.2	0.95
chr7	155017666	155017884	CpG: 17	218	17	112	15.6	51.4	1.29
chr7	155060831	155063180	CpG: 212	2349	212	1555	18.1	66.2	0.82
chr7	155183184	155183462	CpG: 24	278	24	171	17.3	61.5	0.92
chr7	155225765	155227841	CpG: 207	2076	207	1449	19.9	69.8	0.83
chr7	155480263	155480574	CpG: 38	311	38	249	24.4	80.1	0.77
chr7	155541099	155541334	CpG: 20	235	20	141	17.0	60.0	0.95
chr7	155632661	155632936	CpG: 23	275	23	171	16.7	62.2	0.87
chr7	155638887	155639157	CpG: 24	270	24	167	17.8	61.9	0.94
chr7	155924997	155925286	CpG: 22	289	22	190	15.2	65.7	0.71
chr7	155969308	155969962	CpG: 60	654	60	452	18.3	69.1	0.77
chr7	156051058	156051413	CpG: 25	355	25	235	14.1	66.2	0.67
chr7	156054560	156054845	CpG: 21	285	21	174	14.7	61.1	0.80
chr7	156067820	156068179	CpG: 28	359	28	240	15.6	66.9	0.70
chr7	156089313	156090083	CpG: 57	770	57	514	14.8	66.8	0.67
chr7	156132965	156133246	CpG: 22	281	22	173	15.7	61.6	0.84
chr7	156177581	156179315	CpG: 234	1734	234	1335	27.0	77.0	0.91
chr7	156179577	156179843	CpG: 22	266	22	164	16.5	61.7	0.88
chr7	156241819	156242097	CpG: 25	278	25	174	18.0	62.6	0.93
chr7	156245685	156245962	CpG: 26	277	26	192	18.8	69.3	0.79
chr7	156246568	156247133	CpG: 53	565	53	367	18.8	65.0	0.89
chr7	156310615	156310852	CpG: 20	237	20	143	16.9	60.3	0.95
chr7	156443131	156443356	CpG: 16	225	16	147	14.2	65.3	0.69
chr7	156472548	156474055	CpG: 186	1507	186	1114	24.7	73.9	0.91
chr7	156518481	156519433	CpG: 65	952	65	650	13.7	68.3	0.63
chr7	156525945	156526371	CpG: 51	426	51	318	23.9	74.6	0.87
chr7	156529856	156531127	CpG: 133	1271	133	962	20.9	75.7	0.81
chr7	156538920	156539211	CpG: 24	291	24	197	16.5	67.7	0.73
chr7	156552505	156555802	CpG: 284	3297	284	2080	17.2	63.1	0.87
chr7	156558571	156558887	CpG: 39	316	39	231	24.7	73.1	0.92
chr7	156562076	156563196	CpG: 99	1120	99	769	17.7	68.7	0.75
chr7	156565873	156566079	CpG: 20	206	20	131	19.4	63.6	1.00
chr7	156629189	156631628	CpG: 196	2439	196	1624	16.1	66.6	0.73
chr7	156631917	156632228	CpG: 22	311	22	180	14.1	57.9	0.85
chr7	156634261	156639840	CpG: 499	5579	499	3654	17.9	65.5	0.83
chr7	156642983	156643196	CpG: 18	213	18	131	16.9	61.5	0.89
chr7	156646714	156649290	CpG: 194	2576	194	1682	15.1	65.3	0.71
chr7	156671919	156672257	CpG: 27	338	27	223	16.0	66.0	0.77
chr7	156690136	156691055	CpG: 82	919	82	586	17.8	63.8	0.88
chr7	156712939	156713213	CpG: 22	274	22	167	16.1	60.9	0.88
chr7	156713712	156714258	CpG: 54	546	54	352	19.8	64.5	0.95
chr7	156754177	156754586	CpG: 43	409	43	251	21.0	61.4	1.32
chr7	156825047	156826191	CpG: 123	1144	123	791	21.5	69.1	0.90
chr7	156961942	156962166	CpG: 19	224	19	138	17.0	61.6	0.89
chr7	156968162	156968731	CpG: 67	569	67	421	23.6	74.0	0.87
chr7	156969069	156969489	CpG: 33	420	33	250	15.7	59.5	0.89
chr7	156970878	156971117	CpG: 18	239	18	139	15.1	58.2	0.89
chr7	156979716	156980422	CpG: 55	706	55	483	15.6	68.4	0.69
chr7	156985953	156993685	CpG: 579	7732	579	5057	15.0	65.4	0.70
chr7	156995175	156995545	CpG: 40	370	40	248	21.6	67.0	0.98
chr7	157030130	157030371	CpG: 16	241	16	145	13.3	60.2	1.61
chr7	157065279	157065578	CpG: 24	299	24	186	16.1	62.2	0.83
chr7	157250321	157250640	CpG: 22	319	22	200	13.8	62.7	0.70
chr7	157292978	157293224	CpG: 19	246	19	163	15.4	66.3	0.72
chr7	157310343	157310546	CpG: 16	203	16	124	15.8	61.1	0.86
chr7	157341617	157343295	CpG: 134	1678	134	987	16.0	58.8	1.24
chr7	157505945	157506156	CpG: 15	211	15	133	14.2	63.0	0.72
chr7	157531366	157531606	CpG: 17	240	17	142	14.2	59.2	0.83
chr7	157535584	157535918	CpG: 29	334	29	250	17.4	74.9	0.65
chr7	157766221	157766626	CpG: 28	405	28	260	13.8	64.2	0.67
chr7	157795036	157796071	CpG: 100	1035	100	720	19.3	69.6	0.81
chr7	157804051	157804893	CpG: 88	842	88	590	20.9	70.1	0.89
chr7	157827453	157828690	CpG: 137	1237	137	861	22.2	69.6	0.93
chr7	158065373	158065650	CpG: 23	277	23	170	16.6	61.4	0.90
chr7	158080080	158081264	CpG: 148	1184	148	913	25.0	77.1	0.86
chr7	158128705	158130834	CpG: 217	2129	217	1369	20.4	64.3	1.09
chr7	158136641	158138450	CpG: 186	1809	186	1216	20.6	67.2	0.91
chr7	158156017	158156375	CpG: 27	358	27	223	15.1	62.3	0.79
chr7	158187361	158188418	CpG: 118	1057	118	767	22.3	72.6	0.85
chr7	158190390	158194435	CpG: 297	4045	297	2512	14.7	62.1	0.76
chr7	158196459	158196673	CpG: 17	214	17	147	15.9	68.7	0.68
chr7	158197211	158199461	CpG: 283	2250	283	1663	25.2	73.9	0.92
chr7	158205622	158209643	CpG: 295	4021	295	2449	14.7	60.9	0.79
chr7	158227731	158228014	CpG: 22	283	22	190	15.5	67.1	0.73
chr7	158266137	158266380	CpG: 29	243	29	175	23.9	72.0	0.92
chr7	158326267	158327488	CpG: 151	1221	151	938	24.7	76.8	0.84
chr7	158451037	158451279	CpG: 20	242	20	153	16.5	63.2	0.84
chr7	158466946	158467989	CpG: 108	1043	108	760	20.7	72.9	0.78
chr7	158478944	158479414	CpG: 35	470	35	296	14.9	63.0	0.77
chr7	158487742	158488680	CpG: 64	938	64	616	13.6	65.7	0.63
chr7	158524239	158525456	CpG: 151	1217	151	877	24.8	72.1	0.96
chr7	158534760	158534996	CpG: 18	236	18	140	15.3	59.3	0.89
chr7	158588135	158588370	CpG: 20	235	20	150	17.0	63.8	0.85
chr7	158597585	158598340	CpG: 72	755	72	519	19.1	68.7	0.81
chr7	158599600	158599821	CpG: 16	221	16	146	14.5	66.1	0.67
chr7	158602187	158602603	CpG: 33	416	33	270	15.9	64.9	0.77
chr7	158604049	158604263	CpG: 25	214	25	144	23.4	67.3	1.05
chr7	158605741	158606010	CpG: 19	269	19	153	14.1	56.9	0.88
chr7	158606815	158607113	CpG: 20	298	20	201	13.4	67.4	0.60
chr7	158611893	158612244	CpG: 23	351	23	235	13.1	67.0	0.62
chr7	158613791	158614055	CpG: 19	264	19	175	14.4	66.3	0.66
chr7	158623400	158623630	CpG: 19	230	19	140	16.5	60.9	0.91
chr7	158629408	158630699	CpG: 154	1291	154	906	23.9	70.2	1.02
chr7	158656275	158656558	CpG: 22	283	22	193	15.5	68.2	0.67
chr7	158658358	158659062	CpG: 65	704	65	488	18.5	69.3	0.85
chr7	158672043	158672389	CpG: 41	346	41	260	23.7	75.1	0.85
chr7	158689317	158689928	CpG: 56	611	56	443	18.3	72.5	0.70
chr7	158690165	158690379	CpG: 16	214	16	115	15.0	53.7	1.04
chr7	158714135	158714439	CpG: 21	304	21	186	13.8	61.2	0.87
chr7	158716400	158716607	CpG: 16	207	16	139	15.5	67.1	0.69
chr7	158742549	158743060	CpG: 58	511	58	399	22.7	78.1	0.75
chr7	158748993	158749230	CpG: 18	237	18	161	15.2	67.9	0.67
chr7	158757475	158757768	CpG: 21	293	21	173	14.3	59.0	0.82
chr7	158759622	158759843	CpG: 18	221	18	128	16.3	57.9	0.99
chr7	158765087	158765361	CpG: 34	274	34	188	24.8	68.6	1.07
chr7	158783020	158783289	CpG: 22	269	22	185	16.4	68.8	0.69
chr7	158800338	158802575	CpG: 187	2237	187	1492	16.7	66.7	0.75
chr7	158805813	158806208	CpG: 40	395	40	265	20.3	67.1	0.91
chr7	158809964	158810178	CpG: 17	214	17	146	15.9	68.2	0.69
chr7	158835563	158835790	CpG: 16	227	16	140	14.1	61.7	0.74
chr7	158836685	158837559	CpG: 57	874	57	534	13.0	61.1	0.70
chr7	158841357	158841889	CpG: 43	532	43	380	16.2	71.4	1.24
chr7	158843192	158844040	CpG: 58	848	58	500	13.7	59.0	0.79
chr7	158849040	158849557	CpG: 41	517	41	332	15.9	64.2	0.77
chr7	158851138	158851393	CpG: 20	255	20	168	15.7	65.9	0.72
chr7	158872235	158882067	CpG: 732	9832	732	6243	14.9	63.5	0.74
chr7	158889858	158890087	CpG: 17	229	17	130	14.8	56.8	1.05
chr7	158898817	158899492	CpG: 104	675	104	510	30.8	75.6	1.08
chr7	158919505	158922663	CpG: 226	3158	226	1977	14.3	62.6	0.97
chr7	158946470	158946948	CpG: 42	478	42	315	17.6	65.9	0.82
chr7	158956897	158957118	CpG: 19	221	19	142	17.2	64.3	0.84
chr7	158964086	158964327	CpG: 20	241	20	166	16.6	68.9	0.72
chr7	158975171	158975428	CpG: 18	257	18	154	14.0	59.9	0.78
chr7	158984210	158984611	CpG: 33	401	33	277	16.5	69.1	0.74
chr7	158991386	158991627	CpG: 19	241	19	136	15.8	56.4	0.99
chr7	158992195	158992519	CpG: 32	324	32	200	19.8	61.7	1.07
chr7	159009528	159009808	CpG: 24	280	24	193	17.1	68.9	0.75
chr7	159016351	159016797	CpG: 64	446	64	262	28.7	58.7	1.69
chr7	159029090	159029330	CpG: 18	240	18	146	15.0	60.8	0.81
chr7	159030588	159030847	CpG: 24	259	24	157	18.5	60.6	1.12
chr7	159045701	159045908	CpG: 19	207	19	145	18.4	70.0	0.80
chr7	159056520	159057765	CpG: 111	1245	111	895	17.8	71.9	0.84
chr7	159063559	159063935	CpG: 38	376	38	248	20.2	66.0	0.97
chr7	159067415	159067631	CpG: 15	216	15	142	13.9	65.7	0.64
chr7	159088324	159088535	CpG: 23	211	23	138	21.8	65.4	1.03
chr7	159092152	159092354	CpG: 17	202	17	137	16.8	67.8	0.73
chr7	159092718	159093051	CpG: 26	333	26	223	15.6	67.0	0.71
chr7	159100546	159101185	CpG: 76	639	76	402	23.8	62.9	1.21
chr7	159108821	159109041	CpG: 18	220	18	113	16.4	51.4	1.25
chr7	159276942	159277706	CpG: 49	764	49	477	12.8	62.4	1.19
chr7	159289313	159290214	CpG: 61	901	61	594	13.5	65.9	0.63
chr7	159319394	159320100	CpG: 70	706	70	518	19.8	73.4	0.77
chr7	159344499	159344886	CpG: 25	387	25	228	12.9	58.9	1.22
chr7	159345979	159346366	CpG: 25	387	25	227	12.9	58.7	1.20
chr7	159365198	159366104	CpG: 63	906	63	503	13.9	55.5	0.98
chr7	159371263	159371608	CpG: 44	345	44	236	25.5	68.4	1.24
chr7	159395118	159395737	CpG: 74	619	74	462	23.9	74.6	0.86
chr7	159410823	159411208	CpG: 42	385	42	268	21.8	69.6	0.90
chr7	159417029	159417258	CpG: 20	229	20	141	17.5	61.6	0.93
chr7	159451916	159452202	CpG: 20	286	20	173	14.0	60.5	0.77
chr7	159460000	159460206	CpG: 15	206	15	118	14.6	57.3	0.89
chr7	159474167	159475020	CpG: 56	853	56	513	13.1	60.1	0.73
chr7	159486047	159486488	CpG: 34	441	34	305	15.4	69.2	0.66
chr7	159516793	159517146	CpG: 34	353	34	251	19.3	71.1	0.77
chr7	159523399	159523659	CpG: 26	260	26	179	20.0	68.8	0.88
chr7	159524634	159524946	CpG: 33	312	33	214	21.2	68.6	0.90
chr7	159547765	159548218	CpG: 31	453	31	266	13.7	58.7	0.79
chr7	159556274	159557011	CpG: 51	737	51	538	13.8	73.0	0.84
chr7	159564878	159566218	CpG: 81	1340	81	875	12.1	65.3	0.81
chr7	159566646	159566847	CpG: 14	201	14	134	13.9	66.7	0.88
chr7	159567414	159567755	CpG: 22	341	22	226	12.9	66.3	0.84
chr7	159567833	159568104	CpG: 18	271	18	180	13.3	66.4	0.86
chr7	159602692	159604275	CpG: 192	1583	192	1273	24.3	80.4	1.02
chr7	159614215	159614533	CpG: 27	318	27	200	17.0	62.9	0.86
chr7	159633560	159635265	CpG: 183	1705	183	1200	21.5	70.4	0.87
chr7	159662232	159663911	CpG: 143	1679	143	1048	17.0	62.4	0.90
chr7	159669113	159669362	CpG: 22	249	22	158	17.7	63.5	0.92
chr7	159692566	159693276	CpG: 55	710	55	505	15.5	71.1	0.66
chr7	159696336	159696872	CpG: 36	536	36	331	13.4	61.8	0.70
chr7	159697177	159698345	CpG: 98	1168	98	829	16.8	71.0	0.67
chr7	159716229	159716630	CpG: 40	401	40	279	20.0	69.6	0.91
chr7	159735639	159735841	CpG: 14	202	14	127	13.9	62.9	0.70
chr7	159759329	159759633	CpG: 25	304	25	204	16.4	67.1	0.73
chr7	159766056	159766760	CpG: 72	704	72	525	20.5	74.6	0.74
chr7	159778578	159780131	CpG: 155	1553	155	1076	20.0	69.3	0.83
chr7	159795997	159797890	CpG: 220	1893	220	1444	23.2	76.3	0.82
chr7	159855085	159855324	CpG: 21	239	21	146	17.6	61.1	0.96
chr7	159931854	159932708	CpG: 94	854	94	622	22.0	72.8	0.83
chr7	160027960	160028487	CpG: 59	527	59	323	22.4	61.3	1.20
chr7	160052290	160054143	CpG: 229	1853	229	1388	24.7	74.9	0.90
chr7	160079928	160080762	CpG: 94	834	94	607	22.5	72.8	0.85
chr7	160087285	160087747	CpG: 36	462	36	320	15.6	69.3	0.81
chr7	160100802	160101007	CpG: 21	205	21	130	20.5	63.4	1.09
chr7	160107416	160107653	CpG: 20	237	20	143	16.9	60.3	0.96
chr7	160144501	160145036	CpG: 38	535	38	323	14.2	60.4	0.81
chr7	160145838	160146061	CpG: 15	223	15	134	13.5	60.1	0.81
chr7	160182341	160182616	CpG: 22	275	22	181	16.0	65.8	0.75
chr7	160183155	160183381	CpG: 22	226	22	149	19.5	65.9	0.90
chr7	160198276	160199712	CpG: 136	1436	136	1068	18.9	74.4	0.70
chr7	160217589	160218072	CpG: 41	483	41	331	17.0	68.5	0.77
chr7	160221782	160222315	CpG: 55	533	55	364	20.6	68.3	0.93
chr7	160231878	160232455	CpG: 73	577	73	419	25.3	72.6	0.96
chr7	160249759	160250076	CpG: 23	317	23	231	14.5	72.9	0.69
chr7	160250842	160251296	CpG: 41	454	41	294	18.1	64.8	0.86
chr7	160256842	160257980	CpG: 90	1138	90	754	15.8	66.3	0.73
chr7	160288190	160288745	CpG: 50	555	50	382	18.0	68.8	0.79
chr7	160289510	160290068	CpG: 50	558	50	409	17.9	73.3	0.67
chr7	160290727	160291118	CpG: 32	391	32	275	16.4	70.3	0.69
chr7	160326332	160328134	CpG: 177	1802	177	1054	19.6	58.5	1.15
chr7	160338615	160339027	CpG: 35	412	35	288	17.0	69.9	0.70
chr7	160370327	160372314	CpG: 214	1987	214	1357	21.5	68.3	0.93
chr7	160397163	160397368	CpG: 15	205	15	120	14.6	58.5	0.86
chr7	160398850	160399767	CpG: 71	917	71	576	15.5	62.8	0.79
chr7	160428378	160428652	CpG: 24	274	24	173	17.5	63.1	0.89
chr7	160459420	160459767	CpG: 32	347	32	235	18.4	67.7	0.83
chr7	160471268	160471502	CpG: 19	234	19	142	16.2	60.7	0.91
chr7	160563744	160564736	CpG: 196	992	196	836	39.5	84.3	1.11
chr8	2720	3537	CpG: 86	817	86	554	21.1	67.8	0.92
chr8	25802	26567	CpG: 54	765	54	447	14.1	58.4	0.85
chr8	28643	29761	CpG: 126	1118	126	780	22.5	69.8	0.96
chr8	53793	54063	CpG: 20	270	20	168	14.8	62.2	0.77
chr8	63160	63645	CpG: 41	485	41	364	16.9	75.1	0.70
chr8	100593	102384	CpG: 142	1791	142	1005	15.9	56.1	1.01
chr8	156879	157152	CpG: 22	273	22	166	16.1	60.8	0.88
chr8	160697	160902	CpG: 16	205	16	134	15.6	65.4	0.76
chr8	203517	204825	CpG: 158	1308	158	943	24.2	72.1	0.94
chr8	341250	343178	CpG: 199	1928	199	1415	20.6	73.4	0.79
chr8	385170	385408	CpG: 19	238	19	142	16.0	59.7	0.92
chr8	430363	430566	CpG: 16	203	16	138	15.8	68.0	0.70
chr8	431875	432143	CpG: 19	268	19	181	14.2	67.5	0.62
chr8	442269	443008	CpG: 64	739	64	492	17.3	66.6	0.78
chr8	457498	457707	CpG: 15	209	15	139	14.4	66.5	0.70
chr8	461452	461962	CpG: 41	510	41	348	16.1	68.2	0.71
chr8	465727	466065	CpG: 28	338	28	217	16.6	64.2	0.91
chr8	467470	468422	CpG: 133	952	133	700	27.9	73.5	1.04
chr8	479219	480372	CpG: 135	1153	135	862	23.4	74.8	0.84
chr8	491424	492283	CpG: 110	859	110	621	25.6	72.3	1.07
chr8	492855	493145	CpG: 33	290	33	207	22.8	71.4	0.90
chr8	505699	506366	CpG: 48	667	48	450	14.4	67.5	0.64
chr8	522487	523303	CpG: 76	816	76	580	18.6	71.1	0.75
chr8	528411	531087	CpG: 330	2676	330	1940	24.7	72.5	0.94
chr8	536060	536288	CpG: 22	228	22	167	19.3	73.2	0.82
chr8	538956	539913	CpG: 67	957	67	681	14.0	71.2	0.74
chr8	577493	577764	CpG: 20	271	20	173	14.8	63.8	0.72
chr8	632008	632780	CpG: 74	772	74	474	19.2	61.4	1.07
chr8	640221	640849	CpG: 65	628	65	383	20.7	61.0	1.26
chr8	674171	674793	CpG: 57	622	57	446	18.3	71.7	0.75
chr8	689858	690064	CpG: 17	206	17	144	16.5	69.9	0.70
chr8	692408	692710	CpG: 36	302	36	220	23.8	72.8	0.90
chr8	694481	695414	CpG: 66	933	66	640	14.1	68.6	0.78
chr8	736282	736641	CpG: 27	359	27	212	15.0	59.1	0.87
chr8	757768	758615	CpG: 55	847	55	552	13.0	65.2	0.67
chr8	765815	766708	CpG: 77	893	77	624	17.2	69.9	0.71
chr8	798171	799088	CpG: 62	917	62	503	13.5	54.9	0.91
chr8	804198	804630	CpG: 33	432	33	281	15.3	65.0	0.75
chr8	815045	815446	CpG: 29	401	29	240	14.5	59.9	0.81
chr8	816655	817381	CpG: 49	726	49	459	13.5	63.2	0.68
chr8	822717	825876	CpG: 390	3159	390	2110	24.7	66.8	1.18
chr8	828760	830213	CpG: 153	1453	153	912	21.1	62.8	1.15
chr8	831046	831376	CpG: 25	330	25	212	15.2	64.2	0.74
chr8	888262	888724	CpG: 75	462	75	381	32.5	82.5	1.05
chr8	892955	893237	CpG: 20	282	20	172	14.2	61.0	0.92
chr8	917515	917777	CpG: 19	262	19	164	14.5	62.6	0.75
chr8	934143	934444	CpG: 20	301	20	177	13.3	58.8	0.82
chr8	944557	944909	CpG: 24	352	24	227	13.6	64.5	0.66
chr8	945088	945464	CpG: 40	376	40	267	21.3	71.0	0.86
chr8	952550	953427	CpG: 64	877	64	555	14.6	63.3	0.74
chr8	973552	973774	CpG: 18	222	18	150	16.2	67.6	0.77
chr8	978000	979465	CpG: 140	1465	140	875	19.1	59.7	1.15
chr8	979720	980074	CpG: 29	354	29	235	16.4	66.4	0.76
chr8	991634	992046	CpG: 39	412	39	276	18.9	67.0	0.85
chr8	993681	994267	CpG: 40	586	40	333	13.7	56.8	0.85
chr8	1085765	1086559	CpG: 53	794	53	462	13.4	58.2	0.86
chr8	1091071	1091746	CpG: 45	675	45	402	13.3	59.6	0.76
chr8	1103611	1106596	CpG: 197	2985	197	1498	13.2	50.2	1.05
chr8	1139422	1141565	CpG: 183	2143	183	1378	17.1	64.3	0.95
chr8	1143851	1144487	CpG: 40	636	40	347	12.6	54.6	1.09
chr8	1149191	1149583	CpG: 30	392	30	258	15.3	65.8	0.72
chr8	1152472	1152711	CpG: 19	239	19	164	15.9	68.6	0.71
chr8	1162317	1162723	CpG: 46	406	46	291	22.7	71.7	0.90
chr8	1167758	1167974	CpG: 18	216	18	140	16.7	64.8	0.82
chr8	1182453	1182783	CpG: 22	330	22	187	13.3	56.7	0.85
chr8	1192793	1194514	CpG: 147	1721	147	1132	17.1	65.8	0.84
chr8	1214227	1214565	CpG: 42	338	42	231	24.9	68.3	1.07
chr8	1226901	1229274	CpG: 182	2373	182	1628	15.3	68.6	0.87
chr8	1235649	1235897	CpG: 17	248	17	156	13.7	62.9	0.71
chr8	1261105	1261677	CpG: 47	572	47	391	16.4	68.4	0.70
chr8	1271045	1271319	CpG: 25	274	25	187	18.2	68.2	0.81
chr8	1271754	1271965	CpG: 16	211	16	132	15.2	62.6	0.78
chr8	1274251	1274470	CpG: 20	219	20	137	18.3	62.6	0.94
chr8	1285737	1286178	CpG: 41	441	41	335	18.6	76.0	0.65
chr8	1287721	1288061	CpG: 26	340	26	203	15.3	59.7	0.86
chr8	1325790	1326018	CpG: 16	228	16	146	14.0	64.0	0.70
chr8	1327419	1328572	CpG: 118	1153	118	789	20.5	68.4	0.88
chr8	1332095	1332392	CpG: 24	297	24	179	16.2	60.3	0.89
chr8	1340603	1342448	CpG: 137	1845	137	1199	14.9	65.0	0.82
chr8	1374378	1374667	CpG: 24	289	24	178	16.6	61.6	0.89
chr8	1386668	1387062	CpG: 31	394	31	240	15.7	60.9	0.86
chr8	1409960	1410163	CpG: 23	203	23	155	22.7	76.4	0.86
chr8	1420960	1423017	CpG: 185	2057	185	1483	18.0	72.1	0.88
chr8	1447255	1447610	CpG: 27	355	27	240	15.2	67.6	0.68
chr8	1448339	1448603	CpG: 20	264	20	177	15.2	67.0	0.68
chr8	1470631	1471058	CpG: 49	427	49	267	23.0	62.5	1.23
chr8	1479938	1480258	CpG: 46	320	46	231	28.8	72.2	1.12
chr8	1511836	1512067	CpG: 19	231	19	147	16.5	63.6	0.81
chr8	1515806	1516053	CpG: 21	247	21	155	17.0	62.8	0.88
chr8	1541735	1543177	CpG: 201	1442	201	1164	27.9	80.7	0.86
chr8	1563799	1564326	CpG: 50	527	50	334	19.0	63.4	1.00
chr8	1594272	1595813	CpG: 129	1541	129	926	16.7	60.1	0.96
chr8	1601695	1603094	CpG: 145	1399	145	1016	20.7	72.6	0.80
chr8	1610552	1610872	CpG: 24	320	24	207	15.0	64.7	0.81
chr8	1614568	1614930	CpG: 29	362	29	253	16.0	69.9	0.66
chr8	1621503	1621810	CpG: 53	307	53	250	34.5	81.4	1.14
chr8	1628942	1630330	CpG: 92	1388	92	924	13.3	66.6	0.69
chr8	1653145	1653546	CpG: 37	401	37	251	18.5	62.6	0.95
chr8	1662261	1662520	CpG: 23	259	23	177	17.8	68.3	0.78
chr8	1723575	1723979	CpG: 28	404	28	262	13.9	64.9	0.67
chr8	1752186	1753499	CpG: 176	1313	176	1037	26.8	79.0	0.87
chr8	1769151	1769723	CpG: 51	572	51	421	17.8	73.6	0.67
chr8	1779657	1781802	CpG: 318	2145	318	1639	29.7	76.4	1.02
chr8	1787337	1787588	CpG: 19	251	19	164	15.1	65.3	0.71
chr8	1802349	1802846	CpG: 36	497	36	331	14.5	66.6	0.69
chr8	1834212	1834462	CpG: 17	250	17	165	13.6	66.0	0.62
chr8	1850513	1851018	CpG: 38	505	38	307	15.0	60.8	0.81
chr8	1863950	1865083	CpG: 93	1133	93	723	16.4	63.8	0.84
chr8	1868585	1868865	CpG: 20	280	20	163	14.3	58.2	0.85
chr8	1877569	1877841	CpG: 22	272	22	181	16.2	66.5	0.73
chr8	1906314	1906567	CpG: 37	253	37	180	29.2	71.1	1.16
chr8	1908795	1909173	CpG: 31	378	31	235	16.4	62.2	1.01
chr8	1957802	1958048	CpG: 18	246	18	155	14.6	63.0	0.74
chr8	1960386	1960879	CpG: 35	493	35	322	14.2	65.3	0.76
chr8	2014724	2015005	CpG: 24	281	24	175	17.1	62.3	0.90
chr8	2021881	2022134	CpG: 21	253	21	150	16.6	59.3	0.95
chr8	2050986	2051236	CpG: 22	250	22	161	17.6	64.4	0.85
chr8	2080052	2080382	CpG: 25	330	25	214	15.2	64.8	0.72
chr8	2097817	2098087	CpG: 22	270	22	165	16.3	61.1	0.88
chr8	2160865	2161135	CpG: 22	270	22	165	16.3	61.1	0.88
chr8	2178570	2178900	CpG: 25	330	25	214	15.2	64.8	0.72
chr8	2208503	2208753	CpG: 23	250	23	161	18.4	64.4	0.89
chr8	2234457	2234710	CpG: 20	253	20	150	15.8	59.3	0.90
chr8	2315404	2315929	CpG: 40	525	40	355	15.2	67.6	0.68
chr8	2429467	2429729	CpG: 22	262	22	163	16.8	62.2	0.88
chr8	2477715	2477958	CpG: 21	243	21	151	17.3	62.1	0.92
chr8	2481367	2482170	CpG: 75	803	75	541	18.7	67.4	0.83
chr8	2580426	2580665	CpG: 21	239	21	141	17.6	59.0	1.06
chr8	2642910	2643184	CpG: 23	274	23	171	16.8	62.4	0.87
chr8	2791203	2791435	CpG: 17	232	17	137	14.7	59.1	0.87
chr8	2844000	2844242	CpG: 21	242	21	148	17.4	61.2	0.94
chr8	2895793	2896008	CpG: 18	215	18	133	16.7	61.9	0.89
chr8	2943465	2943738	CpG: 24	273	24	173	17.6	63.4	0.88
chr8	3795201	3795480	CpG: 23	279	23	173	16.5	62.0	0.87
chr8	3950514	3950788	CpG: 21	274	21	168	15.3	61.3	0.83
chr8	4206653	4206862	CpG: 19	209	19	129	18.2	61.7	0.97
chr8	4237483	4237721	CpG: 17	238	17	137	14.3	57.6	0.88
chr8	4335601	4335862	CpG: 20	261	20	186	15.3	71.3	0.60
chr8	4336888	4337245	CpG: 26	357	26	185	14.6	51.8	1.09
chr8	4390429	4390702	CpG: 23	273	23	171	16.8	62.6	0.87
chr8	4400069	4400286	CpG: 30	217	30	141	27.6	65.0	1.35
chr8	4502860	4503078	CpG: 16	218	16	130	14.7	59.6	0.84
chr8	4744240	4747906	CpG: 264	3666	264	2354	14.4	64.2	0.70
chr8	4801628	4801909	CpG: 24	281	24	175	17.1	62.3	0.90
chr8	4810256	4810537	CpG: 23	281	23	174	16.4	61.9	0.87
chr8	4836529	4836759	CpG: 20	230	20	140	17.4	60.9	0.95
chr8	4875082	4877380	CpG: 278	2298	278	1321	24.2	57.5	1.59
chr8	5172332	5172572	CpG: 17	240	17	146	14.2	60.8	0.78
chr8	5478588	5479430	CpG: 60	842	60	575	14.3	68.3	0.61
chr8	5739218	5739458	CpG: 18	240	18	141	15.0	58.8	0.88
chr8	5941583	5941857	CpG: 25	274	25	172	18.2	62.8	0.94
chr8	5959905	5960178	CpG: 22	273	22	171	16.1	62.6	0.83
chr8	5965859	5966129	CpG: 23	270	23	168	17.0	62.2	0.88
chr8	6015146	6015378	CpG: 17	232	17	137	14.7	59.1	0.86
chr8	6063026	6063266	CpG: 17	240	17	145	14.2	60.4	0.80
chr8	6100479	6100759	CpG: 21	280	21	170	15.0	60.7	0.83
chr8	6104050	6104282	CpG: 20	232	20	145	17.2	62.5	0.91
chr8	6160641	6161469	CpG: 79	828	79	575	19.1	69.4	0.80
chr8	6258508	6258744	CpG: 18	236	18	143	15.3	60.6	0.85
chr8	6276480	6276754	CpG: 20	274	20	165	14.6	60.2	0.82
chr8	6321133	6321834	CpG: 55	701	55	407	15.7	58.1	1.02
chr8	6410217	6410462	CpG: 17	245	17	143	13.9	58.4	0.83
chr8	6463190	6464534	CpG: 133	1344	133	939	19.8	69.9	0.81
chr8	6521138	6521375	CpG: 19	237	19	146	16.0	61.6	0.87
chr8	6545802	6546039	CpG: 18	237	18	143	15.2	60.3	0.96
chr8	6561793	6562072	CpG: 20	279	20	175	14.3	62.7	0.73
chr8	6589546	6590847	CpG: 123	1301	123	919	18.9	70.6	0.76
chr8	6654117	6654374	CpG: 19	257	19	153	14.8	59.5	0.85
chr8	6846384	6847074	CpG: 81	690	81	509	23.5	73.8	0.88
chr8	6900336	6900576	CpG: 22	240	22	142	18.3	59.2	1.06
chr8	6922990	6923228	CpG: 19	238	19	140	16.0	58.8	0.95
chr8	6967563	6968195	CpG: 72	632	72	457	22.8	72.3	0.88
chr8	6973795	6974332	CpG: 61	537	61	398	22.7	74.1	0.83
chr8	7083946	7084349	CpG: 42	403	42	297	20.8	73.7	0.77
chr8	7094419	7094647	CpG: 16	228	16	132	14.0	57.9	0.86
chr8	7248233	7248487	CpG: 20	254	20	178	15.7	70.1	0.64
chr8	7369053	7369587	CpG: 56	534	56	394	21.0	73.8	0.78
chr8	7375175	7375903	CpG: 78	728	78	528	21.4	72.5	0.82
chr8	7429627	7429896	CpG: 20	269	20	156	14.9	58.0	0.89
chr8	7539498	7540985	CpG: 124	1487	124	1033	16.7	69.5	0.73
chr8	7618355	7618760	CpG: 42	405	42	300	20.7	74.1	0.76
chr8	7661600	7661881	CpG: 20	281	20	172	14.2	61.2	0.78
chr8	7718914	7719490	CpG: 68	576	68	428	23.6	74.3	0.87
chr8	7725022	7725683	CpG: 73	661	73	483	22.1	73.1	0.83
chr8	7753756	7753971	CpG: 17	215	17	142	15.8	66.0	0.77
chr8	7823061	7823508	CpG: 35	447	35	293	15.7	65.5	0.74
chr8	7837595	7837945	CpG: 32	350	32	236	18.3	67.4	0.81
chr8	7870725	7870937	CpG: 18	212	18	125	17.0	59.0	1.00
chr8	7871757	7872748	CpG: 117	991	117	754	23.6	76.1	0.82
chr8	7931486	7932015	CpG: 54	529	54	384	20.4	72.6	0.77
chr8	7936996	7938115	CpG: 104	1119	104	765	18.6	68.4	0.80
chr8	7945111	7945694	CpG: 61	583	61	432	20.9	74.1	0.76
chr8	7970147	7970724	CpG: 56	577	56	424	19.4	73.5	0.72
chr8	8029861	8032569	CpG: 235	2708	235	1774	17.4	65.5	0.81
chr8	8034830	8038190	CpG: 227	3360	227	2110	13.5	62.8	0.68
chr8	8039530	8039930	CpG: 40	400	40	261	20.0	65.2	0.94
chr8	8042179	8042683	CpG: 48	504	48	356	19.0	70.6	0.76
chr8	8047190	8047917	CpG: 88	727	88	502	24.2	69.1	1.02
chr8	8058734	8061003	CpG: 178	2269	178	1425	15.7	62.8	0.79
chr8	8126500	8126735	CpG: 21	235	21	165	17.9	70.2	0.76
chr8	8175348	8176446	CpG: 117	1098	117	765	21.3	69.7	0.88
chr8	8272900	8273963	CpG: 103	1063	103	736	19.4	69.2	0.82
chr8	8337820	8338102	CpG: 23	282	23	172	16.3	61.0	0.89
chr8	8390861	8392010	CpG: 121	1149	121	815	21.1	70.9	0.84
chr8	8398731	8399011	CpG: 26	280	26	175	18.6	62.5	0.96
chr8	8408731	8409554	CpG: 63	823	63	576	15.3	70.0	0.63
chr8	8453834	8454626	CpG: 79	792	79	555	19.9	70.1	0.82
chr8	8515431	8515670	CpG: 20	239	20	145	16.7	60.7	0.92
chr8	8537305	8538862	CpG: 163	1557	163	1141	20.9	73.3	0.78
chr8	8667332	8667544	CpG: 15	212	15	139	14.2	65.6	0.67
chr8	8679205	8679860	CpG: 85	655	85	489	26.0	74.7	0.93
chr8	8722235	8723198	CpG: 104	963	104	711	21.6	73.8	0.80
chr8	8800746	8801056	CpG: 26	310	26	192	16.8	61.9	0.88
chr8	8814243	8814492	CpG: 20	249	20	163	16.1	65.5	0.77
chr8	8886778	8887144	CpG: 29	366	29	245	15.8	66.9	1.20
chr8	8898922	8899628	CpG: 75	706	75	481	21.2	68.1	0.92
chr8	9005473	9009278	CpG: 331	3805	331	2519	17.4	66.2	0.80
chr8	9009696	9009969	CpG: 20	273	20	164	14.7	60.1	0.82
chr8	9012326	9012766	CpG: 38	440	38	300	17.3	68.2	0.75
chr8	9125621	9125896	CpG: 21	275	21	183	15.3	66.5	0.69
chr8	9126384	9126658	CpG: 19	274	19	185	13.9	67.5	0.61
chr8	9147477	9147783	CpG: 22	306	22	210	14.4	68.6	0.62
chr8	9334484	9334806	CpG: 23	322	23	213	14.3	66.1	0.66
chr8	9380386	9380616	CpG: 20	230	20	141	17.4	61.3	0.94
chr8	9404097	9404776	CpG: 56	679	56	421	16.5	62.0	0.86
chr8	9592546	9592756	CpG: 14	210	14	124	13.3	59.0	0.77
chr8	9685524	9686528	CpG: 109	1004	109	694	21.7	69.1	0.91
chr8	9790282	9790563	CpG: 23	281	23	173	16.4	61.6	0.88
chr8	9806909	9807231	CpG: 28	322	28	222	17.4	68.9	0.74
chr8	9833718	9835802	CpG: 180	2084	180	1338	17.3	64.2	0.84
chr8	9836824	9837717	CpG: 70	893	70	572	15.7	64.1	0.77
chr8	9841476	9842292	CpG: 60	816	60	495	14.7	60.7	0.80
chr8	9883999	9884212	CpG: 18	213	18	127	16.9	59.6	0.96
chr8	9893140	9893531	CpG: 31	391	31	281	15.9	71.9	0.61
chr8	9932997	9933282	CpG: 24	285	24	178	16.8	62.5	0.88
chr8	9983995	9984272	CpG: 21	277	21	169	15.2	61.0	0.83
chr8	10002860	10003069	CpG: 15	209	15	121	14.4	57.9	0.88
chr8	10074544	10074825	CpG: 25	281	25	175	17.8	62.3	0.93
chr8	10108732	10109008	CpG: 27	276	27	175	19.6	63.4	0.98
chr8	10168507	10168737	CpG: 19	230	19	135	16.5	58.7	0.97
chr8	10176244	10176446	CpG: 17	202	17	122	16.8	60.4	0.93
chr8	10176979	10177260	CpG: 24	281	24	177	17.1	63.0	0.88
chr8	10187301	10188013	CpG: 60	712	60	485	16.9	68.1	0.73
chr8	10244864	10245078	CpG: 17	214	17	130	15.9	60.7	0.87
chr8	10247178	10247452	CpG: 20	274	20	166	14.6	60.6	0.80
chr8	10269398	10269629	CpG: 17	231	17	136	14.7	58.9	0.86
chr8	10328300	10328536	CpG: 19	236	19	145	16.1	61.4	0.86
chr8	10340224	10340461	CpG: 19	237	19	138	16.0	58.2	0.96
chr8	10554570	10554822	CpG: 18	252	18	148	14.3	58.7	0.85
chr8	10570547	10570781	CpG: 19	234	19	141	16.2	60.3	0.91
chr8	10589282	10590101	CpG: 60	819	60	567	14.7	69.2	0.61
chr8	10592235	10593530	CpG: 131	1295	131	897	20.2	69.3	0.84
chr8	10594579	10595170	CpG: 46	591	46	348	15.6	58.9	0.91
chr8	10616850	10617082	CpG: 17	232	17	140	14.7	60.3	0.83
chr8	10738323	10738551	CpG: 20	228	20	139	17.5	61.0	0.97
chr8	10740885	10741427	CpG: 63	542	63	377	23.2	69.6	0.96
chr8	10780516	10780862	CpG: 35	346	35	244	20.2	70.5	0.81
chr8	10850161	10852987	CpG: 272	2826	272	1984	19.2	70.2	0.78
chr8	10900872	10901167	CpG: 25	295	25	181	16.9	61.4	0.92
chr8	10947495	10947721	CpG: 19	226	19	139	16.8	61.5	0.90
chr8	10962433	10962860	CpG: 45	427	45	322	21.1	75.4	0.74
chr8	11020670	11021333	CpG: 61	663	61	456	18.4	68.8	0.78
chr8	11041020	11042750	CpG: 182	1730	182	1237	21.0	71.5	0.82
chr8	11237701	11237975	CpG: 21	274	21	165	15.3	60.2	0.85
chr8	11272091	11272384	CpG: 26	293	26	180	17.7	61.4	0.94
chr8	11289331	11289576	CpG: 19	245	19	149	15.5	60.8	0.86
chr8	11356527	11357548	CpG: 105	1021	105	729	20.6	71.4	0.82
chr8	11401099	11401314	CpG: 16	215	16	131	14.9	60.9	0.82
chr8	11424332	11425414	CpG: 93	1082	93	747	17.2	69.0	0.73
chr8	11514548	11516140	CpG: 129	1592	129	1094	16.2	68.7	0.73
chr8	11673020	11673748	CpG: 78	728	78	528	21.4	72.5	0.82
chr8	11679334	11679868	CpG: 56	534	56	393	21.0	73.6	0.79
chr8	11886610	11887045	CpG: 31	435	31	291	14.3	66.9	0.65
chr8	11938066	11938320	CpG: 20	254	20	178	15.7	70.1	0.64
chr8	11960978	11961209	CpG: 17	231	17	137	14.7	59.3	0.84
chr8	12062319	12062594	CpG: 24	275	24	170	17.5	61.8	0.93
chr8	12100965	12101370	CpG: 42	405	42	300	20.7	74.1	0.76
chr8	12178717	12180228	CpG: 126	1511	126	1053	16.7	69.7	0.73
chr8	12289816	12290090	CpG: 20	274	20	159	14.6	58.0	0.88
chr8	12343598	12344326	CpG: 80	728	80	528	22.0	72.5	0.84
chr8	12349891	12350425	CpG: 56	534	56	393	21.0	73.6	0.79
chr8	12478611	12478865	CpG: 20	254	20	178	15.7	70.1	0.64
chr8	12602966	12603203	CpG: 21	237	21	144	17.7	60.8	0.99
chr8	12641539	12641944	CpG: 42	405	42	300	20.7	74.1	0.76
chr8	12660723	12661042	CpG: 27	319	27	194	16.9	60.8	0.93
chr8	12715442	12716953	CpG: 127	1511	127	1052	16.8	69.6	0.74
chr8	12867633	12868361	CpG: 79	728	79	529	21.7	72.7	0.83
chr8	12873929	12874449	CpG: 56	520	56	380	21.5	73.1	0.82
chr8	12925089	12925757	CpG: 76	668	76	493	22.8	73.8	0.85
chr8	12931245	12931850	CpG: 67	605	67	444	22.1	73.4	0.83
chr8	12937369	12937654	CpG: 25	285	25	179	17.5	62.8	0.90
chr8	13020184	13022184	CpG: 266	2000	266	1536	26.6	76.8	0.91
chr8	13062464	13062818	CpG: 31	354	31	262	17.5	74.0	0.64
chr8	13197640	13198064	CpG: 52	424	52	329	24.5	77.6	0.81
chr8	13198604	13198899	CpG: 24	295	24	167	16.3	56.6	1.03
chr8	13217568	13218632	CpG: 131	1064	131	764	24.6	71.8	0.96
chr8	13290371	13290637	CpG: 21	266	21	167	15.8	62.8	0.82
chr8	13398368	13398623	CpG: 19	255	19	165	14.9	64.7	0.72
chr8	13399070	13400349	CpG: 126	1279	126	851	19.7	66.5	0.90
chr8	13436934	13437175	CpG: 18	241	18	148	14.9	61.4	0.81
chr8	13542822	13543292	CpG: 54	470	54	334	23.0	71.1	0.91
chr8	13578600	13578874	CpG: 25	274	25	172	18.2	62.8	0.94
chr8	13648760	13649033	CpG: 23	273	23	172	16.8	63.0	0.86
chr8	13886455	13886705	CpG: 19	250	19	145	15.2	58.0	0.92
chr8	14076346	14076647	CpG: 25	301	25	181	16.6	60.1	0.93
chr8	14084542	14084816	CpG: 25	274	25	171	18.2	62.4	0.95
chr8	14412619	14412849	CpG: 19	230	19	142	16.5	61.7	0.88
chr8	14456048	14456291	CpG: 17	243	17	148	14.0	60.9	0.78
chr8	14505631	14505861	CpG: 19	230	19	140	16.5	60.9	0.90
chr8	14530607	14530875	CpG: 22	268	22	166	16.4	61.9	0.87
chr8	14591751	14591994	CpG: 20	243	20	141	16.5	58.0	0.99
chr8	14839074	14839343	CpG: 22	269	22	168	16.4	62.5	0.84
chr8	14867690	14867926	CpG: 20	236	20	148	16.9	62.7	0.88
chr8	14993467	14993668	CpG: 16	201	16	126	15.9	62.7	0.82
chr8	15069205	15069518	CpG: 24	313	24	182	15.3	58.1	0.91
chr8	15095795	15096019	CpG: 18	224	18	133	16.1	59.4	0.92
chr8	15193131	15193368	CpG: 19	237	19	142	16.0	59.9	0.91
chr8	15332329	15332610	CpG: 24	281	24	177	17.1	63.0	0.88
chr8	15438119	15438348	CpG: 21	229	21	140	18.3	61.1	0.99
chr8	15461848	15462133	CpG: 24	285	24	177	16.8	62.1	0.88
chr8	15483073	15483347	CpG: 23	274	23	167	16.8	60.9	0.92
chr8	15502663	15503596	CpG: 94	933	94	670	20.2	71.8	0.78
chr8	15651969	15652244	CpG: 20	275	20	165	14.5	60.0	0.81
chr8	15712111	15712881	CpG: 59	770	59	531	15.3	69.0	0.65
chr8	15796105	15796390	CpG: 24	285	24	177	16.8	62.1	0.89
chr8	15806410	15807061	CpG: 65	651	65	465	20.0	71.4	0.78
chr8	15827768	15828067	CpG: 27	299	27	185	18.1	61.9	0.94
chr8	15848108	15848418	CpG: 25	310	25	191	16.1	61.6	0.85
chr8	16237899	16238174	CpG: 21	275	21	165	15.3	60.0	0.86
chr8	16302741	16302966	CpG: 19	225	19	137	16.9	60.9	0.92
chr8	16346367	16346605	CpG: 17	238	17	132	14.3	55.5	0.95
chr8	16386550	16386782	CpG: 17	232	17	134	14.7	57.8	0.90
chr8	16512578	16512808	CpG: 20	230	20	141	17.4	61.3	0.94
chr8	16518708	16518986	CpG: 24	278	24	173	17.3	62.2	0.91
chr8	16765447	16765660	CpG: 16	213	16	128	15.0	60.1	0.84
chr8	16937771	16938165	CpG: 30	394	30	236	15.2	59.9	0.85
chr8	16956367	16956641	CpG: 22	274	22	168	16.1	61.3	0.86
chr8	17037611	17037873	CpG: 19	262	19	157	14.5	59.9	0.83
chr8	17052194	17052546	CpG: 30	352	30	258	17.0	73.3	0.64
chr8	17059359	17059588	CpG: 17	229	17	136	14.8	59.4	0.87
chr8	17170985	17171293	CpG: 25	308	25	184	16.2	59.7	0.92
chr8	17188646	17188889	CpG: 20	243	20	146	16.5	60.1	0.93
chr8	17212327	17212638	CpG: 26	311	26	193	16.7	62.1	0.88
chr8	17269229	17269794	CpG: 54	565	54	399	19.1	70.6	0.77
chr8	17294740	17295722	CpG: 117	982	117	726	23.8	73.9	0.87
chr8	17304693	17305084	CpG: 32	391	32	282	16.4	72.1	0.63
chr8	17382404	17382678	CpG: 23	274	23	170	16.8	62.0	0.88
chr8	17423508	17424862	CpG: 183	1354	183	1059	27.0	78.2	0.89
chr8	17513978	17514951	CpG: 93	973	93	669	19.1	68.8	0.82
chr8	17631664	17631942	CpG: 21	278	21	168	15.1	60.4	0.83
chr8	17680365	17680882	CpG: 65	517	65	391	25.1	75.6	0.89
chr8	17698139	17698369	CpG: 17	230	17	137	14.8	59.6	0.85
chr8	17764066	17764995	CpG: 115	929	115	700	24.8	75.3	0.87
chr8	17770348	17770584	CpG: 21	236	21	147	17.8	62.3	0.94
chr8	17844279	17844585	CpG: 33	306	33	220	21.6	71.9	0.85
chr8	17924441	17924677	CpG: 19	236	19	144	16.1	61.0	0.88
chr8	18036546	18036813	CpG: 22	267	22	166	16.5	62.2	0.88
chr8	18068242	18069397	CpG: 140	1155	140	864	24.2	74.8	0.87
chr8	18179916	18180151	CpG: 17	235	17	140	14.5	59.6	0.83
chr8	18190013	18191253	CpG: 111	1240	111	818	17.9	66.0	0.82
chr8	18351243	18352403	CpG: 103	1160	103	753	17.8	64.9	0.84
chr8	18654463	18655234	CpG: 76	771	76	541	19.7	70.2	0.82
chr8	18882415	18882689	CpG: 24	274	24	171	17.5	62.4	0.91
chr8	19015938	19016144	CpG: 16	206	16	117	15.5	56.8	0.99
chr8	19016740	19016994	CpG: 21	254	21	182	16.5	71.7	0.65
chr8	19107227	19107501	CpG: 23	274	23	169	16.8	61.7	0.89
chr8	19107897	19108100	CpG: 17	203	17	120	16.7	59.1	0.97
chr8	19278293	19279350	CpG: 128	1057	128	773	24.2	73.1	0.91
chr8	19338650	19338879	CpG: 18	229	18	141	15.7	61.6	0.86
chr8	19502340	19502760	CpG: 42	420	42	300	20.0	71.4	0.80
chr8	19572635	19572916	CpG: 23	281	23	173	16.4	61.6	0.88
chr8	19578374	19579431	CpG: 112	1057	112	779	21.2	73.7	0.79
chr8	19726514	19726739	CpG: 20	225	20	145	17.8	64.4	0.86
chr8	19867404	19867636	CpG: 27	232	27	169	23.3	72.8	0.88
chr8	20021630	20022807	CpG: 139	1177	139	846	23.6	71.9	0.92
chr8	20081768	20082799	CpG: 94	1031	94	681	18.2	66.1	0.84
chr8	20204375	20205538	CpG: 119	1163	119	827	20.5	71.1	0.81
chr8	20239597	20239870	CpG: 25	273	25	169	18.3	61.9	0.96
chr8	20387910	20388184	CpG: 24	274	24	171	17.5	62.4	0.91
chr8	20462128	20462609	CpG: 58	481	58	338	24.1	70.3	0.98
chr8	20515003	20515229	CpG: 20	226	20	162	17.7	71.7	0.70
chr8	20568377	20569251	CpG: 98	874	98	624	22.4	71.4	0.88
chr8	20601007	20601253	CpG: 18	246	18	145	14.6	58.9	0.87
chr8	21290548	21290822	CpG: 21	274	21	169	15.3	61.7	0.82
chr8	21512830	21513111	CpG: 23	281	23	174	16.4	61.9	0.87
chr8	21983786	21984477	CpG: 51	691	51	460	14.8	66.6	0.67
chr8	22022137	22022394	CpG: 24	257	24	173	18.7	67.3	0.84
chr8	22056479	22056683	CpG: 17	204	17	138	16.7	67.6	0.73
chr8	22061226	22064155	CpG: 281	2929	281	1977	19.2	67.5	0.85
chr8	22083161	22083437	CpG: 21	276	21	167	15.2	60.5	0.84
chr8	22186178	22186563	CpG: 35	385	35	277	18.2	71.9	0.70
chr8	22193314	22194414	CpG: 130	1100	130	796	23.6	72.4	0.91
chr8	22284204	22284676	CpG: 44	472	44	317	18.6	67.2	0.83
chr8	22298053	22299329	CpG: 91	1276	91	849	14.3	66.5	0.65
chr8	22321906	22322218	CpG: 29	312	29	210	18.6	67.3	0.83
chr8	22322779	22323375	CpG: 74	596	74	474	24.8	79.5	0.80
chr8	22340285	22341078	CpG: 98	793	98	609	24.7	76.8	0.84
chr8	22360524	22360974	CpG: 49	450	49	338	21.8	75.1	0.77
chr8	22363015	22363857	CpG: 97	842	97	649	23.0	77.1	0.78
chr8	22382927	22383791	CpG: 117	864	117	648	27.1	75.0	0.96
chr8	22403967	22405448	CpG: 158	1481	158	1091	21.3	73.7	0.79
chr8	22415146	22415979	CpG: 75	833	75	577	18.0	69.3	0.76
chr8	22430426	22430991	CpG: 73	565	73	439	25.8	77.7	0.86
chr8	22438560	22439554	CpG: 126	994	126	752	25.4	75.7	0.90
chr8	22450810	22451209	CpG: 35	399	35	289	17.5	72.4	0.69
chr8	22495541	22495796	CpG: 19	255	19	167	14.9	65.5	0.74
chr8	22501703	22501942	CpG: 18	239	18	158	15.1	66.1	0.72
chr8	22505809	22506110	CpG: 21	301	21	195	14.0	64.8	0.67
chr8	22514260	22514534	CpG: 24	274	24	174	17.5	63.5	0.89
chr8	22518604	22519583	CpG: 97	979	97	680	19.8	69.5	0.82
chr8	22549233	22549797	CpG: 47	564	47	391	16.7	69.3	0.73
chr8	22640966	22641795	CpG: 101	829	101	631	24.4	76.1	0.86
chr8	22714428	22715458	CpG: 127	1030	127	774	24.7	75.1	0.90
chr8	22773046	22773302	CpG: 20	256	20	156	15.6	60.9	0.86
chr8	22825014	22825976	CpG: 116	962	116	725	24.1	75.4	0.87
chr8	22838870	22840038	CpG: 145	1168	145	887	24.8	75.9	0.86
chr8	22852633	22853414	CpG: 95	781	95	606	24.3	77.6	0.81
chr8	22872438	22874123	CpG: 139	1685	139	1232	16.5	73.1	0.73
chr8	22878462	22879238	CpG: 86	776	86	559	22.2	72.0	0.86
chr8	22899825	22900119	CpG: 25	294	25	183	17.0	62.2	0.89
chr8	22943037	22943496	CpG: 47	459	47	316	20.5	68.8	0.86
chr8	22963955	22970166	CpG: 511	6211	511	4112	16.5	66.2	0.75
chr8	22977696	22978144	CpG: 52	448	52	320	23.2	71.4	0.91
chr8	23139433	23140666	CpG: 120	1233	120	888	19.5	72.0	0.75
chr8	23166448	23166686	CpG: 19	238	19	140	16.0	58.8	0.94
chr8	23197089	23197370	CpG: 24	281	24	176	17.1	62.6	0.89
chr8	23274074	23275168	CpG: 125	1094	125	763	22.9	69.7	0.94
chr8	23281764	23282028	CpG: 21	264	21	179	15.9	67.8	0.72
chr8	23308272	23308548	CpG: 21	276	21	170	15.2	61.6	0.81
chr8	23343112	23344369	CpG: 109	1257	109	791	17.3	62.9	0.88
chr8	23345681	23346132	CpG: 47	451	47	337	20.8	74.7	0.75
chr8	23377809	23378352	CpG: 51	543	51	367	18.8	67.6	0.83
chr8	23393376	23393612	CpG: 22	236	22	144	18.6	61.0	1.03
chr8	23438050	23439005	CpG: 85	955	85	597	17.8	62.5	0.92
chr8	23497952	23498227	CpG: 22	275	22	170	16.0	61.8	0.84
chr8	23498917	23499127	CpG: 16	210	16	125	15.2	59.5	0.89
chr8	23499311	23500182	CpG: 73	871	73	595	16.8	68.3	0.73
chr8	23500902	23501339	CpG: 32	437	32	256	14.6	58.6	0.87
chr8	23521269	23521944	CpG: 61	675	61	459	18.1	68.0	0.81
chr8	23547006	23547395	CpG: 34	389	34	282	17.5	72.5	0.67
chr8	23562888	23563366	CpG: 50	478	50	353	20.9	73.8	0.77
chr8	23658601	23658842	CpG: 19	241	19	148	15.8	61.4	0.86
chr8	23677810	23679235	CpG: 129	1425	129	958	18.1	67.2	0.81
chr8	23732035	23732861	CpG: 100	826	100	600	24.2	72.6	0.92
chr8	23803576	23804742	CpG: 136	1166	136	837	23.3	71.8	0.91
chr8	23846391	23846618	CpG: 21	227	21	152	18.5	67.0	0.84
chr8	23908806	23909089	CpG: 25	283	25	174	17.7	61.5	0.94
chr8	23957240	23958035	CpG: 106	795	106	606	26.7	76.2	0.92
chr8	23977283	23978036	CpG: 79	753	79	526	21.0	69.9	0.86
chr8	23979920	23982621	CpG: 191	2701	191	1642	14.1	60.8	0.77
chr8	23984291	23985114	CpG: 62	823	62	494	15.1	60.0	0.84
chr8	23989356	23989869	CpG: 57	513	57	342	22.2	66.7	1.00
chr8	24000788	24001064	CpG: 21	276	21	175	15.2	63.4	0.77
chr8	24001421	24002196	CpG: 74	775	74	519	19.1	67.0	0.85
chr8	24147993	24148203	CpG: 15	210	15	122	14.3	58.1	0.85
chr8	24320402	24320672	CpG: 21	270	21	165	15.6	61.1	0.85
chr8	24903246	24903487	CpG: 18	241	18	141	14.9	58.5	0.89
chr8	25188542	25190187	CpG: 165	1645	165	1097	20.1	66.7	0.90
chr8	25196756	25197018	CpG: 25	262	25	165	19.1	63.0	0.98
chr8	25217674	25218016	CpG: 25	342	25	231	14.6	67.5	0.65
chr8	25218374	25218854	CpG: 34	480	34	302	14.2	62.9	0.72
chr8	25230921	25232274	CpG: 147	1353	147	888	21.7	65.6	1.01
chr8	25275499	25276417	CpG: 61	918	61	588	13.3	64.1	0.65
chr8	25381713	25382253	CpG: 44	540	44	385	16.3	71.3	0.64
chr8	25400935	25401215	CpG: 25	280	25	174	17.9	62.1	0.93
chr8	25463084	25464263	CpG: 147	1179	147	868	24.9	73.6	0.92
chr8	25667221	25667501	CpG: 20	280	20	162	14.3	57.9	0.86
chr8	25732990	25734732	CpG: 154	1742	154	1188	17.7	68.2	0.76
chr8	25797305	25797508	CpG: 15	203	15	118	14.8	58.1	0.89
chr8	25814891	25815161	CpG: 21	270	21	161	15.6	59.6	0.88
chr8	26011067	26011295	CpG: 21	228	21	141	18.4	61.8	0.96
chr8	26036711	26036987	CpG: 24	276	24	170	17.4	61.6	0.93
chr8	26315186	26315598	CpG: 32	412	32	250	15.5	60.7	0.85
chr8	26317321	26317678	CpG: 25	357	25	210	14.0	58.8	0.83
chr8	26318548	26323828	CpG: 357	5280	357	3184	13.5	60.3	0.74
chr8	26325687	26325905	CpG: 27	218	27	146	24.8	67.0	1.13
chr8	26327278	26327672	CpG: 36	394	36	248	18.3	62.9	0.93
chr8	26348980	26349254	CpG: 24	274	24	172	17.5	62.8	0.90
chr8	26465930	26466243	CpG: 30	313	30	218	19.2	69.6	0.79
chr8	26491517	26491791	CpG: 24	274	24	170	17.5	62.0	0.92
chr8	26567148	26568045	CpG: 82	897	82	649	18.3	72.4	0.70
chr8	26659334	26660313	CpG: 109	979	109	715	22.3	73.0	0.85
chr8	26672312	26672622	CpG: 25	310	25	191	16.1	61.6	0.85
chr8	26724901	26726786	CpG: 136	1885	136	1248	14.4	66.2	0.69
chr8	26790235	26791893	CpG: 168	1658	168	1187	20.3	71.6	0.79
chr8	26853581	26855991	CpG: 221	2410	221	1542	18.3	64.0	0.90
chr8	27140978	27143884	CpG: 201	2906	201	1810	13.8	62.3	0.72
chr8	27233407	27233623	CpG: 17	216	17	131	15.7	60.6	0.86
chr8	27383890	27384093	CpG: 15	203	15	117	14.8	57.6	0.90
chr8	27390492	27390919	CpG: 31	427	31	255	14.5	59.7	0.82
chr8	27470527	27470764	CpG: 16	237	16	140	13.5	59.1	0.79
chr8	27564437	27564907	CpG: 40	470	40	321	17.0	68.3	0.73
chr8	27587511	27588388	CpG: 89	877	89	618	20.3	70.5	0.82
chr8	27602405	27602705	CpG: 27	300	27	207	18.0	69.0	0.76
chr8	27740751	27741113	CpG: 29	362	29	215	16.0	59.4	0.99
chr8	27768394	27768713	CpG: 36	319	36	240	22.6	75.2	0.82
chr8	27869576	27869888	CpG: 27	312	27	206	17.3	66.0	0.80
chr8	27871386	27871610	CpG: 18	224	18	133	16.1	59.4	0.94
chr8	27891794	27892363	CpG: 46	569	46	389	16.2	68.4	0.69
chr8	27910799	27911615	CpG: 92	816	92	600	22.5	73.5	0.85
chr8	27945641	27945922	CpG: 24	281	24	175	17.1	62.3	0.90
chr8	27989671	27989907	CpG: 20	236	20	144	16.9	61.0	0.93
chr8	28049606	28050087	CpG: 54	481	54	325	22.5	67.6	0.99
chr8	28051700	28052177	CpG: 45	477	45	315	18.9	66.0	0.88
chr8	28082375	28082659	CpG: 25	284	25	179	17.6	63.0	0.90
chr8	28103933	28104163	CpG: 20	230	20	142	17.4	61.7	0.93
chr8	28114909	28115293	CpG: 37	384	37	247	19.3	64.3	0.94
chr8	28156888	28157100	CpG: 23	212	23	141	21.7	66.5	1.05
chr8	28199773	28200459	CpG: 66	686	66	478	19.2	69.7	0.80
chr8	28371163	28371561	CpG: 31	398	31	235	15.6	59.0	0.90
chr8	28384467	28384745	CpG: 25	278	25	176	18.0	63.3	0.90
chr8	28663565	28664932	CpG: 192	1367	192	1087	28.1	79.5	0.89
chr8	28679454	28680783	CpG: 128	1329	128	897	19.3	67.5	0.87
chr8	28682768	28683005	CpG: 19	237	19	142	16.0	59.9	0.91
chr8	28689848	28690635	CpG: 96	787	96	602	24.4	76.5	0.83
chr8	28740472	28740752	CpG: 22	280	22	173	15.7	61.8	0.84
chr8	28748001	28748227	CpG: 19	226	19	126	16.8	55.8	1.08
chr8	28772102	28773208	CpG: 133	1106	133	826	24.1	74.7	0.86
chr8	28900274	28901437	CpG: 127	1163	127	802	21.8	69.0	0.94
chr8	28979275	28980647	CpG: 163	1372	163	1014	23.8	73.9	0.87
chr8	28994285	28994528	CpG: 19	243	19	151	15.6	62.1	0.81
chr8	29158578	29160137	CpG: 128	1559	128	1151	16.4	73.8	0.60
chr8	29168703	29169474	CpG: 53	771	53	478	13.7	62.0	0.73
chr8	29212827	29213103	CpG: 22	276	22	167	15.9	60.5	0.88
chr8	29255820	29256090	CpG: 20	270	20	158	14.8	58.5	0.88
chr8	29349641	29350363	CpG: 76	722	76	545	21.1	75.5	0.74
chr8	29475243	29475517	CpG: 24	274	24	170	17.5	62.0	0.92
chr8	29540647	29541477	CpG: 110	830	110	650	26.5	78.3	0.89
chr8	29615359	29615684	CpG: 27	325	27	216	16.6	66.5	0.75
chr8	29621169	29621432	CpG: 20	263	20	159	15.2	60.5	0.85
chr8	29626424	29630607	CpG: 370	4183	370	2681	17.7	64.1	0.86
chr8	29631243	29631561	CpG: 28	318	28	199	17.6	62.6	0.91
chr8	29656620	29656898	CpG: 25	278	25	175	18.0	62.9	0.92
chr8	29741547	29741821	CpG: 25	274	25	172	18.2	62.8	0.94
chr8	30024457	30024687	CpG: 22	230	22	143	19.1	62.2	1.00
chr8	30306134	30306673	CpG: 53	539	53	380	19.7	70.5	0.79
chr8	30325123	30325410	CpG: 21	287	21	176	14.6	61.3	0.79
chr8	30361542	30362327	CpG: 92	785	92	562	23.4	71.6	0.92
chr8	30366890	30367245	CpG: 39	355	39	264	22.0	74.4	0.80
chr8	30370591	30370807	CpG: 17	216	17	114	15.7	52.8	1.52
chr8	30374027	30374976	CpG: 110	949	110	675	23.2	71.1	0.92
chr8	30435055	30435715	CpG: 51	660	51	429	15.5	65.0	0.73
chr8	30525327	30526650	CpG: 110	1323	110	962	16.6	72.7	0.63
chr8	30662787	30664249	CpG: 157	1462	157	1077	21.5	73.7	0.79
chr8	30888252	30888492	CpG: 17	240	17	143	14.2	59.6	0.82
chr8	30937114	30938376	CpG: 115	1262	115	803	18.2	63.6	0.90
chr8	31006727	31007588	CpG: 99	861	99	630	23.0	73.2	0.86
chr8	31092948	31093973	CpG: 132	1025	132	772	25.8	75.3	0.92
chr8	31192754	31193623	CpG: 89	869	89	609	20.5	70.1	0.84
chr8	31257482	31257756	CpG: 23	274	23	170	16.8	62.0	0.88
chr8	31313861	31314981	CpG: 141	1120	141	852	25.2	76.1	0.87
chr8	31384917	31385153	CpG: 17	236	17	141	14.4	59.7	0.83
chr8	31430251	31430488	CpG: 19	237	19	141	16.0	59.5	0.95
chr8	31741756	31742035	CpG: 24	279	24	175	17.2	62.7	0.88
chr8	31920219	31922040	CpG: 190	1821	190	1269	20.9	69.7	0.86
chr8	31929366	31929639	CpG: 23	273	23	167	16.8	61.2	0.91
chr8	31972525	31972741	CpG: 18	216	18	133	16.7	61.6	0.91
chr8	31989672	31989946	CpG: 24	274	24	172	17.5	62.8	0.90
chr8	32208437	32208711	CpG: 24	274	24	171	17.5	62.4	0.91
chr8	32227996	32228277	CpG: 20	281	20	172	14.2	61.2	0.77
chr8	32306672	32306929	CpG: 22	257	22	158	17.1	61.5	0.92
chr8	32440175	32440456	CpG: 23	281	23	174	16.4	61.9	0.87
chr8	32751073	32751302	CpG: 17	229	17	141	14.8	61.6	0.81
chr8	32783495	32783769	CpG: 20	274	20	172	14.6	62.8	0.76
chr8	32829198	32830692	CpG: 175	1494	175	1082	23.4	72.4	0.89
chr8	32836851	32837082	CpG: 18	231	18	144	15.6	62.3	0.82
chr8	33602897	33603173	CpG: 24	276	24	171	17.4	62.0	0.92
chr8	33743998	33744712	CpG: 61	714	61	463	17.1	64.8	0.81
chr8	33756028	33756992	CpG: 96	964	96	634	19.9	65.8	0.92
chr8	33785115	33785362	CpG: 21	247	21	149	17.0	60.3	0.94
chr8	33785729	33786357	CpG: 53	628	53	406	16.9	64.6	0.83
chr8	33837340	33838646	CpG: 110	1306	110	857	16.8	65.6	0.78
chr8	33845185	33845572	CpG: 33	387	33	277	17.1	71.6	0.67
chr8	33870651	33871251	CpG: 58	600	58	416	19.3	69.3	0.81
chr8	33929380	33930388	CpG: 80	1008	80	716	15.9	71.0	0.63
chr8	33994126	33994362	CpG: 18	236	18	169	15.3	71.6	0.62
chr8	34687518	34687755	CpG: 18	237	18	139	15.2	58.6	0.91
chr8	34715191	34715465	CpG: 22	274	22	168	16.1	61.3	0.86
chr8	34731441	34731719	CpG: 22	278	22	171	15.8	61.5	0.84
chr8	34804347	34805278	CpG: 68	931	68	639	14.6	68.6	0.62
chr8	34875502	34875783	CpG: 22	281	22	172	15.7	61.2	0.85
chr8	35059859	35060440	CpG: 46	581	46	346	15.8	59.6	0.90
chr8	35132950	35133159	CpG: 15	209	15	123	14.4	58.9	0.84
chr8	35134278	35134487	CpG: 16	209	16	125	15.3	59.8	0.87
chr8	35369655	35370256	CpG: 43	601	43	396	14.3	65.9	0.66
chr8	35486820	35487098	CpG: 25	278	25	175	18.0	62.9	0.92
chr8	35510764	35512232	CpG: 146	1468	146	1038	19.9	70.7	0.80
chr8	35611404	35611682	CpG: 21	278	21	167	15.1	60.1	0.84
chr8	35668772	35669045	CpG: 21	273	21	170	15.4	62.3	0.80
chr8	35782665	35782938	CpG: 23	273	23	168	16.8	61.5	0.90
chr8	35809808	35810034	CpG: 19	226	19	129	16.8	57.1	1.03
chr8	36416377	36416645	CpG: 23	268	23	168	17.2	62.7	0.89
chr8	36445697	36445928	CpG: 18	231	18	139	15.6	60.2	0.88
chr8	36592927	36593208	CpG: 23	281	23	174	16.4	61.9	0.87
chr8	36670214	36670608	CpG: 28	394	28	237	14.2	60.2	0.79
chr8	37624288	37624562	CpG: 22	274	22	172	16.1	62.8	0.82
chr8	37970801	37975034	CpG: 402	4233	402	2950	19.0	69.7	0.79
chr8	37976784	37977756	CpG: 72	972	72	614	14.8	63.2	0.74
chr8	38012715	38013584	CpG: 90	869	90	584	20.7	67.2	0.92
chr8	38038657	38039648	CpG: 85	991	85	651	17.2	65.7	0.83
chr8	38052600	38052829	CpG: 16	229	16	136	14.0	59.4	0.80
chr8	38072925	38074977	CpG: 200	2052	200	1469	19.5	71.6	0.76
chr8	38117729	38118814	CpG: 117	1085	117	795	21.6	73.3	0.80
chr8	38126035	38126393	CpG: 31	358	31	235	17.3	65.6	0.80
chr8	38174595	38176287	CpG: 155	1692	155	1118	18.3	66.1	0.84
chr8	38203660	38204636	CpG: 80	976	80	679	16.4	69.6	0.68
chr8	38241291	38242889	CpG: 154	1598	154	1072	19.3	67.1	0.86
chr8	38265359	38265633	CpG: 23	274	23	170	16.8	62.0	0.88
chr8	38288762	38289002	CpG: 18	240	18	141	15.0	58.8	0.89
chr8	38306575	38307713	CpG: 111	1138	111	778	19.5	68.4	0.85
chr8	38381890	38382903	CpG: 92	1013	92	668	18.2	65.9	0.84
chr8	38434351	38434581	CpG: 17	230	17	135	14.8	58.7	0.88
chr8	38452869	38454104	CpG: 102	1235	102	795	16.5	64.4	0.80
chr8	38457973	38458200	CpG: 18	227	18	137	15.9	60.4	0.88
chr8	38508166	38509387	CpG: 130	1221	130	868	21.3	71.1	0.84
chr8	38545534	38546469	CpG: 93	935	93	645	19.9	69.0	0.84
chr8	38610543	38610824	CpG: 24	281	24	175	17.1	62.3	0.90
chr8	38649493	38649976	CpG: 35	483	35	276	14.5	57.1	0.89
chr8	38658640	38660121	CpG: 180	1481	180	1060	24.3	71.6	0.95
chr8	38663192	38664146	CpG: 91	954	91	628	19.1	65.8	0.89
chr8	38743155	38743506	CpG: 32	351	32	237	18.2	67.5	0.81
chr8	38744526	38745809	CpG: 176	1283	176	976	27.4	76.1	0.95
chr8	38794931	38795135	CpG: 16	204	16	114	15.7	55.9	1.04
chr8	38927810	38928259	CpG: 50	449	50	316	22.3	70.4	0.91
chr8	38996802	38997166	CpG: 35	364	35	272	19.2	74.7	0.69
chr8	39033914	39034736	CpG: 86	822	86	614	20.9	74.7	0.75
chr8	39063967	39065254	CpG: 151	1287	151	909	23.5	70.6	0.94
chr8	39123026	39123254	CpG: 20	228	20	138	17.5	60.5	1.00
chr8	39177056	39177344	CpG: 23	288	23	162	16.0	56.2	1.01
chr8	39177862	39178786	CpG: 108	924	108	698	23.4	75.5	0.82
chr8	39251214	39251975	CpG: 78	761	78	530	20.5	69.6	0.85
chr8	39273323	39274739	CpG: 152	1416	152	970	21.5	68.5	0.92
chr8	39384629	39385039	CpG: 47	410	47	289	22.9	70.5	0.93
chr8	39437330	39437592	CpG: 19	262	19	157	14.5	59.9	0.82
chr8	39457170	39457574	CpG: 33	404	33	293	16.3	72.5	0.62
chr8	39600908	39601144	CpG: 19	236	19	143	16.1	60.6	0.90
chr8	39799971	39800279	CpG: 30	308	30	219	19.5	71.1	0.78
chr8	40037649	40037899	CpG: 18	250	18	149	14.4	59.6	0.83
chr8	40707734	40708007	CpG: 21	273	21	170	15.4	62.3	0.80
chr8	40709265	40709559	CpG: 23	294	23	176	15.6	59.9	0.88
chr8	41058405	41058641	CpG: 21	236	21	145	17.8	61.4	0.96
chr8	41176270	41176510	CpG: 20	240	20	157	16.7	65.4	0.78
chr8	41187983	41188189	CpG: 17	206	17	111	16.5	53.9	1.14
chr8	41287963	41288205	CpG: 18	242	18	164	14.9	67.8	0.65
chr8	41337859	41338137	CpG: 25	278	25	174	18.0	62.6	0.93
chr8	41366744	41367012	CpG: 22	268	22	161	16.4	60.1	0.93
chr8	41582039	41583327	CpG: 154	1288	154	931	23.9	72.3	0.92
chr8	41763970	41764757	CpG: 76	787	76	558	19.3	70.9	0.78
chr8	41801775	41801987	CpG: 18	212	18	130	17.0	61.3	0.93
chr8	41802620	41803097	CpG: 52	477	52	339	21.8	71.1	0.87
chr8	41831206	41831480	CpG: 21	274	21	167	15.3	60.9	0.84
chr8	41840572	41841531	CpG: 73	959	73	633	15.2	66.0	0.70
chr8	41851599	41852398	CpG: 107	799	107	613	26.8	76.7	0.91
chr8	41900034	41900908	CpG: 69	874	69	610	15.8	69.8	0.65
chr8	41920023	41920373	CpG: 44	350	44	250	25.1	71.4	0.99
chr8	41923630	41923982	CpG: 27	352	27	249	15.3	70.7	0.62
chr8	41927091	41927814	CpG: 65	723	65	532	18.0	73.6	0.67
chr8	41953214	41953466	CpG: 20	252	20	152	15.9	60.3	0.89
chr8	41969900	41970157	CpG: 22	257	22	181	17.1	70.4	0.69
chr8	41975331	41975682	CpG: 28	351	28	239	16.0	68.1	0.69
chr8	41997389	41997662	CpG: 23	273	23	168	16.8	61.5	0.90
chr8	41999195	41999584	CpG: 41	389	41	269	21.1	69.2	0.88
chr8	42040442	42041450	CpG: 102	1008	102	734	20.2	72.8	0.77
chr8	42070918	42072027	CpG: 79	1109	79	734	14.2	66.2	0.66
chr8	42101747	42102673	CpG: 70	926	70	572	15.1	61.8	0.81
chr8	42149362	42149913	CpG: 66	551	66	407	24.0	73.9	0.91
chr8	42169340	42171250	CpG: 227	1910	227	1410	23.8	73.8	0.87
chr8	42325164	42326930	CpG: 215	1766	215	1307	24.3	74.0	0.90
chr8	42347081	42347355	CpG: 22	274	22	169	16.1	61.7	0.86
chr8	42414234	42415203	CpG: 89	969	89	631	18.4	65.1	0.88
chr8	42426521	42427896	CpG: 141	1375	141	978	20.5	71.1	0.81
chr8	42545523	42545975	CpG: 50	452	50	323	22.1	71.5	0.87
chr8	42586298	42586534	CpG: 19	236	19	144	16.1	61.0	0.88
chr8	42608418	42608783	CpG: 36	365	36	249	19.7	68.2	0.87
chr8	42661603	42662645	CpG: 107	1042	107	709	20.5	68.0	0.89
chr8	42680928	42681578	CpG: 53	650	53	413	16.3	63.5	0.81
chr8	42682051	42682459	CpG: 29	408	29	255	14.2	62.5	0.75
chr8	42706861	42707856	CpG: 71	995	71	625	14.3	62.8	0.73
chr8	42746450	42746735	CpG: 21	285	21	167	14.7	58.6	0.87
chr8	42809072	42810034	CpG: 141	962	141	723	29.3	75.2	1.04
chr8	42889453	42889689	CpG: 20	236	20	142	16.9	60.2	0.96
chr8	42960026	42960549	CpG: 39	523	39	313	14.9	59.8	0.84
chr8	42985187	42985424	CpG: 21	237	21	145	17.7	61.2	0.97
chr8	43025763	43026004	CpG: 20	241	20	134	16.6	55.6	1.07
chr8	43110839	43111296	CpG: 63	457	63	329	27.6	72.0	1.07
chr8	43111400	43111693	CpG: 20	293	20	187	13.7	63.8	0.68
chr8	43163535	43163796	CpG: 22	261	22	157	16.9	60.2	0.94
chr8	43165009	43166929	CpG: 262	1920	262	1405	27.3	73.2	1.03
chr8	43187806	43188738	CpG: 67	932	67	641	14.4	68.8	0.61
chr8	43208213	43209298	CpG: 88	1085	88	784	16.2	72.3	0.62
chr8	43277612	43277886	CpG: 23	274	23	170	16.8	62.0	0.88
chr8	43301902	43302787	CpG: 75	885	75	622	16.9	70.3	0.69
chr8	43324830	43325844	CpG: 111	1014	111	694	21.9	68.4	0.94
chr8	43357587	43357816	CpG: 18	229	18	134	15.7	58.5	0.93
chr8	43361328	43361541	CpG: 19	213	19	129	17.8	60.6	1.00
chr8	43361809	43362967	CpG: 100	1158	100	764	17.3	66.0	0.80
chr8	43409038	43410381	CpG: 172	1343	172	1010	25.6	75.2	0.91
chr8	43418356	43418592	CpG: 19	236	19	144	16.1	61.0	0.88
chr8	43473723	43473941	CpG: 20	218	20	144	18.3	66.1	0.85
chr8	43520570	43521796	CpG: 110	1226	110	856	17.9	69.8	0.74
chr8	43543887	43544115	CpG: 18	228	18	146	15.8	64.0	0.77
chr8	43546023	43546275	CpG: 23	252	23	182	18.3	72.2	0.70
chr8	43550213	43550523	CpG: 27	310	27	224	17.4	72.3	0.72
chr8	43551081	43551514	CpG: 50	433	50	316	23.1	73.0	0.88
chr8	43640556	43640792	CpG: 20	236	20	145	16.9	61.4	0.93
chr8	43720148	43720393	CpG: 18	245	18	143	14.7	58.4	0.91
chr8	43823126	43823353	CpG: 18	227	18	149	15.9	65.6	0.74
chr8	44456597	44456875	CpG: 25	278	25	175	18.0	62.9	0.92
chr8	44461011	44461289	CpG: 25	278	25	175	18.0	62.9	0.92
chr8	46993174	46993541	CpG: 39	367	39	263	21.3	71.7	0.83
chr8	47330574	47330972	CpG: 32	398	32	271	16.1	68.1	0.72
chr8	47346398	47346627	CpG: 18	229	18	141	15.7	61.6	0.86
chr8	47484928	47485201	CpG: 20	273	20	165	14.7	60.4	0.82
chr8	47508729	47508939	CpG: 23	210	23	128	21.9	61.0	1.18
chr8	47540906	47541184	CpG: 24	278	24	174	17.3	62.6	0.89
chr8	47555828	47556141	CpG: 21	313	21	187	13.4	59.7	0.77
chr8	47564300	47565051	CpG: 69	751	69	543	18.4	72.3	0.70
chr8	47625773	47626051	CpG: 24	278	24	173	17.3	62.2	0.90
chr8	47635961	47636163	CpG: 20	202	20	134	19.8	66.3	0.91
chr8	47636430	47637261	CpG: 100	831	100	601	24.1	72.3	0.93
chr8	47639168	47639377	CpG: 18	209	18	123	17.2	58.9	1.00
chr8	47767469	47767743	CpG: 20	274	20	167	14.6	60.9	0.79
chr8	47951095	47951335	CpG: 20	240	20	144	16.7	60.0	0.95
chr8	48112921	48114808	CpG: 244	1887	244	1423	25.9	75.4	0.91
chr8	48140497	48140768	CpG: 26	271	26	186	19.2	68.6	0.82
chr8	48207531	48207867	CpG: 28	336	28	224	16.7	66.7	0.75
chr8	48211001	48211237	CpG: 22	236	22	146	18.6	61.9	0.99
chr8	48331433	48331707	CpG: 23	274	23	169	16.8	61.7	0.89
chr8	48336146	48337595	CpG: 156	1449	156	969	21.5	66.9	0.96
chr8	48384767	48385639	CpG: 116	872	116	605	26.6	69.4	1.11
chr8	48445816	48446155	CpG: 26	339	26	191	15.3	56.3	0.98
chr8	48507794	48508017	CpG: 18	223	18	150	16.1	67.3	0.71
chr8	48638275	48638700	CpG: 33	425	33	286	15.5	67.3	0.69
chr8	48696797	48697085	CpG: 25	288	25	179	17.4	62.2	0.90
chr8	48758482	48758828	CpG: 39	346	39	266	22.5	76.9	0.77
chr8	48774344	48774914	CpG: 45	570	45	415	15.8	72.8	0.69
chr8	48892354	48892696	CpG: 36	342	36	261	21.1	76.3	0.72
chr8	48933963	48934275	CpG: 42	312	42	236	26.9	75.6	0.95
chr8	48986952	48987177	CpG: 17	225	17	132	15.1	58.7	0.89
chr8	49012766	49013003	CpG: 21	237	21	146	17.7	61.6	0.96
chr8	49112992	49113278	CpG: 37	286	37	202	25.9	70.6	1.04
chr8	49177412	49177722	CpG: 24	310	24	181	15.5	58.4	0.91
chr8	49212716	49212942	CpG: 18	226	18	146	15.9	64.6	0.78
chr8	49247984	49248567	CpG: 63	583	63	407	21.6	69.8	0.89
chr8	49288653	49288873	CpG: 17	220	17	141	15.5	64.1	0.75
chr8	49301298	49301542	CpG: 20	244	20	151	16.4	61.9	0.88
chr8	49355690	49356178	CpG: 45	488	45	361	18.4	74.0	0.67
chr8	49536394	49536673	CpG: 24	279	24	168	17.2	60.2	0.96
chr8	49778996	49779219	CpG: 18	223	18	136	16.1	61.0	0.88
chr8	50208757	50209035	CpG: 19	278	19	165	13.7	59.4	0.78
chr8	50290703	50291059	CpG: 34	356	34	230	19.1	64.6	0.92
chr8	50723592	50723797	CpG: 17	205	17	146	16.6	71.2	0.66
chr8	50993203	50993438	CpG: 17	235	17	139	14.5	59.1	0.85
chr8	51060500	51060781	CpG: 23	281	23	174	16.4	61.9	0.87
chr8	51274353	51274648	CpG: 23	295	23	175	15.6	59.3	0.90
chr8	51336052	51336284	CpG: 17	232	17	136	14.7	58.6	0.86
chr8	51644467	51644677	CpG: 19	210	19	149	18.1	71.0	0.74
chr8	51781653	51782712	CpG: 98	1059	98	708	18.5	66.9	0.84
chr8	52109122	52109396	CpG: 24	274	24	171	17.5	62.4	0.91
chr8	52134448	52134738	CpG: 24	290	24	169	16.6	58.3	0.98
chr8	52164917	52165141	CpG: 20	224	20	163	17.9	72.8	0.68
chr8	52274131	52275389	CpG: 121	1258	121	883	19.2	70.2	0.80
chr8	52352601	52352816	CpG: 18	215	18	126	16.7	58.6	1.00
chr8	52412713	52412960	CpG: 18	247	18	153	14.6	61.9	0.78
chr8	52447216	52447484	CpG: 19	268	19	162	14.2	60.4	0.79
chr8	52476571	52476985	CpG: 31	414	31	286	15.0	69.1	0.65
chr8	52932407	52932681	CpG: 25	274	25	169	18.2	61.7	0.97
chr8	52941027	52942110	CpG: 124	1083	124	795	22.9	73.4	0.85
chr8	52948649	52950418	CpG: 129	1769	129	1229	14.6	69.5	0.60
chr8	53089439	53090935	CpG: 153	1496	153	1026	20.5	68.6	0.87
chr8	53120489	53120757	CpG: 20	268	20	163	14.9	60.8	0.82
chr8	53315564	53318289	CpG: 249	2725	249	1788	18.3	65.6	0.85
chr8	53540248	53540524	CpG: 21	276	21	165	15.2	59.8	0.87
chr8	53627228	53628369	CpG: 119	1141	119	824	20.9	72.2	0.80
chr8	53668823	53669100	CpG: 26	277	26	174	18.8	62.8	0.96
chr8	53971963	53972214	CpG: 24	251	24	178	19.1	70.9	0.77
chr8	53987030	53987299	CpG: 19	269	19	158	14.1	58.7	0.82
chr8	54034523	54034866	CpG: 30	343	30	204	17.5	59.5	0.99
chr8	54133179	54133409	CpG: 19	230	19	140	16.5	60.9	0.90
chr8	54152409	54152620	CpG: 17	211	17	119	16.1	56.4	1.04
chr8	54153280	54153665	CpG: 33	385	33	277	17.1	71.9	0.66
chr8	54220409	54221010	CpG: 59	601	59	403	19.6	67.1	0.89
chr8	54254414	54255498	CpG: 92	1084	92	689	17.0	63.6	0.85
chr8	54256678	54260032	CpG: 303	3354	303	2277	18.1	67.9	0.79
chr8	54399166	54400716	CpG: 139	1550	139	967	17.9	62.4	0.92
chr8	54462220	54463089	CpG: 66	869	66	585	15.2	67.3	0.67
chr8	54478544	54479201	CpG: 95	657	95	510	28.9	77.6	0.98
chr8	54512447	54512747	CpG: 31	300	31	211	20.7	70.3	0.84
chr8	54669981	54670203	CpG: 17	222	17	135	15.3	60.8	0.85
chr8	54693615	54693852	CpG: 17	237	17	138	14.3	58.2	0.86
chr8	54830875	54832323	CpG: 123	1448	123	924	17.0	63.8	0.84
chr8	54832580	54832821	CpG: 19	241	19	139	15.8	57.7	0.97
chr8	54834864	54837219	CpG: 240	2355	240	1648	20.4	70.0	0.83
chr8	54843622	54844880	CpG: 142	1258	142	864	22.6	68.7	0.96
chr8	54847333	54847883	CpG: 64	550	64	409	23.3	74.4	0.85
chr8	54926457	54926682	CpG: 16	225	16	133	14.2	59.1	0.84
chr8	54932265	54932540	CpG: 22	275	22	168	16.0	61.1	0.87
chr8	54953423	54953664	CpG: 21	241	21	145	17.4	60.2	0.99
chr8	54998708	54998938	CpG: 25	230	25	162	21.7	70.4	0.88
chr8	55035734	55036007	CpG: 24	273	24	171	17.6	62.6	0.91
chr8	55252632	55252852	CpG: 23	220	23	171	20.9	77.7	0.70
chr8	55436572	55436863	CpG: 22	291	22	171	15.1	58.8	0.90
chr8	55478656	55480761	CpG: 246	2105	246	1558	23.4	74.0	0.85
chr8	55826869	55827181	CpG: 22	312	22	205	14.1	65.7	0.66
chr8	56078315	56078588	CpG: 21	273	21	164	15.4	60.1	0.86
chr8	56149829	56150700	CpG: 85	871	85	589	19.5	67.6	0.85
chr8	56205865	56206081	CpG: 17	216	17	129	15.7	59.7	0.92
chr8	56256608	56257818	CpG: 135	1210	135	885	22.3	73.1	0.83
chr8	56450999	56451751	CpG: 70	752	70	460	18.6	61.2	1.00
chr8	56480543	56480820	CpG: 20	277	20	165	14.4	59.6	0.82
chr8	56489963	56490960	CpG: 75	997	75	613	15.0	61.5	0.80
chr8	56494613	56495301	CpG: 63	688	63	433	18.3	62.9	0.92
chr8	56534103	56534508	CpG: 48	405	48	294	23.7	72.6	0.90
chr8	56588002	56589427	CpG: 163	1425	163	996	22.9	69.9	0.94
chr8	56696948	56697477	CpG: 56	529	56	363	21.2	68.6	0.90
chr8	56815632	56815970	CpG: 26	338	26	210	15.4	62.1	0.80
chr8	56822810	56824098	CpG: 136	1288	136	872	21.1	67.7	0.92
chr8	56824582	56824832	CpG: 17	250	17	166	13.6	66.4	0.65
chr8	56825268	56825498	CpG: 23	230	23	159	20.0	69.1	0.84
chr8	57030867	57031118	CpG: 21	251	21	145	16.7	57.8	1.00
chr8	57103013	57103281	CpG: 20	268	20	161	14.9	60.1	0.84
chr8	57370214	57371058	CpG: 113	844	113	625	26.8	74.1	0.98
chr8	57372999	57373279	CpG: 24	280	24	169	17.1	60.4	0.96
chr8	57448472	57449255	CpG: 59	783	59	527	15.1	67.3	0.67
chr8	57514647	57514877	CpG: 17	230	17	136	14.8	59.1	0.87
chr8	57525266	57526565	CpG: 102	1299	102	816	15.7	62.8	0.80
chr8	57587758	57588004	CpG: 21	246	21	156	17.1	63.4	0.86
chr8	57590441	57591111	CpG: 45	670	45	394	13.4	58.8	0.79
chr8	57595822	57596492	CpG: 45	670	45	394	13.4	58.8	0.79
chr8	57601203	57601873	CpG: 45	670	45	394	13.4	58.8	0.79
chr8	57606584	57607253	CpG: 43	669	43	390	12.9	58.3	0.77
chr8	57611965	57612635	CpG: 44	670	44	393	13.1	58.7	0.78
chr8	57617347	57618017	CpG: 44	670	44	394	13.1	58.8	0.78
chr8	57622729	57623399	CpG: 44	670	44	393	13.1	58.7	0.78
chr8	57628110	57628780	CpG: 44	670	44	393	13.1	58.7	0.78
chr8	57633492	57634162	CpG: 44	670	44	393	13.1	58.7	0.78
chr8	57638869	57639112	CpG: 17	243	17	159	14.0	65.4	0.65
chr8	57681057	57682844	CpG: 117	1787	117	1179	13.1	66.0	0.60
chr8	57701480	57701865	CpG: 32	385	32	267	16.6	69.4	0.69
chr8	57785139	57785369	CpG: 16	230	16	134	13.9	58.3	0.84
chr8	58415878	58416750	CpG: 103	872	103	657	23.6	75.3	0.83
chr8	58474321	58474599	CpG: 26	278	26	176	18.7	63.3	0.94
chr8	58567124	58568371	CpG: 96	1247	96	807	15.4	64.7	0.74
chr8	58662209	58662453	CpG: 18	244	18	141	14.8	57.8	0.92
chr8	58770786	58771021	CpG: 21	235	21	145	17.9	61.7	0.96
chr8	58805216	58805453	CpG: 19	237	19	146	16.0	61.6	0.87
chr8	58822407	58822665	CpG: 24	258	24	163	18.6	63.2	0.94
chr8	58832366	58832740	CpG: 53	374	53	280	28.3	74.9	1.04
chr8	58916423	58916662	CpG: 18	239	18	142	15.1	59.4	0.87
chr8	58966315	58966543	CpG: 16	228	16	139	14.0	61.0	0.78
chr8	58968306	58968545	CpG: 22	239	22	140	18.4	58.6	1.11
chr8	58974051	58974891	CpG: 84	840	84	588	20.0	70.0	0.82
chr8	59080223	59081146	CpG: 111	923	111	686	24.1	74.3	0.87
chr8	59097550	59098321	CpG: 55	771	55	517	14.3	67.1	0.63
chr8	59335988	59336314	CpG: 24	326	24	191	14.7	58.6	0.86
chr8	59405736	59405963	CpG: 18	227	18	139	15.9	61.2	0.86
chr8	59461355	59461633	CpG: 26	278	26	177	18.7	63.7	0.93
chr8	59538898	59541510	CpG: 207	2612	207	1672	15.8	64.0	0.78
chr8	59548223	59548504	CpG: 23	281	23	172	16.4	61.2	0.89
chr8	59595606	59595917	CpG: 25	311	25	192	16.1	61.7	0.85
chr8	59608064	59608332	CpG: 20	268	20	161	14.9	60.1	0.84
chr8	60125616	60125851	CpG: 20	235	20	142	17.0	60.4	0.95
chr8	60254889	60255166	CpG: 20	277	20	166	14.4	59.9	0.82
chr8	60299248	60299490	CpG: 18	242	18	143	14.9	59.1	0.85
chr8	60545631	60545910	CpG: 24	279	24	170	17.2	60.9	0.94
chr8	60704827	60705710	CpG: 110	883	110	632	24.9	71.6	0.97
chr8	60760664	60760900	CpG: 19	236	19	143	16.1	60.6	0.89
chr8	60940393	60941392	CpG: 125	999	125	747	25.0	74.8	0.90
chr8	61065640	61065904	CpG: 19	264	19	161	14.4	61.0	0.78
chr8	61075402	61076419	CpG: 127	1017	127	761	25.0	74.8	0.90
chr8	61076911	61077778	CpG: 63	867	63	514	14.5	59.3	0.86
chr8	61101974	61104365	CpG: 376	2391	376	1853	31.5	77.5	1.06
chr8	61137826	61138252	CpG: 48	426	48	327	22.5	76.8	0.77
chr8	61331015	61331227	CpG: 16	212	16	125	15.1	59.0	0.89
chr8	61333572	61334242	CpG: 81	670	81	505	24.2	75.4	0.85
chr8	61345914	61347157	CpG: 88	1243	88	778	14.2	62.6	0.73
chr8	61352482	61352721	CpG: 20	239	20	142	16.7	59.4	0.96
chr8	61544738	61544965	CpG: 21	227	21	138	18.5	60.8	1.00
chr8	61562806	61563591	CpG: 66	785	66	514	16.8	65.5	0.79
chr8	61697378	61697605	CpG: 20	227	20	137	17.6	60.4	0.97
chr8	62127697	62127927	CpG: 20	230	20	141	17.4	61.3	0.94
chr8	62137728	62138683	CpG: 117	955	117	703	24.5	73.6	0.90
chr8	62356935	62357142	CpG: 16	207	16	124	15.5	59.9	0.88
chr8	62441671	62441945	CpG: 22	274	22	169	16.1	61.7	0.86
chr8	62567415	62567675	CpG: 21	260	21	166	16.2	63.8	0.82
chr8	62568435	62568900	CpG: 36	465	36	287	15.5	61.7	0.82
chr8	62672107	62673573	CpG: 134	1466	134	1012	18.3	69.0	0.81
chr8	62818862	62819461	CpG: 48	599	48	417	16.0	69.6	0.67
chr8	63143996	63144240	CpG: 18	244	18	144	14.8	59.0	0.86
chr8	63463135	63464117	CpG: 104	982	104	674	21.2	68.6	0.90
chr8	63483663	63483900	CpG: 21	237	21	145	17.7	61.2	0.97
chr8	63510238	63510748	CpG: 72	510	72	391	28.2	76.7	0.96
chr8	63529928	63530203	CpG: 24	275	24	170	17.5	61.8	0.92
chr8	63587347	63587550	CpG: 17	203	17	139	16.7	68.5	0.76
chr8	63593280	63594372	CpG: 116	1092	116	762	21.2	69.8	0.88
chr8	63652660	63652933	CpG: 24	273	24	168	17.6	61.5	0.94
chr8	63657524	63657728	CpG: 17	204	17	122	16.7	59.8	0.94
chr8	63915134	63915460	CpG: 26	326	26	194	16.0	59.5	0.90
chr8	63937965	63938200	CpG: 21	235	21	144	17.9	61.3	0.97
chr8	64228320	64228544	CpG: 19	224	19	132	17.0	58.9	0.98
chr8	64438965	64439228	CpG: 25	263	25	166	19.0	63.1	0.98
chr8	64600238	64600519	CpG: 21	281	21	173	14.9	61.6	0.80
chr8	64665679	64665974	CpG: 22	295	22	177	14.9	60.0	0.83
chr8	64679734	64679996	CpG: 25	262	25	165	19.1	63.0	0.97
chr8	64794765	64795905	CpG: 122	1140	122	826	21.4	72.5	0.82
chr8	64798925	64799517	CpG: 53	592	53	370	17.9	62.5	0.94
chr8	64802958	64803796	CpG: 70	838	70	553	16.7	66.0	0.78
chr8	64875456	64875699	CpG: 19	243	19	139	15.6	57.2	0.97
chr8	64897796	64898040	CpG: 18	244	18	144	14.8	59.0	0.86
chr8	65001397	65001977	CpG: 40	580	40	365	13.8	62.9	0.70
chr8	65003944	65004180	CpG: 18	236	18	148	15.3	62.7	0.78
chr8	65005800	65007317	CpG: 186	1517	186	1101	24.5	72.6	0.93
chr8	65011446	65011693	CpG: 22	247	22	151	17.8	61.1	1.03
chr8	65012613	65013010	CpG: 32	397	32	244	16.1	61.5	0.86
chr8	65223913	65224682	CpG: 77	769	77	527	20.0	68.5	0.85
chr8	65400565	65400795	CpG: 20	230	20	140	17.4	60.9	0.95
chr8	65659939	65660220	CpG: 22	281	22	171	15.7	60.9	0.86
chr8	66041930	66042846	CpG: 67	916	67	626	14.6	68.3	0.63
chr8	66059499	66059841	CpG: 32	342	32	231	18.7	67.5	0.82
chr8	66061567	66061816	CpG: 19	249	19	145	15.3	58.2	0.92
chr8	66070205	66070954	CpG: 71	749	71	516	19.0	68.9	0.80
chr8	66087898	66088650	CpG: 57	752	57	523	15.2	69.5	0.63
chr8	66100835	66101069	CpG: 18	234	18	141	15.4	60.3	0.85
chr8	66106604	66106885	CpG: 23	281	23	175	16.4	62.3	0.86
chr8	66190881	66191160	CpG: 26	279	26	176	18.6	63.1	0.94
chr8	66239902	66240180	CpG: 25	278	25	175	18.0	62.9	0.92
chr8	66267027	66268388	CpG: 164	1361	164	983	24.1	72.2	0.93
chr8	66538409	66539766	CpG: 100	1357	100	807	14.7	59.5	0.83
chr8	66602701	66604040	CpG: 112	1339	112	848	16.7	63.3	0.84
chr8	66813036	66813272	CpG: 20	236	20	146	16.9	61.9	0.91
chr8	66854131	66855446	CpG: 112	1315	112	884	17.0	67.2	0.76
chr8	66857832	66858324	CpG: 51	492	51	336	20.7	68.3	0.90
chr8	66864617	66865169	CpG: 43	552	43	330	15.6	59.8	0.88
chr8	66931119	66931407	CpG: 29	288	29	211	20.1	73.3	0.76
chr8	66968066	66968512	CpG: 39	446	39	281	17.5	63.0	0.89
chr8	67038126	67039578	CpG: 147	1452	147	977	20.2	67.3	0.89
chr8	67044200	67044474	CpG: 25	274	25	172	18.2	62.8	0.94
chr8	67092214	67093029	CpG: 70	815	70	506	17.2	62.1	0.91
chr8	67094225	67094466	CpG: 20	241	20	145	16.6	60.2	0.93
chr8	67129323	67129608	CpG: 25	285	25	178	17.5	62.5	0.92
chr8	67138142	67138958	CpG: 98	816	98	596	24.0	73.0	0.90
chr8	67154920	67155214	CpG: 21	294	21	177	14.3	60.2	0.79
chr8	67201546	67202028	CpG: 57	482	57	361	23.7	74.9	0.87
chr8	67351724	67352198	CpG: 53	474	53	331	22.4	69.8	0.92
chr8	67381230	67381581	CpG: 27	351	27	206	15.4	58.7	0.90
chr8	67387634	67389846	CpG: 231	2212	231	1493	20.9	67.5	0.92
chr8	67454937	67455243	CpG: 35	306	35	205	22.9	67.0	1.02
chr8	67476541	67476778	CpG: 19	237	19	148	16.0	62.4	0.85
chr8	67490671	67491679	CpG: 85	1008	85	669	16.9	66.4	0.78
chr8	67769386	67770531	CpG: 128	1145	128	832	22.4	72.7	0.85
chr8	67811245	67811519	CpG: 25	274	25	172	18.2	62.8	0.94
chr8	67828606	67828880	CpG: 20	274	20	167	14.6	60.9	0.79
chr8	67863623	67863845	CpG: 18	222	18	136	16.2	61.3	0.88
chr8	68059814	68060088	CpG: 20	274	20	164	14.6	59.9	0.83
chr8	68070578	68070800	CpG: 18	222	18	137	16.2	61.7	0.87
chr8	68107664	68107945	CpG: 23	281	23	173	16.4	61.6	0.88
chr8	68241528	68241806	CpG: 24	278	24	177	17.3	63.7	0.87
chr8	68378358	68379150	CpG: 91	792	91	546	23.0	68.9	0.97
chr8	68495976	68496257	CpG: 23	281	23	174	16.4	61.9	0.87
chr8	68757385	68758268	CpG: 90	883	90	601	20.4	68.1	0.88
chr8	68758853	68759100	CpG: 21	247	21	169	17.0	68.4	0.73
chr8	68808150	68808431	CpG: 24	281	24	175	17.1	62.3	0.90
chr8	69312667	69312951	CpG: 26	284	26	178	18.3	62.7	0.94
chr8	69501835	69502057	CpG: 15	222	15	132	13.5	59.5	0.77
chr8	69517424	69517698	CpG: 20	274	20	166	14.6	60.6	0.81
chr8	69558037	69558324	CpG: 38	287	38	209	26.5	72.8	1.00
chr8	69683852	69684212	CpG: 26	360	26	212	14.4	58.9	0.84
chr8	69875076	69875350	CpG: 24	274	24	171	17.5	62.4	0.91
chr8	70056120	70056707	CpG: 44	587	44	413	15.0	70.4	0.61
chr8	70261449	70264794	CpG: 244	3345	244	2101	14.6	62.8	0.74
chr8	70270897	70271171	CpG: 23	274	23	170	16.8	62.0	0.88
chr8	70302497	70302782	CpG: 23	285	23	171	16.1	60.0	0.91
chr8	70396174	70396522	CpG: 26	348	26	212	14.9	60.9	0.81
chr8	70421495	70421721	CpG: 18	226	18	137	15.9	60.6	0.89
chr8	70424250	70424540	CpG: 28	290	28	190	19.3	65.5	0.91
chr8	70453302	70453573	CpG: 24	271	24	171	17.7	63.1	0.90
chr8	70464527	70464936	CpG: 39	409	39	262	19.1	64.1	0.93
chr8	70474359	70474633	CpG: 21	274	21	169	15.3	61.7	0.81
chr8	70499493	70502508	CpG: 262	3015	262	1993	17.4	66.1	0.80
chr8	70534610	70534826	CpG: 17	216	17	132	15.7	61.1	0.85
chr8	70831837	70834462	CpG: 266	2625	266	1872	20.3	71.3	0.80
chr8	70901082	70901359	CpG: 20	277	20	159	14.4	57.4	0.89
chr8	70989779	70990060	CpG: 23	281	23	173	16.4	61.6	0.88
chr8	71037356	71038529	CpG: 131	1173	131	867	22.3	73.9	0.82
chr8	71098722	71099322	CpG: 66	600	66	413	22.0	68.8	0.95
chr8	71099598	71099871	CpG: 23	273	23	167	16.8	61.2	0.91
chr8	71431006	71431289	CpG: 23	283	23	174	16.3	61.5	0.87
chr8	71450508	71450781	CpG: 24	273	24	170	17.6	62.3	0.92
chr8	71722962	71723236	CpG: 23	274	23	170	16.8	62.0	0.88
chr8	71723647	71723923	CpG: 23	276	23	175	16.7	63.4	0.84
chr8	71834138	71834355	CpG: 17	217	17	129	15.7	59.4	0.90
chr8	71922017	71922443	CpG: 33	426	33	256	15.5	60.1	0.86
chr8	71929220	71929494	CpG: 24	274	24	171	17.5	62.4	0.91
chr8	71982818	71983777	CpG: 98	959	98	672	20.4	70.1	0.84
chr8	71991812	71992813	CpG: 90	1001	90	682	18.0	68.1	0.78
chr8	72219177	72219451	CpG: 22	274	22	168	16.1	61.3	0.86
chr8	72276844	72277725	CpG: 74	881	74	563	16.8	63.9	0.83
chr8	72278753	72279637	CpG: 88	884	88	610	19.9	69.0	0.84
chr8	72343076	72343345	CpG: 20	269	20	168	14.9	62.5	0.77
chr8	72440177	72440513	CpG: 29	336	29	226	17.3	67.3	0.76
chr8	72510319	72510862	CpG: 53	543	53	359	19.5	66.1	0.90
chr8	72588048	72588459	CpG: 31	411	31	248	15.1	60.3	0.83
chr8	72686421	72686994	CpG: 51	573	51	373	17.8	65.1	0.85
chr8	72914643	72914938	CpG: 21	295	21	179	14.2	60.7	0.78
chr8	72971487	72972553	CpG: 119	1066	119	793	22.3	74.4	0.81
chr8	73437660	73438422	CpG: 75	762	75	505	19.7	66.3	0.91
chr8	73522144	73522979	CpG: 95	835	95	622	22.8	74.5	0.82
chr8	73682368	73682610	CpG: 18	242	18	147	14.9	60.7	0.81
chr8	73715100	73715496	CpG: 35	396	35	292	17.7	73.7	0.65
chr8	73723508	73725464	CpG: 224	1956	224	1397	22.9	71.4	0.90
chr8	73730583	73730857	CpG: 22	274	22	169	16.1	61.7	0.86
chr8	73779994	73780267	CpG: 22	273	22	172	16.1	63.0	0.82
chr8	73843332	73843613	CpG: 25	281	25	177	17.8	63.0	0.91
chr8	73878712	73879094	CpG: 37	382	37	275	19.4	72.0	0.77
chr8	74084436	74084709	CpG: 23	273	23	166	16.8	60.8	0.92
chr8	74175677	74177052	CpG: 158	1375	158	1018	23.0	74.0	0.89
chr8	74273957	74274596	CpG: 55	639	55	473	17.2	74.0	0.63
chr8	74303608	74303877	CpG: 21	269	21	167	15.6	62.1	0.82
chr8	74307467	74308537	CpG: 110	1070	110	719	20.6	67.2	0.91
chr8	74324165	74324415	CpG: 21	250	21	143	16.8	57.2	1.04
chr8	74401249	74401617	CpG: 37	368	37	244	20.1	66.3	0.95
chr8	74405254	74405952	CpG: 89	698	89	525	25.5	75.2	0.92
chr8	74659234	74659459	CpG: 18	225	18	136	16.0	60.4	0.88
chr8	74701886	74702165	CpG: 26	279	26	172	18.6	61.6	0.99
chr8	74744400	74744993	CpG: 62	593	62	379	20.9	63.9	1.02
chr8	74749708	74751160	CpG: 173	1452	173	1064	23.8	73.3	0.90
chr8	74779586	74780109	CpG: 47	523	47	345	18.0	66.0	0.83
chr8	74800676	74800950	CpG: 24	274	24	170	17.5	62.0	0.92
chr8	74831642	74831867	CpG: 16	225	16	131	14.2	58.2	0.84
chr8	74892395	74892673	CpG: 24	278	24	177	17.3	63.7	0.86
chr8	74898987	74899224	CpG: 20	237	20	145	16.9	61.2	0.93
chr8	75201230	75201611	CpG: 43	381	43	285	22.6	74.8	0.81
chr8	75296018	75296445	CpG: 36	427	36	257	16.9	60.2	0.94
chr8	75317099	75317334	CpG: 20	235	20	141	17.0	60.0	0.96
chr8	75377742	75378052	CpG: 24	310	24	189	15.5	61.0	0.84
chr8	75392303	75392868	CpG: 45	565	45	341	15.9	60.4	0.88
chr8	75394256	75394537	CpG: 23	281	23	173	16.4	61.6	0.88
chr8	75413805	75414393	CpG: 60	588	60	402	20.4	68.4	0.87
chr8	75501694	75501930	CpG: 19	236	19	141	16.1	59.7	0.93
chr8	75605873	75606152	CpG: 22	279	22	169	15.8	60.6	0.87
chr8	75644213	75644487	CpG: 24	274	24	171	17.5	62.4	0.91
chr8	75707993	75708304	CpG: 25	311	25	191	16.1	61.4	0.86
chr8	75722883	75723164	CpG: 23	281	23	174	16.4	61.9	0.87
chr8	75836696	75837670	CpG: 92	974	92	654	18.9	67.1	0.84
chr8	75908258	75908509	CpG: 19	251	19	148	15.1	59.0	0.89
chr8	75941108	75941325	CpG: 17	217	17	131	15.7	60.4	0.87
chr8	75956283	75956510	CpG: 18	227	18	130	15.9	57.3	0.98
chr8	76056465	76056785	CpG: 24	320	24	186	15.0	58.1	0.89
chr8	76094923	76095352	CpG: 37	429	37	314	17.2	73.2	0.64
chr8	76410251	76410525	CpG: 23	274	23	169	16.8	61.7	0.89
chr8	76471003	76471247	CpG: 18	244	18	142	14.8	58.2	0.90
chr8	76599225	76599576	CpG: 31	351	31	248	17.7	70.7	0.71
chr8	76642681	76642954	CpG: 21	273	21	168	15.4	61.5	0.83
chr8	76765580	76765854	CpG: 24	274	24	171	17.5	62.4	0.91
chr8	76876943	76877330	CpG: 37	387	37	286	19.1	73.9	0.70
chr8	76941718	76941992	CpG: 24	274	24	171	17.5	62.4	0.91
chr8	77107094	77107446	CpG: 45	352	45	265	25.6	75.3	0.90
chr8	77111078	77111770	CpG: 64	692	64	457	18.5	66.0	0.85
chr8	77383983	77384257	CpG: 22	274	22	170	16.1	62.0	0.84
chr8	77429335	77430260	CpG: 79	925	79	584	17.1	63.1	0.86
chr8	77518141	77518436	CpG: 25	295	25	180	16.9	61.0	0.92
chr8	77847832	77848114	CpG: 23	282	23	169	16.3	59.9	0.92
chr8	77904852	77905127	CpG: 24	275	24	171	17.5	62.2	0.91
chr8	78123993	78124267	CpG: 24	274	24	171	17.5	62.4	0.91
chr8	78388946	78389170	CpG: 19	224	19	135	17.0	60.3	0.95
chr8	78859332	78859614	CpG: 24	282	24	174	17.0	61.7	0.91
chr8	78947720	78948041	CpG: 46	321	46	245	28.7	76.3	1.00
chr8	79097411	79097966	CpG: 53	555	53	385	19.1	69.4	0.80
chr8	79193832	79194066	CpG: 33	234	33	181	28.2	77.4	0.95
chr8	79235826	79236548	CpG: 54	722	54	465	15.0	64.4	0.72
chr8	79734875	79735264	CpG: 32	389	32	283	16.5	72.8	0.63
chr8	79808597	79808939	CpG: 28	342	28	251	16.4	73.4	0.61
chr8	80022092	80022370	CpG: 25	278	25	176	18.0	63.3	0.90
chr8	80043084	80044873	CpG: 131	1789	131	1138	14.6	63.6	0.73
chr8	80196682	80197097	CpG: 44	415	44	272	21.2	65.5	1.00
chr8	80198771	80200430	CpG: 201	1659	201	1214	24.2	73.2	0.90
chr8	80214944	80215572	CpG: 61	628	61	423	19.4	67.4	0.86
chr8	80322834	80323413	CpG: 67	579	67	431	23.1	74.4	0.84
chr8	80461221	80461925	CpG: 58	704	58	428	16.5	60.8	0.91
chr8	80590223	80590500	CpG: 23	277	23	171	16.6	61.7	0.88
chr8	80602646	80603383	CpG: 89	737	89	542	24.2	73.5	0.92
chr8	80633145	80633424	CpG: 21	279	21	172	15.1	61.6	0.80
chr8	80663384	80663775	CpG: 43	391	43	291	22.0	74.4	0.79
chr8	80665036	80665314	CpG: 25	278	25	174	18.0	62.6	0.92
chr8	80692177	80692451	CpG: 24	274	24	171	17.5	62.4	0.91
chr8	80697281	80697531	CpG: 19	250	19	159	15.2	63.6	0.76
chr8	80715207	80715441	CpG: 18	234	18	145	15.4	62.0	0.83
chr8	80838373	80838611	CpG: 18	238	18	143	15.1	60.1	0.85
chr8	80858046	80858281	CpG: 16	235	16	139	13.6	59.1	0.80
chr8	80895939	80896212	CpG: 23	273	23	173	16.8	63.4	0.85
chr8	80917402	80919086	CpG: 216	1684	216	1244	25.7	73.9	0.94
chr8	80925096	80925379	CpG: 20	283	20	158	14.1	55.8	0.92
chr8	80985301	80985571	CpG: 19	270	19	167	14.1	61.9	0.75
chr8	81009633	81010694	CpG: 95	1061	95	790	17.9	74.5	0.68
chr8	81304771	81306179	CpG: 203	1408	203	1081	28.8	76.8	0.99
chr8	81325281	81325653	CpG: 33	372	33	235	17.7	63.2	0.89
chr8	81517612	81517886	CpG: 24	274	24	171	17.5	62.4	0.91
chr8	81543226	81543854	CpG: 85	628	85	477	27.1	76.0	0.94
chr8	81711721	81713028	CpG: 117	1307	117	874	17.9	66.9	0.80
chr8	81734474	81734742	CpG: 22	268	22	168	16.4	62.7	0.85
chr8	81763107	81763324	CpG: 18	217	18	129	16.6	59.4	0.94
chr8	81953795	81954024	CpG: 28	229	28	163	24.5	71.2	1.04
chr8	81999427	81999714	CpG: 25	287	25	179	17.4	62.4	0.91
chr8	82026800	82027039	CpG: 20	239	20	145	16.7	60.7	0.92
chr8	82062154	82062831	CpG: 48	677	48	434	14.2	64.1	0.69
chr8	82117748	82118165	CpG: 41	417	41	281	19.7	67.4	0.87
chr8	82152434	82153361	CpG: 68	927	68	575	14.7	62.0	0.77
chr8	82164071	82164317	CpG: 23	246	23	180	18.7	73.2	0.70
chr8	82273506	82273928	CpG: 46	422	46	287	21.8	68.0	0.96
chr8	82350409	82350645	CpG: 18	236	18	141	15.3	59.7	0.87
chr8	82624110	82624470	CpG: 32	360	32	261	17.8	72.5	0.68
chr8	82655103	82655345	CpG: 20	242	20	143	16.5	59.1	0.97
chr8	82842666	82842944	CpG: 24	278	24	174	17.3	62.6	0.89
chr8	82872972	82873465	CpG: 44	493	44	359	17.8	72.8	0.67
chr8	83326056	83326330	CpG: 25	274	25	171	18.2	62.4	0.94
chr8	83813092	83813371	CpG: 21	279	21	171	15.1	61.3	0.81
chr8	83861728	83861958	CpG: 21	230	21	142	18.3	61.7	0.97
chr8	84093488	84093914	CpG: 32	426	32	255	15.0	59.9	0.84
chr8	84132034	84132291	CpG: 20	257	20	181	15.6	70.4	0.63
chr8	84420467	84420742	CpG: 20	275	20	165	14.5	60.0	0.81
chr8	84483531	84483764	CpG: 18	233	18	142	15.5	60.9	0.84
chr8	84620696	84621110	CpG: 47	414	47	299	22.7	72.2	0.87
chr8	84622133	84622621	CpG: 49	488	49	335	20.1	68.6	0.86
chr8	84704342	84704572	CpG: 22	230	22	143	19.1	62.2	1.00
chr8	84748328	84748608	CpG: 24	280	24	173	17.1	61.8	0.92
chr8	84862762	84862986	CpG: 20	224	20	134	17.9	59.8	1.00
chr8	84907338	84907581	CpG: 20	243	20	148	16.5	60.9	0.89
chr8	84962622	84962898	CpG: 23	276	23	170	16.7	61.6	0.89
chr8	85294613	85294894	CpG: 23	281	23	174	16.4	61.9	0.87
chr8	85455572	85455846	CpG: 24	274	24	171	17.5	62.4	0.91
chr8	85545703	85546262	CpG: 53	559	53	365	19.0	65.3	0.89
chr8	85564027	85564301	CpG: 23	274	23	170	16.8	62.0	0.88
chr8	85615566	85616652	CpG: 129	1086	129	782	23.8	72.0	0.92
chr8	85618319	85618556	CpG: 19	237	19	140	16.0	59.1	0.93
chr8	85619187	85619459	CpG: 21	272	21	166	15.4	61.0	0.84
chr8	85658070	85658292	CpG: 18	222	18	131	16.2	59.0	0.94
chr8	85658792	85659374	CpG: 42	582	42	340	14.4	58.4	0.86
chr8	85684203	85684536	CpG: 39	333	39	238	23.4	71.5	0.93
chr8	85714798	85715150	CpG: 33	352	33	257	18.8	73.0	0.70
chr8	85877266	85877697	CpG: 33	431	33	279	15.3	64.7	0.73
chr8	85901983	85903198	CpG: 144	1215	144	902	23.7	74.2	0.86
chr8	86081213	86082370	CpG: 90	1157	90	749	15.6	64.7	0.76
chr8	86082545	86082767	CpG: 17	222	17	130	15.3	58.6	0.91
chr8	86093120	86094941	CpG: 129	1821	129	1167	14.2	64.1	0.70
chr8	86099951	86101778	CpG: 130	1827	130	1175	14.2	64.3	0.70
chr8	86106788	86108615	CpG: 130	1827	130	1175	14.2	64.3	0.70
chr8	86118978	86120805	CpG: 130	1827	130	1173	14.2	64.2	0.70
chr8	86131168	86132995	CpG: 130	1827	130	1173	14.2	64.2	0.70
chr8	86143356	86145183	CpG: 130	1827	130	1173	14.2	64.2	0.70
chr8	86155408	86157235	CpG: 130	1827	130	1173	14.2	64.2	0.70
chr8	86167597	86169424	CpG: 130	1827	130	1171	14.2	64.1	0.70
chr8	86179786	86181613	CpG: 130	1827	130	1173	14.2	64.2	0.70
chr8	86191978	86193805	CpG: 130	1827	130	1173	14.2	64.2	0.70
chr8	86204168	86205995	CpG: 130	1827	130	1173	14.2	64.2	0.70
chr8	86216358	86218185	CpG: 129	1827	129	1171	14.1	64.1	0.70
chr8	86228547	86230374	CpG: 129	1827	129	1171	14.1	64.1	0.70
chr8	86240739	86242566	CpG: 129	1827	129	1171	14.1	64.1	0.70
chr8	86252931	86254758	CpG: 130	1827	130	1173	14.2	64.2	0.70
chr8	86265119	86266946	CpG: 131	1827	131	1173	14.3	64.2	0.71
chr8	86277309	86279136	CpG: 128	1827	128	1171	14.0	64.1	0.69
chr8	86289498	86291325	CpG: 130	1827	130	1173	14.2	64.2	0.70
chr8	86301687	86303514	CpG: 130	1827	130	1173	14.2	64.2	0.70
chr8	86313877	86315704	CpG: 130	1827	130	1173	14.2	64.2	0.70
chr8	86326069	86327896	CpG: 130	1827	130	1173	14.2	64.2	0.70
chr8	86338259	86340086	CpG: 130	1827	130	1173	14.2	64.2	0.70
chr8	86350448	86352275	CpG: 130	1827	130	1173	14.2	64.2	0.70
chr8	86362637	86364464	CpG: 130	1827	130	1175	14.2	64.3	0.70
chr8	86374826	86376653	CpG: 131	1827	131	1175	14.3	64.3	0.71
chr8	86400466	86402293	CpG: 130	1827	130	1173	14.2	64.2	0.70
chr8	86412656	86414483	CpG: 130	1827	130	1173	14.2	64.2	0.70
chr8	86424846	86426673	CpG: 130	1827	130	1171	14.2	64.1	0.70
chr8	86437036	86438863	CpG: 130	1827	130	1173	14.2	64.2	0.70
chr8	86449226	86451053	CpG: 130	1827	130	1173	14.2	64.2	0.70
chr8	86461416	86463243	CpG: 130	1827	130	1173	14.2	64.2	0.70
chr8	86473606	86475433	CpG: 130	1827	130	1173	14.2	64.2	0.70
chr8	86485796	86487623	CpG: 130	1827	130	1171	14.2	64.1	0.70
chr8	86497988	86499815	CpG: 130	1827	130	1173	14.2	64.2	0.70
chr8	86510177	86512004	CpG: 130	1827	130	1173	14.2	64.2	0.70
chr8	86518597	86520424	CpG: 131	1827	131	1175	14.3	64.3	0.70
chr8	86530788	86532615	CpG: 130	1827	130	1171	14.2	64.1	0.70
chr8	86542979	86544806	CpG: 130	1827	130	1171	14.2	64.1	0.70
chr8	86555169	86556996	CpG: 129	1827	129	1171	14.1	64.1	0.70
chr8	86567362	86569189	CpG: 130	1827	130	1171	14.2	64.1	0.70
chr8	86579555	86581382	CpG: 130	1827	130	1171	14.2	64.1	0.70
chr8	86595141	86596968	CpG: 130	1827	130	1173	14.2	64.2	0.70
chr8	86607335	86609162	CpG: 130	1827	130	1173	14.2	64.2	0.70
chr8	86619525	86621352	CpG: 130	1827	130	1173	14.2	64.2	0.70
chr8	86631715	86633542	CpG: 130	1827	130	1173	14.2	64.2	0.70
chr8	86643905	86645732	CpG: 130	1827	130	1173	14.2	64.2	0.70
chr8	86656098	86657925	CpG: 130	1827	130	1173	14.2	64.2	0.70
chr8	86668290	86670117	CpG: 130	1827	130	1171	14.2	64.1	0.70
chr8	86680483	86682310	CpG: 130	1827	130	1173	14.2	64.2	0.70
chr8	86692673	86694500	CpG: 131	1827	131	1173	14.3	64.2	0.71
chr8	86704863	86706690	CpG: 130	1827	130	1173	14.2	64.2	0.70
chr8	86713283	86715110	CpG: 130	1827	130	1173	14.2	64.2	0.70
chr8	86725335	86727162	CpG: 130	1827	130	1173	14.2	64.2	0.70
chr8	86737524	86739351	CpG: 129	1827	129	1171	14.1	64.1	0.70
chr8	86749716	86751543	CpG: 129	1827	129	1171	14.1	64.1	0.70
chr8	86761909	86763736	CpG: 130	1827	130	1173	14.2	64.2	0.70
chr8	86774103	86775930	CpG: 130	1827	130	1173	14.2	64.2	0.70
chr8	86786295	86788124	CpG: 131	1829	131	1174	14.3	64.2	0.71
chr8	86798489	86800316	CpG: 129	1827	129	1173	14.1	64.2	0.70
chr8	86810677	86812504	CpG: 130	1827	130	1171	14.2	64.1	0.70
chr8	86822729	86824556	CpG: 130	1827	130	1173	14.2	64.2	0.70
chr8	86834918	86836745	CpG: 130	1827	130	1173	14.2	64.2	0.70
chr8	86846970	86848797	CpG: 131	1827	131	1173	14.3	64.2	0.71
chr8	86859159	86860986	CpG: 130	1827	130	1171	14.2	64.1	0.70
chr8	86871211	86873038	CpG: 130	1827	130	1173	14.2	64.2	0.70
chr8	86883400	86885227	CpG: 130	1827	130	1173	14.2	64.2	0.70
chr8	86895452	86897279	CpG: 130	1827	130	1173	14.2	64.2	0.70
chr8	86907505	86909332	CpG: 131	1827	131	1173	14.3	64.2	0.71
chr8	86919694	86921521	CpG: 130	1827	130	1171	14.2	64.1	0.70
chr8	86931883	86933710	CpG: 130	1827	130	1173	14.2	64.2	0.70
chr8	86944071	86945900	CpG: 132	1829	132	1174	14.4	64.2	0.71
chr8	87186842	87187235	CpG: 40	393	40	274	20.4	69.7	0.84
chr8	87364661	87364939	CpG: 20	278	20	170	14.4	61.2	0.77
chr8	87462601	87463503	CpG: 112	902	112	666	24.8	73.8	0.93
chr8	87492331	87492604	CpG: 25	273	25	169	18.3	61.9	0.97
chr8	87509968	87510853	CpG: 67	885	67	624	15.1	70.5	0.61
chr8	87628582	87629125	CpG: 47	543	47	357	17.3	65.7	0.80
chr8	87634569	87635283	CpG: 66	714	66	511	18.5	71.6	0.72
chr8	87910737	87911008	CpG: 24	271	24	167	17.7	61.6	0.95
chr8	88004669	88004948	CpG: 23	279	23	172	16.5	61.6	0.88
chr8	88014884	88015165	CpG: 24	281	24	175	17.1	62.3	0.89
chr8	88450787	88451145	CpG: 26	358	26	207	14.5	57.8	0.87
chr8	88574016	88574290	CpG: 24	274	24	173	17.5	63.1	0.89
chr8	88860756	88861042	CpG: 23	286	23	178	16.1	62.2	0.85
chr8	88965921	88966159	CpG: 19	238	19	139	16.0	58.4	0.94
chr8	88997302	88997576	CpG: 25	274	25	154	18.2	56.2	1.16
chr8	89020342	89020615	CpG: 24	273	24	170	17.6	62.3	0.92
chr8	89094499	89094893	CpG: 41	394	41	294	20.8	74.6	0.75
chr8	89137990	89138261	CpG: 20	271	20	159	14.8	58.7	0.87
chr8	89272273	89272700	CpG: 31	427	31	255	14.5	59.7	0.82
chr8	89450718	89451593	CpG: 75	875	75	581	17.1	66.4	0.80
chr8	89808679	89809090	CpG: 29	411	29	246	14.1	59.9	0.79
chr8	89983370	89983587	CpG: 18	217	18	130	16.6	59.9	0.92
chr8	90481858	90482133	CpG: 22	275	22	170	16.0	61.8	0.84
chr8	90631932	90632206	CpG: 22	274	22	168	16.1	61.3	0.87
chr8	90658285	90658504	CpG: 20	219	20	134	18.3	61.2	0.98
chr8	90704901	90705137	CpG: 19	236	19	145	16.1	61.4	0.88
chr8	90780645	90780930	CpG: 25	285	25	180	17.5	63.2	0.90
chr8	90813868	90814143	CpG: 19	275	19	166	13.8	60.4	0.77
chr8	90821493	90822745	CpG: 101	1252	101	910	16.1	72.7	0.61
chr8	90871426	90871699	CpG: 20	273	20	166	14.7	60.8	0.80
chr8	90880467	90881389	CpG: 92	922	92	636	20.0	69.0	0.84
chr8	91024049	91024389	CpG: 26	340	26	203	15.3	59.7	0.87
chr8	91025152	91026295	CpG: 146	1143	146	848	25.5	74.2	0.93
chr8	91107325	91107910	CpG: 66	585	66	415	22.6	70.9	0.90
chr8	91124584	91125709	CpG: 89	1125	89	714	15.8	63.5	0.80
chr8	91180660	91180935	CpG: 25	275	25	172	18.2	62.5	0.94
chr8	91470244	91470492	CpG: 18	248	18	145	14.5	58.5	0.88
chr8	91653248	91653526	CpG: 21	278	21	170	15.1	61.2	0.82
chr8	91730386	91730643	CpG: 29	257	29	197	22.6	76.7	0.77
chr8	91769171	91770561	CpG: 159	1390	159	1019	22.9	73.3	0.85
chr8	91874697	91874927	CpG: 19	230	19	139	16.5	60.4	0.91
chr8	91916254	91916739	CpG: 55	485	55	344	22.7	70.9	0.90
chr8	91937743	91938012	CpG: 19	269	19	160	14.1	59.5	0.81
chr8	92000041	92000322	CpG: 23	281	23	173	16.4	61.6	0.88
chr8	92109924	92110600	CpG: 85	676	85	511	25.1	75.6	0.89
chr8	92165591	92165805	CpG: 19	214	19	155	17.8	72.4	0.69
chr8	92194933	92195682	CpG: 57	749	57	460	15.2	61.4	0.81
chr8	92265612	92265886	CpG: 25	274	25	171	18.2	62.4	0.95
chr8	92322359	92322670	CpG: 29	311	29	194	18.6	62.4	0.97
chr8	92425394	92425630	CpG: 21	236	21	144	17.8	61.0	0.98
chr8	92546029	92546258	CpG: 19	229	19	134	16.6	58.5	0.99
chr8	92652646	92653163	CpG: 36	517	36	307	13.9	59.4	0.79
chr8	92683635	92684072	CpG: 30	437	30	259	13.7	59.3	0.78
chr8	92824968	92825253	CpG: 25	285	25	179	17.5	62.8	0.90
chr8	92881756	92881995	CpG: 17	239	17	137	14.2	57.3	0.88
chr8	92898066	92898352	CpG: 22	286	22	164	15.4	57.3	0.96
chr8	93151946	93152223	CpG: 26	277	26	174	18.8	62.8	0.96
chr8	93226939	93228862	CpG: 184	1923	184	1244	19.1	64.7	0.91
chr8	93494700	93495051	CpG: 30	351	30	208	17.1	59.3	0.98
chr8	93499745	93500004	CpG: 20	259	20	162	15.4	62.5	0.79
chr8	93564365	93564646	CpG: 22	281	22	174	15.7	61.9	0.84
chr8	93934422	93934628	CpG: 17	206	17	128	16.5	62.1	0.86
chr8	94090468	94091144	CpG: 56	676	56	444	16.6	65.7	0.78
chr8	94163584	94164458	CpG: 69	874	69	614	15.8	70.3	0.64
chr8	94350146	94350430	CpG: 24	284	24	172	16.9	60.6	0.93
chr8	94402544	94402821	CpG: 24	277	24	171	17.3	61.7	0.91
chr8	94801185	94801395	CpG: 15	210	15	120	14.3	57.1	0.91
chr8	94825206	94826185	CpG: 100	979	100	701	20.4	71.6	0.80
chr8	94865749	94866273	CpG: 44	524	44	334	16.8	63.7	0.84
chr8	94866395	94866637	CpG: 18	242	18	140	14.9	57.9	0.89
chr8	94875690	94875974	CpG: 23	284	23	173	16.2	60.9	0.87
chr8	94879757	94879971	CpG: 20	214	20	141	18.7	65.9	0.88
chr8	95041375	95042978	CpG: 166	1603	166	1169	20.7	72.9	0.78
chr8	95387055	95387300	CpG: 38	245	38	183	31.0	74.7	1.11
chr8	95442332	95442606	CpG: 25	274	25	172	18.2	62.8	0.94
chr8	95498890	95499126	CpG: 16	236	16	141	13.6	59.7	0.77
chr8	95502568	95502843	CpG: 24	275	24	171	17.5	62.2	0.91
chr8	95599535	95599979	CpG: 39	444	39	301	17.6	67.8	0.83
chr8	95678131	95678605	CpG: 41	474	41	288	17.3	60.8	0.94
chr8	95694443	95694699	CpG: 24	256	24	158	18.8	61.7	1.00
chr8	95695977	95696382	CpG: 30	405	30	243	14.8	60.0	0.82
chr8	95763914	95767442	CpG: 222	3528	222	2191	12.6	62.1	0.65
chr8	95844565	95845216	CpG: 73	651	73	463	22.4	71.1	0.92
chr8	95929186	95929523	CpG: 31	337	31	193	18.4	57.3	1.13
chr8	95947994	95948677	CpG: 71	683	71	464	20.8	67.9	0.90
chr8	95986312	95986621	CpG: 21	309	21	183	13.6	59.2	0.78
chr8	96007978	96008257	CpG: 20	279	20	168	14.3	60.2	0.79
chr8	96019542	96021842	CpG: 235	2300	235	1603	20.4	69.7	0.85
chr8	96073518	96075152	CpG: 183	1634	183	1211	22.4	74.1	0.83
chr8	96149743	96150325	CpG: 73	582	73	425	25.1	73.0	0.96
chr8	96185005	96185290	CpG: 25	285	25	179	17.5	62.8	0.90
chr8	96198321	96198799	CpG: 49	478	49	322	20.5	67.4	0.90
chr8	96207935	96208165	CpG: 19	230	19	140	16.5	60.9	0.90
chr8	96258781	96259750	CpG: 149	969	149	746	30.8	77.0	1.05
chr8	96332630	96332837	CpG: 18	207	18	126	17.4	60.9	0.96
chr8	96393872	96394989	CpG: 94	1117	94	708	16.8	63.4	0.84
chr8	96396769	96397009	CpG: 20	240	20	148	16.7	61.7	0.90
chr8	96473726	96473945	CpG: 18	219	18	133	16.4	60.7	0.90
chr8	96637114	96637344	CpG: 19	230	19	141	16.5	61.3	0.90
chr8	96682860	96683084	CpG: 19	224	19	132	17.0	58.9	0.98
chr8	96843543	96843829	CpG: 27	286	27	180	18.9	62.9	0.96
chr8	96896651	96896925	CpG: 25	274	25	172	18.2	62.8	0.94
chr8	96949350	96949688	CpG: 34	338	34	254	20.1	75.1	0.71
chr8	96950533	96950784	CpG: 19	251	19	143	15.1	57.0	0.96
chr8	97118150	97118424	CpG: 24	274	24	170	17.5	62.0	0.92
chr8	97118679	97118940	CpG: 21	261	21	156	16.1	59.8	0.92
chr8	97269868	97271135	CpG: 126	1267	126	875	19.9	69.1	0.83
chr8	97282834	97283535	CpG: 56	701	56	442	16.0	63.1	0.81
chr8	97284908	97285125	CpG: 24	217	24	154	22.1	71.0	0.89
chr8	97285737	97286983	CpG: 129	1246	129	905	20.7	72.6	0.79
chr8	97387105	97388257	CpG: 113	1152	113	791	19.6	68.7	0.84
chr8	97400164	97400400	CpG: 17	236	17	137	14.4	58.1	0.88
chr8	97544710	97544946	CpG: 21	236	21	145	17.8	61.4	0.96
chr8	97577862	97578143	CpG: 26	281	26	208	18.5	74.0	0.68
chr8	97619238	97621098	CpG: 171	1860	171	1231	18.4	66.2	0.84
chr8	97659600	97659874	CpG: 23	274	23	201	16.8	73.4	0.62
chr8	97702190	97702464	CpG: 22	274	22	170	16.1	62.0	0.84
chr8	97770670	97771439	CpG: 71	769	71	547	18.5	71.1	0.73
chr8	97979954	97980228	CpG: 24	274	24	170	17.5	62.0	0.92
chr8	98096296	98096570	CpG: 23	274	23	169	16.8	61.7	0.89
chr8	98313636	98313921	CpG: 23	285	23	177	16.1	62.1	0.85
chr8	98403141	98403941	CpG: 100	800	100	562	25.0	70.2	1.01
chr8	98414472	98414742	CpG: 24	270	24	169	17.8	62.6	0.92
chr8	98421373	98421800	CpG: 31	427	31	258	14.5	60.4	0.80
chr8	98682452	98682963	CpG: 51	511	51	377	20.0	73.8	0.74
chr8	98729981	98730920	CpG: 67	939	67	634	14.3	67.5	0.63
chr8	98737485	98737766	CpG: 22	281	22	173	15.7	61.6	0.84
chr8	98749949	98750159	CpG: 15	210	15	138	14.3	65.7	0.66
chr8	98769308	98770485	CpG: 135	1177	135	832	22.9	70.7	0.92
chr8	98896712	98896989	CpG: 23	277	23	172	16.6	62.1	0.87
chr8	98899481	98899711	CpG: 17	230	17	142	14.8	61.7	0.79
chr8	98900916	98902125	CpG: 135	1209	135	799	22.3	66.1	1.03
chr8	98994310	98995117	CpG: 96	807	96	625	23.8	77.4	0.80
chr8	99170801	99171935	CpG: 82	1134	82	660	14.5	58.2	0.86
chr8	99173307	99173544	CpG: 21	237	21	144	17.7	60.8	0.98
chr8	99177167	99177835	CpG: 53	668	53	479	15.9	71.7	0.62
chr8	99190017	99190507	CpG: 56	490	56	350	22.9	71.4	0.90
chr8	99210670	99210913	CpG: 20	243	20	147	16.5	60.5	0.93
chr8	99242696	99243117	CpG: 37	421	37	283	17.6	67.2	0.78
chr8	99384556	99384829	CpG: 24	273	24	168	17.6	61.5	0.94
chr8	99385859	99386102	CpG: 23	243	23	148	18.9	60.9	1.02
chr8	99419149	99419972	CpG: 98	823	98	616	23.8	74.8	0.85
chr8	99470092	99470370	CpG: 25	278	25	174	18.0	62.6	0.93
chr8	99551922	99553655	CpG: 204	1733	204	1270	23.5	73.3	0.88
chr8	99746079	99746364	CpG: 22	285	22	168	15.4	58.9	0.90
chr8	99825210	99825498	CpG: 20	288	20	171	13.9	59.4	0.80
chr8	99901959	99902188	CpG: 18	229	18	138	15.7	60.3	0.87
chr8	99950384	99951162	CpG: 104	778	104	614	26.7	78.9	0.86
chr8	100064515	100067181	CpG: 223	2666	223	1802	16.7	67.6	0.73
chr8	100069053	100069518	CpG: 54	465	54	322	23.2	69.2	0.97
chr8	100072992	100073933	CpG: 73	941	73	604	15.5	64.2	0.75
chr8	100080215	100080492	CpG: 24	277	24	172	17.3	62.1	0.91
chr8	100097082	100099481	CpG: 193	2399	193	1519	16.1	63.3	0.81
chr8	100137653	100138506	CpG: 63	853	63	529	14.8	62.0	0.77
chr8	100138885	100139152	CpG: 19	267	19	158	14.2	59.2	0.82
chr8	100474051	100474329	CpG: 25	278	25	174	18.0	62.6	0.93
chr8	100497014	100497243	CpG: 19	229	19	142	16.6	62.0	0.87
chr8	101018302	101018759	CpG: 45	457	45	293	19.7	64.1	0.96
chr8	101051662	101052415	CpG: 59	753	59	524	15.7	69.6	0.65
chr8	101230486	101231257	CpG: 88	771	88	541	22.8	70.2	0.93
chr8	101261865	101262131	CpG: 20	266	20	156	15.0	58.6	0.88
chr8	101269432	101269705	CpG: 25	273	25	174	18.3	63.7	0.91
chr8	101270199	101270767	CpG: 63	568	63	423	22.2	74.5	0.80
chr8	101282713	101283379	CpG: 67	666	67	469	20.1	70.4	0.83
chr8	101327225	101327499	CpG: 23	274	23	171	16.8	62.4	0.87
chr8	101337619	101338429	CpG: 103	810	103	600	25.4	74.1	0.93
chr8	101370270	101370551	CpG: 21	281	21	172	14.9	61.2	0.82
chr8	101434125	101435271	CpG: 136	1146	136	841	23.7	73.4	0.89
chr8	101436268	101436498	CpG: 18	230	18	139	15.7	60.4	0.87
chr8	101441674	101441955	CpG: 28	281	28	206	19.9	73.3	0.75
chr8	101475505	101476388	CpG: 65	883	65	603	14.7	68.3	0.64
chr8	101685317	101685906	CpG: 62	589	62	422	21.1	71.6	0.82
chr8	101767846	101768113	CpG: 21	267	21	165	15.7	61.8	0.83
chr8	101775490	101775841	CpG: 45	351	45	262	25.6	74.6	0.92
chr8	101847042	101849051	CpG: 226	2009	226	1398	22.5	69.6	0.93
chr8	101916774	101917048	CpG: 25	274	25	173	18.2	63.1	0.93
chr8	102004631	102004905	CpG: 21	274	21	167	15.3	60.9	0.84
chr8	102034110	102034474	CpG: 29	364	29	251	15.9	69.0	0.67
chr8	102076114	102078899	CpG: 284	2785	284	1986	20.4	71.3	0.80
chr8	102096269	102096555	CpG: 21	286	21	166	14.7	58.0	0.88
chr8	102096854	102097128	CpG: 24	274	24	171	17.5	62.4	0.91
chr8	102117224	102117460	CpG: 19	236	19	143	16.1	60.6	0.90
chr8	102172924	102173161	CpG: 18	237	18	142	15.2	59.9	0.89
chr8	102206347	102206793	CpG: 40	446	40	321	17.9	72.0	0.69
chr8	102252099	102252614	CpG: 63	515	63	387	24.5	75.1	0.88
chr8	102330808	102331952	CpG: 153	1144	153	869	26.7	76.0	0.94
chr8	102349645	102350441	CpG: 55	796	55	526	13.8	66.1	0.63
chr8	102504497	102504766	CpG: 24	269	24	162	17.8	60.2	0.99
chr8	102618084	102618314	CpG: 22	230	22	152	19.1	66.1	0.89
chr8	102618985	102619889	CpG: 113	904	113	680	25.0	75.2	0.88
chr8	102804092	102804334	CpG: 20	242	20	145	16.5	59.9	0.92
chr8	103113730	103114005	CpG: 28	275	28	173	20.4	62.9	1.05
chr8	103175720	103176005	CpG: 25	285	25	180	17.5	63.2	0.90
chr8	103249490	103250415	CpG: 89	925	89	665	19.2	71.9	0.78
chr8	103311150	103311423	CpG: 25	273	25	170	18.3	62.3	0.96
chr8	103364425	103365748	CpG: 124	1323	124	918	18.7	69.4	0.81
chr8	103537728	103538837	CpG: 125	1109	125	812	22.5	73.2	0.84
chr8	103611515	103611854	CpG: 33	339	33	250	19.5	73.7	0.72
chr8	103654512	103654762	CpG: 21	250	21	158	16.8	63.2	0.87
chr8	103729081	103729412	CpG: 24	331	24	213	14.5	64.4	0.72
chr8	103739145	103739426	CpG: 21	281	21	172	14.9	61.2	0.82
chr8	103745541	103745818	CpG: 24	277	24	167	17.3	60.3	0.98
chr8	103782084	103784878	CpG: 280	2794	280	2020	20.0	72.3	0.77
chr8	103787525	103787750	CpG: 16	225	16	134	14.2	59.6	0.83
chr8	103866873	103867080	CpG: 18	207	18	134	17.4	64.7	0.88
chr8	103905772	103906046	CpG: 22	274	22	169	16.1	61.7	0.85
chr8	103934618	103935493	CpG: 103	875	103	659	23.5	75.3	0.83
chr8	103938612	103939290	CpG: 91	678	91	538	26.8	79.4	0.86
chr8	103991238	103993097	CpG: 194	1859	194	1290	20.9	69.4	0.87
chr8	104121993	104122231	CpG: 18	238	18	144	15.1	60.5	0.85
chr8	104148883	104149300	CpG: 39	417	39	281	18.7	67.4	0.83
chr8	104219555	104219829	CpG: 23	274	23	170	16.8	62.0	0.88
chr8	104268447	104269111	CpG: 84	664	84	516	25.3	77.7	0.85
chr8	104426527	104427341	CpG: 104	814	104	613	25.6	75.3	0.91
chr8	104498829	104499529	CpG: 75	700	75	503	21.4	71.9	0.83
chr8	104542317	104543244	CpG: 97	927	97	594	20.9	64.1	1.02
chr8	104626240	104629284	CpG: 285	3044	285	2131	18.7	70.0	0.79
chr8	104751103	104751382	CpG: 25	279	25	172	17.9	61.6	0.95
chr8	104916445	104916756	CpG: 27	311	27	193	17.4	62.1	0.91
chr8	104966381	104966655	CpG: 20	274	20	167	14.6	60.9	0.79
chr8	105035358	105035633	CpG: 21	275	21	166	15.3	60.4	0.85
chr8	105048303	105048551	CpG: 19	248	19	142	15.3	57.3	0.95
chr8	105111488	105111741	CpG: 18	253	18	151	14.2	59.7	0.81
chr8	105176706	105176973	CpG: 20	267	20	163	15.0	61.0	0.81
chr8	105350682	105351276	CpG: 54	594	54	420	18.2	70.7	0.73
chr8	105457521	105457866	CpG: 24	345	24	226	13.9	65.5	0.65
chr8	105494842	105495262	CpG: 40	420	40	291	19.0	69.3	0.79
chr8	105593939	105594607	CpG: 81	668	81	496	24.3	74.3	0.88
chr8	105715670	105716918	CpG: 136	1248	136	889	21.8	71.2	0.86
chr8	105872862	105873289	CpG: 31	427	31	255	14.5	59.7	0.82
chr8	105997511	105997741	CpG: 20	230	20	141	17.4	61.3	0.94
chr8	106296672	106296974	CpG: 23	302	23	181	15.2	59.9	0.87
chr8	106445696	106447320	CpG: 171	1624	171	1095	21.1	67.4	0.93
chr8	106514747	106515307	CpG: 47	560	47	405	16.8	72.3	0.64
chr8	107103358	107103621	CpG: 18	263	18	159	13.7	60.5	0.76
chr8	107134994	107135232	CpG: 21	238	21	146	17.6	61.3	0.96
chr8	107185569	107185854	CpG: 25	285	25	179	17.5	62.8	0.90
chr8	107249398	107249679	CpG: 24	281	24	176	17.1	62.6	0.88
chr8	107323596	107323880	CpG: 24	284	24	178	16.9	62.7	0.88
chr8	107343800	107344022	CpG: 19	222	19	144	17.1	64.9	0.82
chr8	107398064	107399910	CpG: 154	1846	154	1218	16.7	66.0	0.80
chr8	107457901	107458108	CpG: 15	207	15	121	14.5	58.5	0.87
chr8	107475230	107475504	CpG: 19	274	19	158	13.9	57.7	0.85
chr8	107785672	107786486	CpG: 83	814	83	564	20.4	69.3	0.85
chr8	107886346	107886622	CpG: 24	276	24	171	17.4	62.0	0.92
chr8	107898829	107899102	CpG: 20	273	20	165	14.7	60.4	0.81
chr8	107900010	107900306	CpG: 23	296	23	176	15.5	59.5	0.89
chr8	108258189	108258425	CpG: 20	236	20	145	16.9	61.4	0.92
chr8	108368237	108368597	CpG: 29	360	29	211	16.1	58.6	0.95
chr8	108463942	108464181	CpG: 20	239	20	146	16.7	61.1	0.91
chr8	109210724	109212088	CpG: 117	1364	117	868	17.2	63.6	0.85
chr8	109376792	109377393	CpG: 44	601	44	326	14.6	54.2	1.01
chr8	109411515	109411751	CpG: 16	236	16	137	13.6	58.1	0.82
chr8	109571852	109572515	CpG: 58	663	58	432	17.5	65.2	0.82
chr8	109846478	109846752	CpG: 25	274	25	172	18.2	62.8	0.94
chr8	109915718	109916179	CpG: 44	461	44	318	19.1	69.0	0.81
chr8	110007724	110008005	CpG: 24	281	24	176	17.1	62.6	0.88
chr8	110075616	110075898	CpG: 22	282	22	174	15.6	61.7	0.84
chr8	110082814	110083095	CpG: 25	281	25	175	17.8	62.3	0.93
chr8	110131400	110131636	CpG: 17	236	17	137	14.4	58.1	0.87
chr8	110279459	110279733	CpG: 26	274	26	169	19.0	61.7	1.01
chr8	110462229	110463217	CpG: 81	988	81	603	16.4	61.0	0.88
chr8	110490867	110491108	CpG: 23	241	23	171	19.1	71.0	0.76
chr8	110550045	110550313	CpG: 22	268	22	162	16.4	60.4	0.91
chr8	110626670	110626951	CpG: 24	281	24	175	17.1	62.3	0.90
chr8	110668094	110669001	CpG: 83	907	83	616	18.3	67.9	0.79
chr8	110720157	110720394	CpG: 20	237	20	144	16.9	60.8	0.95
chr8	110773142	110773638	CpG: 67	496	67	382	27.0	77.0	0.94
chr8	110819764	110820486	CpG: 67	722	67	511	18.6	70.8	0.74
chr8	110883377	110883602	CpG: 19	225	19	133	16.9	59.1	1.00
chr8	111102523	111103393	CpG: 79	870	79	588	18.2	67.6	0.80
chr8	111104267	111104482	CpG: 18	215	18	138	16.7	64.2	0.85
chr8	111310276	111310552	CpG: 22	276	22	165	15.9	59.8	0.90
chr8	111331174	111331784	CpG: 53	610	53	441	17.4	72.3	0.66
chr8	111429987	111430261	CpG: 24	274	24	171	17.5	62.4	0.91
chr8	111730360	111730634	CpG: 25	274	25	173	18.2	63.1	0.92
chr8	112169416	112169805	CpG: 39	389	39	289	20.1	74.3	0.73
chr8	112304236	112304512	CpG: 20	276	20	169	14.5	61.2	0.79
chr8	112352799	112353023	CpG: 16	224	16	132	14.3	58.9	0.84
chr8	112492656	112492893	CpG: 16	237	16	142	13.5	59.9	0.77
chr8	112519025	112519290	CpG: 21	265	21	161	15.8	60.8	0.88
chr8	112549840	112550117	CpG: 23	277	23	173	16.6	62.5	0.87
chr8	112789716	112789957	CpG: 19	241	19	143	15.8	59.3	0.92
chr8	112821644	112821845	CpG: 18	201	18	127	17.9	63.2	0.91
chr8	113020679	113020960	CpG: 24	281	24	174	17.1	61.9	0.91
chr8	113208072	113208325	CpG: 22	253	22	190	17.4	75.1	0.62
chr8	113257676	113258073	CpG: 33	397	33	291	16.6	73.3	0.62
chr8	113334416	113334654	CpG: 18	238	18	141	15.1	59.2	0.88
chr8	113338664	113338946	CpG: 24	282	24	174	17.0	61.7	0.91
chr8	113511520	113511786	CpG: 21	266	21	162	15.8	60.9	0.86
chr8	113872657	113872923	CpG: 24	266	24	166	18.0	62.4	0.94
chr8	114144815	114145096	CpG: 24	281	24	175	17.1	62.3	0.90
chr8	114173029	114173305	CpG: 20	276	20	163	14.5	59.1	0.84
chr8	114433210	114433472	CpG: 19	262	19	158	14.5	60.3	0.82
chr8	114453075	114453349	CpG: 24	274	24	172	17.5	62.8	0.90
chr8	114485518	114485796	CpG: 24	278	24	174	17.3	62.6	0.89
chr8	114497586	114497868	CpG: 23	282	23	175	16.3	62.1	0.86
chr8	114501863	114502168	CpG: 30	305	30	210	19.7	68.9	0.84
chr8	114522486	114522760	CpG: 19	274	19	163	13.9	59.5	0.79
chr8	114557522	114557781	CpG: 21	259	21	150	16.2	57.9	0.97
chr8	114585127	114585412	CpG: 24	285	24	177	16.8	62.1	0.89
chr8	114932196	114932463	CpG: 20	267	20	163	15.0	61.0	0.81
chr8	115000882	115001128	CpG: 19	246	19	142	15.4	57.7	0.96
chr8	115026097	115026337	CpG: 17	240	17	145	14.2	60.4	0.81
chr8	115028200	115028436	CpG: 18	236	18	137	15.3	58.1	0.93
chr8	115130586	115131013	CpG: 30	427	30	256	14.1	60.0	0.79
chr8	115133292	115133573	CpG: 20	281	20	169	14.2	60.1	0.80
chr8	115328530	115328740	CpG: 17	210	17	130	16.2	61.9	0.85
chr8	115363528	115363802	CpG: 23	274	23	171	16.8	62.4	0.87
chr8	115436114	115436505	CpG: 37	391	37	290	18.9	74.2	0.69
chr8	115437058	115437262	CpG: 15	204	15	114	14.7	55.9	0.96
chr8	115510919	115511299	CpG: 33	380	33	271	17.4	71.3	0.68
chr8	115584289	115584526	CpG: 18	237	18	141	15.2	59.5	0.89
chr8	115628932	115629144	CpG: 17	212	17	125	16.0	59.0	0.93
chr8	115844016	115844301	CpG: 24	285	24	178	16.8	62.5	0.88
chr8	116002676	116002905	CpG: 20	229	20	139	17.5	60.7	0.95
chr8	116013444	116013682	CpG: 19	238	19	139	16.0	58.4	0.95
chr8	116117797	116118063	CpG: 22	266	22	166	16.5	62.4	0.86
chr8	116166907	116167131	CpG: 19	224	19	136	17.0	60.7	0.95
chr8	116360790	116361060	CpG: 22	270	22	166	16.3	61.5	0.87
chr8	116775357	116775673	CpG: 34	316	34	227	21.5	71.8	0.85
chr8	116794624	116795147	CpG: 37	523	37	331	14.1	63.3	0.73
chr8	116795551	116796549	CpG: 100	998	100	624	20.0	62.5	1.03
chr8	116880355	116880674	CpG: 25	319	25	187	15.7	58.6	0.92
chr8	117106479	117106703	CpG: 18	224	18	137	16.1	61.2	0.88
chr8	117161945	117162174	CpG: 20	229	20	138	17.5	60.3	0.97
chr8	117218748	117218983	CpG: 20	235	20	143	17.0	60.9	0.94
chr8	117424897	117425216	CpG: 26	319	26	221	16.3	69.3	0.68
chr8	117513736	117513966	CpG: 19	230	19	139	16.5	60.4	0.92
chr8	117658415	117658763	CpG: 28	348	28	251	16.1	72.1	0.62
chr8	117659348	117659568	CpG: 17	220	17	119	15.5	54.1	1.09
chr8	117879021	117879328	CpG: 25	307	25	178	16.3	58.0	0.98
chr8	117883812	117884021	CpG: 21	209	21	129	20.1	61.7	1.07
chr8	117894373	117895032	CpG: 57	659	57	407	17.3	61.8	0.91
chr8	118002207	118003242	CpG: 89	1035	89	691	17.2	66.8	0.77
chr8	118066404	118066891	CpG: 55	487	55	356	22.6	73.1	0.85
chr8	118077883	118078442	CpG: 66	559	66	425	23.6	76.0	0.82
chr8	118555178	118555532	CpG: 33	354	33	264	18.6	74.6	0.67
chr8	118579529	118579817	CpG: 24	288	24	175	16.7	60.8	0.92
chr8	118648056	118648292	CpG: 22	236	22	146	18.6	61.9	1.01
chr8	118648768	118649224	CpG: 46	456	46	307	20.2	67.3	0.89
chr8	118713307	118713581	CpG: 21	274	21	167	15.3	60.9	0.84
chr8	118829008	118829283	CpG: 24	275	24	169	17.5	61.5	0.93
chr8	118905814	118906265	CpG: 36	451	36	313	16.0	69.4	0.67
chr8	119073324	119073564	CpG: 20	240	20	146	16.7	60.8	0.92
chr8	119135470	119135706	CpG: 19	236	19	140	16.1	59.3	0.94
chr8	119239733	119240683	CpG: 119	950	119	663	25.1	69.8	1.03
chr8	119415572	119415847	CpG: 21	275	21	167	15.3	60.7	0.84
chr8	119476870	119477108	CpG: 18	238	18	145	15.1	60.9	0.83
chr8	119590979	119591252	CpG: 23	273	23	168	16.8	61.5	0.90
chr8	119750166	119750553	CpG: 34	387	34	247	17.6	63.8	0.90
chr8	120049710	120049948	CpG: 20	238	20	142	16.8	59.7	0.96
chr8	120080132	120080364	CpG: 24	232	24	157	20.7	67.7	0.91
chr8	120080575	120080823	CpG: 18	248	18	167	14.5	67.3	0.64
chr8	120336617	120337450	CpG: 114	833	114	632	27.4	75.9	0.95
chr8	120544630	120545410	CpG: 57	780	57	506	14.6	64.9	0.70
chr8	120961425	120961742	CpG: 28	317	28	200	17.7	63.1	0.91
chr8	120977755	120978026	CpG: 23	271	23	168	17.0	62.0	0.90
chr8	120984394	120985080	CpG: 76	686	76	482	22.2	70.3	0.90
chr8	121002385	121003181	CpG: 74	796	74	544	18.6	68.3	0.80
chr8	121012006	121012280	CpG: 19	274	19	164	13.9	59.9	0.78
chr8	121252286	121252563	CpG: 27	277	27	182	19.5	65.7	0.90
chr8	121253521	121254343	CpG: 58	822	58	511	14.1	62.2	0.75
chr8	121261591	121261868	CpG: 22	277	22	169	15.9	61.0	0.86
chr8	121377675	121377905	CpG: 20	230	20	138	17.4	60.0	1.01
chr8	121573858	121574162	CpG: 24	304	24	161	15.8	53.0	1.14
chr8	121939343	121940648	CpG: 135	1305	135	908	20.7	69.6	0.86
chr8	122068835	122069122	CpG: 25	287	25	179	17.4	62.4	0.91
chr8	122244201	122244431	CpG: 20	230	20	138	17.4	60.0	0.99
chr8	122439900	122440179	CpG: 23	279	23	171	16.5	61.3	0.89
chr8	122464637	122464990	CpG: 25	353	25	203	14.2	57.5	0.86
chr8	122714254	122714478	CpG: 20	224	20	138	17.9	61.6	0.95
chr8	122769660	122770384	CpG: 63	724	63	485	17.4	67.0	0.79
chr8	122797883	122798405	CpG: 47	522	47	380	18.0	72.8	0.68
chr8	123078787	123079000	CpG: 23	213	23	159	21.6	74.6	0.78
chr8	123835722	123836003	CpG: 24	281	24	175	17.1	62.3	0.90
chr8	123911301	123914017	CpG: 225	2716	225	1670	16.6	61.5	0.88
chr8	123964893	123965135	CpG: 19	242	19	148	15.7	61.2	0.87
chr8	124172951	124173627	CpG: 78	676	78	449	23.1	66.4	1.05
chr8	124175456	124175692	CpG: 18	236	18	139	15.3	58.9	0.89
chr8	124203771	124204187	CpG: 44	416	44	295	21.2	70.9	0.87
chr8	124205188	124205481	CpG: 21	293	21	163	14.3	55.6	0.93
chr8	124248643	124248872	CpG: 21	229	21	140	18.3	61.1	0.99
chr8	124287917	124288997	CpG: 79	1080	79	642	14.6	59.4	0.84
chr8	124291690	124292431	CpG: 54	741	54	497	14.6	67.1	0.65
chr8	124300740	124301091	CpG: 23	351	23	200	13.1	57.0	0.81
chr8	124338307	124338705	CpG: 38	398	38	288	19.1	72.4	0.77
chr8	124371951	124372604	CpG: 73	653	73	461	22.4	70.6	0.92
chr8	124405106	124406563	CpG: 151	1457	151	1045	20.7	71.7	0.83
chr8	124434046	124434280	CpG: 16	234	16	138	13.7	59.0	0.79
chr8	124526960	124527906	CpG: 100	946	100	636	21.1	67.2	0.94
chr8	124546766	124546993	CpG: 18	227	18	135	15.9	59.5	0.93
chr8	124547469	124548289	CpG: 80	820	80	590	19.5	72.0	0.78
chr8	124589736	124589993	CpG: 19	257	19	153	14.8	59.5	0.84
chr8	124671402	124672879	CpG: 144	1477	144	1032	19.5	69.9	0.80
chr8	124799056	124799330	CpG: 25	274	25	172	18.2	62.8	0.94
chr8	124849996	124850305	CpG: 21	309	21	173	13.6	56.0	0.87
chr8	124885239	124885521	CpG: 24	282	24	174	17.0	61.7	0.91
chr8	124900287	124901266	CpG: 99	979	99	668	20.2	68.2	0.87
chr8	124997924	124998351	CpG: 30	427	30	254	14.1	59.5	0.80
chr8	125125547	125125825	CpG: 25	278	25	175	18.0	62.9	0.92
chr8	125354265	125354531	CpG: 19	266	19	162	14.3	60.9	0.78
chr8	125433105	125433378	CpG: 22	273	22	173	16.1	63.4	0.81
chr8	125433787	125434312	CpG: 41	525	41	339	15.6	64.6	0.76
chr8	125496335	125496565	CpG: 18	230	18	139	15.7	60.4	0.87
chr8	125504316	125505939	CpG: 175	1623	175	1180	21.6	72.7	0.82
chr8	125564533	125565392	CpG: 67	859	67	599	15.6	69.7	0.64
chr8	125606987	125608091	CpG: 109	1104	109	731	19.7	66.2	0.90
chr8	125671905	125672564	CpG: 54	659	54	410	16.4	62.2	0.85
chr8	125860135	125862083	CpG: 182	1948	182	1282	18.7	65.8	0.86
chr8	125947635	125947909	CpG: 22	274	22	168	16.1	61.3	0.87
chr8	126010950	126011172	CpG: 18	222	18	135	16.2	60.8	0.89
chr8	126096742	126097141	CpG: 29	399	29	231	14.5	57.9	0.88
chr8	126106225	126106460	CpG: 18	235	18	141	15.3	60.0	0.87
chr8	126131468	126132425	CpG: 111	957	111	667	23.2	69.7	0.96
chr8	126145429	126145671	CpG: 22	242	22	149	18.2	61.6	0.98
chr8	126225357	126225719	CpG: 39	362	39	257	21.5	71.0	0.86
chr8	126467022	126467295	CpG: 24	273	24	170	17.6	62.3	0.92
chr8	126562675	126564756	CpG: 219	2081	219	1465	21.0	70.4	0.85
chr8	126565436	126565644	CpG: 17	208	17	132	16.3	63.5	0.87
chr8	126584706	126584987	CpG: 23	281	23	168	16.4	59.8	0.93
chr8	126986933	126987145	CpG: 16	212	16	122	15.1	57.5	0.92
chr8	127035194	127035474	CpG: 25	280	25	175	17.9	62.5	0.92
chr8	127116780	127117053	CpG: 24	273	24	168	17.6	61.5	0.94
chr8	127317811	127318085	CpG: 23	274	23	170	16.8	62.0	0.88
chr8	127445864	127446082	CpG: 18	218	18	128	16.5	58.7	0.96
chr8	127481462	127481692	CpG: 18	230	18	136	15.7	59.1	0.92
chr8	127579620	127579897	CpG: 21	277	21	168	15.2	60.6	0.85
chr8	127683592	127685789	CpG: 204	2197	204	1463	18.6	66.6	0.84
chr8	127841741	127842295	CpG: 55	554	55	407	19.9	73.5	0.74
chr8	127857380	127857656	CpG: 26	276	26	171	18.8	62.0	0.99
chr8	127932270	127932580	CpG: 26	310	26	192	16.8	61.9	0.88
chr8	127980304	127980542	CpG: 19	238	19	145	16.0	60.9	0.87
chr8	128055812	128056027	CpG: 16	215	16	129	14.9	60.0	0.84
chr8	128261881	128262151	CpG: 20	270	20	159	14.8	58.9	0.86
chr8	128364801	128365035	CpG: 20	234	20	142	17.1	60.7	0.95
chr8	128442847	128444678	CpG: 172	1831	172	1426	18.8	77.9	0.62
chr8	128614867	128615146	CpG: 22	279	22	171	15.8	61.3	0.85
chr8	128765370	128765646	CpG: 21	276	21	165	15.2	59.8	0.87
chr8	128861456	128861686	CpG: 17	230	17	142	14.8	61.7	0.79
chr8	128863013	128866487	CpG: 260	3474	260	2130	15.0	61.3	0.80
chr8	128888790	128889037	CpG: 22	247	22	153	17.8	61.9	0.94
chr8	128921325	128922142	CpG: 94	817	94	594	23.0	72.7	0.87
chr8	128930673	128930920	CpG: 19	247	19	152	15.4	61.5	0.83
chr8	128977208	128977738	CpG: 36	530	36	322	13.6	60.8	0.76
chr8	129680745	129681030	CpG: 26	285	26	180	18.2	63.2	0.92
chr8	129802631	129802863	CpG: 19	232	19	140	16.4	60.3	0.91
chr8	129869540	129869869	CpG: 27	329	27	193	16.4	58.7	0.96
chr8	129978260	129978497	CpG: 20	237	20	145	16.9	61.2	0.92
chr8	130022744	130023103	CpG: 25	359	25	208	13.9	57.9	0.83
chr8	130283397	130283713	CpG: 25	316	25	186	15.8	58.9	0.92
chr8	130383876	130384106	CpG: 21	230	21	142	18.3	61.7	0.97
chr8	130507864	130508145	CpG: 24	281	24	175	17.1	62.3	0.90
chr8	130574578	130574861	CpG: 20	283	20	163	14.1	57.6	0.85
chr8	130765570	130765857	CpG: 24	287	24	179	16.7	62.4	0.88
chr8	131021418	131021699	CpG: 23	281	23	174	16.4	61.9	0.87
chr8	131065457	131066736	CpG: 122	1279	122	881	19.1	68.9	0.82
chr8	131069963	131070242	CpG: 24	279	24	176	17.2	63.1	0.88
chr8	131110028	131110256	CpG: 28	228	28	169	24.6	74.1	0.89
chr8	131142414	131143385	CpG: 152	971	152	764	31.3	78.7	1.02
chr8	131260068	131260349	CpG: 24	281	24	175	17.1	62.3	0.90
chr8	131484471	131485701	CpG: 167	1230	167	938	27.2	76.3	0.93
chr8	131486268	131486549	CpG: 24	281	24	173	17.1	61.6	0.92
chr8	131570366	131571403	CpG: 141	1037	141	796	27.2	76.8	0.92
chr8	131594033	131594303	CpG: 20	270	20	166	14.8	61.5	0.79
chr8	131803829	131804108	CpG: 23	279	23	173	16.5	62.0	0.86
chr8	131934952	131935191	CpG: 20	239	20	145	16.7	60.7	0.93
chr8	132166317	132168863	CpG: 215	2546	215	1680	16.9	66.0	0.78
chr8	132609813	132610351	CpG: 41	538	41	383	15.2	71.2	0.60
chr8	133026914	133027830	CpG: 118	916	118	625	25.8	68.2	1.11
chr8	133252232	133252483	CpG: 18	251	18	155	14.3	61.8	0.75
chr8	133560075	133560348	CpG: 22	273	22	172	16.1	63.0	0.82
chr8	133602938	133604417	CpG: 178	1479	178	1092	24.1	73.8	0.90
chr8	133798614	133799039	CpG: 44	425	44	289	20.7	68.0	0.90
chr8	133898381	133898976	CpG: 81	595	81	455	27.2	76.5	0.94
chr8	133995376	133995612	CpG: 19	236	19	144	16.1	61.0	0.89
chr8	134420172	134421989	CpG: 165	1817	165	1214	18.2	66.8	0.83
chr8	134433718	134433976	CpG: 20	258	20	161	15.5	62.4	0.81
chr8	134442520	134442791	CpG: 19	271	19	166	14.0	61.3	0.76
chr8	134535135	134535416	CpG: 23	281	23	174	16.4	61.9	0.87
chr8	134693615	134696605	CpG: 254	2990	254	2006	17.0	67.1	0.76
chr8	134700175	134700412	CpG: 17	237	17	141	14.3	59.5	0.84
chr8	134749262	134749487	CpG: 18	225	18	125	16.0	55.6	1.05
chr8	134850660	134850916	CpG: 22	256	22	156	17.2	60.9	0.94
chr8	134874501	134874778	CpG: 24	277	24	169	17.3	61.0	0.94
chr8	135269296	135269544	CpG: 21	248	21	152	16.9	61.3	0.92
chr8	135581941	135584693	CpG: 196	2752	196	1599	14.2	58.1	0.87
chr8	135596466	135596766	CpG: 23	300	23	186	15.3	62.0	0.80
chr8	135815287	135815549	CpG: 21	262	21	158	16.0	60.3	0.89
chr8	135830246	135831199	CpG: 117	953	117	649	24.6	68.1	1.07
chr8	135943646	135943909	CpG: 19	263	19	157	14.4	59.7	0.82
chr8	135949356	135950826	CpG: 162	1470	162	1026	22.0	69.8	0.91
chr8	136108566	136108786	CpG: 18	220	18	133	16.4	60.5	0.92
chr8	136367381	136367605	CpG: 18	224	18	136	16.1	60.7	0.90
chr8	136377050	136377282	CpG: 19	232	19	137	16.4	59.1	0.94
chr8	136574551	136575954	CpG: 170	1403	170	1033	24.2	73.6	0.90
chr8	136632959	136633229	CpG: 20	270	20	164	14.8	60.7	0.82
chr8	136654693	136654966	CpG: 22	273	22	168	16.1	61.5	0.87
chr8	136744444	136744719	CpG: 23	275	23	166	16.7	60.4	0.93
chr8	136808403	136808823	CpG: 41	420	41	310	19.5	73.8	0.72
chr8	136840860	136841111	CpG: 19	251	19	151	15.1	60.2	0.86
chr8	137077684	137077969	CpG: 23	285	23	176	16.1	61.8	0.86
chr8	137230269	137230490	CpG: 17	221	17	136	15.4	61.5	0.82
chr8	137342497	137342774	CpG: 22	277	22	166	15.9	59.9	0.89
chr8	137559756	137560048	CpG: 23	292	23	177	15.8	60.6	0.86
chr8	137646533	137647033	CpG: 47	500	47	367	18.8	73.4	0.70
chr8	137691528	137691803	CpG: 23	275	23	170	16.7	61.8	0.89
chr8	137777687	137777960	CpG: 24	273	24	171	17.6	62.6	0.91
chr8	137872853	137873093	CpG: 19	240	19	142	15.8	59.2	0.92
chr8	137909555	137910080	CpG: 48	525	48	380	18.3	72.4	0.70
chr8	138305090	138305294	CpG: 17	204	17	124	16.7	60.8	0.91
chr8	138429147	138429409	CpG: 21	262	21	161	16.0	61.5	0.86
chr8	138440676	138440947	CpG: 19	271	19	165	14.0	60.9	0.77
chr8	138870965	138871213	CpG: 19	248	19	140	15.3	56.5	1.00
chr8	138913142	138913407	CpG: 24	265	24	165	18.1	62.3	0.94
chr8	138922003	138922276	CpG: 20	273	20	167	14.7	61.2	0.80
chr8	139200244	139200790	CpG: 50	546	50	394	18.3	72.2	0.70
chr8	139214233	139214524	CpG: 23	291	23	180	15.8	61.9	0.83
chr8	139232572	139232866	CpG: 22	294	22	177	15.0	60.2	0.83
chr8	139275214	139275499	CpG: 21	285	21	174	14.7	61.1	0.81
chr8	139431425	139431703	CpG: 24	278	24	170	17.3	61.2	0.94
chr8	139434241	139434503	CpG: 25	262	25	165	19.1	63.0	0.98
chr8	139614548	139615527	CpG: 126	979	126	732	25.7	74.8	0.93
chr8	139622137	139622408	CpG: 21	271	21	167	15.5	61.6	0.83
chr8	139997151	139997717	CpG: 61	566	61	398	21.6	70.3	0.87
chr8	140000982	140001212	CpG: 19	230	19	140	16.5	60.9	0.91
chr8	140033592	140033803	CpG: 21	211	21	159	19.9	75.4	0.83
chr8	140079230	140079436	CpG: 15	206	15	122	14.6	59.2	0.84
chr8	140376631	140376912	CpG: 22	281	22	174	15.7	61.9	0.83
chr8	140738522	140739187	CpG: 45	665	45	406	13.5	61.1	0.73
chr8	140822463	140826226	CpG: 372	3763	372	2668	19.8	70.9	0.79
chr8	140852073	140852372	CpG: 28	299	28	206	18.7	68.9	0.79
chr8	141058536	141058823	CpG: 23	287	23	180	16.0	62.7	0.83
chr8	141157796	141158070	CpG: 22	274	22	170	16.1	62.0	0.84
chr8	141167347	141167584	CpG: 20	237	20	145	16.9	61.2	0.91
chr8	141217820	141220967	CpG: 210	3147	210	1979	13.3	62.9	0.68
chr8	141458558	141458984	CpG: 38	426	38	268	17.8	62.9	0.93
chr8	141468916	141469382	CpG: 46	466	46	343	19.7	73.6	0.87
chr8	141470974	141471324	CpG: 28	350	28	215	16.0	61.4	0.87
chr8	141539206	141539486	CpG: 21	280	21	157	15.0	56.1	0.96
chr8	141577282	141577991	CpG: 79	709	79	538	22.3	75.9	0.78
chr8	141578400	141578703	CpG: 28	303	28	217	18.5	71.6	0.72
chr8	141584325	141585115	CpG: 71	790	71	497	18.0	62.9	0.91
chr8	141610702	141611059	CpG: 38	357	38	266	21.3	74.5	0.77
chr8	141631126	141632717	CpG: 195	1591	195	1130	24.5	71.0	1.00
chr8	141655782	141656010	CpG: 18	228	18	143	15.8	62.7	0.80
chr8	141669421	141669625	CpG: 19	204	19	138	18.6	67.6	0.82
chr8	141754345	141756430	CpG: 270	2085	270	1543	25.9	74.0	0.95
chr8	141801484	141801726	CpG: 20	242	20	149	16.5	61.6	0.92
chr8	141876692	141876904	CpG: 15	212	15	126	14.2	59.4	0.82
chr8	142048961	142049235	CpG: 23	274	23	170	16.8	62.0	0.88
chr8	142120412	142121879	CpG: 190	1467	190	1112	25.9	75.8	0.93
chr8	142196665	142196924	CpG: 22	259	22	187	17.0	72.2	0.65
chr8	142211283	142211513	CpG: 20	230	20	141	17.4	61.3	0.93
chr8	142248233	142249367	CpG: 122	1134	122	846	21.5	74.6	0.77
chr8	142293424	142293759	CpG: 24	335	24	194	14.3	57.9	0.85
chr8	142322238	142323113	CpG: 67	875	67	624	15.3	71.3	0.60
chr8	142326961	142327569	CpG: 65	608	65	462	21.4	76.0	0.74
chr8	142330467	142330715	CpG: 17	248	17	154	13.7	62.1	0.74
chr8	142332285	142332513	CpG: 20	228	20	142	17.5	62.3	0.91
chr8	142333415	142333814	CpG: 36	399	36	275	18.0	68.9	0.77
chr8	142339214	142340419	CpG: 106	1205	106	811	17.6	67.3	0.78
chr8	142340960	142341211	CpG: 22	251	22	170	17.5	67.7	0.77
chr8	142342922	142343233	CpG: 23	311	23	197	14.8	63.3	0.75
chr8	142348300	142348623	CpG: 25	323	25	199	15.5	61.6	0.82
chr8	142373864	142374614	CpG: 54	750	54	381	14.4	50.8	1.15
chr8	142375403	142375691	CpG: 23	288	23	174	16.0	60.4	0.88
chr8	142406576	142407237	CpG: 46	661	46	407	13.9	61.6	0.75
chr8	142429200	142430527	CpG: 155	1327	155	1031	23.4	77.7	0.78
chr8	142478402	142479212	CpG: 69	810	69	539	17.0	66.5	0.78
chr8	142508342	142508575	CpG: 19	233	19	163	16.3	70.0	0.68
chr8	142512932	142513893	CpG: 128	961	128	737	26.6	76.7	0.91
chr8	142536839	142537801	CpG: 102	962	102	746	21.2	77.5	0.73
chr8	142544834	142545608	CpG: 92	774	92	601	23.8	77.6	0.79
chr8	142554290	142554529	CpG: 19	239	19	159	15.9	66.5	0.75
chr8	142569503	142569768	CpG: 22	265	22	172	16.6	64.9	0.79
chr8	142600173	142600437	CpG: 22	264	22	185	16.7	70.1	0.68
chr8	142636381	142636787	CpG: 38	406	38	299	18.7	73.6	0.69
chr8	142646999	142647921	CpG: 113	922	113	686	24.5	74.4	0.89
chr8	142660097	142660374	CpG: 21	277	21	172	15.2	62.1	0.79
chr8	142751454	142751795	CpG: 24	341	24	235	14.1	68.9	0.67
chr8	142854938	142855186	CpG: 19	248	19	153	15.3	61.7	0.81
chr8	142869095	142869317	CpG: 24	222	24	168	21.6	75.7	0.77
chr8	142892741	142892986	CpG: 23	245	23	174	18.8	71.0	0.74
chr8	143039905	143040157	CpG: 21	252	21	162	16.7	64.3	0.81
chr8	143110411	143110675	CpG: 28	264	28	194	21.2	73.5	0.79
chr8	143209048	143209341	CpG: 24	293	24	178	16.4	60.8	0.90
chr8	143258979	143259193	CpG: 17	214	17	123	15.9	57.5	0.96
chr8	143273825	143274061	CpG: 21	236	21	156	17.8	66.1	0.88
chr8	143392214	143392686	CpG: 45	472	45	323	19.1	68.4	0.86
chr8	143419467	143419733	CpG: 18	266	18	181	13.5	68.0	0.62
chr8	143420856	143421265	CpG: 38	409	38	297	18.6	72.6	0.71
chr8	143438700	143439017	CpG: 23	317	23	196	14.5	61.8	0.76
chr8	143457002	143457206	CpG: 15	204	15	127	14.7	62.3	0.81
chr8	143458096	143458515	CpG: 37	419	37	261	17.7	62.3	0.92
chr8	143466983	143467785	CpG: 58	802	58	530	14.5	66.1	0.69
chr8	143488786	143489009	CpG: 15	223	15	138	13.5	61.9	0.91
chr8	143531751	143532289	CpG: 41	538	41	318	15.2	59.1	0.88
chr8	143544076	143545109	CpG: 140	1033	140	815	27.1	78.9	0.87
chr8	143545471	143545755	CpG: 20	284	20	187	14.1	65.8	0.66
chr8	143568522	143568780	CpG: 21	258	21	172	16.3	66.7	0.77
chr8	143591542	143595599	CpG: 451	4057	451	2958	22.2	72.9	0.84
chr8	143596381	143596789	CpG: 29	408	29	267	14.2	65.4	0.67
chr8	143606342	143607359	CpG: 112	1017	112	756	22.0	74.3	0.80
chr8	143617615	143618099	CpG: 47	484	47	379	19.4	78.3	0.66
chr8	143619408	143619745	CpG: 27	337	27	240	16.0	71.2	0.64
chr8	143642438	143642666	CpG: 26	228	26	179	22.8	78.5	1.01
chr8	143653309	143654416	CpG: 159	1107	159	898	28.7	81.1	0.87
chr8	143659231	143659636	CpG: 36	405	36	291	17.8	71.9	0.74
chr8	143661131	143661428	CpG: 23	297	23	200	15.5	67.3	0.69
chr8	143671318	143671542	CpG: 17	224	17	147	15.2	65.6	0.70
chr8	143676616	143676850	CpG: 22	234	22	159	18.8	67.9	0.82
chr8	143685215	143685922	CpG: 52	707	52	500	14.7	70.7	0.63
chr8	143687565	143688102	CpG: 54	537	54	399	20.1	74.3	0.73
chr8	143707271	143707872	CpG: 42	601	42	351	14.0	58.4	0.82
chr8	143724974	143725281	CpG: 30	307	30	212	19.5	69.1	0.83
chr8	143756613	143758349	CpG: 170	1736	170	1240	19.6	71.4	0.77
chr8	143807996	143809424	CpG: 91	1428	91	900	12.7	63.0	0.64
chr8	143812869	143813952	CpG: 108	1083	108	764	19.9	70.5	0.81
chr8	143843517	143844579	CpG: 102	1062	102	782	19.2	73.6	0.71
chr8	143869758	143871280	CpG: 189	1522	189	1105	24.8	72.6	0.94
chr8	143882439	143883281	CpG: 81	842	81	612	19.2	72.7	0.73
chr8	143920287	143921448	CpG: 122	1161	122	846	21.0	72.9	0.84
chr8	143978064	143978333	CpG: 27	269	27	199	20.1	74.0	0.77
chr8	144103460	144103811	CpG: 30	351	30	259	17.1	73.8	0.63
chr8	144161736	144162873	CpG: 108	1137	108	840	19.0	73.9	0.70
chr8	144167955	144168159	CpG: 17	204	17	146	16.7	71.6	0.70
chr8	144185794	144186013	CpG: 16	219	16	156	14.6	71.2	0.60
chr8	144216332	144218348	CpG: 160	2016	160	1270	15.9	63.0	0.80
chr8	144229374	144229739	CpG: 30	365	30	228	16.4	62.5	0.85
chr8	144252728	144252960	CpG: 18	232	18	138	15.5	59.5	0.90
chr8	144266666	144266977	CpG: 23	311	23	198	14.8	63.7	0.73
chr8	144303674	144305119	CpG: 153	1445	153	1090	21.2	75.4	0.75
chr8	144331060	144331555	CpG: 53	495	53	367	21.4	74.1	0.80
chr8	144356202	144357157	CpG: 89	955	89	751	18.6	78.6	1.02
chr8	144367493	144367695	CpG: 17	202	17	151	16.8	74.8	0.61
chr8	144375450	144375678	CpG: 28	228	28	166	24.6	72.8	1.00
chr8	144393287	144394762	CpG: 157	1475	157	1092	21.3	74.0	0.81
chr8	144397580	144397958	CpG: 31	378	31	244	16.4	64.6	0.79
chr8	144402698	144403785	CpG: 91	1087	91	678	16.7	62.4	0.87
chr8	144406235	144406487	CpG: 17	252	17	151	13.5	59.9	0.75
chr8	144409012	144409538	CpG: 49	526	49	401	18.6	76.2	0.74
chr8	144414308	144415330	CpG: 143	1022	143	787	28.0	77.0	0.95
chr8	144423208	144426722	CpG: 257	3514	257	2368	14.6	67.4	0.64
chr8	144428900	144429154	CpG: 25	254	25	160	19.7	63.0	1.00
chr8	144430865	144431251	CpG: 37	386	37	284	19.2	73.6	0.73
chr8	144436665	144439058	CpG: 199	2393	199	1582	16.6	66.1	0.77
chr8	144443159	144444833	CpG: 170	1674	170	1163	20.3	69.5	0.84
chr8	144454383	144455769	CpG: 94	1386	94	979	13.6	70.6	0.64
chr8	144464860	144465249	CpG: 29	389	29	255	14.9	65.6	0.70
chr8	144468301	144471444	CpG: 291	3143	291	2021	18.5	64.3	1.14
chr8	144482307	144482859	CpG: 53	552	53	410	19.2	74.3	0.71
chr8	144507333	144507901	CpG: 68	568	68	429	23.9	75.5	0.84
chr8	144515840	144517021	CpG: 122	1181	122	810	20.7	68.6	0.88
chr8	144520971	144521374	CpG: 29	403	29	290	14.4	72.0	0.92
chr8	144527451	144527740	CpG: 21	289	21	198	14.5	68.5	0.65
chr8	144528109	144528433	CpG: 26	324	26	221	16.0	68.2	0.69
chr8	144549714	144549958	CpG: 19	244	19	169	15.6	69.3	0.69
chr8	144555150	144555991	CpG: 81	841	81	623	19.3	74.1	0.75
chr8	144570883	144571271	CpG: 40	388	40	285	20.6	73.5	0.76
chr8	144574785	144575007	CpG: 19	222	19	158	17.1	71.2	0.83
chr8	144578352	144581353	CpG: 368	3001	368	2191	24.5	73.0	0.92
chr8	144588752	144589002	CpG: 21	250	21	149	16.8	59.6	0.96
chr8	144619971	144620178	CpG: 17	207	17	149	16.4	72.0	0.63
chr8	144632653	144632869	CpG: 19	216	19	140	17.6	64.8	0.86
chr8	144636306	144637893	CpG: 103	1587	103	968	13.0	61.0	0.91
chr8	144668809	144669013	CpG: 17	204	17	140	16.7	68.6	0.71
chr8	144690144	144691076	CpG: 97	932	97	650	20.8	69.7	0.86
chr8	144702473	144704143	CpG: 135	1670	135	1072	16.2	64.2	0.80
chr8	144706329	144706875	CpG: 43	546	43	329	15.8	60.3	0.87
chr8	144707582	144707958	CpG: 41	376	41	286	21.8	76.1	0.76
chr8	144709830	144710353	CpG: 48	523	48	383	18.4	73.2	0.68
chr8	144721000	144721202	CpG: 20	202	20	147	19.8	72.8	0.75
chr8	144726971	144727861	CpG: 111	890	111	648	24.9	72.8	0.94
chr8	144743226	144743445	CpG: 18	219	18	137	16.4	62.6	0.89
chr8	144746479	144749093	CpG: 302	2614	302	1945	23.1	74.4	0.84
chr8	144758646	144759515	CpG: 92	869	92	620	21.2	71.3	0.83
chr8	144763575	144764324	CpG: 49	749	49	492	13.1	65.7	0.61
chr8	144766480	144767899	CpG: 141	1419	141	985	19.9	69.4	0.82
chr8	144768283	144768552	CpG: 19	269	19	165	14.1	61.3	0.76
chr8	144778078	144778473	CpG: 28	395	28	248	14.2	62.8	0.73
chr8	144784943	144786055	CpG: 119	1112	119	792	21.4	71.2	0.84
chr8	144810852	144811072	CpG: 17	220	17	149	15.5	67.7	0.68
chr8	144814852	144815069	CpG: 16	217	16	146	14.7	67.3	0.66
chr8	144834058	144834292	CpG: 16	234	16	139	13.7	59.4	0.79
chr8	144835895	144836136	CpG: 18	241	18	140	14.9	58.1	0.92
chr8	144839088	144839323	CpG: 17	235	17	141	14.5	60.0	0.82
chr8	144840691	144841214	CpG: 53	523	53	353	20.3	67.5	0.89
chr8	144849689	144849977	CpG: 21	288	21	173	14.6	60.1	0.82
chr8	144850225	144850950	CpG: 62	725	62	481	17.1	66.3	0.78
chr8	144852095	144852695	CpG: 50	600	50	401	16.7	66.8	1.06
chr8	144862005	144865299	CpG: 315	3294	315	2161	19.1	65.6	0.89
chr8	144872576	144873306	CpG: 68	730	68	537	18.6	73.6	0.71
chr8	144882490	144885134	CpG: 295	2644	295	1906	22.3	72.1	0.86
chr8	144885506	144885715	CpG: 16	209	16	134	15.3	64.1	0.75
chr8	144889470	144890785	CpG: 162	1315	162	1013	24.6	77.0	0.84
chr8	144894936	144895176	CpG: 22	240	22	177	18.3	73.8	0.67
chr8	144896278	144897072	CpG: 100	794	100	584	25.2	73.6	0.94
chr8	144917288	144917866	CpG: 70	578	70	433	24.2	74.9	0.87
chr8	144927105	144928883	CpG: 195	1778	195	1332	21.9	74.9	0.79
chr8	144932504	144932820	CpG: 27	316	27	203	17.1	64.2	0.83
chr8	144946309	144946584	CpG: 21	275	21	189	15.3	68.7	0.68
chr8	144946853	144947363	CpG: 41	510	41	356	16.1	69.8	0.67
chr8	144966265	144966554	CpG: 22	289	22	200	15.2	69.2	0.65
chr8	144967448	144967996	CpG: 42	548	42	377	15.3	68.8	0.65
chr8	144969446	144969697	CpG: 19	251	19	176	15.1	70.1	0.62
chr8	144971811	144973144	CpG: 175	1333	175	1012	26.3	75.9	0.91
chr8	144985586	144986606	CpG: 141	1020	141	735	27.6	72.1	1.07
chr8	144992423	144992849	CpG: 43	426	43	314	20.2	73.7	0.74
chr8	144996173	144996443	CpG: 29	270	29	208	21.5	77.0	0.75
chr8	144997273	144998629	CpG: 141	1356	141	1008	20.8	74.3	0.80
chr8	145014752	145024918	CpG: 1158	10166	1158	7442	22.8	73.2	0.85
chr8	145026266	145026690	CpG: 44	424	44	274	20.8	64.6	1.00
chr8	145026994	145027300	CpG: 23	306	23	201	15.0	65.7	0.71
chr8	145028715	145029489	CpG: 63	774	63	509	16.3	65.8	0.75
chr8	145030657	145030928	CpG: 21	271	21	187	15.5	69.0	0.66
chr8	145036147	145037089	CpG: 113	942	113	702	24.0	74.5	0.88
chr8	145050744	145050986	CpG: 20	242	20	164	16.5	67.8	0.74
chr8	145074381	145086246	CpG: 965	11865	965	8044	16.3	67.8	0.71
chr8	145087431	145088256	CpG: 61	825	61	575	14.8	69.7	0.61
chr8	145093019	145093518	CpG: 39	499	39	348	15.6	69.7	0.64
chr8	145100527	145101026	CpG: 47	499	47	370	18.8	74.1	0.71
chr8	145102006	145102554	CpG: 52	548	52	409	19.0	74.6	0.71
chr8	145102925	145103324	CpG: 29	399	29	276	14.5	69.2	0.62
chr8	145108559	145109289	CpG: 67	730	67	526	18.4	72.1	0.71
chr8	145110248	145110575	CpG: 29	327	29	216	17.7	66.1	0.81
chr8	145111731	145112471	CpG: 68	740	68	549	18.4	74.2	0.68
chr8	145131413	145136425	CpG: 424	5012	424	3443	16.9	68.7	0.72
chr8	145138026	145138348	CpG: 26	322	26	188	16.1	58.4	0.96
chr8	145141646	145141993	CpG: 27	347	27	210	15.6	60.5	0.85
chr8	145149949	145151416	CpG: 165	1467	165	1074	22.5	73.2	0.85
chr8	145207580	145207783	CpG: 22	203	22	143	21.7	70.4	0.87
chr8	145209234	145213975	CpG: 451	4741	451	3342	19.0	70.5	0.77
chr8	145217245	145217512	CpG: 23	267	23	183	17.2	68.5	0.73
chr8	145219158	145219505	CpG: 28	347	28	245	16.1	70.6	0.65
chr8	145220498	145221776	CpG: 121	1278	121	937	18.9	73.3	0.71
chr8	145236107	145236373	CpG: 19	266	19	163	14.3	61.3	0.77
chr8	145239147	145240082	CpG: 97	935	97	629	20.7	67.3	0.92
chr8	145243124	145244183	CpG: 122	1059	122	768	23.0	72.5	0.88
chr8	145255268	145256354	CpG: 130	1086	130	804	23.9	74.0	0.87
chr8	145264293	145265958	CpG: 201	1665	201	1200	24.1	72.1	0.93
chr8	145268926	145271360	CpG: 222	2434	222	1682	18.2	69.1	0.76
chr8	145276147	145277331	CpG: 99	1184	99	836	16.7	70.6	0.67
chr8	145286436	145292828	CpG: 671	6392	671	3893	21.0	60.9	1.16
chr8	145304114	145305355	CpG: 151	1241	151	923	24.3	74.4	0.88
chr8	145313769	145315409	CpG: 193	1640	193	1197	23.5	73.0	0.88
chr8	145346948	145347188	CpG: 24	240	24	168	20.0	70.0	0.82
chr8	145352169	145352783	CpG: 62	614	62	482	20.2	78.5	0.95
chr8	145369682	145370215	CpG: 44	533	44	420	16.5	78.8	0.67
chr8	145402858	145403093	CpG: 21	235	21	144	17.9	61.3	0.97
chr8	145407421	145407668	CpG: 19	247	19	171	15.4	69.2	0.65
chr8	145435047	145436025	CpG: 144	978	144	754	29.4	77.1	0.99
chr8	145439261	145439526	CpG: 21	265	21	192	15.8	72.5	0.61
chr8	145439676	145440364	CpG: 54	688	54	475	15.7	69.0	0.68
chr8	145443599	145443856	CpG: 21	257	21	157	16.3	61.1	0.88
chr8	145446178	145447084	CpG: 63	906	63	615	13.9	67.9	0.61
chr8	145454765	145455045	CpG: 22	280	22	203	15.7	72.5	0.60
chr8	145459489	145460729	CpG: 160	1240	160	929	25.8	74.9	0.92
chr8	145482024	145482587	CpG: 82	563	82	469	29.1	83.3	1.02
chr8	145494956	145496218	CpG: 162	1262	162	928	25.7	73.5	0.95
chr8	145496473	145496704	CpG: 16	231	16	136	13.9	58.9	0.83
chr8	145500314	145507788	CpG: 662	7474	662	5254	17.7	70.3	0.72
chr8	145522067	145523474	CpG: 124	1407	124	976	17.6	69.4	0.73
chr8	145526300	145527734	CpG: 173	1434	173	1076	24.1	75.0	0.86
chr8	145542376	145543550	CpG: 133	1174	133	865	22.7	73.7	0.84
chr8	145558107	145558380	CpG: 18	273	18	165	13.2	60.4	0.73
chr8	145561236	145564297	CpG: 214	3061	214	2057	14.0	67.2	0.62
chr8	145566007	145566313	CpG: 25	306	25	202	16.3	66.0	0.75
chr8	145567401	145567747	CpG: 27	346	27	240	15.6	69.4	0.66
chr8	145578766	145579651	CpG: 114	885	114	657	25.8	74.2	0.94
chr8	145582394	145583611	CpG: 102	1217	102	864	16.8	71.0	0.67
chr8	145586344	145586547	CpG: 17	203	17	142	16.7	70.0	0.69
chr8	145593862	145594142	CpG: 21	280	21	189	15.0	67.5	0.66
chr8	145597615	145599242	CpG: 148	1627	148	1079	18.2	66.3	0.83
chr8	145602891	145603195	CpG: 22	304	22	176	14.5	57.9	0.87
chr8	145606574	145606814	CpG: 18	240	18	160	15.0	66.7	0.68
chr8	145612009	145612210	CpG: 18	201	18	130	17.9	64.7	0.86
chr8	145613540	145614836	CpG: 150	1296	150	954	23.1	73.6	0.85
chr8	145614987	145615203	CpG: 15	216	15	132	13.9	61.1	0.75
chr8	145619727	145620518	CpG: 57	791	57	504	14.4	63.7	0.72
chr8	145631766	145636863	CpG: 438	5097	438	3532	17.2	69.3	0.72
chr8	145642236	145643141	CpG: 106	905	106	673	23.4	74.4	0.86
chr8	145644595	145645179	CpG: 51	584	51	407	17.5	69.7	0.72
chr8	145646784	145648288	CpG: 134	1504	134	1021	17.8	67.9	0.77
chr8	145669842	145671089	CpG: 113	1247	113	902	18.1	72.3	0.69
chr8	145674772	145679753	CpG: 353	4981	353	3417	14.2	68.6	0.60
chr8	145683019	145684059	CpG: 85	1040	85	736	16.3	70.8	0.79
chr8	145687264	145701138	CpG: 943	13874	943	9018	13.6	65.0	0.64
chr8	145703454	145703661	CpG: 17	207	17	138	16.4	66.7	0.74
chr8	145715710	145716132	CpG: 33	422	33	275	15.6	65.2	0.74
chr8	145717612	145718933	CpG: 104	1321	104	937	15.7	70.9	0.63
chr8	145751562	145752264	CpG: 66	702	66	494	18.8	70.4	0.79
chr8	145759470	145759865	CpG: 31	395	31	270	15.7	68.4	0.67
chr8	145769041	145769247	CpG: 18	206	18	129	17.5	62.6	0.90
chr8	145771052	145774228	CpG: 217	3176	217	1867	13.7	58.8	0.91
chr8	145776248	145776760	CpG: 41	512	41	324	16.0	63.3	0.81
chr8	145783063	145783938	CpG: 75	875	75	622	17.1	71.1	0.68
chr8	145789871	145790081	CpG: 19	210	19	152	18.1	72.4	0.69
chr8	145790413	145790743	CpG: 28	330	28	218	17.0	66.1	0.78
chr8	145795676	145796820	CpG: 115	1144	115	833	20.1	72.8	0.81
chr8	145847706	145847961	CpG: 20	255	20	185	15.7	72.5	0.60
chr8	145853040	145853257	CpG: 17	217	17	128	15.7	59.0	0.93
chr8	145855346	145859009	CpG: 304	3663	304	2425	16.6	66.2	0.80
chr8	145859061	145859536	CpG: 28	475	28	307	11.8	64.6	0.63
chr8	145865769	145866109	CpG: 24	340	24	203	14.1	59.7	0.80
chr8	145873547	145874238	CpG: 63	691	63	466	18.2	67.4	0.81
chr8	145886624	145887840	CpG: 120	1216	120	803	19.7	66.0	0.91
chr8	145897484	145897735	CpG: 19	251	19	151	15.1	60.2	0.85
chr8	145900111	145900343	CpG: 17	232	17	138	14.7	59.5	0.84
chr8	145902906	145903142	CpG: 19	236	19	145	16.1	61.4	0.89
chr8	145903764	145904114	CpG: 45	350	45	253	25.7	72.3	1.02
chr8	145928654	145929733	CpG: 100	1079	100	730	18.5	67.7	0.81
chr8	145960311	145961034	CpG: 81	723	81	521	22.4	72.1	0.87
chr8	145965048	145966785	CpG: 169	1737	169	1186	19.5	68.3	0.83
chr8	145972021	145972979	CpG: 121	958	121	704	25.3	73.5	0.94
chr8	145973164	145973400	CpG: 19	236	19	142	16.1	60.2	0.92
chr8	145978863	145979374	CpG: 34	511	34	294	13.3	57.5	0.82
chr8	145980828	145981961	CpG: 105	1133	105	782	18.5	69.0	0.78
chr8	145991888	145992115	CpG: 16	227	16	135	14.1	59.5	0.80
chr8	145995011	145995430	CpG: 28	419	28	276	13.4	65.9	0.65
chr8	146000191	146001650	CpG: 167	1459	167	1096	22.9	75.1	0.81
chr8	146026448	146027418	CpG: 107	970	107	666	22.1	68.7	0.94
chr8	146074497	146076509	CpG: 189	2012	189	1358	18.8	67.5	0.83
chr8	146125615	146126117	CpG: 55	502	55	371	21.9	73.9	0.82
chr8	146177705	146178680	CpG: 94	975	94	654	19.3	67.1	0.86
chr8	146229823	146231011	CpG: 130	1188	130	815	21.9	68.6	0.95
chr9	4035	5154	CpG: 210	1119	210	893	37.5	79.8	1.19
chr9	22651	23726	CpG: 116	1075	116	787	21.6	73.2	0.83
chr9	67095	68168	CpG: 131	1073	131	794	24.4	74.0	0.89
chr9	77563	77945	CpG: 32	382	32	253	16.8	66.2	0.77
chr9	107052	108975	CpG: 219	1923	219	1311	22.8	68.2	0.98
chr9	110823	112300	CpG: 124	1477	124	997	16.8	67.5	0.74
chr9	113630	113848	CpG: 18	218	18	135	16.5	61.9	0.88
chr9	134115	134422	CpG: 22	307	22	188	14.3	61.2	0.77
chr9	173180	173578	CpG: 39	398	39	263	19.6	66.1	0.94
chr9	208613	209458	CpG: 112	845	112	610	26.5	72.2	1.02
chr9	256459	256733	CpG: 23	274	23	170	16.8	62.0	0.88
chr9	380270	380507	CpG: 17	237	17	142	14.3	59.9	0.81
chr9	503393	505196	CpG: 226	1803	226	1322	25.1	73.3	0.94
chr9	541272	541546	CpG: 25	274	25	171	18.2	62.4	0.95
chr9	561536	561817	CpG: 24	281	24	174	17.1	61.9	0.91
chr9	632647	632884	CpG: 18	237	18	140	15.2	59.1	0.89
chr9	706501	706900	CpG: 43	399	43	286	21.6	71.7	0.86
chr9	762618	762892	CpG: 19	274	19	162	13.9	59.1	0.80
chr9	797118	797393	CpG: 21	275	21	165	15.3	60.0	0.87
chr9	798449	798665	CpG: 18	216	18	130	16.7	60.2	0.94
chr9	827092	827309	CpG: 15	217	15	137	13.8	63.1	0.70
chr9	841881	843872	CpG: 169	1991	169	1276	17.0	64.1	0.83
chr9	849452	849739	CpG: 24	287	24	180	16.7	62.7	0.87
chr9	862829	863646	CpG: 66	817	66	577	16.2	70.6	0.65
chr9	872655	873028	CpG: 28	373	28	215	15.0	57.6	0.91
chr9	970799	974546	CpG: 283	3747	283	2357	15.1	62.9	0.77
chr9	977432	979098	CpG: 170	1666	170	1171	20.4	70.3	0.83
chr9	999719	1000584	CpG: 72	865	72	536	16.6	62.0	0.87
chr9	1043963	1044519	CpG: 61	556	61	378	21.9	68.0	0.96
chr9	1046860	1048063	CpG: 101	1203	101	774	16.8	64.3	0.82
chr9	1051747	1052179	CpG: 39	432	39	282	18.1	65.3	0.85
chr9	1053140	1053909	CpG: 97	769	97	577	25.2	75.0	0.90
chr9	1061533	1061807	CpG: 24	274	24	172	17.5	62.8	0.90
chr9	1138713	1138943	CpG: 19	230	19	140	16.5	60.9	0.90
chr9	1225603	1225986	CpG: 25	383	25	228	13.1	59.5	0.74
chr9	1281176	1281417	CpG: 20	241	20	143	16.6	59.3	0.97
chr9	1409847	1410121	CpG: 24	274	24	171	17.5	62.4	0.91
chr9	1478490	1478769	CpG: 25	279	25	175	17.9	62.7	0.92
chr9	1576355	1576666	CpG: 24	311	24	189	15.4	60.8	0.84
chr9	1779890	1780164	CpG: 23	274	23	172	16.8	62.8	0.86
chr9	1811781	1812056	CpG: 24	275	24	172	17.5	62.5	0.90
chr9	1943206	1943447	CpG: 21	241	21	151	17.4	62.7	0.91
chr9	2003482	2003764	CpG: 26	282	26	178	18.4	63.1	0.94
chr9	2012519	2012730	CpG: 17	211	17	128	16.1	60.7	0.90
chr9	2017355	2020629	CpG: 291	3274	291	2148	17.8	65.6	0.83
chr9	2049672	2050324	CpG: 64	652	64	458	19.6	70.2	0.80
chr9	2071845	2072062	CpG: 17	217	17	130	15.7	59.9	0.89
chr9	2213777	2214061	CpG: 23	284	23	175	16.2	61.6	0.87
chr9	2243811	2244133	CpG: 24	322	24	202	14.9	62.7	0.76
chr9	2244365	2244576	CpG: 18	211	18	136	17.1	64.5	0.84
chr9	2274456	2274703	CpG: 20	247	20	151	16.2	61.1	0.88
chr9	2479398	2479667	CpG: 19	269	19	163	14.1	60.6	0.78
chr9	2509902	2510177	CpG: 26	275	26	174	18.9	63.3	0.95
chr9	2582820	2583045	CpG: 16	225	16	135	14.2	60.0	0.79
chr9	2624075	2626444	CpG: 230	2369	230	1625	19.4	68.6	0.82
chr9	2697700	2697904	CpG: 18	204	18	126	17.6	61.8	0.94
chr9	2720660	2721710	CpG: 104	1050	104	707	19.8	67.3	0.87
chr9	2750781	2751015	CpG: 19	234	19	142	16.2	60.7	0.90
chr9	2847279	2848107	CpG: 63	828	63	501	15.2	60.5	0.84
chr9	2937175	2937526	CpG: 27	351	27	244	15.4	69.5	0.64
chr9	3001764	3001994	CpG: 20	230	20	141	17.4	61.3	0.94
chr9	3082289	3082570	CpG: 24	281	24	176	17.1	62.6	0.89
chr9	3099779	3100009	CpG: 20	230	20	141	17.4	61.3	0.94
chr9	3184833	3185694	CpG: 82	861	82	572	19.0	66.4	0.87
chr9	3198844	3199073	CpG: 18	229	18	138	15.7	60.3	0.89
chr9	3373632	3373874	CpG: 20	242	20	142	16.5	58.7	0.97
chr9	3428205	3428478	CpG: 27	273	27	175	19.8	64.1	0.97
chr9	3432866	3433140	CpG: 23	274	23	166	16.8	60.6	0.92
chr9	3529791	3531323	CpG: 136	1532	136	1003	17.8	65.5	0.84
chr9	3673673	3673954	CpG: 27	281	27	179	19.2	63.7	0.96
chr9	3738014	3738545	CpG: 53	531	53	390	20.0	73.4	0.74
chr9	3809237	3809454	CpG: 20	217	20	137	18.4	63.1	0.94
chr9	4122074	4122843	CpG: 69	769	69	531	17.9	69.1	0.76
chr9	4199576	4199970	CpG: 32	394	32	289	16.2	73.4	0.61
chr9	4241416	4241638	CpG: 19	222	19	137	17.1	61.7	0.91
chr9	4302403	4304768	CpG: 215	2365	215	1511	18.2	63.9	0.89
chr9	4325721	4325959	CpG: 18	238	18	145	15.1	60.9	0.84
chr9	4400695	4400965	CpG: 23	270	23	172	17.0	63.7	0.86
chr9	4493901	4494555	CpG: 82	654	82	488	25.1	74.6	0.90
chr9	4494806	4495057	CpG: 20	251	20	162	15.9	64.5	0.78
chr9	4540941	4541226	CpG: 24	285	24	178	16.8	62.5	0.88
chr9	4609464	4609905	CpG: 33	441	33	271	15.0	61.5	0.80
chr9	4652142	4652378	CpG: 19	236	19	145	16.1	61.4	0.86
chr9	4665926	4666625	CpG: 67	699	67	499	19.2	71.4	0.75
chr9	4683001	4683675	CpG: 60	674	60	430	17.8	63.8	0.87
chr9	4745822	4746996	CpG: 131	1174	131	858	22.3	73.1	0.90
chr9	4797672	4798669	CpG: 117	997	117	703	23.5	70.5	0.94
chr9	4809544	4809895	CpG: 31	351	31	241	17.7	68.7	0.75
chr9	4961920	4962205	CpG: 25	285	25	179	17.5	62.8	0.90
chr9	4989651	4990738	CpG: 121	1087	121	787	22.3	72.4	0.85
chr9	5045818	5047511	CpG: 117	1693	117	1045	13.8	61.7	0.73
chr9	5047886	5048143	CpG: 23	257	23	188	17.9	73.2	0.67
chr9	5115847	5117335	CpG: 106	1488	106	1006	14.2	67.6	0.62
chr9	5135824	5136104	CpG: 23	280	23	174	16.4	62.1	0.87
chr9	5190408	5190855	CpG: 41	447	41	281	18.3	62.9	0.93
chr9	5308951	5309567	CpG: 42	616	42	382	13.6	62.0	0.71
chr9	5334109	5334386	CpG: 22	277	22	170	15.9	61.4	0.86
chr9	5344119	5344771	CpG: 45	652	45	397	13.8	60.9	0.75
chr9	5352199	5352477	CpG: 27	278	27	178	19.4	64.0	0.96
chr9	5442701	5443131	CpG: 43	430	43	290	20.0	67.4	0.88
chr9	5455536	5455756	CpG: 25	220	25	154	22.7	70.0	0.93
chr9	5633699	5634872	CpG: 131	1173	131	843	22.3	71.9	0.87
chr9	5685982	5686260	CpG: 24	278	24	174	17.3	62.6	0.89
chr9	5814246	5814456	CpG: 16	210	16	128	15.2	61.0	0.84
chr9	5837720	5838402	CpG: 88	682	88	501	25.8	73.5	0.97
chr9	6010369	6010575	CpG: 17	206	17	128	16.5	62.1	0.86
chr9	6012102	6013814	CpG: 158	1712	158	1198	18.5	70.0	0.76
chr9	6141019	6141445	CpG: 31	426	31	252	14.6	59.2	0.84
chr9	6187940	6188240	CpG: 22	300	22	187	14.7	62.3	0.76
chr9	6267394	6267657	CpG: 23	263	23	160	17.5	60.8	0.95
chr9	6331597	6331871	CpG: 22	274	22	168	16.1	61.3	0.86
chr9	6417409	6419153	CpG: 186	1744	186	1174	21.3	67.3	0.94
chr9	6421620	6421879	CpG: 26	259	26	165	20.1	63.7	1.00
chr9	6456560	6456827	CpG: 22	267	22	169	16.5	63.3	0.84
chr9	6514055	6514329	CpG: 25	274	25	174	18.2	63.5	0.91
chr9	6587597	6587871	CpG: 22	274	22	165	16.1	60.2	0.90
chr9	6627406	6628097	CpG: 55	691	55	476	15.9	68.9	0.67
chr9	6650131	6651026	CpG: 87	895	87	651	19.4	72.7	0.74
chr9	6664401	6664920	CpG: 39	519	39	299	15.0	57.6	0.91
chr9	6685748	6686841	CpG: 95	1093	95	686	17.4	62.8	0.89
chr9	6710668	6711195	CpG: 49	527	49	336	18.6	63.8	0.92
chr9	6743268	6743473	CpG: 15	205	15	121	14.6	59.0	0.87
chr9	6748583	6748857	CpG: 25	274	25	169	18.2	61.7	0.97
chr9	6753869	6755406	CpG: 153	1537	153	1024	19.9	66.6	0.90
chr9	6795335	6795939	CpG: 51	604	51	400	16.9	66.2	0.77
chr9	6856186	6856458	CpG: 20	272	20	157	14.7	57.7	0.89
chr9	6945310	6946087	CpG: 59	777	59	516	15.2	66.4	0.69
chr9	7031411	7031685	CpG: 24	274	24	170	17.5	62.0	0.92
chr9	7368366	7368638	CpG: 24	272	24	173	17.6	63.6	0.88
chr9	7436885	7437166	CpG: 23	281	23	174	16.4	61.9	0.87
chr9	7738044	7738438	CpG: 31	394	31	236	15.7	59.9	0.88
chr9	7802004	7802487	CpG: 42	483	42	311	17.4	64.4	0.84
chr9	7937317	7937558	CpG: 23	241	23	149	19.1	61.8	1.02
chr9	8093522	8093797	CpG: 21	275	21	167	15.3	60.7	0.83
chr9	8101625	8101861	CpG: 19	236	19	142	16.1	60.2	0.92
chr9	8297467	8297750	CpG: 24	283	24	175	17.0	61.8	0.90
chr9	8719833	8720443	CpG: 48	610	48	374	15.7	61.3	0.84
chr9	8863920	8865143	CpG: 120	1223	120	832	19.6	68.0	0.86
chr9	9069919	9070196	CpG: 24	277	24	178	17.3	64.3	0.85
chr9	9151752	9152026	CpG: 20	274	20	165	14.6	60.2	0.81
chr9	9424291	9424572	CpG: 24	281	24	175	17.1	62.3	0.90
chr9	9453222	9453426	CpG: 18	204	18	133	17.6	65.2	0.86
chr9	9664299	9664580	CpG: 24	281	24	175	17.1	62.3	0.90
chr9	9961603	9961876	CpG: 22	273	22	171	16.1	62.6	0.83
chr9	10029738	10030014	CpG: 23	276	23	170	16.7	61.6	0.89
chr9	10179237	10179503	CpG: 19	266	19	163	14.3	61.3	0.77
chr9	10218240	10218520	CpG: 25	280	25	175	17.9	62.5	0.93
chr9	10287975	10288190	CpG: 16	215	16	126	14.9	58.6	0.92
chr9	10370873	10371097	CpG: 18	224	18	135	16.1	60.3	0.90
chr9	10458714	10459225	CpG: 40	511	40	346	15.7	67.7	0.68
chr9	10621949	10622647	CpG: 90	698	90	520	25.8	74.5	0.94
chr9	10766650	10766880	CpG: 21	230	21	145	18.3	63.0	0.93
chr9	10772438	10772719	CpG: 22	281	22	173	15.7	61.6	0.84
chr9	10796136	10796370	CpG: 19	234	19	137	16.2	58.5	0.99
chr9	10837503	10837777	CpG: 23	274	23	172	16.8	62.8	0.86
chr9	10942786	10943057	CpG: 23	271	23	168	17.0	62.0	0.89
chr9	10950588	10950800	CpG: 17	212	17	130	16.0	61.3	0.87
chr9	10980162	10980433	CpG: 20	271	20	163	14.8	60.1	0.83
chr9	11470671	11470906	CpG: 19	235	19	138	16.2	58.7	0.95
chr9	11627444	11627959	CpG: 48	515	48	362	18.6	70.3	0.76
chr9	11989821	11990046	CpG: 17	225	17	137	15.1	60.9	0.82
chr9	12097083	12097313	CpG: 17	230	17	137	14.8	59.6	0.83
chr9	12116506	12116742	CpG: 20	236	20	144	16.9	61.0	0.93
chr9	12215186	12215463	CpG: 25	277	25	171	18.1	61.7	0.95
chr9	12343554	12343805	CpG: 20	251	20	151	15.9	60.2	0.88
chr9	12597110	12597347	CpG: 19	237	19	143	16.0	60.3	0.91
chr9	12734698	12734922	CpG: 19	224	19	138	17.0	61.6	0.92
chr9	12784772	12785591	CpG: 64	819	64	525	15.6	64.1	0.77
chr9	12829594	12829823	CpG: 17	229	17	136	14.8	59.4	0.85
chr9	12907339	12907613	CpG: 24	274	24	171	17.5	62.4	0.91
chr9	13047234	13047661	CpG: 36	427	36	263	16.9	61.6	0.89
chr9	13287710	13289204	CpG: 150	1494	150	1028	20.1	68.8	0.85
chr9	13332537	13332775	CpG: 19	238	19	138	16.0	58.0	0.96
chr9	13664880	13665153	CpG: 23	273	23	167	16.8	61.2	0.91
chr9	13850272	13850545	CpG: 24	273	24	170	17.6	62.3	0.91
chr9	13861013	13861259	CpG: 22	246	22	158	17.9	64.2	0.90
chr9	13882337	13882560	CpG: 17	223	17	132	15.2	59.2	0.89
chr9	14109915	14110157	CpG: 19	242	19	148	15.7	61.2	0.87
chr9	14296926	14297303	CpG: 26	377	26	222	13.8	58.9	0.80
chr9	14322735	14325796	CpG: 293	3061	293	2020	19.1	66.0	0.88
chr9	14332042	14332761	CpG: 95	719	95	529	26.4	73.6	0.98
chr9	14355785	14357917	CpG: 151	2132	151	1266	14.2	59.4	0.81
chr9	14358452	14358842	CpG: 26	390	26	226	13.3	57.9	0.81
chr9	14359075	14359283	CpG: 16	208	16	110	15.4	52.9	1.10
chr9	14668052	14668281	CpG: 18	229	18	141	15.7	61.6	0.84
chr9	14673575	14673884	CpG: 26	309	26	187	16.8	60.5	0.92
chr9	14702738	14703284	CpG: 70	546	70	418	25.6	76.6	0.88
chr9	14814098	14814320	CpG: 18	222	18	139	16.2	62.6	0.84
chr9	14987910	14988401	CpG: 41	491	41	332	16.7	67.6	0.74
chr9	15003021	15003250	CpG: 27	229	27	163	23.6	71.2	0.98
chr9	15147431	15147709	CpG: 20	278	20	172	14.4	61.9	0.76
chr9	15211017	15211249	CpG: 19	232	19	138	16.4	59.5	0.95
chr9	15244251	15244501	CpG: 21	250	21	157	16.8	62.8	0.86
chr9	15245041	15246162	CpG: 86	1121	86	800	15.3	71.4	0.60
chr9	15296674	15296922	CpG: 21	248	21	151	16.9	60.9	0.93
chr9	15297271	15297508	CpG: 19	237	19	145	16.0	61.2	0.88
chr9	15318422	15319086	CpG: 66	664	66	479	19.9	72.1	0.78
chr9	15341815	15342054	CpG: 21	239	21	145	17.6	60.7	0.98
chr9	15434452	15435131	CpG: 66	679	66	466	19.4	68.6	0.83
chr9	15522090	15523252	CpG: 131	1162	131	812	22.5	69.9	0.93
chr9	15539555	15539784	CpG: 24	229	24	160	21.0	69.9	0.93
chr9	15544793	15545041	CpG: 21	248	21	150	16.9	60.5	0.94
chr9	15551610	15551846	CpG: 17	236	17	138	14.4	58.5	0.86
chr9	15563138	15563414	CpG: 20	276	20	169	14.5	61.2	0.79
chr9	15564640	15565241	CpG: 56	601	56	396	18.6	65.9	0.86
chr9	15565984	15566221	CpG: 22	237	22	147	18.6	62.0	0.99
chr9	15581437	15581715	CpG: 26	278	26	179	18.7	64.4	0.92
chr9	15712120	15712331	CpG: 17	211	17	153	16.1	72.5	0.62
chr9	15790019	15790310	CpG: 24	291	24	181	16.5	62.2	0.86
chr9	15822512	15822779	CpG: 24	267	24	198	18.0	74.2	0.65
chr9	15848425	15848651	CpG: 18	226	18	135	15.9	59.7	0.91
chr9	16071729	16072006	CpG: 23	277	23	171	16.6	61.7	0.88
chr9	16475176	16475450	CpG: 22	274	22	171	16.1	62.4	0.83
chr9	16718767	16718999	CpG: 18	232	18	136	15.5	58.6	0.93
chr9	16738704	16739118	CpG: 53	414	53	296	25.6	71.5	1.01
chr9	16777691	16777926	CpG: 18	235	18	139	15.3	59.1	0.89
chr9	16825175	16825405	CpG: 18	230	18	138	15.7	60.0	0.90
chr9	16840787	16841021	CpG: 21	234	21	172	17.9	73.5	0.70
chr9	16857718	16857983	CpG: 21	265	21	161	15.8	60.8	0.86
chr9	16881929	16883868	CpG: 173	1939	173	1278	17.8	65.9	0.83
chr9	16899929	16900152	CpG: 20	223	20	136	17.9	61.0	0.97
chr9	16912391	16912665	CpG: 22	274	22	171	16.1	62.4	0.83
chr9	16917667	16917941	CpG: 22	274	22	170	16.1	62.0	0.84
chr9	16989893	16990831	CpG: 73	938	73	656	15.6	69.9	0.64
chr9	17147461	17148346	CpG: 89	885	89	615	20.1	69.5	0.83
chr9	17191501	17191877	CpG: 31	376	31	237	16.5	63.0	0.85
chr9	17216256	17216457	CpG: 16	201	16	120	15.9	59.7	0.94
chr9	17303297	17303521	CpG: 19	224	19	132	17.0	58.9	0.98
chr9	17307735	17308006	CpG: 24	271	24	199	17.7	73.4	0.66
chr9	17564448	17564681	CpG: 17	233	17	140	14.6	60.1	0.84
chr9	17591454	17592537	CpG: 131	1083	131	797	24.2	73.6	0.90
chr9	17650624	17650891	CpG: 19	267	19	163	14.2	61.0	0.77
chr9	17887342	17887623	CpG: 22	281	22	173	15.7	61.6	0.84
chr9	17919626	17920695	CpG: 94	1069	94	737	17.6	68.9	0.74
chr9	18267658	18267903	CpG: 19	245	19	150	15.5	61.2	0.87
chr9	18312014	18312239	CpG: 19	225	19	137	16.9	60.9	0.94
chr9	18381214	18381462	CpG: 18	248	18	137	14.5	55.2	0.98
chr9	18451808	18452054	CpG: 20	246	20	158	16.3	64.2	0.81
chr9	18522177	18522458	CpG: 24	281	24	176	17.1	62.6	0.89
chr9	18527626	18527855	CpG: 16	229	16	137	14.0	59.8	0.80
chr9	18671262	18671532	CpG: 22	270	22	169	16.3	62.6	0.84
chr9	18724669	18724889	CpG: 18	220	18	130	16.4	59.1	0.94
chr9	18789713	18790698	CpG: 80	985	80	665	16.2	67.5	0.71
chr9	18820295	18820563	CpG: 24	268	24	169	17.9	63.1	0.91
chr9	19041013	19041219	CpG: 16	206	16	115	15.5	55.8	1.02
chr9	19057910	19058195	CpG: 23	285	23	177	16.1	62.1	0.86
chr9	19061948	19062816	CpG: 83	868	83	555	19.1	63.9	0.94
chr9	19115325	19115965	CpG: 57	640	57	407	17.8	63.6	0.90
chr9	19139681	19141290	CpG: 131	1609	131	1018	16.3	63.3	0.82
chr9	19141933	19142205	CpG: 19	272	19	163	14.0	59.9	0.78
chr9	19171584	19171797	CpG: 16	213	16	128	15.0	60.1	0.85
chr9	19200210	19200447	CpG: 20	237	20	134	16.9	56.5	1.09
chr9	19243015	19244110	CpG: 122	1095	122	804	22.3	73.4	0.85
chr9	19392583	19393130	CpG: 48	547	48	346	17.6	63.3	0.89
chr9	19405146	19405424	CpG: 24	278	24	171	17.3	61.5	0.92
chr9	19421319	19422106	CpG: 70	787	70	532	17.8	67.6	0.79
chr9	19446456	19446961	CpG: 45	505	45	381	17.8	75.4	0.63
chr9	19447172	19447375	CpG: 16	203	16	126	15.8	62.1	0.82
chr9	19457008	19457244	CpG: 20	236	20	143	16.9	60.6	0.96
chr9	19477481	19477825	CpG: 39	344	39	258	22.7	75.0	0.89
chr9	19554466	19554893	CpG: 30	427	30	255	14.1	59.7	0.79
chr9	19720318	19720595	CpG: 25	277	25	170	18.1	61.4	0.97
chr9	19802124	19803197	CpG: 97	1073	97	721	18.1	67.2	0.80
chr9	19851061	19851342	CpG: 22	281	22	173	15.7	61.6	0.84
chr9	19948232	19948708	CpG: 40	476	40	309	16.8	64.9	0.80
chr9	19962440	19962707	CpG: 26	267	26	170	19.5	63.7	0.97
chr9	20111602	20111843	CpG: 21	241	21	143	17.4	59.3	1.01
chr9	20364098	20364376	CpG: 23	278	23	174	16.5	62.6	0.85
chr9	20515255	20515540	CpG: 25	285	25	178	17.5	62.5	0.92
chr9	20634154	20636395	CpG: 210	2241	210	1432	18.7	63.9	0.92
chr9	20672153	20672441	CpG: 24	288	24	174	16.7	60.4	0.92
chr9	20697856	20698466	CpG: 72	610	72	454	23.6	74.4	0.87
chr9	20791626	20791888	CpG: 24	262	24	163	18.3	62.2	0.96
chr9	21045305	21045701	CpG: 42	396	42	285	21.2	72.0	0.82
chr9	21045786	21046146	CpG: 24	360	24	215	13.3	59.7	0.75
chr9	21058582	21058816	CpG: 20	234	20	136	17.1	58.1	1.03
chr9	21119508	21119763	CpG: 23	255	23	158	18.0	62.0	0.97
chr9	21275813	21276086	CpG: 22	273	22	172	16.1	63.0	0.82
chr9	21349296	21349731	CpG: 42	435	42	308	19.3	70.8	0.78
chr9	21410248	21410541	CpG: 28	293	28	185	19.1	63.1	0.96
chr9	21416677	21417234	CpG: 49	557	49	349	17.6	62.7	0.91
chr9	21573324	21574272	CpG: 112	948	112	685	23.6	72.3	0.91
chr9	21654335	21654613	CpG: 23	278	23	173	16.5	62.2	0.86
chr9	21710690	21710957	CpG: 24	267	24	177	18.0	66.3	0.86
chr9	21816349	21817209	CpG: 71	860	71	529	16.5	61.5	0.87
chr9	21932370	21932644	CpG: 23	274	23	169	16.8	61.7	0.89
chr9	21973563	21973951	CpG: 36	388	36	281	18.6	72.4	0.71
chr9	21979397	21980048	CpG: 51	651	51	402	15.7	61.8	0.83
chr9	21982659	21983029	CpG: 32	370	32	236	17.3	63.8	0.86
chr9	21985214	21985491	CpG: 35	277	35	205	25.3	74.0	0.92
chr9	21988891	21989619	CpG: 63	728	63	498	17.3	68.4	0.79
chr9	21994998	21995230	CpG: 17	232	17	139	14.7	59.9	0.83
chr9	22004136	22004471	CpG: 25	335	25	202	14.9	60.3	0.84
chr9	22008475	22010284	CpG: 177	1809	177	1201	19.6	66.4	0.92
chr9	22020266	22020608	CpG: 35	342	35	237	20.5	69.3	0.85
chr9	22023035	22023849	CpG: 91	814	91	557	22.4	68.4	0.97
chr9	22168686	22169048	CpG: 28	362	28	269	15.5	74.3	0.63
chr9	22303039	22303317	CpG: 25	278	25	174	18.0	62.6	0.93
chr9	22368952	22369379	CpG: 32	427	32	257	15.0	60.2	0.83
chr9	22378047	22378336	CpG: 25	289	25	211	17.3	73.0	0.65
chr9	22409781	22410031	CpG: 22	250	22	155	17.6	62.0	0.94
chr9	22461095	22462109	CpG: 100	1014	100	719	19.7	70.9	0.78
chr9	22604056	22604330	CpG: 22	274	22	170	16.1	62.0	0.84
chr9	22751240	22751514	CpG: 21	274	21	168	15.3	61.3	0.82
chr9	22819080	22819316	CpG: 21	236	21	144	17.8	61.0	0.98
chr9	23081005	23081283	CpG: 25	278	25	175	18.0	62.9	0.92
chr9	23083871	23084139	CpG: 18	268	18	163	13.4	60.8	0.73
chr9	23231230	23231515	CpG: 25	285	25	179	17.5	62.8	0.90
chr9	23334669	23334956	CpG: 23	287	23	174	16.0	60.6	0.88
chr9	23458066	23458268	CpG: 17	202	17	145	16.8	71.8	0.66
chr9	23485223	23485501	CpG: 24	278	24	164	17.3	59.0	1.00
chr9	23826673	23828117	CpG: 172	1444	172	1021	23.8	70.7	0.97
chr9	23828394	23828907	CpG: 36	513	36	292	14.0	56.9	0.89
chr9	23856890	23857502	CpG: 54	612	54	380	17.6	62.1	0.92
chr9	24141088	24141327	CpG: 22	239	22	171	18.4	71.5	0.72
chr9	24236230	24236520	CpG: 21	290	21	174	14.5	60.0	0.81
chr9	24269198	24269461	CpG: 18	263	18	160	13.7	60.8	0.74
chr9	24362462	24362736	CpG: 25	274	25	172	18.2	62.8	0.93
chr9	24431542	24431780	CpG: 22	238	22	147	18.5	61.8	0.99
chr9	24543452	24543688	CpG: 21	236	21	145	17.8	61.4	0.96
chr9	24730036	24730272	CpG: 17	236	17	145	14.4	61.4	0.80
chr9	24759849	24760119	CpG: 23	270	23	167	17.0	61.9	0.90
chr9	24797941	24798225	CpG: 22	284	22	174	15.5	61.3	0.83
chr9	25002375	25002656	CpG: 24	281	24	175	17.1	62.3	0.90
chr9	25037546	25037820	CpG: 25	274	25	171	18.2	62.4	0.95
chr9	25202716	25202990	CpG: 24	274	24	169	17.5	61.7	0.93
chr9	25585399	25585635	CpG: 17	236	17	139	14.4	58.9	0.85
chr9	25604481	25604762	CpG: 25	281	25	176	17.8	62.6	0.92
chr9	25688013	25689203	CpG: 137	1190	137	870	23.0	73.1	0.86
chr9	25897205	25897481	CpG: 19	276	19	164	13.8	59.4	0.79
chr9	25988251	25988532	CpG: 24	281	24	177	17.1	63.0	0.88
chr9	26129987	26130256	CpG: 19	269	19	164	14.1	61.0	0.77
chr9	26148068	26148313	CpG: 18	245	18	150	14.7	61.2	0.80
chr9	26225134	26226415	CpG: 96	1281	96	869	15.0	67.8	0.65
chr9	26333624	26333907	CpG: 23	283	23	176	16.3	62.2	0.85
chr9	26373113	26373391	CpG: 26	278	26	180	18.7	64.7	0.91
chr9	26419893	26420100	CpG: 15	207	15	124	14.5	59.9	0.82
chr9	26651135	26651370	CpG: 18	235	18	139	15.3	59.1	0.92
chr9	26674271	26675276	CpG: 74	1005	74	687	14.7	68.4	0.64
chr9	26901281	26901555	CpG: 20	274	20	171	14.6	62.4	0.76
chr9	26902905	26903553	CpG: 69	648	69	433	21.3	66.8	0.96
chr9	26953199	26953476	CpG: 23	277	23	173	16.6	62.5	0.86
chr9	26957452	26958183	CpG: 72	731	72	494	19.7	67.6	0.86
chr9	26966892	26967361	CpG: 37	469	37	292	15.8	62.3	0.82
chr9	27093590	27093794	CpG: 15	204	15	120	14.7	58.8	0.87
chr9	27103196	27103585	CpG: 31	389	31	279	15.9	71.7	0.62
chr9	27306180	27306409	CpG: 18	229	18	138	15.7	60.3	0.88
chr9	27366134	27366367	CpG: 16	233	16	138	13.7	59.2	0.79
chr9	27493762	27493973	CpG: 16	211	16	123	15.2	58.3	0.91
chr9	27538926	27539294	CpG: 28	368	28	240	15.2	65.2	0.72
chr9	27539544	27540453	CpG: 95	909	95	621	20.9	68.3	0.90
chr9	27583547	27584164	CpG: 75	617	75	457	24.3	74.1	0.92
chr9	27584370	27584648	CpG: 23	278	23	151	16.5	54.3	1.14
chr9	27701159	27701631	CpG: 32	472	32	284	13.6	60.2	0.76
chr9	27717667	27717964	CpG: 24	297	24	175	16.2	58.9	0.94
chr9	27720693	27720966	CpG: 21	273	21	168	15.4	61.5	0.83
chr9	28128100	28128392	CpG: 24	292	24	179	16.4	61.3	0.88
chr9	28182715	28182993	CpG: 24	278	24	174	17.3	62.6	0.89
chr9	28327338	28327579	CpG: 19	241	19	149	15.8	61.8	0.85
chr9	28449878	28450174	CpG: 21	296	21	170	14.2	57.4	0.87
chr9	28489753	28489964	CpG: 19	211	19	131	18.0	62.1	0.95
chr9	28973898	28974170	CpG: 24	272	24	169	17.6	62.1	0.92
chr9	29124027	29124303	CpG: 21	276	21	166	15.2	60.1	0.86
chr9	29225838	29227484	CpG: 137	1646	137	1042	16.6	63.3	0.84
chr9	29228363	29228601	CpG: 19	238	19	138	16.0	58.0	0.95
chr9	29337270	29337539	CpG: 19	269	19	158	14.1	58.7	0.83
chr9	29412290	29412518	CpG: 16	228	16	133	14.0	58.3	0.84
chr9	29464058	29464362	CpG: 22	304	22	178	14.5	58.6	0.86
chr9	29839739	29839949	CpG: 20	210	20	149	19.0	71.0	0.76
chr9	29966606	29966880	CpG: 24	274	24	171	17.5	62.4	0.91
chr9	30076358	30076624	CpG: 20	266	20	163	15.0	61.3	0.81
chr9	30083092	30083324	CpG: 19	232	19	140	16.4	60.3	0.91
chr9	30620873	30621151	CpG: 20	278	20	168	14.4	60.4	0.80
chr9	30750010	30750284	CpG: 23	274	23	169	16.8	61.7	0.90
chr9	30850645	30850861	CpG: 19	216	19	133	17.6	61.6	0.95
chr9	30877850	30878114	CpG: 21	264	21	156	15.9	59.1	0.93
chr9	30888837	30889069	CpG: 17	232	17	138	14.7	59.5	0.84
chr9	31269259	31270527	CpG: 94	1268	94	786	14.8	62.0	0.77
chr9	31368914	31369195	CpG: 23	281	23	174	16.4	61.9	0.87
chr9	31390192	31390416	CpG: 18	224	18	137	16.1	61.2	0.89
chr9	31407693	31407918	CpG: 18	225	18	136	16.0	60.4	0.90
chr9	32076248	32076483	CpG: 22	235	22	144	18.7	61.3	1.02
chr9	32148852	32149084	CpG: 20	232	20	140	17.2	60.3	0.96
chr9	32400322	32400813	CpG: 63	491	63	367	25.7	74.7	0.92
chr9	32480545	32480769	CpG: 17	224	17	135	15.2	60.3	0.86
chr9	32542319	32542599	CpG: 27	280	27	170	19.3	60.7	1.08
chr9	32564053	32564313	CpG: 19	260	19	145	14.6	55.8	0.96
chr9	32566698	32568699	CpG: 150	2001	150	1165	15.0	58.2	0.89
chr9	32582928	32583191	CpG: 22	263	22	172	16.7	65.4	0.78
chr9	32589193	32589424	CpG: 28	231	28	145	24.2	62.8	1.27
chr9	32598965	32599201	CpG: 18	236	18	141	15.3	59.7	0.88
chr9	32613717	32613991	CpG: 24	274	24	171	17.5	62.4	0.91
chr9	32619638	32619902	CpG: 21	264	21	165	15.9	62.5	0.82
chr9	32651698	32651968	CpG: 21	270	21	151	15.6	55.9	1.00
chr9	32710133	32710406	CpG: 26	273	26	197	19.0	72.2	0.73
chr9	32726591	32727064	CpG: 33	473	33	279	14.0	59.0	0.81
chr9	32799139	32799828	CpG: 77	689	77	496	22.4	72.0	0.87
chr9	32972228	32972855	CpG: 51	627	51	452	16.3	72.1	0.64
chr9	33017778	33018230	CpG: 38	452	38	265	16.8	58.6	0.98
chr9	33036482	33036707	CpG: 21	225	21	155	18.7	68.9	0.79
chr9	33041645	33042360	CpG: 79	715	79	511	22.1	71.5	0.87
chr9	33060805	33061172	CpG: 37	367	37	253	20.2	68.9	0.85
chr9	33067400	33067666	CpG: 23	266	23	167	17.3	62.8	0.89
chr9	33091656	33091893	CpG: 18	237	18	140	15.2	59.1	0.89
chr9	33093053	33093927	CpG: 69	874	69	505	15.8	57.8	0.95
chr9	33147715	33149108	CpG: 117	1393	117	1031	16.8	74.0	0.61
chr9	33185335	33186569	CpG: 138	1234	138	900	22.4	72.9	0.86
chr9	33282442	33283767	CpG: 119	1325	119	852	18.0	64.3	0.89
chr9	33308953	33309638	CpG: 62	685	62	434	18.1	63.4	0.91
chr9	33397478	33397751	CpG: 22	273	22	172	16.1	63.0	0.82
chr9	33437630	33437877	CpG: 18	247	18	152	14.6	61.5	0.77
chr9	33456986	33457374	CpG: 26	388	26	228	13.4	58.8	0.79
chr9	33465946	33466324	CpG: 41	378	41	283	21.7	74.9	0.79
chr9	33488906	33489138	CpG: 19	232	19	143	16.4	61.6	0.89
chr9	33492179	33492412	CpG: 17	233	17	150	14.6	64.4	0.75
chr9	33529365	33529728	CpG: 36	363	36	245	19.8	67.5	0.91
chr9	33541997	33543318	CpG: 115	1321	115	919	17.4	69.6	0.72
chr9	33618925	33619782	CpG: 63	857	63	589	14.7	68.7	0.62
chr9	33665433	33665681	CpG: 18	248	18	151	14.5	60.9	0.82
chr9	33695385	33695963	CpG: 71	578	71	421	24.6	72.8	0.93
chr9	33769104	33769745	CpG: 57	641	57	457	17.8	71.3	0.73
chr9	33782004	33782270	CpG: 19	266	19	160	14.3	60.2	0.80
chr9	33835388	33836890	CpG: 155	1502	155	1092	20.6	72.7	0.78
chr9	34023092	34023330	CpG: 16	238	16	139	13.4	58.4	0.80
chr9	34055639	34055863	CpG: 17	224	17	128	15.2	57.1	0.94
chr9	34057375	34057867	CpG: 47	492	47	373	19.1	75.8	0.67
chr9	34067209	34068185	CpG: 80	976	80	626	16.4	64.1	0.80
chr9	34069285	34069511	CpG: 19	226	19	135	16.8	59.7	0.97
chr9	34145134	34145827	CpG: 66	693	66	455	19.0	65.7	0.88
chr9	34155808	34157059	CpG: 101	1251	101	907	16.1	72.5	0.61
chr9	34197911	34198440	CpG: 43	529	43	361	16.3	68.2	0.83
chr9	34298593	34298871	CpG: 23	278	23	172	16.5	61.9	0.87
chr9	34336840	34337506	CpG: 54	666	54	438	16.2	65.8	0.75
chr9	34347572	34348065	CpG: 53	493	53	312	21.5	63.3	1.10
chr9	34348672	34348964	CpG: 22	292	22	176	15.1	60.3	0.84
chr9	34349207	34349457	CpG: 22	250	22	153	17.6	61.2	0.96
chr9	34389262	34391391	CpG: 223	2129	223	1403	20.9	65.9	0.97
chr9	34394992	34395679	CpG: 58	687	58	475	16.9	69.1	0.73
chr9	34395893	34396102	CpG: 18	209	18	129	17.2	61.7	0.90
chr9	34398033	34398509	CpG: 31	476	31	290	13.0	60.9	0.70
chr9	34398702	34398938	CpG: 20	236	20	150	16.9	63.6	0.84
chr9	34399229	34399643	CpG: 45	414	45	297	21.7	71.7	0.86
chr9	34419329	34419574	CpG: 25	245	25	176	20.4	71.8	0.81
chr9	34457485	34457733	CpG: 20	248	20	144	16.1	58.1	0.98
chr9	34475898	34477415	CpG: 137	1517	137	1039	18.1	68.5	0.79
chr9	34541218	34541897	CpG: 93	679	93	517	27.4	76.1	0.95
chr9	34596419	34596848	CpG: 64	429	64	341	29.8	79.5	0.98
chr9	34607584	34610527	CpG: 279	2943	279	2034	19.0	69.1	0.81
chr9	34630499	34631257	CpG: 70	758	70	516	18.5	68.1	0.81
chr9	34638812	34639101	CpG: 25	289	25	188	17.3	65.1	0.83
chr9	34641416	34641688	CpG: 22	272	22	166	16.2	61.0	0.88
chr9	34642062	34642631	CpG: 53	569	53	397	18.6	69.8	0.77
chr9	34643136	34643343	CpG: 24	207	24	137	23.2	66.2	1.08
chr9	34647345	34647865	CpG: 60	520	60	394	23.1	75.8	0.80
chr9	34654896	34655160	CpG: 23	264	23	165	17.4	62.5	0.91
chr9	34655749	34656631	CpG: 88	882	88	622	20.0	70.5	0.80
chr9	34665108	34665525	CpG: 38	417	38	278	18.2	66.7	0.82
chr9	34683462	34684219	CpG: 69	757	69	528	18.2	69.7	0.75
chr9	34698932	34699206	CpG: 24	274	24	173	17.5	63.1	0.89
chr9	34720247	34720863	CpG: 56	616	56	440	18.2	71.4	0.73
chr9	34759214	34759641	CpG: 35	427	35	314	16.4	73.5	0.61
chr9	34786502	34786727	CpG: 17	225	17	133	15.1	59.1	0.87
chr9	34828604	34829251	CpG: 76	647	76	468	23.5	72.3	0.90
chr9	34841931	34842216	CpG: 23	285	23	178	16.1	62.5	0.85
chr9	34955333	34956263	CpG: 76	930	76	654	16.3	70.3	0.66
chr9	34976903	34977658	CpG: 120	755	120	614	31.8	81.3	0.97
chr9	35008740	35009421	CpG: 62	681	62	491	18.2	72.1	0.72
chr9	35090938	35092067	CpG: 133	1129	133	800	23.6	70.9	0.94
chr9	35098810	35099395	CpG: 57	585	57	391	19.5	66.8	0.87
chr9	35099980	35100254	CpG: 24	274	24	174	17.5	63.5	0.87
chr9	35115333	35115854	CpG: 48	521	48	359	18.4	68.9	0.78
chr9	35121876	35122644	CpG: 58	768	58	462	15.1	60.2	0.85
chr9	35130448	35130916	CpG: 45	468	45	342	19.2	73.1	0.78
chr9	35134892	35135637	CpG: 51	745	51	483	13.7	64.8	0.70
chr9	35150316	35150590	CpG: 24	274	24	170	17.5	62.0	0.92
chr9	35181077	35181612	CpG: 63	535	63	381	23.6	71.2	0.94
chr9	35316736	35317010	CpG: 22	274	22	167	16.1	60.9	0.88
chr9	35460561	35460797	CpG: 18	236	18	141	15.3	59.7	0.87
chr9	35478109	35478375	CpG: 18	266	18	162	13.5	60.9	0.74
chr9	35508854	35509850	CpG: 99	996	99	711	19.9	71.4	0.80
chr9	35624635	35626658	CpG: 172	2023	172	1402	17.0	69.3	0.71
chr9	35637647	35637991	CpG: 37	344	37	241	21.5	70.1	0.88
chr9	35652264	35652512	CpG: 21	248	21	147	16.9	59.3	0.98
chr9	35667414	35667935	CpG: 51	521	51	365	19.6	70.1	0.80
chr9	35678120	35679432	CpG: 114	1312	114	817	17.4	62.3	0.90
chr9	35685714	35686019	CpG: 42	305	42	225	27.5	73.8	1.01
chr9	35696302	35697029	CpG: 58	727	58	511	16.0	70.3	0.65
chr9	35710267	35711968	CpG: 139	1701	139	1191	16.3	70.0	0.67
chr9	35730267	35730539	CpG: 23	272	23	165	16.9	60.7	0.93
chr9	35752493	35753440	CpG: 89	947	89	666	18.8	70.3	0.76
chr9	35769337	35770196	CpG: 87	859	87	604	20.3	70.3	0.83
chr9	35777632	35778023	CpG: 38	391	38	287	19.4	73.4	0.74
chr9	35795123	35795359	CpG: 17	236	17	145	14.4	61.4	0.80
chr9	35811494	35811820	CpG: 23	326	23	220	14.1	67.5	0.66
chr9	35812068	35812595	CpG: 62	527	62	409	23.5	77.6	0.80
chr9	35823793	35824068	CpG: 24	275	24	170	17.5	61.8	0.92
chr9	35832760	35833059	CpG: 25	299	25	185	16.7	61.9	0.87
chr9	35835319	35835789	CpG: 54	470	54	351	23.0	74.7	0.84
chr9	35849411	35850204	CpG: 70	793	70	551	17.7	69.5	0.74
chr9	35866991	35867319	CpG: 34	328	34	234	20.7	71.3	0.83
chr9	35908697	35908963	CpG: 20	266	20	162	15.0	60.9	0.82
chr9	35927090	35927351	CpG: 20	261	20	179	15.3	68.6	0.70
chr9	35993820	35994123	CpG: 34	303	34	225	22.4	74.3	0.83
chr9	36058794	36059560	CpG: 80	766	80	536	20.9	70.0	0.86
chr9	36158195	36159237	CpG: 126	1042	126	776	24.2	74.5	0.87
chr9	36188207	36188838	CpG: 57	631	57	421	18.1	66.7	0.81
chr9	36204921	36205140	CpG: 17	219	17	132	15.5	60.3	0.87
chr9	36212879	36213545	CpG: 68	666	68	442	20.4	66.4	0.94
chr9	36244144	36244423	CpG: 24	279	24	174	17.2	62.4	0.89
chr9	36279374	36279800	CpG: 29	426	29	240	13.6	56.3	0.87
chr9	36280183	36280899	CpG: 76	716	76	495	21.2	69.1	0.89
chr9	36286972	36287184	CpG: 17	212	17	131	16.0	61.8	0.85
chr9	36296746	36297026	CpG: 23	280	23	170	16.4	60.7	0.90
chr9	36305418	36305655	CpG: 17	237	17	139	14.3	58.6	0.85
chr9	36331331	36331616	CpG: 25	285	25	179	17.5	62.8	0.90
chr9	36422227	36423303	CpG: 143	1076	143	803	26.6	74.6	0.99
chr9	36445609	36445919	CpG: 27	310	27	189	17.4	61.0	0.95
chr9	36457672	36457908	CpG: 20	236	20	144	16.9	61.0	0.93
chr9	36509823	36510799	CpG: 143	976	143	787	29.3	80.6	0.91
chr9	36515263	36515549	CpG: 20	286	20	172	14.0	60.1	0.78
chr9	36538410	36538680	CpG: 20	270	20	165	14.8	61.1	0.80
chr9	36595439	36596067	CpG: 65	628	65	407	20.7	64.8	1.00
chr9	36596298	36596536	CpG: 18	238	18	144	15.1	60.5	0.85
chr9	36606755	36607147	CpG: 31	392	31	229	15.8	58.4	0.94
chr9	36762289	36762537	CpG: 29	248	29	181	23.4	73.0	0.88
chr9	36905556	36905817	CpG: 20	261	20	163	15.3	62.5	0.79
chr9	37009717	37010631	CpG: 113	914	113	643	24.7	70.4	1.02
chr9	37026201	37026669	CpG: 55	468	55	334	23.5	71.4	0.94
chr9	37049212	37049515	CpG: 22	303	22	184	14.5	60.7	0.79
chr9	37049942	37051734	CpG: 163	1792	163	1236	18.2	69.0	0.77
chr9	37053652	37054226	CpG: 43	574	43	358	15.0	62.4	0.77
chr9	37057854	37062060	CpG: 279	4206	279	2540	13.3	60.4	0.73
chr9	37103184	37104127	CpG: 82	943	82	602	17.4	63.8	0.85
chr9	37105304	37105541	CpG: 19	237	19	139	16.0	58.6	0.95
chr9	37143795	37144731	CpG: 89	936	89	613	19.0	65.5	0.89
chr9	37174781	37174998	CpG: 17	217	17	129	15.7	59.4	0.91
chr9	37446263	37446610	CpG: 44	347	44	253	25.4	72.9	0.96
chr9	37488511	37490583	CpG: 149	2072	149	1264	14.4	61.0	0.78
chr9	37509518	37509816	CpG: 36	298	36	209	24.2	70.1	1.01
chr9	37568399	37568669	CpG: 21	270	21	168	15.6	62.2	0.82
chr9	37599627	37600279	CpG: 80	652	80	475	24.5	72.9	0.93
chr9	37615684	37616643	CpG: 83	959	83	592	17.3	61.7	0.93
chr9	37622840	37623056	CpG: 17	216	17	130	15.7	60.2	0.89
chr9	37674423	37675136	CpG: 91	713	91	539	25.5	75.6	0.89
chr9	37777369	37777663	CpG: 30	294	30	204	20.4	69.4	0.87
chr9	37808483	37809079	CpG: 63	596	63	390	21.1	65.4	1.00
chr9	37810808	37811343	CpG: 60	535	60	356	22.4	66.5	1.02
chr9	37824299	37825297	CpG: 113	998	113	726	22.6	72.7	0.86
chr9	37927543	37928388	CpG: 92	845	92	615	21.8	72.8	0.82
chr9	38091191	38093560	CpG: 288	2369	288	1727	24.3	72.9	0.91
chr9	38093718	38093925	CpG: 14	207	14	121	13.5	58.5	0.81
chr9	38099131	38099648	CpG: 43	517	43	379	16.6	73.3	0.62
chr9	38119790	38120068	CpG: 25	278	25	176	18.0	63.3	0.91
chr9	38265158	38266866	CpG: 170	1708	170	1331	19.9	77.9	0.66
chr9	38347986	38349283	CpG: 110	1297	110	964	17.0	74.3	0.61
chr9	38349667	38349941	CpG: 23	274	23	170	16.8	62.0	0.88
chr9	38401613	38402101	CpG: 40	488	40	358	16.4	73.4	0.61
chr9	38416692	38417370	CpG: 57	678	57	472	16.8	69.6	0.69
chr9	38448130	38448908	CpG: 116	778	116	590	29.8	75.8	1.04
chr9	38502462	38502715	CpG: 20	253	20	174	15.8	68.8	0.68
chr9	38511810	38512492	CpG: 63	682	63	482	18.5	70.7	0.75
chr9	38550869	38551157	CpG: 38	288	38	210	26.4	72.9	0.99
chr9	38644113	38646836	CpG: 228	2723	228	1876	16.7	68.9	0.71
chr9	38670872	38671109	CpG: 18	237	18	141	15.2	59.5	0.89
chr9	38712763	38713022	CpG: 21	259	21	159	16.2	61.4	0.86
chr9	38713187	38713435	CpG: 19	248	19	147	15.3	59.3	0.89
chr9	38759947	38760186	CpG: 20	239	20	146	16.7	61.1	0.92
chr9	38769369	38769772	CpG: 26	403	26	240	12.9	59.6	0.75
chr9	38792165	38792438	CpG: 22	273	22	172	16.1	63.0	0.82
chr9	38815882	38816160	CpG: 25	278	25	174	18.0	62.6	0.93
chr9	38842704	38842983	CpG: 23	279	23	172	16.5	61.6	0.88
chr9	38857941	38858228	CpG: 25	287	25	182	17.4	63.4	0.88
chr9	38869002	38869283	CpG: 24	281	24	174	17.1	61.9	0.91
chr9	38882671	38882951	CpG: 25	280	25	173	17.9	61.8	0.95
chr9	38945094	38945373	CpG: 20	279	20	167	14.3	59.9	0.81
chr9	38961773	38961975	CpG: 16	202	16	119	15.8	58.9	0.93
chr9	38962959	38963216	CpG: 20	257	20	153	15.6	59.5	0.91
chr9	38993549	38993830	CpG: 23	281	23	174	16.4	61.9	0.87
chr9	39020965	39021195	CpG: 18	230	18	138	15.7	60.0	0.88
chr9	39034063	39034332	CpG: 22	269	22	163	16.4	60.6	0.90
chr9	39046293	39046533	CpG: 17	240	17	141	14.2	58.8	0.84
chr9	39088215	39088455	CpG: 20	240	20	148	16.7	61.7	0.90
chr9	39092087	39092404	CpG: 42	317	42	240	26.5	75.7	0.93
chr9	39135473	39135685	CpG: 16	212	16	126	15.1	59.4	0.88
chr9	39146259	39146545	CpG: 43	286	43	216	30.1	75.5	1.06
chr9	39159854	39160081	CpG: 16	227	16	133	14.1	58.6	0.83
chr9	39301497	39302110	CpG: 73	613	73	429	23.8	70.0	0.98
chr9	39309041	39309254	CpG: 17	213	17	128	16.0	60.1	0.92
chr9	39310021	39310299	CpG: 19	278	19	171	13.7	61.5	0.73
chr9	39319856	39320134	CpG: 25	278	25	174	18.0	62.6	0.93
chr9	39323568	39323842	CpG: 22	274	22	170	16.1	62.0	0.84
chr9	39351986	39352267	CpG: 24	281	24	173	17.1	61.6	0.91
chr9	39363297	39363572	CpG: 24	275	24	171	17.5	62.2	0.91
chr9	39382367	39382635	CpG: 18	268	18	158	13.4	59.0	0.78
chr9	39477695	39478125	CpG: 39	430	39	296	18.1	68.8	0.77
chr9	39540041	39540290	CpG: 20	249	20	151	16.1	60.6	0.90
chr9	39541802	39542079	CpG: 24	277	24	171	17.3	61.7	0.92
chr9	39547175	39547657	CpG: 37	482	37	331	15.4	68.7	0.65
chr9	39585469	39585701	CpG: 20	232	20	140	17.2	60.3	0.96
chr9	39593218	39593465	CpG: 18	247	18	146	14.6	59.1	0.85
chr9	39604456	39604692	CpG: 19	236	19	141	16.1	59.7	0.93
chr9	39606814	39607130	CpG: 25	316	25	185	15.8	58.5	0.94
chr9	39617621	39617844	CpG: 20	223	20	153	17.9	68.6	0.79
chr9	39650325	39650599	CpG: 24	274	24	170	17.5	62.0	0.92
chr9	39679429	39679641	CpG: 17	212	17	125	16.0	59.0	0.94
chr9	39683490	39683707	CpG: 17	217	17	131	15.7	60.4	0.88
chr9	39685150	39685420	CpG: 21	270	21	164	15.6	60.7	0.85
chr9	39685708	39685980	CpG: 24	272	24	172	17.6	63.2	0.89
chr9	39693985	39694262	CpG: 23	277	23	170	16.6	61.4	0.89
chr9	39711524	39711798	CpG: 25	274	25	172	18.2	62.8	0.93
chr9	39749161	39749385	CpG: 18	224	18	135	16.1	60.3	0.91
chr9	39805535	39806304	CpG: 56	769	56	473	14.6	61.5	0.77
chr9	39823584	39824049	CpG: 39	465	39	300	16.8	64.5	0.82
chr9	39839121	39839394	CpG: 21	273	21	164	15.4	60.1	0.87
chr9	39888163	39888444	CpG: 30	281	30	190	21.4	67.6	0.95
chr9	39908241	39908519	CpG: 26	278	26	181	18.7	65.1	0.90
chr9	40010621	40010902	CpG: 22	281	22	173	15.7	61.6	0.84
chr9	40039638	40039874	CpG: 21	236	21	144	17.8	61.0	0.98
chr9	40078277	40078554	CpG: 23	277	23	169	16.6	61.0	0.90
chr9	40113056	40113294	CpG: 18	238	18	144	15.1	60.5	0.85
chr9	40120138	40121965	CpG: 142	1827	142	1180	15.5	64.6	0.75
chr9	40122152	40122379	CpG: 18	227	18	137	15.9	60.4	0.87
chr9	40122788	40123124	CpG: 30	336	30	229	17.9	68.2	0.77
chr9	40125682	40126223	CpG: 40	541	40	351	14.8	64.9	0.70
chr9	40236882	40238611	CpG: 134	1729	134	1162	15.5	67.2	0.69
chr9	40363419	40363676	CpG: 32	257	32	187	24.9	72.8	0.97
chr9	40403811	40404047	CpG: 18	236	18	142	15.3	60.2	0.86
chr9	40426423	40426653	CpG: 19	230	19	138	16.5	60.0	0.93
chr9	40475777	40476335	CpG: 45	558	45	403	16.1	72.2	0.62
chr9	40565645	40566225	CpG: 122	580	122	477	42.1	82.2	1.36
chr9	40599089	40599313	CpG: 16	224	16	130	14.3	58.0	0.85
chr9	40628593	40629756	CpG: 163	1163	163	825	28.0	70.9	1.26
chr9	40653496	40654971	CpG: 113	1475	113	966	15.3	65.5	0.72
chr9	40716166	40716455	CpG: 31	289	31	198	21.5	68.5	0.93
chr9	40760157	40760413	CpG: 21	256	21	179	16.4	69.9	0.67
chr9	40762643	40763148	CpG: 42	505	42	358	16.6	70.9	0.67
chr9	40764427	40765515	CpG: 89	1088	89	739	16.4	67.9	0.71
chr9	40793696	40793940	CpG: 21	244	21	179	17.2	73.4	0.65
chr9	40800044	40801460	CpG: 123	1416	123	1005	17.4	71.0	0.69
chr9	40860253	40860617	CpG: 33	364	33	237	18.1	65.1	0.88
chr9	40877893	40878662	CpG: 55	769	55	473	14.3	61.5	0.76
chr9	40936188	40936462	CpG: 21	274	21	168	15.3	61.3	0.83
chr9	40973263	40973541	CpG: 24	278	24	175	17.3	62.9	0.88
chr9	40975048	40975321	CpG: 24	273	24	171	17.6	62.6	0.91
chr9	41069796	41070022	CpG: 20	226	20	155	17.7	68.6	0.78
chr9	41082311	41082547	CpG: 19	236	19	141	16.1	59.7	0.94
chr9	41100397	41100678	CpG: 24	281	24	175	17.1	62.3	0.90
chr9	41101711	41101946	CpG: 17	235	17	141	14.5	60.0	0.82
chr9	41139624	41139890	CpG: 19	266	19	163	14.3	61.3	0.78
chr9	41141703	41142185	CpG: 38	482	38	334	15.8	69.3	0.66
chr9	41148469	41148709	CpG: 17	240	17	141	14.2	58.8	0.85
chr9	41227590	41227867	CpG: 24	277	24	172	17.3	62.1	0.91
chr9	41233792	41234060	CpG: 18	268	18	158	13.4	59.0	0.78
chr9	41292256	41292530	CpG: 21	274	21	169	15.3	61.7	0.82
chr9	41295957	41296235	CpG: 24	278	24	175	17.3	62.9	0.88
chr9	41306908	41307304	CpG: 27	396	27	231	13.6	58.3	0.80
chr9	41314037	41314650	CpG: 72	613	72	429	23.5	70.0	0.97
chr9	41326627	41326846	CpG: 15	219	15	127	13.7	58.0	0.83
chr9	41340246	41340505	CpG: 36	259	36	198	27.8	76.4	0.96
chr9	41394526	41394843	CpG: 43	317	43	241	27.1	76.0	0.94
chr9	41395968	41396197	CpG: 17	229	17	134	14.8	58.5	0.88
chr9	41514157	41514476	CpG: 30	319	30	207	18.8	64.9	0.89
chr9	41612826	41613852	CpG: 80	1026	80	647	15.6	63.1	0.79
chr9	41617573	41617854	CpG: 22	281	22	174	15.7	61.9	0.84
chr9	41629781	41630081	CpG: 29	300	29	209	19.3	69.7	0.81
chr9	41635591	41635885	CpG: 33	294	33	216	22.4	73.5	0.85
chr9	41642071	41642512	CpG: 30	441	30	275	13.6	62.4	0.71
chr9	41642808	41643011	CpG: 16	203	16	118	15.8	58.1	0.93
chr9	41645083	41645317	CpG: 17	234	17	141	14.5	60.3	0.85
chr9	41646568	41647064	CpG: 39	496	39	319	15.7	64.3	0.77
chr9	41647991	41648958	CpG: 70	967	70	621	14.5	64.2	0.70
chr9	41650402	41650949	CpG: 54	547	54	371	19.7	67.8	0.86
chr9	41699433	41699684	CpG: 22	251	22	155	17.5	61.8	0.94
chr9	41738015	41738251	CpG: 19	236	19	143	16.1	60.6	0.90
chr9	41893100	41893377	CpG: 21	277	21	168	15.2	60.6	0.83
chr9	41927868	41928136	CpG: 19	268	19	162	14.2	60.4	0.79
chr9	41934827	41936606	CpG: 142	1779	142	1160	16.0	65.2	0.75
chr9	41936968	41937312	CpG: 24	344	24	206	14.0	59.9	0.78
chr9	41937604	41937940	CpG: 28	336	28	227	16.7	67.6	0.73
chr9	41940265	41941029	CpG: 54	764	54	487	14.1	63.7	0.70
chr9	42020510	42021888	CpG: 116	1378	116	976	16.8	70.8	0.67
chr9	42027972	42028216	CpG: 22	244	22	177	18.0	72.5	0.70
chr9	42056394	42057482	CpG: 89	1088	89	740	16.4	68.0	0.71
chr9	42058732	42059263	CpG: 44	531	44	367	16.6	69.1	0.70
chr9	42061509	42061774	CpG: 22	265	22	187	16.6	70.6	0.67
chr9	42105458	42105747	CpG: 30	289	30	196	20.8	67.8	0.92
chr9	42166636	42167859	CpG: 100	1223	100	815	16.4	66.6	0.75
chr9	42170017	42171464	CpG: 108	1447	108	917	14.9	63.4	0.75
chr9	42220069	42221124	CpG: 104	1055	104	748	19.7	70.9	0.78
chr9	42302259	42303142	CpG: 76	883	76	582	17.2	65.9	0.80
chr9	42362131	42362405	CpG: 23	274	23	170	16.8	62.0	0.88
chr9	42419276	42419501	CpG: 18	225	18	137	16.0	60.9	0.87
chr9	42529646	42530090	CpG: 34	444	34	293	15.3	66.0	0.71
chr9	42646538	42647999	CpG: 184	1461	184	999	25.2	68.4	1.21
chr9	42677284	42677508	CpG: 17	224	17	131	15.2	58.5	0.89
chr9	42710388	42710807	CpG: 81	419	81	334	38.7	79.7	1.30
chr9	42821084	42821641	CpG: 44	557	44	401	15.8	72.0	0.61
chr9	42870720	42871025	CpG: 25	305	25	185	16.4	60.7	0.90
chr9	42893404	42893640	CpG: 19	236	19	141	16.1	59.7	0.92
chr9	42933821	42934078	CpG: 32	257	32	186	24.9	72.4	0.97
chr9	43058891	43060535	CpG: 122	1644	122	1098	14.8	66.8	0.67
chr9	43145308	43145559	CpG: 22	251	22	155	17.5	61.8	0.94
chr9	43194116	43194663	CpG: 53	547	53	368	19.4	67.3	0.86
chr9	43205422	43205734	CpG: 32	312	32	231	20.5	74.0	0.77
chr9	43213874	43214174	CpG: 27	300	27	206	18.0	68.7	0.78
chr9	43229778	43230804	CpG: 80	1026	80	649	15.6	63.3	0.78
chr9	43329130	43329449	CpG: 30	319	30	207	18.8	64.9	0.89
chr9	43449214	43449531	CpG: 43	317	43	240	27.1	75.7	0.95
chr9	43503562	43503873	CpG: 42	311	42	232	27.0	74.6	0.97
chr9	43517177	43517396	CpG: 15	219	15	127	13.7	58.0	0.83
chr9	43679656	43680260	CpG: 71	604	71	426	23.5	70.5	0.96
chr9	43832425	43832661	CpG: 16	236	16	138	13.6	58.5	0.82
chr9	43838926	43839408	CpG: 37	482	37	331	15.4	68.7	0.65
chr9	43841226	43841492	CpG: 19	266	19	161	14.3	60.5	0.80
chr9	43879133	43879368	CpG: 17	235	17	140	14.5	59.6	0.83
chr9	43880387	43880668	CpG: 23	281	23	175	16.4	62.3	0.86
chr9	43898498	43898734	CpG: 19	236	19	141	16.1	59.7	0.94
chr9	43910928	43911246	CpG: 26	318	26	218	16.4	68.6	0.72
chr9	44005733	44005968	CpG: 21	235	21	146	17.9	62.1	0.94
chr9	44007510	44007788	CpG: 25	278	25	174	18.0	62.6	0.93
chr9	44045678	44045952	CpG: 21	274	21	168	15.3	61.3	0.83
chr9	44103486	44103926	CpG: 33	440	33	271	15.0	61.6	0.79
chr9	44121695	44121975	CpG: 30	280	30	188	21.4	67.1	0.97
chr9	44152821	44153038	CpG: 17	217	17	129	15.7	59.4	0.90
chr9	44189429	44189973	CpG: 40	544	40	348	14.7	64.0	0.76
chr9	44246830	44247047	CpG: 17	217	17	129	15.7	59.4	0.90
chr9	44277893	44278173	CpG: 30	280	30	188	21.4	67.1	0.97
chr9	44296051	44296419	CpG: 30	368	30	228	16.3	62.0	0.85
chr9	44403771	44405407	CpG: 121	1636	121	1103	14.8	67.4	0.65
chr9	44527117	44527374	CpG: 31	257	31	187	24.1	72.8	0.93
chr9	44567571	44567807	CpG: 18	236	18	142	15.3	60.2	0.87
chr9	44590169	44590399	CpG: 18	230	18	138	15.7	60.0	0.88
chr9	44640199	44640480	CpG: 23	281	23	173	16.4	61.6	0.88
chr9	44794960	44795538	CpG: 121	578	121	480	41.9	83.0	1.34
chr9	44864065	44864923	CpG: 117	858	117	601	27.3	70.0	1.23
chr9	44893574	44895477	CpG: 169	1903	169	1174	17.8	61.7	1.00
chr9	47592029	47592275	CpG: 21	246	21	176	17.1	71.5	0.67
chr9	47694598	47695498	CpG: 71	900	71	595	15.8	66.1	0.73
chr9	47737505	47737765	CpG: 22	260	22	184	16.9	70.8	0.68
chr9	47740004	47740671	CpG: 53	667	53	458	15.9	68.7	0.69
chr9	47741825	47742869	CpG: 81	1044	81	707	15.5	67.7	0.68
chr9	47770936	47771180	CpG: 19	244	19	176	15.6	72.1	0.61
chr9	47777204	47778580	CpG: 109	1376	109	967	15.8	70.3	0.64
chr9	47789972	47790182	CpG: 15	210	15	116	14.3	55.2	0.95
chr9	47806834	47807100	CpG: 20	266	20	163	15.0	61.3	0.81
chr9	47850740	47851288	CpG: 39	548	39	347	14.2	63.3	0.71
chr9	47853842	47857037	CpG: 223	3195	223	2026	14.0	63.4	0.69
chr9	48141435	48141982	CpG: 50	547	50	364	18.3	66.5	0.83
chr9	48143414	48144404	CpG: 74	990	74	639	14.9	64.5	0.72
chr9	48145281	48145839	CpG: 47	558	47	366	16.8	65.6	0.78
chr9	48147608	48148029	CpG: 32	421	32	273	15.2	64.8	0.72
chr9	48156580	48156983	CpG: 31	403	31	310	15.4	76.9	0.63
chr9	48225236	48226007	CpG: 57	771	57	482	14.8	62.5	0.76
chr9	48323857	48324397	CpG: 47	540	47	343	17.4	63.5	0.89
chr9	48324556	48324883	CpG: 24	327	24	215	14.7	65.7	0.70
chr9	48340397	48340704	CpG: 28	307	28	213	18.2	69.4	0.77
chr9	48348282	48348513	CpG: 19	231	19	166	16.5	71.9	0.64
chr9	48357078	48357400	CpG: 29	322	29	213	18.0	66.1	0.82
chr9	48359334	48359833	CpG: 40	499	40	318	16.0	63.7	0.79
chr9	48360748	48361233	CpG: 40	485	40	319	16.5	65.8	0.76
chr9	48363986	48364201	CpG: 16	215	16	123	14.9	57.2	0.92
chr9	48822499	48823361	CpG: 65	862	65	569	15.1	66.0	0.69
chr9	76769971	76770327	CpG: 33	356	33	255	18.5	71.6	0.76
chr9	76888515	76889012	CpG: 43	497	43	365	17.3	73.4	0.64
chr9	76917788	76918566	CpG: 70	778	70	529	18.0	68.0	0.81
chr9	76922244	76922503	CpG: 25	259	25	186	19.3	71.8	0.75
chr9	76968364	76968740	CpG: 29	376	29	265	15.4	70.5	0.62
chr9	76972604	76973521	CpG: 102	917	102	657	22.2	71.6	0.87
chr9	76974647	76974978	CpG: 24	331	24	215	14.5	65.0	0.69
chr9	77013396	77013671	CpG: 21	275	21	168	15.3	61.1	0.82
chr9	77032202	77033750	CpG: 118	1548	118	1002	15.2	64.7	0.73
chr9	77035490	77037022	CpG: 110	1532	110	958	14.4	62.5	0.74
chr9	77087962	77089052	CpG: 106	1090	106	770	19.4	70.6	0.78
chr9	77171309	77172192	CpG: 76	883	76	581	17.2	65.8	0.80
chr9	77231190	77231464	CpG: 20	274	20	167	14.6	60.9	0.80
chr9	77286906	77287180	CpG: 20	274	20	167	14.6	60.9	0.80
chr9	77394412	77394856	CpG: 34	444	34	292	15.3	65.8	0.72
chr9	77511067	77513266	CpG: 294	2199	294	1528	26.7	69.5	1.24
chr9	77542576	77542800	CpG: 16	224	16	130	14.3	58.0	0.85
chr9	77579898	77580395	CpG: 95	497	95	400	38.2	80.5	1.28
chr9	77668496	77669054	CpG: 45	558	45	403	16.1	72.2	0.62
chr9	77715094	77715399	CpG: 22	305	22	181	14.4	59.3	0.83
chr9	77737862	77738098	CpG: 19	236	19	143	16.1	60.6	0.90
chr9	77778229	77778486	CpG: 32	257	32	187	24.9	72.8	0.96
chr9	77922114	77923843	CpG: 135	1729	135	1164	15.6	67.3	0.69
chr9	78033934	78035087	CpG: 75	1153	75	734	13.0	63.7	0.64
chr9	78037480	78037749	CpG: 26	269	26	188	19.3	69.9	0.79
chr9	78038157	78038384	CpG: 18	227	18	138	15.9	60.8	0.86
chr9	78038571	78040585	CpG: 158	2014	158	1305	15.7	64.8	0.75
chr9	78047254	78047522	CpG: 20	268	20	163	14.9	60.8	0.82
chr9	78082018	78082295	CpG: 24	277	24	171	17.3	61.7	0.92
chr9	78153067	78153348	CpG: 22	281	22	173	15.7	61.6	0.84
chr9	78250775	78251053	CpG: 26	278	26	180	18.7	64.7	0.91
chr9	78270856	78271137	CpG: 31	281	31	190	22.1	67.6	0.98
chr9	78301989	78302206	CpG: 18	217	18	130	16.6	59.9	0.94
chr9	78336455	78336819	CpG: 32	364	32	235	17.6	64.6	0.87
chr9	78354083	78354852	CpG: 56	769	56	475	14.6	61.8	0.76
chr9	78411048	78411272	CpG: 18	224	18	136	16.1	60.7	0.90
chr9	78473829	78474101	CpG: 24	272	24	172	17.6	63.2	0.89
chr9	78474389	78474659	CpG: 21	270	21	164	15.6	60.7	0.85
chr9	78476099	78476316	CpG: 17	217	17	131	15.7	60.4	0.88
chr9	78480168	78480380	CpG: 17	212	17	125	16.0	59.0	0.94
chr9	78509200	78509474	CpG: 24	274	24	170	17.5	62.0	0.92
chr9	78544688	78544911	CpG: 20	223	20	152	17.9	68.2	0.80
chr9	78557192	78557428	CpG: 17	236	17	141	14.4	59.7	0.83
chr9	78564945	78565181	CpG: 21	236	21	143	17.8	60.6	0.99
chr9	78598742	78599020	CpG: 25	278	25	174	18.0	62.6	0.93
chr9	78603292	78603774	CpG: 37	482	37	335	15.4	69.5	0.64
chr9	78608871	78609148	CpG: 24	277	24	171	17.3	61.7	0.92
chr9	78610657	78610898	CpG: 18	241	18	145	14.9	60.2	0.85
chr9	78672752	78673192	CpG: 40	440	40	298	18.2	67.7	0.80
chr9	78751174	78751442	CpG: 18	268	18	157	13.4	58.6	0.79
chr9	78781216	78781497	CpG: 24	281	24	173	17.1	61.6	0.91
chr9	78809620	78809894	CpG: 22	274	22	169	16.1	61.7	0.85
chr9	78822825	78823104	CpG: 20	279	20	170	14.3	60.9	0.78
chr9	78823869	78824081	CpG: 17	212	17	128	16.0	60.4	0.91
chr9	78831151	78831648	CpG: 65	497	65	365	26.2	73.4	0.99
chr9	78855598	78855864	CpG: 22	266	22	165	16.5	62.0	0.87
chr9	78992870	78993089	CpG: 15	219	15	128	13.7	58.4	0.82
chr9	79006444	79006703	CpG: 40	259	40	201	30.9	77.6	1.04
chr9	79060730	79061047	CpG: 39	317	39	237	24.6	74.8	0.88
chr9	79062156	79062385	CpG: 17	229	17	136	14.8	59.4	0.86
chr9	79118883	79119168	CpG: 24	285	24	171	16.8	60.0	0.94
chr9	79159407	79159688	CpG: 24	281	24	175	17.1	62.3	0.89
chr9	79190013	79190270	CpG: 20	257	20	153	15.6	59.5	0.91
chr9	79191258	79191460	CpG: 16	202	16	119	15.8	58.9	0.93
chr9	79207871	79208150	CpG: 20	279	20	167	14.3	59.9	0.81
chr9	79281614	79281886	CpG: 23	272	23	167	16.9	61.4	0.91
chr9	79295267	79295548	CpG: 24	281	24	174	17.1	61.9	0.91
chr9	79306339	79306626	CpG: 24	287	24	180	16.7	62.7	0.86
chr9	79321605	79321884	CpG: 22	279	22	171	15.8	61.3	0.85
chr9	79373586	79373857	CpG: 26	271	26	177	19.2	65.3	0.90
chr9	79471365	79472391	CpG: 80	1026	80	649	15.6	63.3	0.78
chr9	79476117	79476398	CpG: 23	281	23	175	16.4	62.3	0.86
chr9	79488337	79488643	CpG: 29	306	29	211	19.0	69.0	0.81
chr9	79494158	79494450	CpG: 31	292	31	213	21.2	72.9	0.81
chr9	79500708	79501095	CpG: 28	387	28	243	14.5	62.8	0.74
chr9	79501391	79501594	CpG: 16	203	16	118	15.8	58.1	0.93
chr9	79502986	79503275	CpG: 25	289	25	191	17.3	66.1	0.79
chr9	79505160	79505656	CpG: 38	496	38	318	15.3	64.1	0.75
chr9	79506602	79507569	CpG: 74	967	74	623	15.3	64.4	0.74
chr9	79509025	79509572	CpG: 54	547	54	370	19.7	67.6	0.86
chr9	79558137	79558388	CpG: 22	251	22	155	17.5	61.8	0.94
chr9	79581456	79581734	CpG: 27	278	27	180	19.4	64.7	0.94
chr9	79640711	79642440	CpG: 137	1729	137	1165	15.8	67.4	0.70
chr9	79767648	79767905	CpG: 34	257	34	190	26.5	73.9	0.99
chr9	79787042	79787275	CpG: 19	233	19	139	16.3	59.7	0.92
chr9	79808140	79808376	CpG: 19	236	19	143	16.1	60.6	0.90
chr9	79830846	79831151	CpG: 21	305	21	180	13.8	59.0	0.81
chr9	79877189	79877747	CpG: 46	558	46	404	16.5	72.4	0.63
chr9	79965832	79966406	CpG: 115	574	115	467	40.1	81.4	1.32
chr9	80001749	80001973	CpG: 16	224	16	130	14.3	58.0	0.85
chr9	80031286	80033475	CpG: 300	2189	300	1539	27.4	70.3	1.25
chr9	80056998	80058534	CpG: 117	1536	117	1008	15.2	65.6	0.72
chr9	80119643	80119932	CpG: 30	289	30	196	20.8	67.8	0.92
chr9	80163828	80164084	CpG: 22	256	22	180	17.2	70.3	0.70
chr9	80166312	80166843	CpG: 44	531	44	369	16.6	69.5	0.70
chr9	80168094	80169182	CpG: 88	1088	88	739	16.2	67.9	0.70
chr9	80185370	80185614	CpG: 22	244	22	180	18.0	73.8	0.67
chr9	80191694	80192983	CpG: 114	1289	114	920	17.7	71.4	0.69
chr9	80266747	80267516	CpG: 56	769	56	475	14.6	61.8	0.76
chr9	80343215	80344682	CpG: 138	1467	138	1056	18.8	72.0	0.73
chr9	80350747	80350991	CpG: 22	244	22	180	18.0	73.8	0.67
chr9	80367184	80368272	CpG: 89	1088	89	740	16.4	68.0	0.71
chr9	80369523	80370054	CpG: 45	531	45	370	16.9	69.7	0.71
chr9	80372276	80372541	CpG: 23	265	23	188	17.4	70.9	0.69
chr9	80416273	80416562	CpG: 30	289	30	196	20.8	67.8	0.92
chr9	80476659	80477882	CpG: 99	1223	99	813	16.2	66.5	0.74
chr9	80480041	80481488	CpG: 109	1447	109	919	15.1	63.5	0.75
chr9	80497313	80497670	CpG: 25	357	25	226	14.0	63.3	0.70
chr9	80530239	80531294	CpG: 106	1055	106	753	20.1	71.4	0.79
chr9	80653240	80653503	CpG: 22	263	22	162	16.7	61.6	0.89
chr9	80790566	80790955	CpG: 35	389	35	292	18.0	75.1	0.64
chr9	80878300	80879539	CpG: 136	1239	136	896	22.0	72.3	0.84
chr9	80953401	80954100	CpG: 68	699	68	462	19.5	66.1	0.89
chr9	81134448	81134768	CpG: 28	320	28	195	17.5	60.9	0.96
chr9	81187032	81187765	CpG: 71	733	71	475	19.4	64.8	0.93
chr9	81209276	81209806	CpG: 68	530	68	387	25.7	73.0	0.96
chr9	81240332	81240730	CpG: 31	398	31	271	15.6	68.1	0.68
chr9	81261500	81261885	CpG: 29	385	29	225	15.1	58.4	0.90
chr9	81284672	81284961	CpG: 20	289	20	172	13.8	59.5	0.80
chr9	81292530	81292762	CpG: 17	232	17	136	14.7	58.6	0.88
chr9	81294533	81295826	CpG: 112	1293	112	857	17.3	66.3	0.80
chr9	81324680	81324942	CpG: 26	262	26	166	19.8	63.4	1.00
chr9	81341599	81342432	CpG: 105	833	105	604	25.2	72.5	0.98
chr9	81388882	81389378	CpG: 56	496	56	365	22.6	73.6	0.84
chr9	81415921	81416131	CpG: 19	210	19	132	18.1	62.9	0.92
chr9	81491153	81492409	CpG: 139	1256	139	906	22.1	72.1	0.86
chr9	81578623	81579148	CpG: 43	525	43	348	16.4	66.3	0.75
chr9	81643879	81644103	CpG: 20	224	20	139	17.9	62.1	0.93
chr9	81682588	81683875	CpG: 147	1287	147	894	22.8	69.5	0.95
chr9	81823463	81823753	CpG: 24	290	24	182	16.6	62.8	0.85
chr9	81838509	81839786	CpG: 148	1277	148	933	23.2	73.1	0.88
chr9	81926252	81926799	CpG: 86	547	86	406	31.4	74.2	1.14
chr9	81927666	81928038	CpG: 30	372	30	232	16.1	62.4	0.84
chr9	81976988	81977257	CpG: 21	269	21	161	15.6	59.9	0.88
chr9	82204119	82204402	CpG: 24	283	24	164	17.0	58.0	1.02
chr9	82210716	82211406	CpG: 52	690	52	477	15.1	69.1	0.64
chr9	82425621	82426196	CpG: 70	575	70	396	24.3	68.9	1.04
chr9	82426809	82427255	CpG: 34	446	34	263	15.2	59.0	0.88
chr9	82440943	82441213	CpG: 20	270	20	164	14.8	60.7	0.81
chr9	82579232	82581086	CpG: 178	1854	178	1192	19.2	64.3	0.93
chr9	82585702	82587352	CpG: 132	1650	132	1066	16.0	64.6	0.78
chr9	82835219	82835494	CpG: 25	275	25	173	18.2	62.9	0.93
chr9	83066232	83066506	CpG: 23	274	23	170	16.8	62.0	0.88
chr9	83123232	83123512	CpG: 23	280	23	174	16.4	62.1	0.86
chr9	83365914	83366188	CpG: 25	274	25	172	18.2	62.8	0.94
chr9	83477946	83478164	CpG: 16	218	16	131	14.7	60.1	0.83
chr9	83597043	83597627	CpG: 65	584	65	404	22.3	69.2	0.95
chr9	83775799	83776073	CpG: 23	274	23	167	16.8	60.9	0.92
chr9	83918581	83920206	CpG: 148	1625	148	1133	18.2	69.7	0.75
chr9	83951374	83951575	CpG: 16	201	16	117	15.9	58.2	0.98
chr9	84060683	84062113	CpG: 130	1430	130	951	18.2	66.5	0.82
chr9	84062813	84063125	CpG: 22	312	22	172	14.1	55.1	0.94
chr9	84080218	84080499	CpG: 24	281	24	175	17.1	62.3	0.90
chr9	84144678	84144942	CpG: 23	264	23	168	17.4	63.6	0.87
chr9	84300154	84300816	CpG: 71	662	71	459	21.5	69.3	0.89
chr9	84310849	84311095	CpG: 18	246	18	140	14.6	56.9	0.92
chr9	84369940	84370177	CpG: 18	237	18	142	15.2	59.9	0.86
chr9	84495478	84495757	CpG: 22	279	22	171	15.8	61.3	0.86
chr9	84515086	84516682	CpG: 188	1596	188	1136	23.6	71.2	0.93
chr9	84572933	84573169	CpG: 17	236	17	140	14.4	59.3	0.84
chr9	84630245	84630461	CpG: 17	216	17	121	15.7	56.0	1.03
chr9	84643379	84643615	CpG: 17	236	17	136	14.4	57.6	0.88
chr9	84894003	84894277	CpG: 23	274	23	169	16.8	61.7	0.89
chr9	85472661	85472942	CpG: 24	281	24	175	17.1	62.3	0.90
chr9	85537721	85537996	CpG: 24	275	24	170	17.5	61.8	0.92
chr9	85733079	85733345	CpG: 19	266	19	157	14.3	59.0	0.84
chr9	85780152	85780427	CpG: 21	275	21	167	15.3	60.7	0.84
chr9	86028280	86028529	CpG: 19	249	19	144	15.3	57.8	0.95
chr9	86126085	86126366	CpG: 23	281	23	174	16.4	61.9	0.87
chr9	86281002	86281276	CpG: 22	274	22	169	16.1	61.7	0.86
chr9	86309560	86309834	CpG: 25	274	25	171	18.2	62.4	0.95
chr9	86431735	86432018	CpG: 22	283	22	174	15.5	61.5	0.84
chr9	86454837	86455072	CpG: 17	235	17	141	14.5	60.0	0.81
chr9	86577773	86577991	CpG: 19	218	19	128	17.4	58.7	1.01
chr9	86650139	86650583	CpG: 43	444	43	300	19.4	67.6	0.88
chr9	86651073	86652288	CpG: 109	1215	109	793	17.9	65.3	0.86
chr9	86761551	86761786	CpG: 19	235	19	143	16.2	60.9	0.90
chr9	87005707	87006471	CpG: 61	764	61	519	16.0	67.9	0.69
chr9	87040279	87040706	CpG: 47	427	47	295	22.0	69.1	0.93
chr9	87067923	87068163	CpG: 17	240	17	143	14.2	59.6	0.81
chr9	87104759	87106024	CpG: 157	1265	157	896	24.8	70.8	0.99
chr9	87184380	87185271	CpG: 113	891	113	651	25.4	73.1	0.95
chr9	87244499	87245433	CpG: 113	934	113	672	24.2	71.9	0.93
chr9	87252467	87252700	CpG: 17	233	17	142	14.6	60.9	0.80
chr9	87532522	87532796	CpG: 23	274	23	170	16.8	62.0	0.88
chr9	87678435	87678676	CpG: 20	241	20	147	16.6	61.0	0.91
chr9	88049007	88050891	CpG: 156	1884	156	1217	16.6	64.6	0.81
chr9	88051122	88051423	CpG: 23	301	23	213	15.3	70.8	0.63
chr9	88280489	88280763	CpG: 24	274	24	171	17.5	62.4	0.91
chr9	88493376	88493650	CpG: 24	274	24	171	17.5	62.4	0.91
chr9	88550292	88551417	CpG: 114	1125	114	763	20.3	67.8	0.89
chr9	88614811	88615045	CpG: 19	234	19	142	16.2	60.7	0.90
chr9	88615558	88616212	CpG: 62	654	62	466	19.0	71.3	0.76
chr9	88679961	88680313	CpG: 31	352	31	252	17.6	71.6	0.69
chr9	88728131	88728387	CpG: 36	256	36	185	28.1	72.3	1.08
chr9	88733469	88733684	CpG: 17	215	17	132	15.8	61.4	0.85
chr9	88826619	88826820	CpG: 20	201	20	122	19.9	60.7	1.08
chr9	88902841	88903126	CpG: 23	285	23	178	16.1	62.5	0.84
chr9	89062335	89063040	CpG: 75	705	75	494	21.3	70.1	0.87
chr9	89111461	89112185	CpG: 51	724	51	489	14.1	67.5	0.62
chr9	89170511	89173350	CpG: 184	2839	184	1641	13.0	57.8	0.78
chr9	89174927	89177631	CpG: 252	2704	252	1828	18.6	67.6	0.82
chr9	89179415	89179770	CpG: 37	355	37	261	20.8	73.5	0.78
chr9	89217208	89217978	CpG: 54	770	54	518	14.0	67.3	0.62
chr9	89333720	89334978	CpG: 136	1258	136	867	21.6	68.9	0.91
chr9	89692314	89692547	CpG: 16	233	16	138	13.7	59.2	0.80
chr9	89775649	89775923	CpG: 24	274	24	171	17.5	62.4	0.91
chr9	89804509	89805764	CpG: 108	1255	108	840	17.2	66.9	0.77
chr9	89814638	89814915	CpG: 21	277	21	168	15.2	60.6	0.83
chr9	89839599	89839877	CpG: 23	278	23	172	16.5	61.9	0.87
chr9	89860238	89860625	CpG: 26	387	26	249	13.4	64.3	0.65
chr9	90187722	90189706	CpG: 260	1984	260	1492	26.2	75.2	0.93
chr9	90308066	90308337	CpG: 23	271	23	170	17.0	62.7	0.86
chr9	90392740	90393646	CpG: 98	906	98	599	21.6	66.1	0.99
chr9	90436954	90437155	CpG: 17	201	17	120	16.9	59.7	0.96
chr9	90453424	90453636	CpG: 15	212	15	119	14.2	56.1	0.92
chr9	90454007	90454839	CpG: 87	832	87	569	20.9	68.4	0.90
chr9	90592860	90593106	CpG: 19	246	19	145	15.4	58.9	0.92
chr9	90599065	90599496	CpG: 41	431	41	312	19.0	72.4	0.73
chr9	90894378	90894655	CpG: 24	277	24	171	17.3	61.7	0.92
chr9	91163306	91163588	CpG: 25	282	25	176	17.7	62.4	0.92
chr9	91262209	91262497	CpG: 23	288	23	174	16.0	60.4	0.88
chr9	91443923	91444200	CpG: 22	277	22	170	15.9	61.4	0.85
chr9	91597474	91597785	CpG: 26	311	26	190	16.7	61.1	0.90
chr9	91658591	91658826	CpG: 18	235	18	141	15.3	60.0	0.85
chr9	91728940	91732021	CpG: 301	3081	301	1941	19.5	63.0	0.99
chr9	91783425	91783699	CpG: 25	274	25	172	18.2	62.8	0.93
chr9	92357336	92357616	CpG: 25	280	25	173	17.9	61.8	0.95
chr9	92360608	92360844	CpG: 18	236	18	138	15.3	58.5	0.93
chr9	92378841	92379116	CpG: 20	275	20	165	14.5	60.0	0.83
chr9	92631709	92631983	CpG: 25	274	25	172	18.2	62.8	0.94
chr9	92657815	92658057	CpG: 19	242	19	148	15.7	61.2	0.85
chr9	92899339	92899582	CpG: 20	243	20	146	16.5	60.1	0.91
chr9	93167713	93167994	CpG: 23	281	23	174	16.4	61.9	0.87
chr9	93463351	93463588	CpG: 21	237	21	149	17.7	62.9	0.92
chr9	93732467	93732747	CpG: 20	280	20	170	14.3	60.7	0.78
chr9	93744172	93744418	CpG: 19	246	19	147	15.4	59.8	0.88
chr9	93839294	93842154	CpG: 300	2860	300	1965	21.0	68.7	0.89
chr9	93847598	93847872	CpG: 21	274	21	168	15.3	61.3	0.83
chr9	93885330	93885611	CpG: 20	281	20	169	14.2	60.1	0.80
chr9	93949859	93950089	CpG: 20	230	20	140	17.4	60.9	0.95
chr9	93971499	93971737	CpG: 22	238	22	144	18.5	60.5	1.03
chr9	93990538	93990802	CpG: 21	264	21	159	15.9	60.2	0.89
chr9	93992851	93993127	CpG: 24	276	24	170	17.4	61.6	0.93
chr9	94011812	94012086	CpG: 24	274	24	171	17.5	62.4	0.91
chr9	94013504	94013785	CpG: 24	281	24	174	17.1	61.9	0.91
chr9	94126472	94126869	CpG: 34	397	34	251	17.1	63.2	0.87
chr9	94238233	94238494	CpG: 22	261	22	155	16.9	59.4	0.96
chr9	94319060	94319290	CpG: 21	230	21	142	18.3	61.7	0.97
chr9	94568571	94568852	CpG: 24	281	24	173	17.1	61.6	0.92
chr9	94610984	94611220	CpG: 19	236	19	141	16.1	59.7	0.92
chr9	95204691	95205118	CpG: 34	427	34	256	15.9	60.0	0.89
chr9	95207775	95208045	CpG: 22	270	22	169	16.3	62.6	0.84
chr9	95211667	95212971	CpG: 147	1304	147	902	22.5	69.2	0.94
chr9	95378323	95378566	CpG: 20	243	20	146	16.5	60.1	0.92
chr9	95387413	95387643	CpG: 19	230	19	139	16.5	60.4	0.91
chr9	95422054	95422808	CpG: 54	754	54	511	14.3	67.8	0.63
chr9	95506143	95506380	CpG: 18	237	18	141	15.2	59.5	0.88
chr9	95513331	95513604	CpG: 20	273	20	169	14.7	61.9	0.77
chr9	95570707	95570985	CpG: 22	278	22	174	15.8	62.6	0.82
chr9	95596134	95596370	CpG: 20	236	20	143	16.9	60.6	0.94
chr9	95687141	95688565	CpG: 144	1424	144	1005	20.2	70.6	0.81
chr9	95744000	95744253	CpG: 22	253	22	159	17.4	62.8	0.89
chr9	95772575	95773354	CpG: 89	779	89	573	22.8	73.6	0.88
chr9	95856813	95858443	CpG: 143	1630	143	1042	17.5	63.9	0.86
chr9	95966725	95967865	CpG: 140	1140	140	837	24.6	73.4	0.93
chr9	96071099	96072004	CpG: 101	905	101	626	22.3	69.2	0.95
chr9	96097937	96098924	CpG: 80	987	80	693	16.2	70.2	0.66
chr9	96106412	96107392	CpG: 77	980	77	617	15.7	63.0	0.80
chr9	96129692	96131508	CpG: 177	1816	177	1202	19.5	66.2	0.89
chr9	96245435	96245701	CpG: 24	266	24	168	18.0	63.2	0.91
chr9	96290852	96291167	CpG: 30	315	30	216	19.0	68.6	0.81
chr9	96323138	96323392	CpG: 20	254	20	151	15.7	59.4	0.90
chr9	96419822	96420045	CpG: 17	223	17	132	15.2	59.2	0.89
chr9	96558745	96559219	CpG: 42	474	42	348	17.7	73.4	0.66
chr9	96818613	96821155	CpG: 208	2542	208	1596	16.4	62.8	0.83
chr9	96880833	96881108	CpG: 24	275	24	171	17.5	62.2	0.91
chr9	97039347	97039583	CpG: 22	236	22	146	18.6	61.9	1.00
chr9	97041642	97041925	CpG: 23	283	23	175	16.3	61.8	0.86
chr9	97228055	97228441	CpG: 27	386	27	222	14.0	57.5	0.85
chr9	97516943	97517165	CpG: 19	222	19	127	17.1	57.2	1.07
chr9	97672976	97673557	CpG: 55	581	55	372	18.9	64.0	0.95
chr9	97723738	97724407	CpG: 45	669	45	441	13.5	65.9	0.62
chr9	97891722	97892947	CpG: 148	1225	148	873	24.2	71.3	0.95
chr9	97955564	97956582	CpG: 128	1018	128	744	25.1	73.1	0.95
chr9	97976568	97976805	CpG: 17	237	17	142	14.3	59.9	0.83
chr9	98091313	98092250	CpG: 109	937	109	663	23.3	70.8	0.93
chr9	98250424	98251627	CpG: 160	1203	160	885	26.6	73.6	0.98
chr9	98285288	98285522	CpG: 18	234	18	141	15.4	60.3	0.87
chr9	98339550	98339832	CpG: 21	282	21	172	14.9	61.0	0.82
chr9	98433055	98434035	CpG: 122	980	122	710	24.9	72.4	0.95
chr9	98462984	98463796	CpG: 56	812	56	547	13.8	67.4	0.61
chr9	98505338	98506235	CpG: 95	897	95	621	21.2	69.2	0.89
chr9	98762937	98763296	CpG: 30	359	30	212	16.7	59.1	0.96
chr9	99096902	99098965	CpG: 273	2063	273	1502	26.5	72.8	1.00
chr9	99099810	99100027	CpG: 18	217	18	130	16.6	59.9	0.93
chr9	99110683	99110924	CpG: 18	241	18	143	14.9	59.3	0.87
chr9	99165279	99165512	CpG: 18	233	18	160	15.5	68.7	0.69
chr9	99286119	99286350	CpG: 20	231	20	141	17.3	61.0	0.95
chr9	99302089	99302519	CpG: 41	430	41	292	19.1	67.9	0.83
chr9	99361252	99361482	CpG: 20	230	20	141	17.4	61.3	0.94
chr9	99538797	99539038	CpG: 22	241	22	146	18.3	60.6	1.02
chr9	99550525	99550735	CpG: 15	210	15	130	14.3	61.9	0.76
chr9	99580453	99580685	CpG: 16	232	16	134	13.8	57.8	0.85
chr9	99592600	99592881	CpG: 24	281	24	175	17.1	62.3	0.90
chr9	99613779	99614009	CpG: 17	230	17	135	14.8	58.7	0.87
chr9	99651066	99652369	CpG: 145	1303	145	952	22.3	73.1	0.84
chr9	99714724	99714998	CpG: 21	274	21	169	15.3	61.7	0.82
chr9	99813125	99813485	CpG: 24	360	24	242	13.3	67.2	0.61
chr9	99859826	99860077	CpG: 21	251	21	167	16.7	66.5	0.76
chr9	99879416	99880243	CpG: 75	827	75	565	18.1	68.3	0.78
chr9	99978240	99978727	CpG: 40	487	40	310	16.4	63.7	0.82
chr9	100012832	100013130	CpG: 28	298	28	172	18.8	57.7	1.18
chr9	100098755	100099032	CpG: 32	277	32	218	23.1	78.7	0.88
chr9	100128331	100128929	CpG: 51	598	51	397	17.1	66.4	0.78
chr9	100146957	100147171	CpG: 16	214	16	127	15.0	59.3	0.87
chr9	100158282	100158567	CpG: 23	285	23	177	16.1	62.1	0.85
chr9	100160764	100161277	CpG: 38	513	38	349	14.8	68.0	0.64
chr9	100230295	100231260	CpG: 74	965	74	659	15.3	68.3	0.69
chr9	100334532	100334758	CpG: 20	226	20	162	17.7	71.7	0.70
chr9	100356929	100357165	CpG: 19	236	19	139	16.1	58.9	0.95
chr9	100398767	100399938	CpG: 95	1171	95	848	16.2	72.4	0.62
chr9	100423923	100424199	CpG: 21	276	21	169	15.2	61.2	0.82
chr9	100438457	100438719	CpG: 19	262	19	156	14.5	59.5	0.83
chr9	100541929	100543518	CpG: 205	1589	205	1162	25.8	73.1	0.97
chr9	100548943	100549204	CpG: 18	261	18	156	13.8	59.8	0.78
chr9	100590890	100591165	CpG: 24	275	24	171	17.5	62.2	0.91
chr9	100688170	100690232	CpG: 184	2062	184	1452	17.8	70.4	0.81
chr9	100819356	100820286	CpG: 83	930	83	671	17.8	72.2	0.69
chr9	101153337	101154396	CpG: 106	1059	106	744	20.0	70.3	0.82
chr9	101163474	101163819	CpG: 26	345	26	210	15.1	60.9	0.81
chr9	101211764	101212004	CpG: 17	240	17	139	14.2	57.9	0.86
chr9	101340527	101341476	CpG: 110	949	110	684	23.2	72.1	0.89
chr9	101419258	101419531	CpG: 23	273	23	174	16.8	63.7	0.84
chr9	101421315	101421553	CpG: 19	238	19	145	16.0	60.9	0.88
chr9	101446215	101446597	CpG: 32	382	32	281	16.8	73.6	0.62
chr9	101474170	101475502	CpG: 140	1332	140	896	21.0	67.3	0.93
chr9	101482143	101482766	CpG: 82	623	82	444	26.3	71.3	1.04
chr9	101544813	101545092	CpG: 21	279	21	185	15.1	66.3	0.70
chr9	101626679	101626951	CpG: 31	272	31	212	22.8	77.9	1.50
chr9	101643504	101643751	CpG: 18	247	18	144	14.6	58.3	0.88
chr9	101661297	101662117	CpG: 100	820	100	651	24.4	79.4	0.78
chr9	101668719	101668993	CpG: 22	274	22	168	16.1	61.3	0.87
chr9	101767842	101770420	CpG: 217	2578	217	1645	16.8	63.8	0.83
chr9	101840916	101841172	CpG: 18	256	18	163	14.1	63.7	0.69
chr9	101845505	101846090	CpG: 50	585	50	448	17.1	76.6	0.61
chr9	101934366	101934937	CpG: 41	571	41	342	14.4	59.9	0.81
chr9	102124944	102125218	CpG: 22	274	22	167	16.1	60.9	0.87
chr9	102289171	102289462	CpG: 26	291	26	183	17.9	62.9	0.91
chr9	102299644	102299925	CpG: 21	281	21	171	14.9	60.9	0.83
chr9	102384689	102384956	CpG: 20	267	20	179	15.0	67.0	0.69
chr9	102540727	102541006	CpG: 25	279	25	177	17.9	63.4	0.90
chr9	102558082	102558317	CpG: 19	235	19	141	16.2	60.0	0.92
chr9	102747441	102747767	CpG: 23	326	23	223	14.1	68.4	0.60
chr9	102807736	102808073	CpG: 38	337	38	243	22.6	72.1	0.89
chr9	102966845	102967616	CpG: 85	771	85	548	22.0	71.1	0.88
chr9	103031299	103031536	CpG: 19	237	19	141	16.0	59.5	0.93
chr9	103101624	103101898	CpG: 21	274	21	168	15.3	61.3	0.82
chr9	103283383	103284276	CpG: 62	893	62	567	13.9	63.5	0.69
chr9	103326023	103326506	CpG: 38	483	38	341	15.7	70.6	0.67
chr9	103359362	103360282	CpG: 76	920	76	543	16.5	59.0	0.95
chr9	103479568	103479849	CpG: 23	281	23	174	16.4	61.9	0.87
chr9	103527648	103528194	CpG: 74	546	74	415	27.1	76.0	0.98
chr9	103587264	103587851	CpG: 69	587	69	441	23.5	75.1	0.84
chr9	103589507	103591152	CpG: 216	1645	216	1179	26.3	71.7	1.02
chr9	103602437	103602674	CpG: 21	237	21	141	17.7	59.5	1.04
chr9	103671547	103671781	CpG: 17	234	17	139	14.5	59.4	0.84
chr9	103847778	103848145	CpG: 30	367	30	231	16.3	62.9	0.84
chr9	103881186	103881466	CpG: 26	280	26	186	18.6	66.4	0.85
chr9	103890937	103891701	CpG: 54	764	54	475	14.1	62.2	0.73
chr9	103899816	103900213	CpG: 41	397	41	271	20.7	68.3	0.89
chr9	104045206	104045444	CpG: 18	238	18	155	15.1	65.1	0.73
chr9	104052786	104053097	CpG: 30	311	30	208	19.3	66.9	0.96
chr9	104066697	104066911	CpG: 20	214	20	155	18.7	72.4	0.72
chr9	104103187	104103465	CpG: 25	278	25	176	18.0	63.3	0.91
chr9	104115284	104117242	CpG: 212	1958	212	1406	21.7	71.8	0.84
chr9	104172069	104172339	CpG: 19	270	19	158	14.1	58.5	0.83
chr9	104264584	104264894	CpG: 22	310	22	192	14.2	61.9	0.86
chr9	104281477	104281987	CpG: 49	510	49	328	19.2	64.3	0.96
chr9	104307781	104308036	CpG: 39	255	39	206	30.6	80.8	0.96
chr9	104381090	104381315	CpG: 20	225	20	135	17.8	60.0	0.99
chr9	104393906	104394363	CpG: 38	457	38	333	16.6	72.9	0.63
chr9	104460009	104460546	CpG: 52	537	52	335	19.4	62.4	1.00
chr9	104492196	104492853	CpG: 64	657	64	434	19.5	66.1	0.90
chr9	104711730	104712173	CpG: 39	443	39	320	17.6	72.2	0.68
chr9	104836094	104836993	CpG: 92	899	92	616	20.5	68.5	0.89
chr9	104837129	104837334	CpG: 15	205	15	121	14.6	59.0	0.84
chr9	104881575	104881987	CpG: 30	412	30	263	14.6	63.8	0.72
chr9	104885120	104885861	CpG: 54	741	54	491	14.6	66.3	0.66
chr9	104930732	104932101	CpG: 161	1369	161	1019	23.5	74.4	0.86
chr9	104943169	104943428	CpG: 20	259	20	158	15.4	61.0	0.86
chr9	104969591	104969864	CpG: 25	273	25	167	18.3	61.2	0.99
chr9	104973703	104976538	CpG: 219	2835	219	1942	15.4	68.5	0.66
chr9	105003829	105004132	CpG: 28	303	28	181	18.5	59.7	1.04
chr9	105079663	105079891	CpG: 16	228	16	139	14.0	61.0	0.77
chr9	105084627	105084908	CpG: 24	281	24	174	17.1	61.9	0.91
chr9	105225131	105225913	CpG: 87	782	87	594	22.3	76.0	0.77
chr9	105262092	105263468	CpG: 151	1376	151	1006	21.9	73.1	0.87
chr9	105300337	105301358	CpG: 113	1021	113	746	22.1	73.1	0.83
chr9	105350480	105352505	CpG: 235	2025	235	1511	23.2	74.6	0.83
chr9	105414953	105415210	CpG: 20	257	20	179	15.6	69.6	0.64
chr9	105460154	105460507	CpG: 35	353	35	243	19.8	68.8	0.84
chr9	105474236	105474475	CpG: 25	239	25	162	20.9	67.8	0.92
chr9	105485214	105485431	CpG: 17	217	17	146	15.7	67.3	0.70
chr9	105502732	105502967	CpG: 18	235	18	143	15.3	60.9	0.83
chr9	105513583	105514109	CpG: 62	526	62	385	23.6	73.2	0.88
chr9	105618470	105620083	CpG: 197	1613	197	1208	24.4	74.9	0.88
chr9	105646537	105646767	CpG: 18	230	18	138	15.7	60.0	0.88
chr9	105683483	105683718	CpG: 21	235	21	146	17.9	62.1	0.93
chr9	105733891	105734296	CpG: 49	405	49	300	24.2	74.1	0.88
chr9	105743179	105744975	CpG: 235	1796	235	1387	26.2	77.2	0.88
chr9	105994292	105994649	CpG: 42	357	42	253	23.5	70.9	0.94
chr9	105995690	105996134	CpG: 33	444	33	283	14.9	63.7	0.73
chr9	106028821	106029198	CpG: 33	377	33	269	17.5	71.4	0.74
chr9	106113817	106114188	CpG: 36	371	36	242	19.4	65.2	0.91
chr9	106116510	106117419	CpG: 65	909	65	602	14.3	66.2	0.66
chr9	106119031	106123890	CpG: 400	4859	400	3207	16.5	66.0	0.76
chr9	106126290	106128892	CpG: 185	2602	185	1605	14.2	61.7	0.75
chr9	106198111	106198895	CpG: 96	784	96	558	24.5	71.2	0.97
chr9	106262458	106262816	CpG: 25	358	25	211	14.0	58.9	0.81
chr9	106286856	106287283	CpG: 33	427	33	256	15.5	60.0	0.86
chr9	106315529	106315807	CpG: 24	278	24	174	17.3	62.6	0.89
chr9	106333896	106335237	CpG: 155	1341	155	971	23.1	72.4	0.89
chr9	106427257	106427760	CpG: 41	503	41	328	16.3	65.2	0.78
chr9	106428034	106428289	CpG: 20	255	20	155	15.7	60.8	0.87
chr9	106429168	106429401	CpG: 21	233	21	143	18.0	61.4	0.98
chr9	106445655	106445930	CpG: 23	275	23	170	16.7	61.8	0.88
chr9	106501886	106502406	CpG: 48	520	48	348	18.5	66.9	0.82
chr9	106515835	106516080	CpG: 20	245	20	150	16.3	61.2	0.88
chr9	106543956	106545023	CpG: 121	1067	121	713	22.7	66.8	1.03
chr9	106760462	106760848	CpG: 34	386	34	280	17.6	72.5	0.67
chr9	106764182	106764422	CpG: 18	240	18	141	15.0	58.8	0.88
chr9	106783126	106783364	CpG: 17	238	17	141	14.3	59.2	0.83
chr9	106794873	106795200	CpG: 24	327	24	199	14.7	60.9	0.79
chr9	106803162	106803379	CpG: 20	217	20	131	18.4	60.4	1.01
chr9	106808314	106809095	CpG: 77	781	77	555	19.7	71.1	0.78
chr9	106836570	106836784	CpG: 19	214	19	133	17.8	62.1	0.94
chr9	106870999	106871263	CpG: 18	264	18	159	13.6	60.2	0.77
chr9	106895048	106895313	CpG: 21	265	21	165	15.8	62.3	0.83
chr9	106895850	106896204	CpG: 40	354	40	244	22.6	68.9	0.95
chr9	106959235	106959511	CpG: 23	276	23	169	16.7	61.2	0.90
chr9	107054066	107054338	CpG: 21	272	21	167	15.4	61.4	0.84
chr9	107173726	107175032	CpG: 184	1306	184	981	28.2	75.1	1.01
chr9	107214564	107214808	CpG: 25	244	25	174	20.5	71.3	0.82
chr9	107217807	107218386	CpG: 56	579	56	379	19.3	65.5	0.91
chr9	107252746	107253160	CpG: 30	414	30	260	14.5	62.8	0.85
chr9	107255251	107255636	CpG: 30	385	30	249	15.6	64.7	0.75
chr9	107461818	107462145	CpG: 42	327	42	256	25.7	78.3	0.84
chr9	107482616	107482973	CpG: 28	357	28	227	15.7	63.6	0.78
chr9	107486421	107487445	CpG: 114	1024	114	715	22.3	69.8	0.92
chr9	107509522	107509752	CpG: 21	230	21	141	18.3	61.3	0.99
chr9	107518616	107519614	CpG: 103	998	103	705	20.6	70.6	0.83
chr9	107520699	107520914	CpG: 21	215	21	142	19.5	66.0	0.90
chr9	107537601	107537831	CpG: 18	230	18	140	15.7	60.9	0.87
chr9	107596275	107596581	CpG: 36	306	36	238	23.5	77.8	0.78
chr9	107643247	107643477	CpG: 18	230	18	137	15.7	59.6	0.89
chr9	107673377	107673658	CpG: 21	281	21	172	14.9	61.2	0.81
chr9	107675491	107681265	CpG: 498	5774	498	3615	17.2	62.6	0.88
chr9	107685485	107687111	CpG: 173	1626	173	1101	21.3	67.7	0.94
chr9	107722699	107723192	CpG: 37	493	37	336	15.0	68.2	0.65
chr9	107771988	107772223	CpG: 20	235	20	146	17.0	62.1	0.91
chr9	107868293	107868720	CpG: 31	427	31	255	14.5	59.7	0.82
chr9	107899799	107900107	CpG: 32	308	32	234	20.8	76.0	0.72
chr9	107923411	107923741	CpG: 30	330	30	248	18.2	75.2	0.65
chr9	107955726	107956104	CpG: 32	378	32	262	16.9	69.3	0.70
chr9	108044411	108044685	CpG: 24	274	24	170	17.5	62.0	0.92
chr9	108046333	108047533	CpG: 101	1200	101	736	16.8	61.3	0.90
chr9	108192307	108193455	CpG: 129	1148	129	844	22.5	73.5	0.83
chr9	108197585	108197834	CpG: 23	249	23	180	18.5	72.3	0.73
chr9	108198763	108199402	CpG: 62	639	62	450	19.4	70.4	0.79
chr9	108208207	108208443	CpG: 20	236	20	145	16.9	61.4	0.91
chr9	108305716	108305981	CpG: 20	265	20	157	15.1	59.2	0.87
chr9	108326527	108326764	CpG: 17	237	17	139	14.3	58.6	0.85
chr9	108389569	108391249	CpG: 131	1680	131	1079	15.6	64.2	0.76
chr9	108403278	108403555	CpG: 23	277	23	174	16.6	62.8	0.85
chr9	108472808	108473087	CpG: 26	279	26	177	18.6	63.4	0.93
chr9	108505027	108505300	CpG: 19	273	19	165	13.9	60.4	0.77
chr9	108543468	108543738	CpG: 23	270	23	167	17.0	61.9	0.90
chr9	108554963	108555524	CpG: 67	561	67	419	23.9	74.7	0.86
chr9	108588917	108591230	CpG: 274	2313	274	1670	23.7	72.2	0.91
chr9	108621658	108623001	CpG: 163	1343	163	999	24.3	74.4	0.89
chr9	108668290	108669017	CpG: 61	727	61	494	16.8	68.0	0.73
chr9	108738306	108739260	CpG: 76	954	76	667	15.9	69.9	0.66
chr9	108790307	108791729	CpG: 182	1422	182	1058	25.6	74.4	0.93
chr9	108794019	108794295	CpG: 21	276	21	165	15.2	59.8	0.87
chr9	108810937	108811174	CpG: 19	237	19	147	16.0	62.0	0.85
chr9	108816745	108816982	CpG: 18	237	18	140	15.2	59.1	0.89
chr9	108824715	108824961	CpG: 19	246	19	148	15.4	60.2	0.88
chr9	108825685	108825917	CpG: 17	232	17	143	14.7	61.6	0.79
chr9	108826399	108827321	CpG: 117	922	117	664	25.4	72.0	0.98
chr9	108835620	108835907	CpG: 21	287	21	169	14.6	58.9	0.88
chr9	108850910	108851188	CpG: 22	278	22	175	15.8	62.9	0.81
chr9	108857283	108857553	CpG: 20	270	20	170	14.8	63.0	0.76
chr9	108858604	108859072	CpG: 53	468	53	305	22.6	65.2	1.07
chr9	108887272	108887896	CpG: 47	624	47	441	15.1	70.7	0.61
chr9	108890526	108890761	CpG: 18	235	18	141	15.3	60.0	0.87
chr9	108891394	108891962	CpG: 51	568	51	385	18.0	67.8	0.80
chr9	108949455	108949968	CpG: 46	513	46	328	17.9	63.9	0.90
chr9	109025820	109026438	CpG: 64	618	64	413	20.7	66.8	0.96
chr9	109047205	109047780	CpG: 42	575	42	347	14.6	60.3	0.83
chr9	109049087	109049552	CpG: 49	465	49	327	21.1	70.3	0.85
chr9	109061263	109061479	CpG: 16	216	16	125	14.8	57.9	0.89
chr9	109082954	109083199	CpG: 19	245	19	149	15.5	60.8	0.85
chr9	109096663	109097226	CpG: 52	563	52	377	18.5	67.0	0.82
chr9	109184596	109185600	CpG: 112	1004	112	661	22.3	65.8	1.04
chr9	109210354	109211222	CpG: 82	868	82	624	18.9	71.9	0.74
chr9	109248700	109249548	CpG: 73	848	73	589	17.2	69.5	0.72
chr9	109250113	109250501	CpG: 30	388	30	263	15.5	67.8	0.67
chr9	109292986	109293252	CpG: 39	266	39	198	29.3	74.4	1.06
chr9	109371624	109371914	CpG: 23	290	23	183	15.9	63.1	0.80
chr9	109392695	109394444	CpG: 144	1749	144	1221	16.5	69.8	0.68
chr9	109409722	109410341	CpG: 51	619	51	388	16.5	62.7	0.84
chr9	109443234	109443516	CpG: 27	282	27	215	19.1	76.2	0.69
chr9	109479216	109480014	CpG: 56	798	56	493	14.0	61.8	0.74
chr9	109542937	109543219	CpG: 25	282	25	176	17.7	62.4	0.92
chr9	109583767	109584614	CpG: 121	847	121	644	28.6	76.0	1.00
chr9	109669850	109670718	CpG: 61	868	61	585	14.1	67.4	0.62
chr9	109673343	109674885	CpG: 155	1542	155	1093	20.1	70.9	0.80
chr9	109746018	109746543	CpG: 52	525	52	392	19.8	74.7	0.71
chr9	109758525	109758836	CpG: 26	311	26	193	16.7	62.1	0.88
chr9	109804999	109806073	CpG: 116	1074	116	730	21.6	68.0	0.94
chr9	109868755	109869434	CpG: 78	679	78	484	23.0	71.3	0.90
chr9	109913212	109913675	CpG: 45	463	45	328	19.4	70.8	0.78
chr9	109975398	109975927	CpG: 69	529	69	399	26.1	75.4	0.92
chr9	110020351	110021172	CpG: 66	821	66	513	16.1	62.5	0.83
chr9	110023593	110027165	CpG: 351	3572	351	2443	19.7	68.4	0.84
chr9	110029639	110029847	CpG: 29	208	29	153	27.9	73.6	1.03
chr9	110045023	110045296	CpG: 23	273	23	167	16.8	61.2	0.91
chr9	110058357	110058638	CpG: 21	281	21	172	14.9	61.2	0.81
chr9	110093382	110093657	CpG: 21	275	21	169	15.3	61.5	0.82
chr9	110094153	110094706	CpG: 53	553	53	347	19.2	62.7	0.98
chr9	110099986	110100264	CpG: 26	278	26	174	18.7	62.6	0.97
chr9	110129783	110130154	CpG: 27	371	27	211	14.6	56.9	0.91
chr9	110154640	110157426	CpG: 344	2786	344	2045	24.7	73.4	0.92
chr9	110170770	110171048	CpG: 23	278	23	174	16.5	62.6	0.85
chr9	110198841	110199058	CpG: 16	217	16	132	14.7	60.8	0.82
chr9	110228389	110229061	CpG: 74	672	74	484	22.0	72.0	0.85
chr9	110259360	110260053	CpG: 89	693	89	506	25.7	73.0	0.97
chr9	110290763	110291325	CpG: 63	562	63	411	22.4	73.1	0.86
chr9	110291784	110292067	CpG: 21	283	21	171	14.8	60.4	0.83
chr9	110363945	110365181	CpG: 134	1236	134	906	21.7	73.3	0.81
chr9	110427047	110428246	CpG: 99	1199	99	772	16.5	64.4	0.80
chr9	110438464	110438738	CpG: 23	274	23	170	16.8	62.0	0.88
chr9	110618992	110619268	CpG: 22	276	22	168	15.9	60.9	0.87
chr9	110635487	110636189	CpG: 47	702	47	453	13.4	64.5	0.66
chr9	110868870	110869147	CpG: 22	277	22	168	15.9	60.6	0.88
chr9	110878957	110881532	CpG: 272	2575	272	1846	21.1	71.7	0.82
chr9	110951332	110951611	CpG: 24	279	24	171	17.2	61.3	0.92
chr9	110967697	110968582	CpG: 126	885	126	688	28.5	77.7	0.96
chr9	110979206	110979749	CpG: 82	543	82	428	30.2	78.8	0.99
chr9	111115326	111116101	CpG: 94	775	94	548	24.3	70.7	0.97
chr9	111157295	111157502	CpG: 15	207	15	130	14.5	62.8	0.75
chr9	111276413	111277716	CpG: 171	1303	171	997	26.2	76.5	0.92
chr9	111393141	111394383	CpG: 112	1242	112	810	18.0	65.2	0.86
chr9	111453698	111453931	CpG: 17	233	17	135	14.6	57.9	0.88
chr9	111468244	111468616	CpG: 29	372	29	250	15.6	67.2	0.69
chr9	111670418	111670832	CpG: 31	414	31	249	15.0	60.1	0.83
chr9	111858924	111859198	CpG: 24	274	24	171	17.5	62.4	0.91
chr9	111968740	111969027	CpG: 25	287	25	179	17.4	62.4	0.91
chr9	111991144	111996914	CpG: 439	5770	439	3485	15.2	60.4	0.84
chr9	112000093	112000654	CpG: 75	561	75	428	26.7	76.3	0.94
chr9	112078169	112078841	CpG: 72	672	72	473	21.4	70.4	0.88
chr9	112170609	112170840	CpG: 25	231	25	171	21.6	74.0	0.79
chr9	112270113	112271015	CpG: 70	902	70	583	15.5	64.6	0.75
chr9	112523949	112524768	CpG: 93	819	93	578	22.7	70.6	0.92
chr9	112584514	112584749	CpG: 18	235	18	138	15.3	58.7	0.90
chr9	112586297	112586544	CpG: 20	247	20	146	16.2	59.1	0.95
chr9	112598659	112599439	CpG: 116	780	116	630	29.7	80.8	0.92
chr9	112644549	112646005	CpG: 177	1456	177	1085	24.3	74.5	0.89
chr9	112699076	112699417	CpG: 24	341	24	202	14.1	59.2	0.81
chr9	112770357	112770714	CpG: 37	357	37	245	20.7	68.6	0.88
chr9	112772046	112772324	CpG: 25	278	25	175	18.0	62.9	0.91
chr9	112875052	112875265	CpG: 17	213	17	128	16.0	60.1	0.90
chr9	113200294	113201446	CpG: 102	1152	102	768	17.7	66.7	0.80
chr9	113201626	113201855	CpG: 18	229	18	143	15.7	62.4	0.82
chr9	113279695	113280122	CpG: 32	427	32	253	15.0	59.3	0.86
chr9	113510125	113510343	CpG: 16	218	16	129	14.7	59.2	0.85
chr9	113570546	113571221	CpG: 49	675	49	429	14.5	63.6	0.72
chr9	113621120	113621545	CpG: 37	425	37	282	17.4	66.4	0.82
chr9	113631452	113631726	CpG: 24	274	24	172	17.5	62.8	0.90
chr9	113657284	113658538	CpG: 108	1254	108	856	17.2	68.3	0.74
chr9	113708386	113708701	CpG: 27	315	27	197	17.1	62.5	0.88
chr9	113709719	113709958	CpG: 18	239	18	143	15.1	59.8	0.86
chr9	113769477	113769758	CpG: 23	281	23	170	16.4	60.5	0.89
chr9	113791702	113791983	CpG: 23	281	23	171	16.4	60.9	0.90
chr9	113856717	113856987	CpG: 20	270	20	164	14.8	60.7	0.81
chr9	113897178	113897392	CpG: 17	214	17	123	15.9	57.5	1.00
chr9	113898104	113898498	CpG: 32	394	32	287	16.2	72.8	0.61
chr9	113911569	113912796	CpG: 115	1227	115	849	18.7	69.2	0.79
chr9	113952793	113953029	CpG: 21	236	21	145	17.8	61.4	0.96
chr9	114096968	114097253	CpG: 25	285	25	180	17.5	63.2	0.90
chr9	114397625	114397852	CpG: 18	227	18	136	15.9	59.9	0.88
chr9	114452249	114452485	CpG: 18	236	18	140	15.3	59.3	0.90
chr9	114593990	114594264	CpG: 25	274	25	172	18.2	62.8	0.94
chr9	115234339	115234613	CpG: 24	274	24	171	17.5	62.4	0.91
chr9	115411318	115411545	CpG: 21	227	21	135	18.5	59.5	1.05
chr9	115543964	115544239	CpG: 24	275	24	171	17.5	62.2	0.91
chr9	115583179	115583456	CpG: 22	277	22	171	15.9	61.7	0.84
chr9	115657259	115657500	CpG: 20	241	20	168	16.6	69.7	0.68
chr9	115709642	115709920	CpG: 22	278	22	171	15.8	61.5	0.85
chr9	115897504	115897780	CpG: 24	276	24	175	17.4	63.4	0.87
chr9	116051840	116052075	CpG: 17	235	17	138	14.5	58.7	0.85
chr9	116173106	116173504	CpG: 38	398	38	283	19.1	71.1	0.76
chr9	116267406	116268283	CpG: 64	877	64	525	14.6	59.9	0.82
chr9	116324445	116324710	CpG: 20	265	20	161	15.1	60.8	0.83
chr9	116409285	116409864	CpG: 48	579	48	421	16.6	72.7	0.63
chr9	116416551	116416821	CpG: 20	270	20	168	14.8	62.2	0.78
chr9	116551819	116552038	CpG: 17	219	17	130	15.5	59.4	0.90
chr9	116663998	116664759	CpG: 56	761	56	504	14.7	66.2	0.67
chr9	116671447	116671726	CpG: 21	279	21	166	15.1	59.5	0.87
chr9	116807979	116808209	CpG: 18	230	18	140	15.7	60.9	0.86
chr9	116808861	116809089	CpG: 20	228	20	155	17.5	68.0	0.77
chr9	116813494	116813768	CpG: 24	274	24	171	17.5	62.4	0.91
chr9	116922415	116923272	CpG: 81	857	81	578	18.9	67.4	0.83
chr9	116938674	116939484	CpG: 73	810	73	513	18.0	63.3	0.90
chr9	117049567	117049784	CpG: 23	217	23	182	21.2	83.9	0.60
chr9	117088678	117088918	CpG: 20	240	20	146	16.7	60.8	0.94
chr9	117101312	117103341	CpG: 148	2029	148	1262	14.6	62.2	0.76
chr9	117142944	117143311	CpG: 34	367	34	237	18.5	64.6	0.89
chr9	117166436	117166855	CpG: 45	419	45	272	21.5	64.9	1.03
chr9	117301272	117301550	CpG: 23	278	23	174	16.5	62.6	0.86
chr9	117390316	117390527	CpG: 15	211	15	121	14.2	57.3	0.88
chr9	117418793	117420247	CpG: 160	1454	160	1056	22.0	72.6	0.84
chr9	117528720	117528956	CpG: 22	236	22	146	18.6	61.9	1.00
chr9	117547282	117547556	CpG: 22	274	22	169	16.1	61.7	0.85
chr9	117572292	117572569	CpG: 19	277	19	163	13.7	58.8	0.80
chr9	117622448	117623116	CpG: 74	668	74	489	22.2	73.2	0.84
chr9	117694423	117694665	CpG: 29	242	29	184	24.0	76.0	0.86
chr9	117732633	117733231	CpG: 43	598	43	374	14.4	62.5	0.74
chr9	117756416	117756726	CpG: 23	310	23	188	14.8	60.6	0.81
chr9	117830803	117831334	CpG: 67	531	67	380	25.2	71.6	1.01
chr9	117869099	117869884	CpG: 92	785	92	545	23.4	69.4	0.98
chr9	117957382	117957607	CpG: 19	225	19	133	16.9	59.1	0.97
chr9	117976847	117977121	CpG: 21	274	21	167	15.3	60.9	0.83
chr9	118186461	118186697	CpG: 19	236	19	142	16.1	60.2	0.90
chr9	118363162	118363368	CpG: 17	206	17	121	16.5	58.7	0.96
chr9	118437728	118438002	CpG: 23	274	23	170	16.8	62.0	0.88
chr9	118450387	118450666	CpG: 25	279	25	176	17.9	63.1	0.91
chr9	118585888	118586097	CpG: 18	209	18	124	17.2	59.3	1.00
chr9	118648868	118649191	CpG: 27	323	27	193	16.7	59.8	0.95
chr9	119020798	119021095	CpG: 22	297	22	166	14.8	55.9	0.96
chr9	119036415	119037347	CpG: 64	932	64	553	13.7	59.3	0.79
chr9	119064397	119064633	CpG: 22	236	22	148	18.6	62.7	0.98
chr9	119454606	119455797	CpG: 139	1191	139	869	23.3	73.0	0.88
chr9	119637457	119638146	CpG: 67	689	67	479	19.4	69.5	0.81
chr9	119659240	119662151	CpG: 317	2911	317	1994	21.8	68.5	0.93
chr9	119671220	119671505	CpG: 25	285	25	180	17.5	63.2	0.90
chr9	119682124	119682394	CpG: 21	270	21	165	15.6	61.1	0.84
chr9	119704496	119704725	CpG: 21	229	21	140	18.3	61.1	0.99
chr9	119809187	119810106	CpG: 69	919	69	579	15.0	63.0	0.76
chr9	119888272	119888681	CpG: 38	409	38	275	18.6	67.2	0.92
chr9	119986139	119986730	CpG: 53	591	53	436	17.9	73.8	0.66
chr9	120077297	120077568	CpG: 20	271	20	161	14.8	59.4	0.85
chr9	120521820	120522057	CpG: 20	237	20	147	16.9	62.0	0.90
chr9	120533932	120534156	CpG: 20	224	20	139	17.9	62.1	0.96
chr9	120554625	120554903	CpG: 22	278	22	170	15.8	61.2	0.86
chr9	120699378	120699729	CpG: 27	351	27	248	15.4	70.7	0.62
chr9	120785366	120785651	CpG: 24	285	24	178	16.8	62.5	0.88
chr9	120901360	120901634	CpG: 24	274	24	171	17.5	62.4	0.91
chr9	121024168	121024992	CpG: 67	824	67	531	16.3	64.4	0.78
chr9	121041652	121041903	CpG: 20	251	20	152	15.9	60.6	0.88
chr9	121102489	121103648	CpG: 101	1159	101	745	17.4	64.3	0.84
chr9	121181836	121182729	CpG: 110	893	110	663	24.6	74.2	0.90
chr9	121288269	121289065	CpG: 101	796	101	582	25.4	73.1	0.95
chr9	121335805	121336389	CpG: 78	584	78	454	26.7	77.7	0.93
chr9	121356553	121356838	CpG: 24	285	24	179	16.8	62.8	0.87
chr9	121437972	121438252	CpG: 24	280	24	173	17.1	61.8	0.91
chr9	121488470	121490617	CpG: 243	2147	243	1593	22.6	74.2	0.82
chr9	121501588	121501816	CpG: 22	228	22	141	19.3	61.8	1.04
chr9	121654619	121654860	CpG: 19	241	19	148	15.8	61.4	0.87
chr9	121667076	121667902	CpG: 132	826	132	669	32.0	81.0	0.98
chr9	121669127	121669434	CpG: 43	307	43	241	28.0	78.5	0.91
chr9	121702547	121702884	CpG: 29	337	29	206	17.2	61.1	0.92
chr9	121703546	121703945	CpG: 38	399	38	273	19.0	68.4	0.83
chr9	121767992	121768227	CpG: 19	235	19	147	16.2	62.6	0.86
chr9	121809903	121810485	CpG: 63	582	63	406	21.6	69.8	0.89
chr9	121837385	121837663	CpG: 24	278	24	173	17.3	62.2	0.90
chr9	121949345	121949881	CpG: 80	536	80	416	29.9	77.6	0.99
chr9	122217646	122218357	CpG: 54	711	54	465	15.2	65.4	0.71
chr9	122342382	122342620	CpG: 23	238	23	147	19.3	61.8	1.03
chr9	122346166	122346440	CpG: 23	274	23	169	16.8	61.7	0.89
chr9	122425003	122426555	CpG: 143	1552	143	1071	18.4	69.0	0.78
chr9	122586827	122587144	CpG: 25	317	25	195	15.8	61.5	0.84
chr9	122636103	122636384	CpG: 24	281	24	174	17.1	61.9	0.90
chr9	122748549	122749381	CpG: 100	832	100	582	24.0	70.0	0.99
chr9	122900577	122900858	CpG: 24	281	24	175	17.1	62.3	0.90
chr9	122933261	122933534	CpG: 22	273	22	170	16.1	62.3	0.84
chr9	122962772	122963199	CpG: 32	427	32	257	15.0	60.2	0.83
chr9	123209284	123210746	CpG: 158	1462	158	1069	21.6	73.1	0.82
chr9	123250843	123251113	CpG: 21	270	21	164	15.6	60.7	0.85
chr9	123654193	123655933	CpG: 251	1740	251	1310	28.9	75.3	1.02
chr9	123656479	123656714	CpG: 18	235	18	136	15.3	57.9	0.94
chr9	123696482	123696797	CpG: 38	315	38	222	24.1	70.5	0.99
chr9	123769678	123770190	CpG: 33	512	33	293	12.9	57.2	0.79
chr9	123770508	123771278	CpG: 63	770	63	500	16.4	64.9	0.78
chr9	123788789	123789504	CpG: 56	715	56	491	15.7	68.7	0.67
chr9	123802431	123803290	CpG: 89	859	89	603	20.7	70.2	0.84
chr9	123832649	123833529	CpG: 105	880	105	667	23.9	75.8	0.84
chr9	123854327	123854560	CpG: 17	233	17	140	14.6	60.1	0.83
chr9	123966369	123966658	CpG: 22	289	22	185	15.2	64.0	0.80
chr9	124018349	124018550	CpG: 15	201	15	128	14.9	63.7	0.75
chr9	124040855	124041136	CpG: 24	281	24	173	17.1	61.6	0.91
chr9	124061133	124061403	CpG: 20	270	20	165	14.8	61.1	0.80
chr9	124067685	124068840	CpG: 141	1155	141	851	24.4	73.7	0.91
chr9	124090001	124090267	CpG: 22	266	22	163	16.5	61.3	0.90
chr9	124119496	124119758	CpG: 20	262	20	153	15.3	58.4	0.91
chr9	124345897	124346701	CpG: 106	804	106	629	26.4	78.2	0.87
chr9	124476801	124477071	CpG: 18	270	18	166	13.3	61.5	0.71
chr9	124504030	124505334	CpG: 173	1304	173	969	26.5	74.3	0.97
chr9	124550767	124551550	CpG: 80	783	80	533	20.4	68.1	0.90
chr9	124657638	124658654	CpG: 152	1016	152	790	29.9	77.8	0.99
chr9	124684571	124686336	CpG: 167	1765	167	1363	18.9	77.2	0.63
chr9	124887889	124888179	CpG: 22	290	22	170	15.2	58.6	0.89
chr9	124889024	124889739	CpG: 60	715	60	451	16.8	63.1	0.84
chr9	124921568	124922713	CpG: 133	1145	133	848	23.2	74.1	0.85
chr9	124974953	124975379	CpG: 32	426	32	255	15.0	59.9	0.84
chr9	125061612	125062614	CpG: 87	1002	87	686	17.4	68.5	0.74
chr9	125168266	125168540	CpG: 22	274	22	169	16.1	61.7	0.86
chr9	125183769	125184089	CpG: 27	320	27	191	16.9	59.7	0.96
chr9	125228314	125228821	CpG: 49	507	49	310	19.3	61.1	1.04
chr9	125231549	125288849	CpG: 3405	57300	3405	34437	11.9	60.1	0.66
chr9	125309969	125310508	CpG: 52	539	52	346	19.3	64.2	0.94
chr9	125311744	125312295	CpG: 53	551	53	353	19.2	64.1	0.94
chr9	125349637	125350363	CpG: 83	726	83	520	22.9	71.6	0.90
chr9	125373663	125373894	CpG: 19	231	19	139	16.5	60.2	0.92
chr9	125419965	125420655	CpG: 62	690	62	442	18.0	64.1	0.89
chr9	125474109	125474789	CpG: 56	680	56	435	16.5	64.0	0.81
chr9	125512704	125512923	CpG: 18	219	18	131	16.4	59.8	0.93
chr9	125532210	125532495	CpG: 23	285	23	179	16.1	62.8	0.84
chr9	125538793	125539250	CpG: 40	457	40	304	17.5	66.5	0.79
chr9	125548197	125548723	CpG: 71	526	71	407	27.0	77.4	0.92
chr9	125575218	125576217	CpG: 89	999	89	670	17.8	67.1	0.85
chr9	125599744	125600386	CpG: 55	642	55	458	17.1	71.3	0.68
chr9	125608840	125609627	CpG: 78	787	78	527	19.8	67.0	0.90
chr9	125610175	125610416	CpG: 21	241	21	143	17.4	59.3	1.03
chr9	125641961	125642388	CpG: 30	427	30	254	14.1	59.5	0.80
chr9	125662078	125662448	CpG: 43	370	43	276	23.2	74.6	0.84
chr9	125685726	125686007	CpG: 24	281	24	175	17.1	62.3	0.90
chr9	125782721	125782924	CpG: 18	203	18	139	17.7	68.5	0.76
chr9	125806056	125806317	CpG: 24	261	24	163	18.4	62.5	0.95
chr9	125886343	125886685	CpG: 31	342	31	237	18.1	69.3	0.76
chr9	126074393	126075283	CpG: 127	890	127	709	28.5	79.7	0.93
chr9	126099183	126099796	CpG: 58	613	58	399	18.9	65.1	1.22
chr9	126247727	126248778	CpG: 71	1051	71	644	13.5	61.3	0.72
chr9	126296639	126297974	CpG: 110	1335	110	939	16.5	70.3	0.67
chr9	126352662	126355226	CpG: 219	2564	219	1705	17.1	66.5	0.78
chr9	126366392	126366756	CpG: 30	364	30	248	16.5	68.1	0.72
chr9	126590288	126591088	CpG: 73	800	73	549	18.2	68.6	0.78
chr9	126696579	126698205	CpG: 180	1626	180	1154	22.1	71.0	0.88
chr9	126780025	126780526	CpG: 42	501	42	316	16.8	63.1	0.86
chr9	126789430	126789704	CpG: 24	274	24	171	17.5	62.4	0.91
chr9	126802517	126802749	CpG: 16	232	16	137	13.8	59.1	0.81
chr9	126803622	126804214	CpG: 93	592	93	477	31.4	80.6	0.98
chr9	126895090	126895514	CpG: 35	424	35	252	16.5	59.4	0.94
chr9	126944430	126944696	CpG: 25	266	25	165	18.8	62.0	0.99
chr9	127136773	127137055	CpG: 22	282	22	174	15.6	61.7	0.84
chr9	127548162	127548436	CpG: 25	274	25	171	18.2	62.4	0.95
chr9	128347135	128347948	CpG: 109	813	109	625	26.8	76.9	0.91
chr9	128460656	128460943	CpG: 22	287	22	175	15.3	61.0	0.84
chr9	128632230	128632504	CpG: 24	274	24	171	17.5	62.4	0.91
chr9	128827339	128827613	CpG: 24	274	24	172	17.5	62.8	0.90
chr9	128880107	128880505	CpG: 44	398	44	286	22.1	71.9	0.89
chr9	128907822	128908097	CpG: 24	275	24	170	17.5	61.8	0.92
chr9	128930927	128931201	CpG: 25	274	25	172	18.2	62.8	0.94
chr9	129033460	129034635	CpG: 90	1175	90	838	15.3	71.3	0.60
chr9	129265506	129265816	CpG: 24	310	24	192	15.5	61.9	0.81
chr9	129408372	129408585	CpG: 18	213	18	135	16.9	63.4	0.86
chr9	129606802	129609045	CpG: 200	2243	200	1501	17.8	66.9	0.80
chr9	129734807	129735073	CpG: 18	266	18	159	13.5	59.8	0.77
chr9	129836583	129837085	CpG: 44	502	44	364	17.5	72.5	0.67
chr9	129938828	129939244	CpG: 44	416	44	281	21.2	67.5	0.93
chr9	130045870	130046206	CpG: 27	336	27	240	16.1	71.4	0.63
chr9	130218178	130218413	CpG: 22	235	22	144	18.7	61.3	1.04
chr9	130579610	130579884	CpG: 22	274	22	171	16.1	62.4	0.84
chr9	130646339	130646613	CpG: 22	274	22	169	16.1	61.7	0.85
chr9	130861378	130861652	CpG: 24	274	24	171	17.5	62.4	0.91
chr9	130914586	130914871	CpG: 25	285	25	179	17.5	62.8	0.90
chr9	131003066	131003614	CpG: 58	548	58	406	21.2	74.1	0.77
chr9	131089362	131089602	CpG: 23	240	23	148	19.2	61.7	1.01
chr9	131094374	131094647	CpG: 23	273	23	166	16.8	60.8	0.92
chr9	131146983	131147264	CpG: 21	281	21	172	14.9	61.2	0.81
chr9	131237653	131237866	CpG: 19	213	19	131	17.8	61.5	0.96
chr9	131363464	131363758	CpG: 23	294	23	178	15.6	60.5	0.86
chr9	131441594	131441825	CpG: 18	231	18	135	15.6	58.4	0.92
chr9	131515167	131515442	CpG: 19	275	19	167	13.8	60.7	0.76
chr9	131562935	131564142	CpG: 122	1207	122	805	20.2	66.7	0.92
chr9	131793075	131793349	CpG: 24	274	24	170	17.5	62.0	0.92
chr9	131821124	131821485	CpG: 28	361	28	214	15.5	59.3	0.88
chr9	132249076	132249504	CpG: 32	428	32	258	15.0	60.3	0.83
chr9	132358134	132358410	CpG: 20	276	20	163	14.5	59.1	0.83
chr9	132486832	132487106	CpG: 25	274	25	172	18.2	62.8	0.94
chr9	132499094	132499459	CpG: 31	365	31	268	17.0	73.4	0.63
chr9	132689076	132691170	CpG: 191	2094	191	1623	18.2	77.5	0.61
chr9	132774174	132774561	CpG: 42	387	42	261	21.7	67.4	0.97
chr9	132794023	132794298	CpG: 23	275	23	168	16.7	61.1	0.91
chr9	132831061	132831267	CpG: 23	206	23	165	22.3	80.1	0.70
chr9	132909867	132911131	CpG: 156	1264	156	935	24.7	74.0	0.91
chr9	132989281	132989804	CpG: 63	523	63	373	24.1	71.3	0.95
chr9	133037459	133037695	CpG: 20	236	20	143	16.9	60.6	0.95
chr9	133038924	133039720	CpG: 67	796	67	519	16.8	65.2	0.79
chr9	133064977	133065543	CpG: 53	566	53	415	18.7	73.3	0.73
chr9	133072374	133073808	CpG: 163	1434	163	1040	22.7	72.5	0.86
chr9	133090614	133090953	CpG: 48	339	48	257	28.3	75.8	0.99
chr9	133092611	133092891	CpG: 25	280	25	172	17.9	61.4	0.95
chr9	133124611	133125515	CpG: 91	904	91	657	20.1	72.7	0.76
chr9	133126768	133126983	CpG: 18	215	18	131	16.7	60.9	0.91
chr9	133176735	133176972	CpG: 17	237	17	141	14.3	59.5	0.82
chr9	133189564	133189842	CpG: 20	278	20	171	14.4	61.5	0.77
chr9	133270531	133271414	CpG: 89	883	89	599	20.2	67.8	0.89
chr9	133397010	133398227	CpG: 130	1217	130	881	21.4	72.4	0.82
chr9	133398870	133399119	CpG: 25	249	25	155	20.1	62.2	1.05
chr9	133463998	133464399	CpG: 46	401	46	305	22.9	76.1	0.81
chr9	133495536	133496044	CpG: 66	508	66	390	26.0	76.8	0.88
chr9	133565769	133567013	CpG: 99	1244	99	797	15.9	64.1	0.79
chr9	133695566	133696347	CpG: 80	781	80	555	20.5	71.1	0.82
chr9	133746574	133746949	CpG: 34	375	34	264	18.1	70.4	0.74
chr9	133794186	133796130	CpG: 182	1944	182	1334	18.7	68.6	0.80
chr9	133847299	133847980	CpG: 80	681	80	510	23.5	74.9	0.84
chr9	133894677	133895900	CpG: 159	1223	159	940	26.0	76.9	0.88
chr9	133930087	133930368	CpG: 23	281	23	173	16.4	61.6	0.88
chr9	133932223	133932672	CpG: 46	449	46	333	20.5	74.2	0.79
chr9	133955955	133956255	CpG: 23	300	23	189	15.3	63.0	0.77
chr9	133968688	133969321	CpG: 48	633	48	445	15.2	70.3	0.62
chr9	134093778	134094024	CpG: 21	246	21	156	17.1	63.4	0.85
chr9	134290018	134291013	CpG: 110	995	110	728	22.1	73.2	0.83
chr9	134324138	134324571	CpG: 47	433	47	283	21.7	65.4	1.02
chr9	134355340	134355580	CpG: 18	240	18	140	15.0	58.3	0.90
chr9	134357141	134357361	CpG: 27	220	27	149	24.5	67.7	1.10
chr9	134373303	134373543	CpG: 18	240	18	144	15.0	60.0	0.86
chr9	134410967	134411906	CpG: 106	939	106	676	22.6	72.0	0.88
chr9	134414543	134414813	CpG: 25	270	25	175	18.5	64.8	0.89
chr9	134416749	134418049	CpG: 102	1300	102	818	15.7	62.9	0.79
chr9	134422956	134426449	CpG: 277	3493	277	2204	15.9	63.1	0.80
chr9	134462055	134462490	CpG: 51	435	51	286	23.4	65.7	1.08
chr9	134544210	134544847	CpG: 84	637	84	463	26.4	72.7	1.00
chr9	134603606	134604164	CpG: 56	558	56	415	20.1	74.4	0.73
chr9	134635362	134635636	CpG: 23	274	23	170	16.8	62.0	0.88
chr9	134713772	134714046	CpG: 24	274	24	171	17.5	62.4	0.91
chr9	134908255	134908676	CpG: 34	421	34	289	16.2	68.6	0.69
chr9	135009029	135009313	CpG: 25	284	25	174	17.6	61.3	0.95
chr9	135025488	135025997	CpG: 42	509	42	342	16.5	67.2	0.76
chr9	135026182	135026449	CpG: 19	267	19	158	14.2	59.2	0.82
chr9	135026703	135026923	CpG: 16	220	16	129	14.5	58.6	0.85
chr9	135031860	135032131	CpG: 20	271	20	166	14.8	61.3	0.80
chr9	135048995	135050179	CpG: 96	1184	96	854	16.2	72.1	0.62
chr9	135102061	135102751	CpG: 70	690	70	479	20.3	69.4	0.85
chr9	135110706	135111103	CpG: 31	397	31	228	15.6	57.4	0.96
chr9	135128642	135129079	CpG: 38	437	38	301	17.4	68.9	0.73
chr9	135138058	135138557	CpG: 46	499	46	352	18.4	70.5	0.77
chr9	135254285	135255163	CpG: 65	878	65	609	14.8	69.4	0.62
chr9	135415568	135415849	CpG: 24	281	24	176	17.1	62.6	0.89
chr9	135465257	135466252	CpG: 155	995	155	773	31.2	77.7	1.06
chr9	135536680	135536941	CpG: 19	261	19	162	14.6	62.1	0.77
chr9	135563659	135564337	CpG: 74	678	74	489	21.8	72.1	0.86
chr9	135568453	135568708	CpG: 19	255	19	169	14.9	66.3	0.68
chr9	135570862	135571648	CpG: 110	786	110	605	28.0	77.0	0.94
chr9	135589684	135590020	CpG: 28	336	28	188	16.7	56.0	1.07
chr9	136100939	136101213	CpG: 20	274	20	167	14.6	60.9	0.79
chr9	136127569	136128206	CpG: 97	637	97	516	30.5	81.0	0.97
chr9	136197348	136198305	CpG: 139	957	139	786	29.0	82.1	0.86
chr9	136206302	136216592	CpG: 685	10290	685	6297	13.3	61.2	0.71
chr9	136220660	136220864	CpG: 20	204	20	153	19.6	75.0	0.74
chr9	136238900	136239311	CpG: 43	411	43	295	20.9	71.8	0.82
chr9	136243150	136243821	CpG: 53	671	53	481	15.8	71.7	0.63
chr9	136455873	136456564	CpG: 120	691	120	567	34.7	82.1	1.06
chr9	136613141	136613593	CpG: 32	452	32	276	14.2	61.1	0.76
chr9	136648576	136649016	CpG: 36	440	36	295	16.4	67.0	0.75
chr9	136651243	136651974	CpG: 96	731	96	549	26.3	75.1	0.93
chr9	136675853	136676406	CpG: 56	553	56	406	20.3	73.4	0.76
chr9	136685491	136685942	CpG: 34	451	34	274	15.1	60.8	0.82
chr9	136701116	136704030	CpG: 319	2914	319	2078	21.9	71.3	0.86
chr9	136765067	136765341	CpG: 22	274	22	169	16.1	61.7	0.85
chr9	136786606	136787146	CpG: 34	540	34	312	12.6	57.8	0.75
chr9	136787455	136787680	CpG: 18	225	18	136	16.0	60.4	0.89
chr9	136797542	136797892	CpG: 33	350	33	204	18.9	58.3	1.12
chr9	136831415	136831639	CpG: 19	224	19	135	17.0	60.3	0.94
chr9	136948732	136948964	CpG: 16	232	16	140	13.8	60.3	0.78
chr9	136968018	136969669	CpG: 153	1651	153	1138	18.5	68.9	0.81
chr9	136975202	136976059	CpG: 99	857	99	643	23.1	75.0	0.83
chr9	136976337	136976613	CpG: 21	276	21	167	15.2	60.5	0.84
chr9	137008108	137008623	CpG: 52	515	52	329	20.2	63.9	1.00
chr9	137037022	137037401	CpG: 44	379	44	290	23.2	76.5	0.80
chr9	137051464	137051906	CpG: 52	442	52	328	23.5	74.2	0.86
chr9	137059586	137060738	CpG: 111	1152	111	761	19.3	66.1	0.89
chr9	137066863	137068294	CpG: 141	1431	141	995	19.7	69.5	0.82
chr9	137139109	137139896	CpG: 77	787	77	553	19.6	70.3	0.80
chr9	137206266	137206486	CpG: 17	220	17	132	15.5	60.0	0.87
chr9	137271470	137271744	CpG: 25	274	25	172	18.2	62.8	0.94
chr9	137282545	137282815	CpG: 19	270	19	167	14.1	61.9	0.75
chr9	137306303	137307146	CpG: 65	843	65	575	15.4	68.2	0.67
chr9	137341375	137342010	CpG: 72	635	72	490	22.7	77.2	0.80
chr9	137386437	137387081	CpG: 43	644	43	361	13.4	56.1	0.86
chr9	137387449	137388321	CpG: 96	872	96	597	22.0	68.5	0.94
chr9	137398116	137399182	CpG: 76	1066	76	657	14.3	61.6	0.75
chr9	137416371	137416616	CpG: 18	245	18	139	14.7	56.7	0.93
chr9	137438984	137440010	CpG: 88	1026	88	646	17.2	63.0	0.88
chr9	137453425	137453661	CpG: 22	236	22	145	18.6	61.4	1.01
chr9	137459453	137460630	CpG: 97	1177	97	754	16.5	64.1	0.82
chr9	137527951	137528192	CpG: 26	241	26	183	21.6	75.9	0.75
chr9	137607095	137608550	CpG: 138	1455	138	986	19.0	67.8	0.82
chr9	137609868	137610113	CpG: 20	245	20	175	16.3	71.4	0.66
chr9	137658011	137659363	CpG: 112	1352	112	992	16.6	73.4	0.61
chr9	137906790	137907320	CpG: 58	530	58	394	21.9	74.3	0.79
chr9	137945993	137948342	CpG: 320	2349	320	1788	27.2	76.1	0.94
chr9	138095104	138095410	CpG: 59	306	59	249	38.6	81.4	1.17
chr9	138221203	138221424	CpG: 16	221	16	144	14.5	65.2	0.75
chr9	138428385	138428803	CpG: 33	418	33	274	15.8	65.6	0.74
chr9	138428921	138429127	CpG: 16	206	16	143	15.5	69.4	0.67
chr9	138441652	138441948	CpG: 27	296	27	182	18.2	61.5	0.97
chr9	138532133	138533107	CpG: 142	974	142	792	29.2	81.3	0.88
chr9	138543846	138544049	CpG: 18	203	18	143	17.7	70.4	0.72
chr9	138688239	138688749	CpG: 41	510	41	337	16.1	66.1	0.74
chr9	138705048	138705343	CpG: 26	295	26	191	17.6	64.7	0.88
chr9	138719741	138720147	CpG: 56	406	56	311	27.6	76.6	0.95
chr9	138815904	138821258	CpG: 503	5354	503	3710	18.8	69.3	0.78
chr9	138829254	138832372	CpG: 220	3118	220	1918	14.1	61.5	0.75
chr9	138876913	138877117	CpG: 15	204	15	124	14.7	60.8	0.81
chr9	138881196	138881470	CpG: 24	274	24	171	17.5	62.4	0.91
chr9	138888418	138888905	CpG: 60	487	60	359	24.6	73.7	0.91
chr9	138896232	138896495	CpG: 25	263	25	169	19.0	64.3	0.92
chr9	138910845	138911455	CpG: 46	610	46	395	15.1	64.8	0.72
chr9	138927944	138928990	CpG: 97	1046	97	761	18.5	72.8	0.71
chr9	138967248	138967526	CpG: 22	278	22	173	15.8	62.2	0.83
chr9	139010247	139010906	CpG: 71	659	71	458	21.5	69.5	0.89
chr9	139038818	139039045	CpG: 19	227	19	141	16.7	62.1	0.87
chr9	139066061	139067024	CpG: 127	963	127	759	26.4	78.8	0.86
chr9	139120935	139122180	CpG: 145	1245	145	957	23.3	76.9	0.83
chr9	139146909	139147127	CpG: 16	218	16	127	14.7	58.3	0.87
chr9	139430729	139432484	CpG: 198	1755	198	1322	22.6	75.3	0.83
chr9	139451425	139451884	CpG: 39	459	39	302	17.0	65.8	0.81
chr9	139602974	139603257	CpG: 22	283	22	193	15.5	68.2	0.67
chr9	139603410	139604747	CpG: 140	1337	140	984	20.9	73.6	0.79
chr9	139610978	139611391	CpG: 29	413	29	279	14.0	67.6	0.62
chr9	139630939	139631823	CpG: 66	884	66	537	14.9	60.7	0.83
chr9	139657814	139659006	CpG: 103	1192	103	762	17.3	63.9	0.85
chr9	139715924	139716134	CpG: 16	210	16	136	15.2	64.8	0.73
chr9	139734086	139734315	CpG: 17	229	17	146	14.8	63.8	0.76
chr9	139775263	139776648	CpG: 143	1385	143	1042	20.6	75.2	0.73
chr9	139815353	139815663	CpG: 36	310	36	229	23.2	73.9	0.88
chr9	139818788	139819565	CpG: 102	777	102	585	26.3	75.3	0.93
chr9	139820032	139820474	CpG: 35	442	35	292	15.8	66.1	0.73
chr9	139884543	139884817	CpG: 23	274	23	169	16.8	61.7	0.89
chr9	139899173	139899383	CpG: 16	210	16	126	15.2	60.0	0.93
chr9	139906219	139906515	CpG: 28	296	28	196	18.9	66.2	0.87
chr9	139921871	139922889	CpG: 94	1018	94	693	18.5	68.1	0.81
chr9	139942427	139943011	CpG: 68	584	68	419	23.3	71.7	0.92
chr9	139949261	139950286	CpG: 68	1025	68	629	13.3	61.4	0.73
chr9	139961576	139963018	CpG: 137	1442	137	1071	19.0	74.3	0.69
chr9	139978628	139979114	CpG: 50	486	50	354	20.6	72.8	0.87
chr9	139992436	139994289	CpG: 211	1853	211	1390	22.8	75.0	0.82
chr9	139996781	139997003	CpG: 19	222	19	141	17.1	63.5	0.90
chr9	140010003	140010706	CpG: 81	703	81	510	23.0	72.5	0.93
chr9	140017107	140017504	CpG: 44	397	44	300	22.2	75.6	0.82
chr9	140032670	140033229	CpG: 42	559	42	387	15.0	69.2	0.67
chr9	140061754	140061993	CpG: 24	239	24	177	20.1	74.1	0.78
chr9	140084806	140085298	CpG: 56	492	56	364	22.8	74.0	0.83
chr9	140098436	140098670	CpG: 19	234	19	149	16.2	63.7	0.80
chr9	140106616	140107556	CpG: 106	940	106	719	22.6	76.5	0.77
chr9	140120041	140120453	CpG: 34	412	34	270	16.5	65.5	0.77
chr9	140124609	140125108	CpG: 61	499	61	374	24.4	74.9	0.90
chr9	140129444	140129866	CpG: 45	422	45	288	21.3	68.2	0.93
chr9	140134844	140135716	CpG: 67	872	67	599	15.4	68.7	0.67
chr9	140138325	140138832	CpG: 57	507	57	380	22.5	75.0	0.81
chr9	140145256	140145763	CpG: 44	507	44	325	17.4	64.1	0.85
chr9	140146154	140146452	CpG: 22	298	22	194	14.8	65.1	0.76
chr9	140152363	140152800	CpG: 33	437	33	284	15.1	65.0	0.72
chr9	140153157	140153359	CpG: 19	202	19	145	18.8	71.8	0.75
chr9	140159320	140159584	CpG: 21	264	21	162	15.9	61.4	0.86
chr9	140188008	140188979	CpG: 135	971	135	772	27.8	79.5	0.89
chr9	140207926	140208158	CpG: 16	232	16	139	13.8	59.9	0.78
chr9	140272081	140272347	CpG: 27	266	27	170	20.3	63.9	1.01
chr9	140274731	140274970	CpG: 20	239	20	170	16.7	71.1	0.69
chr9	140275232	140276646	CpG: 130	1414	130	904	18.4	63.9	0.91
chr9	140285194	140285458	CpG: 25	264	25	160	18.9	60.6	1.06
chr9	140335409	140336927	CpG: 167	1518	167	1063	22.0	70.0	0.90
chr9	140367009	140367937	CpG: 94	928	94	653	20.3	70.4	0.84
chr9	140398310	140400290	CpG: 159	1980	159	1267	16.1	64.0	0.78
chr9	140410265	140411317	CpG: 123	1052	123	770	23.4	73.2	0.88
chr9	140425720	140426137	CpG: 33	417	33	264	15.8	63.3	0.90
chr9	140441045	140441278	CpG: 21	233	21	165	18.0	70.8	0.73
chr9	140457289	140458264	CpG: 99	975	99	726	20.3	74.5	0.73
chr9	140482426	140483530	CpG: 91	1104	91	749	16.5	67.8	0.74
chr9	140502023	140502304	CpG: 24	281	24	174	17.1	61.9	0.90
chr9	140503258	140503493	CpG: 18	235	18	143	15.3	60.9	0.85
chr9	140529364	140530294	CpG: 94	930	94	602	20.2	64.7	0.97
chr9	140547244	140548121	CpG: 107	877	107	654	24.4	74.6	0.90
chr9	140560867	140561141	CpG: 24	274	24	171	17.5	62.4	0.91
chr9	140573516	140573755	CpG: 17	239	17	140	14.2	58.6	0.85
chr9	140578142	140578780	CpG: 48	638	48	408	15.0	63.9	0.74
chr9	140599169	140600746	CpG: 158	1577	158	1080	20.0	68.5	0.86
chr9	140608192	140608432	CpG: 17	240	17	143	14.2	59.6	0.83
chr9	140625734	140626011	CpG: 26	277	26	175	18.8	63.2	0.96
chr9	140627220	140628395	CpG: 117	1175	117	874	19.9	74.4	0.72
chr9	140662856	140664165	CpG: 144	1309	144	939	22.0	71.7	0.86
chr9	140711419	140711858	CpG: 47	439	47	301	21.4	68.6	0.92
chr9	140758789	140760057	CpG: 151	1268	151	937	23.8	73.9	0.87
chr9	140861363	140862139	CpG: 90	776	90	538	23.2	69.3	0.97
chr9	140893430	140895140	CpG: 251	1710	251	1332	29.4	77.9	0.97
chr9	140907103	140908313	CpG: 126	1210	126	865	20.8	71.5	0.83
chr9	140913761	140913999	CpG: 20	238	20	149	16.8	62.6	0.88
chr9	140928703	140929258	CpG: 59	555	59	398	21.3	71.7	0.83
chr9	140938614	140938849	CpG: 21	235	21	144	17.9	61.3	0.97
chr9	140976280	140977422	CpG: 105	1142	105	771	18.4	67.5	0.81
chr9	140984422	140985363	CpG: 70	941	70	659	14.9	70.0	0.61
chr9	140991791	140992117	CpG: 44	326	44	247	27.0	75.8	0.97
chr9	141022627	141022902	CpG: 21	275	21	164	15.3	59.6	0.87
chr9	141023112	141024123	CpG: 136	1011	136	737	26.9	72.9	1.01
chr9	141034275	141034770	CpG: 51	495	51	348	20.6	70.3	0.83
chr9	141086379	141087217	CpG: 87	838	87	577	20.8	68.9	0.88
chr9	141112352	141113562	CpG: 81	1210	81	716	13.4	59.2	0.77
chr9	141120141	141120376	CpG: 19	235	19	142	16.2	60.4	0.90
chr9	141126100	141126372	CpG: 24	272	24	168	17.6	61.8	0.95
chr9	141150483	141151694	CpG: 123	1211	123	827	20.3	68.3	0.87
chr9	141231326	141232122	CpG: 100	796	100	628	25.1	78.9	0.81
chr9	141239918	141240470	CpG: 54	552	54	384	19.6	69.6	0.86
chr9	141284116	141284933	CpG: 82	817	82	566	20.1	69.3	0.84
chr9	141313798	141315127	CpG: 140	1329	140	924	21.1	69.5	0.88
chr9	141347913	141348122	CpG: 15	209	15	124	14.4	59.3	0.84
chr9	141377468	141382224	CpG: 427	4756	427	3153	18.0	66.3	0.82
chr9	141406257	141406856	CpG: 52	599	52	407	17.4	67.9	0.77
chr9	141461886	141462295	CpG: 53	409	53	299	25.9	73.1	0.97
chr9	141522758	141523469	CpG: 49	711	49	457	13.8	64.3	0.67
chr9	141539012	141539505	CpG: 46	493	46	318	18.7	64.5	0.92
chr9	141554218	141554789	CpG: 47	571	47	406	16.5	71.1	0.65
chr9	141563405	141563683	CpG: 21	278	21	145	15.1	52.2	1.55
chr9	141585480	141586232	CpG: 82	752	82	532	21.8	70.7	0.88
chr9	141617787	141619156	CpG: 140	1369	140	960	20.5	70.1	0.83
chr9	141620830	141621121	CpG: 20	291	20	190	13.7	65.3	0.67
chr9	141625894	141626211	CpG: 29	317	29	193	18.3	60.9	0.99
chr9	141641515	141642259	CpG: 78	744	78	499	21.0	67.1	0.96
chr9	141643125	141643393	CpG: 19	268	19	162	14.2	60.4	0.78
chr9	141664924	141665200	CpG: 31	276	31	197	22.5	71.4	0.88
chr9	141686615	141687960	CpG: 143	1345	143	967	21.3	71.9	0.82
chr9	141692696	141693382	CpG: 86	686	86	501	25.1	73.0	0.94
chr9	141700292	141701386	CpG: 86	1094	86	740	15.7	67.6	0.70
chr9	141754458	141755194	CpG: 88	736	88	550	23.9	74.7	0.86
chr9	141773200	141773984	CpG: 87	784	87	598	22.2	76.3	0.78
chr9	141798340	141798557	CpG: 16	217	16	132	14.7	60.8	0.81
chr9	141801792	141802378	CpG: 58	586	58	436	19.8	74.4	0.72
chr9	141814631	141815466	CpG: 90	835	90	620	21.6	74.3	0.83
chr9	141824621	141825338	CpG: 87	717	87	548	24.3	76.4	0.83
chr9	141830669	141831073	CpG: 54	404	54	298	26.7	73.8	0.99
chr9	141846201	141847080	CpG: 106	879	106	650	24.1	73.9	0.88
chr9	141864276	141864580	CpG: 25	304	25	178	16.4	58.6	0.97
chr9	141869771	141871123	CpG: 152	1352	152	1006	22.5	74.4	0.84
chr9	141880242	141880474	CpG: 24	232	24	147	20.7	63.4	1.04
chr9	141888053	141888319	CpG: 20	266	20	161	15.0	60.5	0.84
chr9	141901903	141902333	CpG: 60	430	60	335	27.9	77.9	0.92
chr9	141923791	141924064	CpG: 37	273	37	194	27.1	71.1	1.07
chr9	141924717	141924957	CpG: 21	240	21	164	17.5	68.3	0.83
chr9	141942287	141942872	CpG: 45	585	45	402	15.4	68.7	0.65
chr9	141968493	141968725	CpG: 18	232	18	135	15.5	58.2	0.93
chr9	142006852	142008332	CpG: 134	1480	134	924	18.1	62.4	0.93
chr9	142009393	142009673	CpG: 19	280	19	161	13.6	57.5	0.83
chr9	142028479	142028858	CpG: 40	379	40	261	21.1	68.9	0.91
chr9	142039511	142040613	CpG: 108	1102	108	745	19.6	67.6	0.87
chr9	142072743	142073232	CpG: 38	489	38	326	15.5	66.7	0.71
chr9	142079205	142079640	CpG: 31	435	31	265	14.3	60.9	0.79
chr9	142090491	142090732	CpG: 21	241	21	177	17.4	73.4	0.65
chr9	142094798	142095111	CpG: 23	313	23	213	14.7	68.1	0.67
chr9	142242812	142243298	CpG: 33	486	33	279	13.6	57.4	0.82
chr9	142246742	142248466	CpG: 202	1724	202	1253	23.4	72.7	0.91
chr9	142253236	142253501	CpG: 20	265	20	158	15.1	59.6	0.87
chr9	142258213	142259063	CpG: 69	850	69	566	16.2	66.6	0.73
chr9	142268941	142269225	CpG: 24	284	24	175	16.9	61.6	0.91
chr9	142271430	142271705	CpG: 20	275	20	167	14.5	60.7	0.80
chr9	142285250	142285524	CpG: 21	274	21	167	15.3	60.9	0.84
chr9	142376662	142377992	CpG: 171	1330	171	1049	25.7	78.9	0.83
chr9	142452783	142453008	CpG: 18	225	18	136	16.0	60.4	0.88
chr9	142470340	142471166	CpG: 99	826	99	607	24.0	73.5	0.90
chr9	142482959	142483199	CpG: 19	240	19	146	15.8	60.8	0.88
chr9	142638154	142639038	CpG: 102	884	102	639	23.1	72.3	0.88
chr9	142649458	142650388	CpG: 93	930	93	675	20.0	72.6	0.76
chr9	142711428	142712150	CpG: 52	722	52	497	14.4	68.8	0.61
chr9	142742445	142742651	CpG: 16	206	16	134	15.5	65.0	0.73
chr9	142784214	142785081	CpG: 98	867	98	622	22.6	71.7	0.89
chr9	142854936	142855171	CpG: 16	235	16	141	13.6	60.0	0.78
chr9	142864109	142871984	CpG: 649	7875	649	5182	16.5	65.8	0.76
chr9	142881218	142881454	CpG: 18	236	18	143	15.3	60.6	0.84
chr9	142885965	142887212	CpG: 147	1247	147	924	23.6	74.1	0.87
chr9	142898647	142899016	CpG: 30	369	30	229	16.3	62.1	0.84
chr9	142917240	142918470	CpG: 112	1230	112	825	18.2	67.1	0.81
chr9	143039742	143040771	CpG: 114	1029	114	726	22.2	70.6	0.89
chr9	143067640	143067894	CpG: 18	254	18	152	14.2	59.8	0.79
chr9	143089906	143090365	CpG: 34	459	34	301	14.8	65.6	0.70
chr9	143108931	143109419	CpG: 39	488	39	311	16.0	63.7	0.79
chr9	143114997	143115389	CpG: 32	392	32	284	16.3	72.4	0.62
chr9	143118156	143118398	CpG: 24	242	24	157	19.8	64.9	0.94
chr9	143123905	143124145	CpG: 19	240	19	149	15.8	62.1	0.82
chr9	143128536	143128746	CpG: 20	210	20	143	19.0	68.1	0.82
chr9	143134488	143134937	CpG: 39	449	39	321	17.4	71.5	0.68
chr9	143143108	143145273	CpG: 254	2165	254	1589	23.5	73.4	0.88
chr9	143217197	143217848	CpG: 87	651	87	495	26.7	76.0	0.93
chr9	143220578	143220800	CpG: 16	222	16	142	14.4	64.0	0.71
chr9	143234593	143234804	CpG: 21	211	21	147	19.9	69.7	0.83
chr9	143304511	143305458	CpG: 108	947	108	704	22.8	74.3	0.83
chr9	143332585	143332859	CpG: 23	274	23	171	16.8	62.4	0.88
chr9	143333629	143334151	CpG: 55	522	55	349	21.1	66.9	0.95
chr9	143432070	143432300	CpG: 17	230	17	138	14.8	60.0	0.83
chr9	143476938	143477209	CpG: 19	271	19	158	14.0	58.3	0.84
chr9	143484748	143486440	CpG: 245	1692	245	1311	29.0	77.5	0.97
chr9	143491055	143491577	CpG: 56	522	56	374	21.5	71.6	0.84
chr9	143516219	143516502	CpG: 29	283	29	194	20.5	68.6	0.89
chr9	143522412	143522785	CpG: 29	373	29	231	15.5	61.9	0.82
chr9	143528933	143529164	CpG: 17	231	17	138	14.7	59.7	0.84
chr9	143558879	143559172	CpG: 25	293	25	180	17.1	61.4	0.92
chr9	143568585	143568811	CpG: 16	226	16	135	14.2	59.7	0.80
chr9	143582788	143583571	CpG: 69	783	69	487	17.6	62.2	0.91
chr9	143603151	143604358	CpG: 173	1207	173	984	28.7	81.5	0.86
chr9	143688220	143689220	CpG: 66	1000	66	641	13.2	64.1	0.65
chr9	143714867	143716299	CpG: 127	1432	127	908	17.7	63.4	0.89
chr9	143731705	143731945	CpG: 24	240	24	163	20.0	67.9	0.87
chr9	143741892	143742135	CpG: 24	243	24	164	19.8	67.5	0.87
chr9	143743600	143744955	CpG: 140	1355	140	976	20.7	72.0	0.80
chr9	143767428	143768245	CpG: 107	817	107	621	26.2	76.0	0.91
chr9	143770991	143771233	CpG: 17	242	17	163	14.0	67.4	0.62
chr9	143780290	143780526	CpG: 19	236	19	141	16.1	59.7	0.93
chr9	143952221	143953194	CpG: 156	973	156	783	32.1	80.5	1.00
chr9	143975235	143975676	CpG: 39	441	39	315	17.7	71.4	0.69
chr9	144037024	144037406	CpG: 34	382	34	239	17.8	62.6	0.91
chr9	144041590	144041792	CpG: 15	202	15	108	14.9	53.5	1.04
chr9	144055156	144055466	CpG: 24	310	24	177	15.5	57.1	0.96
chr9	144062125	144062396	CpG: 26	271	26	184	19.2	67.9	0.83
chr9	144120636	144121616	CpG: 75	980	75	681	15.3	69.5	0.63
chr9	144252271	144252550	CpG: 25	279	25	175	17.9	62.7	0.92
chr9	144293616	144293991	CpG: 33	375	33	232	17.6	61.9	0.93
chr9	144296945	144297149	CpG: 17	204	17	123	16.7	60.3	0.93
chr9	144375830	144379093	CpG: 288	3263	288	2157	17.7	66.1	0.81
chr9	144388155	144388912	CpG: 58	757	58	466	15.3	61.6	0.85
chr9	144412631	144413121	CpG: 50	490	50	319	20.4	65.1	0.96
chr9	144423869	144424185	CpG: 29	316	29	223	18.4	70.6	0.77
chr9	144455259	144457041	CpG: 182	1782	182	1287	20.4	72.2	0.79
chr9	144469180	144469419	CpG: 20	239	20	144	16.7	60.3	0.94
chr9	144568715	144570230	CpG: 140	1515	140	961	18.5	63.4	0.92
chr9	144578989	144579198	CpG: 18	209	18	129	17.2	61.7	0.92
chr9	144620763	144621374	CpG: 42	611	42	352	13.7	57.6	0.83
chr9	144624367	144625093	CpG: 79	726	79	527	21.8	72.6	0.83
chr9	144700482	144701462	CpG: 63	980	63	577	12.9	58.9	0.74
chr9	144790983	144794403	CpG: 247	3420	247	2189	14.4	64.0	0.70
chr9	144797747	144802052	CpG: 308	4305	308	2794	14.3	64.9	0.68
chr9	144879842	144880085	CpG: 19	243	19	148	15.6	60.9	0.86
chr9	144880834	144882295	CpG: 152	1461	152	1010	20.8	69.1	0.87
chr9	144919910	144920307	CpG: 29	397	29	244	14.6	61.5	0.78
chr9	144981288	144981939	CpG: 47	651	47	431	14.4	66.2	0.67
chr9	145089712	145090810	CpG: 114	1098	114	757	20.8	68.9	0.88
chr9	145155954	145156957	CpG: 84	1003	84	679	16.7	67.7	0.73
chr9	145205610	145205817	CpG: 17	207	17	140	16.4	67.6	0.75
chr9	145244025	145245376	CpG: 108	1351	108	835	16.0	61.8	0.84
chr9	145285355	145285787	CpG: 56	432	56	360	25.9	83.3	0.79
chr9	145334682	145335667	CpG: 113	985	113	731	22.9	74.2	0.84
chr9	145358407	145358833	CpG: 40	426	40	301	18.8	70.7	0.78
chr9	145362842	145363811	CpG: 137	969	137	751	28.3	77.5	0.95
chr9	145377126	145378287	CpG: 106	1161	106	823	18.3	70.9	0.73
chr9	145413585	145414093	CpG: 44	508	44	324	17.3	63.8	0.87
chr9	145438996	145439310	CpG: 23	314	23	207	14.6	65.9	0.68
chr9	145445828	145446049	CpG: 19	221	19	130	17.2	58.8	1.00
chr9	145469525	145470307	CpG: 64	782	64	520	16.4	66.5	0.74
chr9	145488490	145490158	CpG: 178	1668	178	1214	21.3	72.8	0.81
chr9	145545765	145546264	CpG: 52	499	52	346	20.8	69.3	0.89
chr9	145549662	145550337	CpG: 74	675	74	438	21.9	64.9	1.04
chr9	145560985	145561196	CpG: 17	211	17	138	16.1	65.4	0.86
chr9	145561311	145562845	CpG: 127	1534	127	1003	16.6	65.4	0.77
chr9	145570213	145571044	CpG: 97	831	97	626	23.3	75.3	0.83
chr9	145589395	145590638	CpG: 157	1243	157	956	25.3	76.9	0.85
chr9	145631468	145631752	CpG: 24	284	24	175	16.9	61.6	0.89
chr9	145631988	145632791	CpG: 73	803	73	537	18.2	66.9	0.82
chr9	145642874	145644544	CpG: 157	1670	157	1207	18.8	72.3	0.84
chr9	145673996	145675076	CpG: 101	1080	101	769	18.7	71.2	0.74
chr9	145689333	145689548	CpG: 18	215	18	149	16.7	69.3	0.71
chr9	145693265	145694050	CpG: 83	785	83	583	21.1	74.3	0.77
chr9	145748254	145749161	CpG: 73	907	73	644	16.1	71.0	0.64
chr9	145753547	145753910	CpG: 33	363	33	254	18.2	70.0	0.74
chr9	145763050	145763353	CpG: 25	303	25	184	16.5	60.7	0.91
chr9	145768421	145768690	CpG: 23	269	23	193	17.1	71.7	0.66
chr9	145775029	145775295	CpG: 21	266	21	170	15.8	63.9	0.77
chr9	145776449	145777047	CpG: 81	598	81	479	27.1	80.1	0.86
chr9	145782243	145782502	CpG: 30	259	30	183	23.2	70.7	0.95
chr9	145793002	145793479	CpG: 43	477	43	335	18.0	70.2	0.74
chr9	145799886	145800150	CpG: 19	264	19	155	14.4	58.7	0.84
chr9	145825052	145825630	CpG: 86	578	86	458	29.8	79.2	0.95
chr9	145916974	145917297	CpG: 24	323	24	212	14.9	65.6	0.69
chr9	145918085	145918536	CpG: 36	451	36	304	16.0	67.4	0.70
chr9	145960012	145960388	CpG: 35	376	35	282	18.6	75.0	0.66
chr9	146009962	146010180	CpG: 16	218	16	139	14.7	63.8	0.74
chr9	146028121	146028385	CpG: 21	264	21	183	15.9	69.3	0.67
chr9	146062866	146063101	CpG: 18	235	18	138	15.3	58.7	0.90
chr9	146078128	146078342	CpG: 17	214	17	136	15.9	63.6	0.80
chr9	146108280	146108813	CpG: 37	533	37	352	13.9	66.0	0.64
chr9	146130537	146130741	CpG: 16	204	16	106	15.7	52.0	1.38
chr9	146183865	146184068	CpG: 19	203	19	134	18.7	66.0	0.86
chr9	146194110	146194476	CpG: 28	366	28	247	15.3	67.5	0.67
chr9	146205912	146208363	CpG: 295	2451	295	1836	24.1	74.9	0.86
chr9	146226622	146230032	CpG: 495	3410	495	2428	29.0	71.2	1.15
chr9	146241277	146242262	CpG: 95	985	95	695	19.3	70.6	0.78
chr9	146263835	146264513	CpG: 52	678	52	446	15.3	65.8	0.71
chr9	146265276	146265490	CpG: 18	214	18	152	16.8	71.0	0.67
chr9	146269312	146269522	CpG: 19	210	19	147	18.1	70.0	0.74
chr9	146269957	146270190	CpG: 19	233	19	156	16.3	67.0	0.75
chr9	146282812	146284617	CpG: 274	1805	274	1393	30.4	77.2	1.02
chr9	146284993	146285229	CpG: 17	236	17	135	14.4	57.2	0.89
chr9	146291507	146292050	CpG: 43	543	43	380	15.8	70.0	0.65
chr9	146310897	146311160	CpG: 18	263	18	157	13.7	59.7	0.77
chr9	146325796	146326032	CpG: 16	236	16	141	13.6	59.7	0.79
chr9	146349081	146350611	CpG: 170	1530	170	1094	22.2	71.5	0.88
chr9	146367218	146367493	CpG: 23	275	23	189	16.7	68.7	0.71
chr9	146368031	146368278	CpG: 20	247	20	161	16.2	65.2	0.76
chr9	146377063	146379316	CpG: 202	2253	202	1363	17.9	60.5	0.98
chr9	146433767	146434200	CpG: 31	433	31	264	14.3	61.0	0.78
chr9	146495932	146496218	CpG: 22	286	22	173	15.4	60.5	0.86
chr9	146540394	146542300	CpG: 279	1906	279	1470	29.3	77.1	0.99
chr9	146553058	146553263	CpG: 16	205	16	143	15.6	69.8	0.66
chr9	146575447	146575783	CpG: 26	336	26	228	15.5	67.9	0.67
chr9	146623827	146624074	CpG: 22	247	22	176	17.8	71.3	0.72
chr9	146625472	146625832	CpG: 27	360	27	242	15.0	67.2	0.70
chr9	146655948	146656278	CpG: 22	330	22	216	13.3	65.5	0.63
chr9	146672740	146673091	CpG: 28	351	28	251	16.0	71.5	0.63
chr9	146681339	146683645	CpG: 151	2306	151	1637	13.1	71.0	0.75
chr9	146718002	146718770	CpG: 80	768	80	474	20.8	61.7	1.10
chr9	146800148	146800501	CpG: 24	353	24	203	13.6	57.5	0.83
chr9	146809366	146809575	CpG: 17	209	17	140	16.3	67.0	0.73
chr9	146858884	146859922	CpG: 138	1038	138	787	26.6	75.8	0.93
chr9	146861840	146862118	CpG: 21	278	21	208	15.1	74.8	0.67
chr9	146950238	146950976	CpG: 65	738	65	474	17.6	64.2	1.11
chr9	146989814	146990043	CpG: 16	229	16	128	14.0	55.9	1.00
chr9	147022072	147022406	CpG: 25	334	25	185	15.0	55.4	0.98
chr9	147039093	147039422	CpG: 24	329	24	217	14.6	66.0	0.68
chr9	147048443	147048664	CpG: 15	221	15	140	13.6	63.3	0.68
chr9	147060147	147060463	CpG: 23	316	23	186	14.6	58.9	0.84
chr9	147063414	147063736	CpG: 24	322	24	220	14.9	68.3	0.67
chr9	147212646	147213034	CpG: 34	388	34	285	17.5	73.5	0.65
chr9	147293882	147294112	CpG: 18	230	18	140	15.7	60.9	0.86
chr9	147297262	147298018	CpG: 87	756	87	565	23.0	74.7	0.83
chr9	147308696	147311003	CpG: 229	2307	229	1673	19.9	72.5	0.76
chr9	147328984	147329202	CpG: 17	218	17	152	15.6	69.7	0.64
chr9	147330109	147330314	CpG: 17	205	17	134	16.6	65.4	0.78
chr9	147343510	147343719	CpG: 18	209	18	137	17.2	65.6	0.80
chr9	147355802	147356003	CpG: 18	201	18	132	17.9	65.7	0.88
chr9	147399855	147400059	CpG: 16	204	16	137	15.7	67.2	0.70
chr9	147467973	147468239	CpG: 28	266	28	190	21.1	71.4	0.83
chr9	147471430	147471650	CpG: 18	220	18	157	16.4	71.4	0.65
chr9	147475872	147476135	CpG: 19	263	19	146	14.4	55.5	1.06
chr9	147477525	147477740	CpG: 21	215	21	150	19.5	69.8	0.82
chr9	147482325	147483320	CpG: 84	995	84	634	16.9	63.7	0.96
chr9	147525517	147525838	CpG: 24	321	24	203	15.0	63.2	0.78
chr9	147640233	147640449	CpG: 30	216	30	165	27.8	76.4	0.95
chr9	147706965	147708641	CpG: 228	1676	228	1326	27.2	79.1	0.87
chr9	147713450	147713679	CpG: 19	229	19	143	16.6	62.4	0.85
chr9	147713990	147714199	CpG: 17	209	17	130	16.3	62.2	0.85
chr9	147715539	147715823	CpG: 26	284	26	209	18.3	73.6	0.68
chr9	147716064	147716294	CpG: 19	230	19	139	16.5	60.4	0.95
chr9	147727626	147729503	CpG: 189	1877	189	1318	20.1	70.2	0.82
chr9	147745510	147745742	CpG: 20	232	20	138	17.2	59.5	0.98
chr9	147772423	147772703	CpG: 24	280	24	174	17.1	62.1	0.90
chr9	147784602	147784815	CpG: 18	213	18	130	16.9	61.0	0.93
chr9	147886865	147887071	CpG: 17	206	17	109	16.5	52.9	1.27
chr9	147926274	147926495	CpG: 22	221	22	161	19.9	72.9	0.83
chr9	147928518	147929255	CpG: 75	737	75	521	20.4	70.7	0.81
chr9	147941172	147941937	CpG: 105	765	105	598	27.5	78.2	0.90
chr9	147961777	147962022	CpG: 20	245	20	174	16.3	71.0	0.65
chr9	147963315	147963963	CpG: 78	648	78	502	24.1	77.5	0.81
chr9	147971942	147972202	CpG: 21	260	21	186	16.2	71.5	0.64
chr9	147995793	147996480	CpG: 50	687	50	464	14.6	67.5	0.67
chr9	148005866	148006095	CpG: 23	229	23	161	20.1	70.3	0.87
chr9	148007992	148008228	CpG: 19	236	19	162	16.1	68.6	0.70
chr9	148009868	148010357	CpG: 38	489	38	298	15.5	60.9	0.84
chr9	148013239	148013721	CpG: 46	482	46	356	19.1	73.9	0.70
chr9	148016135	148016413	CpG: 22	278	22	193	15.8	69.4	0.66
chr9	148019135	148019348	CpG: 16	213	16	142	15.0	66.7	0.68
chr9	148045030	148046353	CpG: 105	1323	105	844	15.9	63.8	0.79
chr9	148060206	148060480	CpG: 25	274	25	169	18.2	61.7	0.97
chr9	148132164	148132382	CpG: 16	218	16	128	14.7	58.7	0.88
chr9	148134038	148135901	CpG: 260	1863	260	1448	27.9	77.7	0.93
chr9	148158812	148159102	CpG: 25	290	25	187	17.2	64.5	0.83
chr9	148188051	148189015	CpG: 120	964	120	714	24.9	74.1	0.91
chr9	148208811	148209461	CpG: 49	650	49	435	15.1	66.9	0.68
chr9	148217391	148217627	CpG: 22	236	22	163	18.6	69.1	0.80
chr9	148223522	148224092	CpG: 39	570	39	325	13.7	57.0	0.84
chr9	148235506	148235783	CpG: 30	277	30	167	21.7	60.3	1.31
chr9	148239677	148240266	CpG: 70	589	70	422	23.8	71.6	0.93
chr9	148278026	148280664	CpG: 232	2638	232	1889	17.6	71.6	0.69
chr9	148303751	148304570	CpG: 54	819	54	523	13.2	63.9	0.65
chr9	148322944	148324953	CpG: 257	2009	257	1551	25.6	77.2	0.86
chr9	148328565	148328826	CpG: 30	261	30	207	23.0	79.3	1.33
chr9	148330500	148331237	CpG: 56	737	56	492	15.2	66.8	0.69
chr9	148345591	148348867	CpG: 297	3276	297	2293	18.1	70.0	0.74
chr9	148352176	148352625	CpG: 31	449	31	304	13.8	67.7	0.60
chr9	148361897	148363428	CpG: 140	1531	140	1124	18.3	73.4	0.68
chr9	148407506	148407782	CpG: 22	276	22	193	15.9	69.9	0.69
chr9	148422210	148423905	CpG: 191	1695	191	1263	22.5	74.5	0.81
chr9	148428117	148434953	CpG: 526	6836	526	4621	15.4	67.6	0.67
chr9	148466215	148466451	CpG: 18	236	18	151	15.3	64.0	0.75
chr9	148475000	148475695	CpG: 104	695	104	542	29.9	78.0	1.01
chr9	148479805	148480083	CpG: 21	278	21	182	15.1	65.5	0.72
chr9	148481303	148482107	CpG: 75	804	75	593	18.7	73.8	0.71
chr9	148496783	148497236	CpG: 46	453	46	331	20.3	73.1	0.76
chr9	148519982	148520222	CpG: 21	240	21	178	17.5	74.2	0.64
chr9	148522092	148522418	CpG: 28	326	28	214	17.2	65.6	0.80
chr9	148525380	148525669	CpG: 20	289	20	192	13.8	66.4	0.64
chr9	148542179	148542402	CpG: 16	223	16	130	14.3	58.3	0.86
chr9	148556791	148557353	CpG: 88	562	88	463	31.3	82.4	0.92
chr9	148563772	148564185	CpG: 30	413	30	279	14.5	67.6	0.66
chr9	148566232	148566484	CpG: 21	252	21	168	16.7	66.7	0.75
chr9	148571731	148572473	CpG: 56	742	56	527	15.1	71.0	0.62
chr9	148574666	148574912	CpG: 19	246	19	171	15.4	69.5	0.64
chr9	148581466	148581703	CpG: 25	237	25	140	21.1	59.1	1.21
chr9	148590406	148590895	CpG: 36	489	36	324	14.7	66.3	0.67
chr9	148592721	148593954	CpG: 135	1233	135	872	21.9	70.7	0.88
chr9	148596883	148597278	CpG: 33	395	33	287	16.7	72.7	0.65
chr9	148600073	148600772	CpG: 51	699	51	475	14.6	68.0	0.64
chr9	148619609	148619843	CpG: 17	234	17	140	14.5	59.8	0.83
chr9	148628968	148629790	CpG: 103	822	103	623	25.1	75.8	0.88
chr9	148636421	148636728	CpG: 28	307	28	198	18.2	64.5	0.88
chr9	148639277	148640673	CpG: 152	1396	152	966	21.8	69.2	0.91
chr9	148647639	148647848	CpG: 21	209	21	146	20.1	69.9	0.83
chr9	148648233	148648467	CpG: 16	234	16	139	13.7	59.4	0.78
chr9	148652351	148653696	CpG: 91	1345	91	816	13.5	60.7	0.74
chr9	148660923	148661936	CpG: 75	1013	75	683	14.8	67.4	0.65
chr9	148663183	148663591	CpG: 27	408	27	272	13.2	66.7	0.61
chr9	148667109	148669141	CpG: 202	2032	202	1437	19.9	70.7	0.80
chr9	148676358	148676561	CpG: 19	203	19	128	18.7	63.1	0.96
chr9	148680276	148680505	CpG: 18	229	18	151	15.7	65.9	0.72
chr9	148684159	148684441	CpG: 21	282	21	191	14.9	67.7	0.67
chr9	148695319	148695779	CpG: 39	460	39	300	17.0	65.2	0.80
chr9	148701820	148702044	CpG: 17	224	17	140	15.2	62.5	0.78
chr9	148703120	148703385	CpG: 18	265	18	174	13.6	65.7	0.66
chr9	148709747	148709973	CpG: 17	226	17	135	15.0	59.7	0.85
chr9	148711749	148713827	CpG: 240	2078	240	1527	23.1	73.5	0.87
chr9	148721880	148722460	CpG: 37	580	37	357	12.8	61.6	0.67
chr9	148726049	148726634	CpG: 47	585	47	403	16.1	68.9	0.68
chr9	148727836	148728507	CpG: 49	671	49	438	14.6	65.3	0.69
chr9	148729667	148729934	CpG: 27	267	27	183	20.2	68.5	0.87
chr9	148730853	148731688	CpG: 65	835	65	581	15.6	69.6	0.65
chr9	148732060	148732358	CpG: 21	298	21	195	14.1	65.4	0.66
chr9	148733688	148735036	CpG: 110	1348	110	931	16.3	69.1	0.68
chr9	148735526	148736217	CpG: 57	691	57	475	16.5	68.7	0.70
chr9	148737336	148737549	CpG: 17	213	17	142	16.0	66.7	0.72
chr9	148738717	148739074	CpG: 28	357	28	237	15.7	66.4	0.71
chr9	148740313	148740519	CpG: 16	206	16	141	15.5	68.4	0.67
chr9	148743592	148743892	CpG: 22	300	22	200	14.7	66.7	0.66
chr9	148744371	148744866	CpG: 39	495	39	341	15.8	68.9	0.67
chr9	148746806	148747044	CpG: 23	238	23	158	19.3	66.4	0.88
chr9	148751753	148752156	CpG: 36	403	36	295	17.9	73.2	0.67
chr9	148755733	148756139	CpG: 30	406	30	280	14.8	69.0	0.62
chr9	148761621	148761946	CpG: 29	325	29	230	17.8	70.8	0.73
chr9	148763565	148763774	CpG: 18	209	18	136	17.2	65.1	0.81
chr9	148776448	148778939	CpG: 282	2491	282	1786	22.6	71.7	0.88
chr9	148843785	148844247	CpG: 33	462	33	278	14.3	60.2	0.79
chr9	148860323	148860596	CpG: 23	273	23	189	16.8	69.2	0.77
chr9	148864405	148866111	CpG: 104	1706	104	1000	12.2	58.6	0.71
chr9	148886738	148886959	CpG: 19	221	19	153	17.2	69.2	0.72
chr9	148887422	148887673	CpG: 19	251	19	157	15.1	62.5	0.79
chr9	148889784	148890089	CpG: 20	305	20	202	13.1	66.2	0.60
chr9	148891476	148891798	CpG: 23	322	23	214	14.3	66.5	0.65
chr9	148892188	148892444	CpG: 21	256	21	184	16.4	71.9	0.66
chr9	148898333	148899534	CpG: 170	1201	170	982	28.3	81.8	0.85
chr9	148903528	148903815	CpG: 29	287	29	186	20.2	64.8	0.97
chr9	148919702	148921348	CpG: 164	1646	164	1221	19.9	74.2	0.73
chr9	148925557	148925781	CpG: 19	224	19	152	17.0	67.9	0.74
chr9	148927761	148927989	CpG: 17	228	17	160	14.9	70.2	0.61
chr9	148929170	148929494	CpG: 23	324	23	217	14.2	67.0	0.63
chr9	148934587	148934872	CpG: 20	285	20	177	14.0	62.1	0.73
chr9	148944930	148946164	CpG: 154	1234	154	942	25.0	76.3	0.86
chr9	148956351	148956860	CpG: 43	509	43	351	16.9	69.0	0.71
chr9	148960968	148962154	CpG: 146	1186	146	878	24.6	74.0	0.90
chr9	148972788	148973007	CpG: 19	219	19	150	17.4	68.5	0.74
chr9	148979366	148979611	CpG: 21	245	21	177	17.1	72.2	0.85
chr9	148993623	148993880	CpG: 24	257	24	177	18.7	68.9	0.79
chr9	149002965	149003463	CpG: 58	498	58	428	23.3	85.9	0.93
chr9	149023679	149024407	CpG: 70	728	70	543	19.2	74.6	0.72
chr9	149032412	149033525	CpG: 84	1113	84	761	15.1	68.4	0.65
chr9	149041504	149042933	CpG: 186	1429	186	1075	26.0	75.2	0.92
chr9	149053213	149053441	CpG: 17	228	17	137	14.9	60.1	0.85
chr9	149055380	149056158	CpG: 97	778	97	582	24.9	74.8	0.90
chr9	149065964	149066187	CpG: 20	223	20	154	17.9	69.1	0.79
chr9	149073440	149073706	CpG: 19	266	19	175	14.3	65.8	0.66
chr9	149074595	149074835	CpG: 25	240	25	182	20.8	75.8	0.74
chr9	149078026	149084348	CpG: 686	6322	686	4527	21.7	71.6	0.85
chr9	149100036	149101459	CpG: 146	1423	146	973	20.5	68.4	0.88
chr9	149119797	149120018	CpG: 18	221	18	132	16.3	59.7	0.92
chr9	149120128	149121249	CpG: 152	1121	152	855	27.1	76.3	0.94
chr9	149124044	149124413	CpG: 44	369	44	241	23.8	65.3	1.15
chr9	149142308	149142855	CpG: 43	547	43	351	15.7	64.2	0.77
chr9	149175325	149179348	CpG: 330	4023	330	2804	16.4	69.7	0.68
chr9	149184201	149184602	CpG: 42	401	42	296	20.9	73.8	0.78
chr9	149187231	149187489	CpG: 18	258	18	170	14.0	65.9	0.64
chr9	149187572	149187797	CpG: 19	225	19	153	16.9	68.0	0.73
chr9	149212192	149213468	CpG: 131	1276	131	953	20.5	74.7	0.78
chr9	149219232	149220539	CpG: 102	1307	102	942	15.6	72.1	0.60
chr9	149226214	149230302	CpG: 285	4088	285	2776	13.9	67.9	0.61
chr9	149241919	149242192	CpG: 21	273	21	186	15.4	68.1	0.67
chr9	149244401	149244777	CpG: 39	376	39	260	20.7	69.1	0.88
chr9	149249844	149250623	CpG: 55	779	55	515	14.1	66.1	0.65
chr9	149251475	149252851	CpG: 95	1376	95	910	13.8	66.1	0.63
chr9	149254735	149255017	CpG: 22	282	22	195	15.6	69.1	0.69
chr9	149257161	149257475	CpG: 26	314	26	217	16.6	69.1	0.70
chr9	149262180	149263430	CpG: 182	1250	182	965	29.1	77.2	0.98
chr9	149265226	149265979	CpG: 58	753	58	503	15.4	66.8	0.69
chr9	149280455	149281813	CpG: 152	1358	152	1004	22.4	73.9	0.82
chr9	149283772	149284388	CpG: 61	616	61	441	19.8	71.6	0.77
chr9	149289408	149290439	CpG: 126	1031	126	797	24.4	77.3	0.82
chr9	149305616	149306747	CpG: 141	1131	141	836	24.9	73.9	0.91
chr9	149312947	149315408	CpG: 225	2461	225	1735	18.3	70.5	0.74
chr9	149321834	149323323	CpG: 160	1489	160	1059	21.5	71.1	0.85
chr9	149339317	149339725	CpG: 29	408	29	235	14.2	57.6	0.90
chr9	149341195	149341547	CpG: 23	352	23	200	13.1	56.8	0.85
chr9	149348653	149348859	CpG: 18	206	18	149	17.5	72.3	0.67
chr9	149351691	149352903	CpG: 165	1212	165	942	27.2	77.7	0.90
chr9	149367196	149368459	CpG: 153	1263	153	908	24.2	71.9	0.94
chr9	149370109	149370385	CpG: 21	276	21	163	15.2	59.1	0.88
chr9	149376673	149377614	CpG: 132	941	132	678	28.1	72.1	1.09
chr9	149383351	149383958	CpG: 53	607	53	417	17.5	68.7	0.75
chr9	149385569	149386292	CpG: 55	723	55	474	15.2	65.6	0.71
chr9	149394290	149394958	CpG: 66	668	66	471	19.8	70.5	0.81
chr9	149398139	149398362	CpG: 17	223	17	137	15.2	61.4	0.82
chr9	149411519	149411723	CpG: 16	204	16	138	15.7	67.6	0.71
chr9	149412020	149412310	CpG: 22	290	22	195	15.2	67.2	0.67
chr9	149412539	149413291	CpG: 56	752	56	521	14.9	69.3	0.62
chr9	149418390	149418607	CpG: 17	217	17	143	15.7	65.9	0.73
chr9	149422540	149422975	CpG: 35	435	35	298	16.1	68.5	0.69
chr9	149425676	149427064	CpG: 145	1388	145	973	20.9	70.1	0.85
chr9	149437093	149438968	CpG: 217	1875	217	1416	23.1	75.5	0.81
chr9	149442540	149443684	CpG: 118	1144	118	780	20.6	68.2	0.89
chr9	149450719	149450992	CpG: 23	273	23	161	16.8	59.0	0.99
chr9	149454966	149455209	CpG: 19	243	19	158	15.6	65.0	0.78
chr9	149458017	149458607	CpG: 47	590	47	403	15.9	68.3	0.69
chr9	149459203	149461683	CpG: 233	2480	233	1833	18.8	73.9	0.69
chr9	149471779	149472240	CpG: 35	461	35	323	15.2	70.1	0.62
chr9	149477923	149479785	CpG: 210	1862	210	1348	22.6	72.4	0.86
chr9	149492316	149493719	CpG: 155	1403	155	1019	22.1	72.6	0.85
chr9	149500609	149500867	CpG: 24	258	24	169	18.6	65.5	0.88
chr9	149510397	149510650	CpG: 20	253	20	182	15.8	71.9	0.61
chr9	149516206	149519698	CpG: 348	3492	348	2479	19.9	71.0	0.79
chr9	149532771	149534534	CpG: 192	1763	192	1299	21.8	73.7	0.80
chr9	149538969	149540943	CpG: 291	1974	291	1504	29.5	76.2	1.02
chr9	149553978	149554741	CpG: 79	763	79	590	20.7	77.3	0.70
chr9	149560333	149562206	CpG: 151	1873	151	1317	16.1	70.3	0.70
chr9	149575505	149577960	CpG: 236	2455	236	1583	19.2	64.5	0.93
chr9	149602595	149602960	CpG: 32	365	32	263	17.5	72.1	0.69
chr9	149618055	149618778	CpG: 65	723	65	542	18.0	75.0	0.67
chr9	149620490	149621157	CpG: 56	667	56	451	16.8	67.6	0.73
chr9	149623839	149624119	CpG: 23	280	23	187	16.4	66.8	0.74
chr9	149624608	149624881	CpG: 24	273	24	168	17.6	61.5	0.94
chr9	149628589	149630344	CpG: 113	1755	113	1139	12.9	64.9	0.82
chr9	149632492	149632798	CpG: 32	306	32	227	20.9	74.2	1.34
chr9	149641798	149642383	CpG: 42	585	42	402	14.4	68.7	0.61
chr9	149644811	149645190	CpG: 27	379	27	273	14.2	72.0	0.87
chr9	149649150	149649645	CpG: 49	495	49	329	19.8	66.5	1.05
chr9	149657497	149657985	CpG: 54	488	54	367	22.1	75.2	0.79
chr9	149658887	149659120	CpG: 17	233	17	137	14.6	58.8	0.87
chr9	149662378	149662601	CpG: 16	223	16	150	14.3	67.3	0.64
chr9	149667060	149668623	CpG: 157	1563	157	1122	20.1	71.8	0.78
chr9	149673329	149674832	CpG: 184	1503	184	1175	24.5	78.2	0.80
chr9	149685624	149685880	CpG: 23	256	23	180	18.0	70.3	0.75
chr9	149686790	149687028	CpG: 20	238	20	176	16.8	73.9	0.61
chr9	149689005	149689258	CpG: 21	253	21	180	16.6	71.1	0.66
chr9	149691857	149692467	CpG: 62	610	62	465	20.3	76.2	0.70
chr9	149699703	149700055	CpG: 26	352	26	238	14.8	67.6	0.65
chr9	149703560	149704040	CpG: 41	480	41	337	17.1	70.2	0.70
chr9	149705386	149705652	CpG: 22	266	22	188	16.5	70.7	0.66
chr9	149708500	149709726	CpG: 146	1226	146	949	23.8	77.4	0.80
chr9	149711996	149712669	CpG: 55	673	55	464	16.3	68.9	0.69
chr9	149716888	149717262	CpG: 26	374	26	247	13.9	66.0	0.83
chr9	149731147	149731362	CpG: 17	215	17	143	15.8	66.5	0.71
chr9	149745105	149745532	CpG: 29	427	29	289	13.6	67.7	0.61
chr9	149750999	149751536	CpG: 42	537	42	361	15.6	67.2	0.69
chr9	149752778	149755041	CpG: 344	2263	344	1980	30.4	87.5	1.28
chr9	149759618	149759822	CpG: 17	204	17	121	16.7	59.3	0.97
chr9	149775303	149775647	CpG: 31	344	31	225	18.0	65.4	0.85
chr9	149776335	149776565	CpG: 19	230	19	152	16.5	66.1	0.76
chr9	149796437	149796665	CpG: 17	228	17	144	14.9	63.2	0.76
chr9	149804338	149805593	CpG: 160	1255	160	921	25.5	73.4	0.95
chr9	149829892	149831207	CpG: 120	1315	120	869	18.3	66.1	0.84
chr9	149841433	149842936	CpG: 218	1503	218	1163	29.0	77.4	0.97
chr9	149856441	149858121	CpG: 199	1680	199	1309	23.7	77.9	0.82
chr9	149859681	149859915	CpG: 19	234	19	146	16.2	62.4	0.85
chr9	149870122	149871202	CpG: 160	1080	160	831	29.6	76.9	1.00
chr9	149920995	149922701	CpG: 126	1706	126	1136	14.8	66.6	0.90
chr9	149928852	149929174	CpG: 27	322	27	186	16.8	57.8	1.02
chr9	149930876	149931161	CpG: 22	285	22	167	15.4	58.6	0.91
chr9	149946646	149947581	CpG: 70	935	70	640	15.0	68.4	0.65
chr9	149973289	149973529	CpG: 24	240	24	155	20.0	64.6	1.05
chr9	149982362	149982625	CpG: 19	263	19	158	14.4	60.1	0.95
chr9	149998628	149998846	CpG: 16	218	16	129	14.7	59.2	0.85
chr9	150009747	150009962	CpG: 21	215	21	135	19.5	62.8	1.03
chr9	150026175	150026408	CpG: 21	233	21	142	18.0	60.9	0.99
chr9	150038243	150039748	CpG: 134	1505	134	874	17.8	58.1	1.38
chr9	150047043	150047697	CpG: 59	654	59	447	18.0	68.3	0.78
chr9	150067796	150068056	CpG: 19	260	19	174	14.6	66.9	0.66
chr9	150068229	150068749	CpG: 70	520	70	370	26.9	71.2	1.10
chr9	150072836	150073050	CpG: 19	214	19	139	17.8	65.0	0.84
chr9	150076915	150077534	CpG: 60	619	60	409	19.4	66.1	0.98
chr9	150090896	150091272	CpG: 28	376	28	243	14.9	64.6	0.72
chr9	150091888	150093306	CpG: 132	1418	132	961	18.6	67.8	0.81
chr9	150098939	150099184	CpG: 26	245	26	164	21.2	66.9	1.58
chr9	150111648	150111849	CpG: 16	201	16	126	15.9	62.7	0.85
chr9	150141992	150144205	CpG: 268	2213	268	1673	24.2	75.6	0.86
chr9	150147823	150148099	CpG: 19	276	19	167	13.8	60.5	0.75
chr9	150186400	150187541	CpG: 83	1141	83	649	14.5	56.9	0.90
chr9	150225775	150226185	CpG: 29	410	29	296	14.1	72.2	0.79
chr9	150288090	150289278	CpG: 148	1188	148	905	24.9	76.2	0.87
chr9	150312163	150312381	CpG: 18	218	18	145	16.5	66.5	0.75
chr9	150322302	150322540	CpG: 19	238	19	146	16.0	61.3	0.87
chr9	150385477	150385704	CpG: 19	227	19	162	16.7	71.4	0.66
chr9	150413214	150413665	CpG: 49	451	49	307	21.7	68.1	0.94
chr9	150415354	150416280	CpG: 81	926	81	590	17.5	63.7	0.87
chr9	150440373	150441368	CpG: 78	995	78	688	15.7	69.1	0.66
chr9	150482196	150482656	CpG: 45	460	45	289	19.6	62.8	0.99
chr9	150550118	150550439	CpG: 22	321	22	221	13.7	68.8	0.60
chr9	150550846	150551057	CpG: 16	211	16	151	15.2	71.6	0.64
chr9	150612896	150614039	CpG: 168	1143	168	854	29.4	74.7	1.07
chr10	2540	5025	CpG: 378	2485	378	1901	30.4	76.5	1.05
chr10	41608	42322	CpG: 59	714	59	498	16.5	69.7	0.68
chr10	66440	67164	CpG: 70	724	70	480	19.3	66.3	0.89
chr10	68933	69614	CpG: 67	681	67	443	19.7	65.1	0.93
chr10	107930	108196	CpG: 22	266	22	168	16.5	63.2	0.85
chr10	127546	129416	CpG: 259	1870	259	1401	27.7	74.9	1.00
chr10	180291	180561	CpG: 22	270	22	165	16.3	61.1	0.89
chr10	231419	231623	CpG: 16	204	16	121	15.7	59.3	0.91
chr10	293726	294050	CpG: 32	324	32	225	19.8	69.4	0.84
chr10	314715	317096	CpG: 257	2381	257	1619	21.6	68.0	1.04
chr10	320643	320870	CpG: 19	227	19	139	16.7	61.2	0.90
chr10	335067	335317	CpG: 19	250	19	151	15.2	60.4	0.84
chr10	339156	341689	CpG: 210	2533	210	1492	16.6	58.9	1.22
chr10	342851	343085	CpG: 21	234	21	158	17.9	67.5	0.80
chr10	344622	344907	CpG: 24	285	24	180	16.8	63.2	0.88
chr10	351258	351469	CpG: 22	211	22	134	20.9	63.5	1.12
chr10	356830	357152	CpG: 25	322	25	200	15.5	62.1	0.81
chr10	360707	360979	CpG: 24	272	24	171	17.6	62.9	0.90
chr10	361325	361562	CpG: 20	237	20	155	16.9	65.4	0.79
chr10	369529	369789	CpG: 23	260	23	174	17.7	66.9	0.79
chr10	392245	392467	CpG: 16	222	16	139	14.4	62.6	0.74
chr10	405658	406024	CpG: 27	366	27	231	14.8	63.1	0.78
chr10	412576	413044	CpG: 40	468	40	284	17.1	60.7	0.93
chr10	464847	465126	CpG: 23	279	23	178	16.5	63.8	0.81
chr10	474763	475085	CpG: 21	322	21	202	13.0	62.7	0.67
chr10	479757	480143	CpG: 31	386	31	228	16.1	59.1	0.93
chr10	526038	526271	CpG: 20	233	20	151	17.2	64.8	0.82
chr10	526997	527234	CpG: 17	237	17	147	14.3	62.0	0.76
chr10	530680	530961	CpG: 23	281	23	174	16.4	61.9	0.87
chr10	564855	565128	CpG: 22	273	22	168	16.1	61.5	0.86
chr10	580735	581376	CpG: 55	641	55	421	17.2	65.7	0.97
chr10	602685	602954	CpG: 18	269	18	154	13.4	57.2	0.82
chr10	619775	620041	CpG: 18	266	18	180	13.5	67.7	0.62
chr10	628967	630220	CpG: 95	1253	95	776	15.2	61.9	0.79
chr10	635738	637574	CpG: 134	1836	134	1151	14.6	62.7	0.74
chr10	663126	663625	CpG: 35	499	35	288	14.0	57.7	0.84
chr10	668223	669530	CpG: 132	1307	132	797	20.2	61.0	1.09
chr10	675644	676161	CpG: 36	517	36	372	13.9	72.0	0.84
chr10	685565	687095	CpG: 224	1530	224	1187	29.3	77.6	0.97
chr10	694119	694358	CpG: 17	239	17	155	14.2	64.9	0.68
chr10	720440	720690	CpG: 23	250	23	159	18.4	63.6	0.93
chr10	725189	725610	CpG: 49	421	49	262	23.3	62.2	1.48
chr10	781883	783146	CpG: 95	1263	95	898	15.0	71.1	0.61
chr10	785051	785315	CpG: 20	264	20	177	15.2	67.0	0.67
chr10	791446	792083	CpG: 54	637	54	352	17.0	55.3	1.15
chr10	802932	803357	CpG: 40	425	40	306	18.8	72.0	0.76
chr10	807458	807717	CpG: 23	259	23	164	17.8	63.3	0.90
chr10	928588	930748	CpG: 240	2160	240	1668	22.2	77.2	0.80
chr10	953653	953854	CpG: 15	201	15	117	14.9	58.2	0.91
chr10	956654	957013	CpG: 23	359	23	228	12.8	63.5	1.75
chr10	972937	973805	CpG: 60	868	60	493	13.8	56.8	0.88
chr10	985078	986200	CpG: 96	1122	96	742	17.1	66.1	0.79
chr10	986400	986637	CpG: 17	237	17	140	14.3	59.1	0.86
chr10	988941	989219	CpG: 23	278	23	173	16.5	62.2	0.86
chr10	1030134	1030405	CpG: 20	271	20	166	14.8	61.3	0.79
chr10	1031381	1031611	CpG: 18	230	18	139	15.7	60.4	0.87
chr10	1045007	1046268	CpG: 138	1261	138	847	21.9	67.2	0.98
chr10	1052483	1054036	CpG: 142	1553	142	1030	18.3	66.3	0.85
chr10	1098694	1099031	CpG: 39	337	39	219	23.1	65.0	1.10
chr10	1122640	1122890	CpG: 17	250	17	145	13.6	58.0	0.84
chr10	1156151	1156640	CpG: 55	489	55	323	22.5	66.1	1.08
chr10	1160102	1160309	CpG: 20	207	20	128	19.3	61.8	1.01
chr10	1169965	1170217	CpG: 21	252	21	157	16.7	62.3	0.86
chr10	1179726	1179940	CpG: 18	214	18	131	16.8	61.2	0.90
chr10	1181650	1182051	CpG: 33	401	33	263	16.5	65.6	0.77
chr10	1186527	1186750	CpG: 19	223	19	143	17.0	64.1	0.97
chr10	1202997	1203546	CpG: 35	549	35	338	12.8	61.6	0.67
chr10	1240685	1240956	CpG: 23	271	23	189	17.0	69.7	0.71
chr10	1300709	1300935	CpG: 17	226	17	132	15.0	58.4	0.88
chr10	1325204	1326336	CpG: 86	1132	86	833	15.2	73.6	0.72
chr10	1361365	1362925	CpG: 170	1560	170	1125	21.8	72.1	0.85
chr10	1372711	1372942	CpG: 24	231	24	150	20.8	64.9	1.03
chr10	1462942	1464293	CpG: 100	1351	100	935	14.8	69.2	0.62
chr10	1474408	1474742	CpG: 28	334	28	219	16.8	65.6	0.81
chr10	1540774	1541021	CpG: 18	247	18	159	14.6	64.4	0.70
chr10	1551121	1551344	CpG: 18	223	18	126	16.1	56.5	1.02
chr10	1558139	1558369	CpG: 26	230	26	157	22.6	68.3	0.97
chr10	1671437	1671757	CpG: 25	320	25	227	15.6	70.9	0.84
chr10	1698381	1699323	CpG: 71	942	71	589	15.1	62.5	0.87
chr10	1722919	1723126	CpG: 15	207	15	132	14.5	63.8	0.72
chr10	1733981	1735215	CpG: 94	1234	94	826	15.2	66.9	0.68
chr10	1744285	1744662	CpG: 33	377	33	189	17.5	50.1	1.48
chr10	1747597	1747827	CpG: 20	230	20	142	17.4	61.7	0.93
chr10	1770794	1771078	CpG: 21	284	21	178	14.8	62.7	0.78
chr10	1807314	1807591	CpG: 21	277	21	171	15.2	61.7	0.80
chr10	1949749	1950414	CpG: 46	665	46	427	13.8	64.2	0.68
chr10	2032815	2033089	CpG: 22	274	22	169	16.1	61.7	0.85
chr10	2273009	2273244	CpG: 20	235	20	141	17.0	60.0	0.97
chr10	2313287	2313694	CpG: 48	407	48	296	23.6	72.7	0.90
chr10	2315343	2315614	CpG: 21	271	21	167	15.5	61.6	0.83
chr10	2335674	2335967	CpG: 26	293	26	183	17.7	62.5	0.92
chr10	2338885	2339151	CpG: 21	266	21	163	15.8	61.3	0.86
chr10	2375720	2375950	CpG: 17	230	17	131	14.8	57.0	0.92
chr10	2499929	2500650	CpG: 76	721	76	433	21.1	60.1	1.36
chr10	2544414	2544650	CpG: 21	236	21	143	17.8	60.6	0.98
chr10	2577145	2577558	CpG: 33	413	33	265	16.0	64.2	0.78
chr10	2772364	2772830	CpG: 33	466	33	288	14.2	61.8	0.74
chr10	2806041	2806422	CpG: 30	381	30	248	15.7	65.1	0.75
chr10	2836168	2836441	CpG: 20	273	20	169	14.7	61.9	0.78
chr10	2865462	2865758	CpG: 21	296	21	183	14.2	61.8	0.79
chr10	2889523	2889895	CpG: 26	372	26	219	14.0	58.9	0.81
chr10	3067559	3070328	CpG: 310	2769	310	2016	22.4	72.8	0.85
chr10	3103266	3103502	CpG: 21	236	21	146	17.8	61.9	0.95
chr10	3105019	3105320	CpG: 30	301	30	192	19.9	63.8	0.98
chr10	3119978	3120197	CpG: 24	219	24	134	21.9	61.2	1.18
chr10	3131051	3131447	CpG: 29	396	29	245	14.6	61.9	0.77
chr10	3139226	3139630	CpG: 28	404	28	250	13.9	61.9	0.73
chr10	3173311	3174272	CpG: 92	961	92	633	19.1	65.9	0.88
chr10	3193502	3193739	CpG: 19	237	19	144	16.0	60.8	0.88
chr10	3320158	3321092	CpG: 77	934	77	646	16.5	69.2	0.69
chr10	3322434	3322700	CpG: 24	266	24	192	18.0	72.2	0.70
chr10	3325294	3325630	CpG: 23	336	23	212	13.7	63.1	0.70
chr10	3334270	3334534	CpG: 19	264	19	157	14.4	59.5	0.83
chr10	3346163	3346392	CpG: 18	229	18	140	15.7	61.1	0.86
chr10	3401832	3402078	CpG: 33	246	33	154	26.8	62.6	1.63
chr10	3461091	3461651	CpG: 38	560	38	312	13.6	55.7	0.91
chr10	3462469	3462705	CpG: 16	236	16	128	13.6	54.2	0.96
chr10	3560174	3560629	CpG: 37	455	37	271	16.3	59.6	0.93
chr10	3711890	3712168	CpG: 22	278	22	174	15.8	62.6	0.82
chr10	3785491	3785719	CpG: 19	228	19	154	16.7	67.5	0.74
chr10	3788555	3789828	CpG: 153	1273	153	919	24.0	72.2	0.93
chr10	4324266	4324484	CpG: 16	218	16	131	14.7	60.1	0.82
chr10	4516146	4516371	CpG: 17	225	17	134	15.1	59.6	0.87
chr10	4524100	4524370	CpG: 24	270	24	164	17.8	60.7	0.98
chr10	4533063	4533388	CpG: 25	325	25	195	15.4	60.0	0.88
chr10	4681273	4681509	CpG: 17	236	17	139	14.4	58.9	0.86
chr10	4826290	4827114	CpG: 83	824	83	570	20.1	69.2	0.84
chr10	5247121	5247548	CpG: 32	427	32	256	15.0	60.0	0.84
chr10	5377260	5377504	CpG: 16	244	16	155	13.1	63.5	0.66
chr10	5415852	5416266	CpG: 45	414	45	299	21.7	72.2	0.84
chr10	5434313	5434549	CpG: 17	236	17	142	14.4	60.2	0.82
chr10	5449870	5450072	CpG: 18	202	18	144	17.8	71.3	0.70
chr10	5502059	5502789	CpG: 65	730	65	498	17.8	68.2	0.77
chr10	5514830	5515072	CpG: 18	242	18	158	14.9	65.3	0.71
chr10	5515616	5515881	CpG: 23	265	23	173	17.4	65.3	0.87
chr10	5528427	5529133	CpG: 62	706	62	468	17.6	66.3	0.80
chr10	5580333	5580609	CpG: 23	276	23	188	16.7	68.1	1.56
chr10	5580964	5581231	CpG: 24	267	24	183	18.0	68.5	1.52
chr10	5619962	5620364	CpG: 44	402	44	323	21.9	80.3	0.82
chr10	5628642	5628945	CpG: 23	303	23	191	15.2	63.0	0.77
chr10	5645553	5645783	CpG: 21	230	21	144	18.3	62.6	0.95
chr10	5652243	5652725	CpG: 33	482	33	292	13.7	60.6	0.84
chr10	5669773	5670631	CpG: 115	858	115	636	26.8	74.1	0.98
chr10	5688287	5689530	CpG: 127	1243	127	814	20.4	65.5	0.96
chr10	5816504	5817763	CpG: 144	1259	144	904	22.9	71.8	0.89
chr10	5844120	5844452	CpG: 23	332	23	203	13.9	61.1	0.75
chr10	5889479	5891202	CpG: 217	1723	217	1306	25.2	75.8	0.88
chr10	5977675	5978865	CpG: 140	1190	140	895	23.5	75.2	0.84
chr10	6088988	6089976	CpG: 117	988	117	709	23.7	71.8	0.92
chr10	6144743	6146081	CpG: 154	1338	154	987	23.0	73.8	0.85
chr10	6155413	6155693	CpG: 20	280	20	172	14.3	61.4	0.77
chr10	6163729	6164448	CpG: 85	719	85	530	23.6	73.7	0.88
chr10	6189105	6189349	CpG: 17	244	17	142	13.9	58.2	0.84
chr10	6201222	6204716	CpG: 326	3494	326	2358	18.7	67.5	0.82
chr10	6206720	6206976	CpG: 26	256	26	196	20.3	76.6	0.69
chr10	6207422	6207723	CpG: 25	301	25	194	16.6	64.5	0.80
chr10	6215268	6215470	CpG: 16	202	16	129	15.8	63.9	0.82
chr10	6220740	6220964	CpG: 20	224	20	149	17.9	66.5	0.81
chr10	6330413	6330886	CpG: 38	473	38	293	16.1	61.9	0.84
chr10	6375498	6375807	CpG: 25	309	25	184	16.2	59.5	0.92
chr10	6395308	6395541	CpG: 19	233	19	142	16.3	60.9	0.89
chr10	6580069	6580802	CpG: 87	733	87	561	23.7	76.5	0.81
chr10	6665800	6666105	CpG: 24	305	24	171	15.7	56.1	1.01
chr10	6706364	6706616	CpG: 20	252	20	156	15.9	61.9	0.85
chr10	7171653	7171914	CpG: 30	261	30	193	23.0	73.9	0.84
chr10	7367275	7367501	CpG: 21	226	21	137	18.6	60.6	1.02
chr10	7407366	7413329	CpG: 437	5963	437	3685	14.7	61.8	0.78
chr10	7430556	7430835	CpG: 24	279	24	175	17.2	62.7	0.88
chr10	7519931	7520168	CpG: 18	237	18	143	15.2	60.3	0.86
chr10	7577333	7577571	CpG: 18	238	18	165	15.1	69.3	0.64
chr10	7580674	7580906	CpG: 22	232	22	147	19.0	63.4	0.95
chr10	7667518	7667979	CpG: 51	461	51	363	22.1	78.7	0.74
chr10	7788395	7789324	CpG: 77	929	77	633	16.6	68.1	0.72
chr10	7819047	7819893	CpG: 79	846	79	582	18.7	68.8	0.79
chr10	7916173	7916446	CpG: 20	273	20	163	14.7	59.7	0.83
chr10	7936122	7936349	CpG: 17	227	17	137	15.0	60.4	0.86
chr10	8009866	8010140	CpG: 36	274	36	208	26.3	75.9	0.94
chr10	8034923	8036182	CpG: 98	1259	98	846	15.6	67.2	0.69
chr10	8036750	8037298	CpG: 41	548	41	352	15.0	64.2	0.73
chr10	8050291	8057246	CpG: 543	6955	543	4347	15.6	62.5	0.80
chr10	8059301	8059685	CpG: 33	384	33	274	17.2	71.4	0.75
chr10	8339210	8339484	CpG: 22	274	22	167	16.1	60.9	0.87
chr10	8368457	8368693	CpG: 23	236	23	147	19.5	62.3	1.03
chr10	8493418	8493703	CpG: 26	285	26	181	18.2	63.5	0.91
chr10	8712740	8712959	CpG: 17	219	17	130	15.5	59.4	0.90
chr10	9003973	9004306	CpG: 26	333	26	194	15.6	58.3	0.94
chr10	9186140	9186531	CpG: 41	391	41	289	21.0	73.9	0.77
chr10	9187074	9187292	CpG: 19	218	19	126	17.4	57.8	1.09
chr10	9197106	9197342	CpG: 21	236	21	146	17.8	61.9	0.94
chr10	9219745	9220020	CpG: 23	275	23	169	16.7	61.5	0.89
chr10	9275796	9276402	CpG: 54	606	54	441	17.8	72.8	0.67
chr10	9411988	9412925	CpG: 69	937	69	601	14.7	64.1	0.72
chr10	9473767	9474042	CpG: 23	275	23	170	16.7	61.8	0.88
chr10	9488584	9488805	CpG: 18	221	18	131	16.3	59.3	0.93
chr10	9530299	9530580	CpG: 24	281	24	175	17.1	62.3	0.90
chr10	9606904	9607174	CpG: 23	270	23	169	17.0	62.6	0.88
chr10	9629631	9629899	CpG: 22	268	22	165	16.4	61.6	0.88
chr10	9716027	9716301	CpG: 24	274	24	171	17.5	62.4	0.91
chr10	9941997	9942263	CpG: 23	266	23	166	17.3	62.4	0.90
chr10	9976971	9977244	CpG: 20	273	20	163	14.7	59.7	0.83
chr10	10661303	10661612	CpG: 25	309	25	184	16.2	59.5	0.92
chr10	10677008	10677282	CpG: 25	274	25	171	18.2	62.4	0.95
chr10	11027740	11029055	CpG: 199	1315	199	1018	30.3	77.4	1.03
chr10	11175944	11176746	CpG: 61	802	61	517	15.2	64.5	0.73
chr10	11355932	11356175	CpG: 18	243	18	135	14.8	55.6	0.96
chr10	11356388	11356961	CpG: 54	573	54	383	18.8	66.8	0.84
chr10	11474633	11475177	CpG: 41	544	41	332	15.1	61.0	0.81
chr10	11622275	11623413	CpG: 150	1138	150	828	26.4	72.8	1.01
chr10	11638551	11638825	CpG: 23	274	23	170	16.8	62.0	0.88
chr10	11748485	11748913	CpG: 31	428	31	257	14.5	60.0	0.81
chr10	11753484	11754407	CpG: 111	923	111	678	24.1	73.5	0.89
chr10	11806881	11807193	CpG: 21	312	21	192	13.5	61.5	1.17
chr10	11834578	11835437	CpG: 114	859	114	655	26.5	76.3	0.92
chr10	11881003	11881864	CpG: 93	861	93	657	21.6	76.3	0.75
chr10	11905487	11906379	CpG: 69	892	69	599	15.5	67.2	0.70
chr10	11930956	11931234	CpG: 22	278	22	169	15.8	60.8	0.86
chr10	11939741	11939945	CpG: 16	204	16	124	15.7	60.8	0.86
chr10	11997195	11997469	CpG: 20	274	20	166	14.6	60.6	0.81
chr10	12053528	12054723	CpG: 96	1195	96	804	16.1	67.3	0.72
chr10	12055555	12055793	CpG: 17	238	17	137	14.3	57.6	0.87
chr10	12080012	12080615	CpG: 65	603	65	437	21.6	72.5	0.82
chr10	12130607	12130883	CpG: 20	276	20	170	14.5	61.6	0.78
chr10	12140181	12141317	CpG: 130	1136	130	803	22.9	70.7	0.92
chr10	12205156	12205442	CpG: 22	286	22	172	15.4	60.1	0.85
chr10	12206076	12206323	CpG: 22	247	22	144	17.8	58.3	1.06
chr10	12207103	12207648	CpG: 46	545	46	317	16.9	58.2	1.00
chr10	12315126	12315400	CpG: 20	274	20	167	14.6	60.9	0.80
chr10	12342276	12342549	CpG: 25	273	25	170	18.3	62.3	0.95
chr10	12350648	12350931	CpG: 23	283	23	174	16.3	61.5	0.87
chr10	12360087	12361938	CpG: 221	1851	221	1338	23.9	72.3	0.91
chr10	12518837	12519115	CpG: 23	278	23	173	16.5	62.2	0.86
chr10	12535083	12535951	CpG: 65	868	65	609	15.0	70.2	0.61
chr10	12544615	12544889	CpG: 21	274	21	167	15.3	60.9	0.83
chr10	12629015	12629247	CpG: 17	232	17	143	14.7	61.6	0.80
chr10	12638359	12638640	CpG: 24	281	24	175	17.1	62.3	0.90
chr10	12748152	12748532	CpG: 29	380	29	222	15.3	58.4	0.90
chr10	12865091	12865329	CpG: 19	238	19	140	16.0	58.8	0.95
chr10	13015459	13016333	CpG: 98	874	98	657	22.4	75.2	0.80
chr10	13114109	13114824	CpG: 71	715	71	512	19.9	71.6	0.78
chr10	13131791	13132027	CpG: 16	236	16	141	13.6	59.7	0.78
chr10	13134658	13134900	CpG: 19	242	19	143	15.7	59.1	0.93
chr10	13140920	13141206	CpG: 24	286	24	179	16.8	62.6	0.87
chr10	13176058	13176412	CpG: 43	354	43	249	24.3	70.3	1.02
chr10	13177406	13177621	CpG: 17	215	17	131	15.8	60.9	0.86
chr10	13272711	13272922	CpG: 18	211	18	153	17.1	72.5	0.66
chr10	13302319	13302555	CpG: 18	236	18	143	15.3	60.6	0.86
chr10	13312446	13313275	CpG: 93	829	93	608	22.4	73.3	0.84
chr10	13314065	13314341	CpG: 20	276	20	166	14.5	60.1	0.81
chr10	13315288	13315551	CpG: 21	263	21	170	16.0	64.6	0.76
chr10	13315659	13315903	CpG: 17	244	17	148	13.9	60.7	0.79
chr10	13355048	13355311	CpG: 19	263	19	161	14.4	61.2	0.78
chr10	13360128	13361989	CpG: 231	1861	231	1329	24.8	71.4	0.98
chr10	13375885	13376126	CpG: 23	241	23	154	19.1	63.9	0.97
chr10	13396962	13397203	CpG: 18	241	18	149	14.9	61.8	0.81
chr10	13452785	13452992	CpG: 18	207	18	130	17.4	62.8	0.96
chr10	13484943	13485223	CpG: 23	280	23	149	16.4	53.2	1.17
chr10	13486221	13486463	CpG: 19	242	19	135	15.7	55.8	1.01
chr10	13487207	13487789	CpG: 55	582	55	321	18.9	55.2	1.24
chr10	13541187	13542439	CpG: 191	1252	191	1012	30.5	80.8	0.93
chr10	13599790	13600267	CpG: 36	477	36	295	15.1	61.8	0.81
chr10	13669583	13670561	CpG: 107	978	107	686	21.9	70.1	0.89
chr10	13904560	13905262	CpG: 95	702	95	515	27.1	73.4	1.04
chr10	13980149	13980444	CpG: 22	295	22	180	14.9	61.0	0.81
chr10	14051115	14051386	CpG: 19	271	19	160	14.0	59.0	0.81
chr10	14207445	14207660	CpG: 16	215	16	129	14.9	60.0	0.84
chr10	14248254	14248493	CpG: 18	239	18	145	15.1	60.7	0.86
chr10	14508815	14509094	CpG: 25	279	25	176	17.9	63.1	0.91
chr10	14617686	14618639	CpG: 153	953	153	771	32.1	80.9	0.98
chr10	14806920	14807156	CpG: 17	236	17	142	14.4	60.2	0.82
chr10	14823002	14823274	CpG: 21	272	21	168	15.4	61.8	0.82
chr10	14851735	14853007	CpG: 125	1272	125	873	19.7	68.6	0.85
chr10	14892286	14893654	CpG: 158	1368	158	964	23.1	70.5	0.93
chr10	14906991	14907264	CpG: 22	273	22	172	16.1	63.0	0.82
chr10	14908353	14908631	CpG: 26	278	26	175	18.7	62.9	0.96
chr10	14967633	14968389	CpG: 64	756	64	489	16.9	64.7	0.81
chr10	14972575	14972849	CpG: 20	274	20	167	14.6	60.9	0.80
chr10	14973231	14973799	CpG: 51	568	51	383	18.0	67.4	0.79
chr10	14974436	14974711	CpG: 21	275	21	161	15.3	58.5	0.89
chr10	15009932	15010457	CpG: 50	525	50	335	19.0	63.8	0.94
chr10	15039894	15040179	CpG: 25	285	25	178	17.5	62.5	0.92
chr10	15102362	15102889	CpG: 59	527	59	390	22.4	74.0	0.82
chr10	15110940	15111826	CpG: 95	886	95	599	21.4	67.6	0.94
chr10	15182318	15183613	CpG: 151	1295	151	985	23.3	76.1	0.85
chr10	15224166	15224714	CpG: 43	548	43	333	15.7	60.8	0.85
chr10	15230909	15231163	CpG: 22	254	22	136	17.3	53.5	1.23
chr10	15231365	15231598	CpG: 17	233	17	150	14.6	64.4	0.71
chr10	15355784	15355994	CpG: 18	210	18	126	17.1	60.0	0.96
chr10	15388646	15389692	CpG: 170	1046	170	857	32.5	81.9	0.99
chr10	15443498	15443714	CpG: 20	216	20	123	18.5	56.9	1.19
chr10	15444581	15444854	CpG: 28	273	28	205	20.5	75.1	0.73
chr10	15447343	15447617	CpG: 24	274	24	171	17.5	62.4	0.91
chr10	15552855	15553123	CpG: 21	268	21	192	15.7	71.6	0.63
chr10	15665434	15665715	CpG: 24	281	24	175	17.1	62.3	0.90
chr10	15737423	15738101	CpG: 77	678	77	512	22.7	75.5	0.80
chr10	15783909	15784189	CpG: 22	280	22	167	15.7	59.6	0.90
chr10	15878091	15878414	CpG: 29	323	29	212	18.0	65.6	0.85
chr10	15907682	15907963	CpG: 23	281	23	173	16.4	61.6	0.88
chr10	15939327	15939777	CpG: 33	450	33	266	14.7	59.1	0.84
chr10	15966178	15966414	CpG: 20	236	20	142	16.9	60.2	0.96
chr10	15976973	15977248	CpG: 23	275	23	169	16.7	61.5	0.89
chr10	16001514	16001788	CpG: 23	274	23	170	16.8	62.0	0.88
chr10	16361469	16361743	CpG: 22	274	22	170	16.1	62.0	0.84
chr10	16407262	16407498	CpG: 16	236	16	142	13.6	60.2	0.77
chr10	16455233	16455733	CpG: 40	500	40	333	16.0	66.6	0.76
chr10	16538072	16540290	CpG: 230	2218	230	1537	20.7	69.3	0.87
chr10	16823848	16824118	CpG: 21	270	21	156	15.6	57.8	0.95
chr10	16835547	16836433	CpG: 68	886	68	554	15.3	62.5	0.79
chr10	16927407	16927691	CpG: 24	284	24	175	16.9	61.6	0.90
chr10	16980280	16980521	CpG: 19	241	19	147	15.8	61.0	0.88
chr10	17074857	17075130	CpG: 19	273	19	160	13.9	58.6	0.82
chr10	17149578	17149789	CpG: 17	211	17	128	16.1	60.7	0.90
chr10	17219844	17220327	CpG: 48	483	48	339	19.9	70.2	0.82
chr10	17243103	17243380	CpG: 19	277	19	170	13.7	61.4	0.73
chr10	17246976	17249163	CpG: 196	2187	196	1472	17.9	67.3	0.80
chr10	17438602	17438838	CpG: 18	236	18	143	15.3	60.6	0.85
chr10	17471844	17473158	CpG: 164	1314	164	974	25.0	74.1	0.91
chr10	17477218	17477432	CpG: 17	214	17	129	15.9	60.3	0.88
chr10	17512494	17512709	CpG: 17	215	17	130	15.8	60.5	0.88
chr10	17633314	17633562	CpG: 23	248	23	150	18.5	60.5	1.03
chr10	17634328	17634546	CpG: 16	218	16	128	14.7	58.7	0.87
chr10	17635168	17636142	CpG: 124	974	124	727	25.5	74.6	0.92
chr10	17647423	17648632	CpG: 95	1209	95	852	15.7	70.5	0.63
chr10	17661341	17661561	CpG: 17	220	17	133	15.5	60.5	0.85
chr10	17662599	17662832	CpG: 22	233	22	153	18.9	65.7	0.88
chr10	17847478	17847688	CpG: 16	210	16	126	15.2	60.0	0.86
chr10	17910544	17910780	CpG: 18	236	18	140	15.3	59.3	0.89
chr10	17954322	17954563	CpG: 22	241	22	149	18.3	61.8	0.98
chr10	18016139	18016396	CpG: 21	257	21	156	16.3	60.7	0.92
chr10	18055709	18055955	CpG: 19	246	19	147	15.4	59.8	0.87
chr10	18159527	18160636	CpG: 124	1109	124	798	22.4	72.0	0.87
chr10	18376349	18376622	CpG: 24	273	24	168	17.6	61.5	0.94
chr10	18385528	18385767	CpG: 18	239	18	141	15.1	59.0	0.88
chr10	18670709	18670946	CpG: 24	237	24	150	20.3	63.3	1.07
chr10	18678288	18678885	CpG: 69	597	69	406	23.1	68.0	1.03
chr10	18729295	18729541	CpG: 23	246	23	171	18.7	69.5	0.77
chr10	18921256	18921466	CpG: 17	210	17	129	16.2	61.4	0.89
chr10	18921932	18922206	CpG: 23	274	23	171	16.8	62.4	0.87
chr10	18963642	18963908	CpG: 21	266	21	163	15.8	61.3	0.86
chr10	19054137	19054403	CpG: 20	266	20	158	15.0	59.4	0.86
chr10	19069136	19069410	CpG: 24	274	24	171	17.5	62.4	0.91
chr10	19113254	19113613	CpG: 27	359	27	210	15.0	58.5	0.88
chr10	19195070	19195351	CpG: 23	281	23	174	16.4	61.9	0.87
chr10	19524341	19524622	CpG: 24	281	24	176	17.1	62.6	0.88
chr10	19748055	19748292	CpG: 21	237	21	147	17.7	62.0	0.95
chr10	19759428	19759700	CpG: 21	272	21	168	15.4	61.8	0.82
chr10	19790568	19790852	CpG: 23	284	23	173	16.2	60.9	0.89
chr10	19833782	19835436	CpG: 142	1654	142	1083	17.2	65.5	0.80
chr10	19835974	19836277	CpG: 23	303	23	209	15.2	69.0	0.64
chr10	19838608	19838896	CpG: 25	288	25	181	17.4	62.8	0.90
chr10	19934622	19934858	CpG: 22	236	22	147	18.6	62.3	0.99
chr10	19980987	19981221	CpG: 21	234	21	140	17.9	59.8	1.02
chr10	20006135	20006423	CpG: 20	288	20	171	13.9	59.4	0.80
chr10	20326416	20326648	CpG: 20	232	20	141	17.2	60.8	0.95
chr10	20415953	20416184	CpG: 18	231	18	141	15.6	61.0	0.86
chr10	20775918	20776220	CpG: 24	302	24	178	15.9	58.9	0.92
chr10	21191898	21193578	CpG: 182	1680	182	1198	21.7	71.3	0.85
chr10	21513403	21516625	CpG: 268	3222	268	2101	16.6	65.2	0.78
chr10	21518838	21519793	CpG: 79	955	79	618	16.5	64.7	0.79
chr10	21527826	21529667	CpG: 133	1841	133	1189	14.4	64.6	0.70
chr10	21535391	21536830	CpG: 151	1439	151	981	21.0	68.2	0.91
chr10	21544989	21546731	CpG: 169	1742	169	1151	19.4	66.1	0.89
chr10	21553031	21554593	CpG: 176	1562	176	1154	22.5	73.9	0.83
chr10	21603062	21603293	CpG: 16	231	16	136	13.9	58.9	0.83
chr10	21611604	21611887	CpG: 21	283	21	172	14.8	60.8	0.81
chr10	21640171	21640776	CpG: 39	605	39	339	12.9	56.0	0.84
chr10	21726340	21726575	CpG: 20	235	20	142	17.0	60.4	0.95
chr10	21792935	21793209	CpG: 24	274	24	171	17.5	62.4	0.91
chr10	21856087	21857207	CpG: 88	1120	88	802	15.7	71.6	0.61
chr10	22022070	22022993	CpG: 94	923	94	655	20.4	71.0	0.81
chr10	22148603	22148936	CpG: 25	333	25	196	15.0	58.9	0.87
chr10	22226920	22227151	CpG: 20	231	20	138	17.3	59.7	0.98
chr10	22248156	22248645	CpG: 59	489	59	330	24.1	67.5	1.06
chr10	22270811	22272843	CpG: 184	2032	184	1325	18.1	65.2	0.85
chr10	22297164	22297499	CpG: 26	335	26	200	15.5	59.7	0.88
chr10	22335012	22335737	CpG: 102	725	102	523	28.1	72.1	1.09
chr10	22339453	22341242	CpG: 270	1789	270	1372	30.2	76.7	1.03
chr10	22344380	22345039	CpG: 86	659	86	483	26.1	73.3	0.99
chr10	22353455	22355980	CpG: 245	2525	245	1679	19.4	66.5	0.88
chr10	22359465	22360433	CpG: 119	968	119	715	24.6	73.9	0.91
chr10	22364105	22364967	CpG: 102	862	102	598	23.7	69.4	0.98
chr10	22430950	22431191	CpG: 23	241	23	144	19.1	59.8	1.09
chr10	22455607	22456880	CpG: 138	1273	138	848	21.7	66.6	0.98
chr10	22471975	22472249	CpG: 20	274	20	167	14.6	60.9	0.79
chr10	22494824	22497166	CpG: 217	2342	217	1527	18.5	65.2	0.87
chr10	22732227	22733862	CpG: 199	1635	199	1203	24.3	73.6	0.90
chr10	22790107	22790387	CpG: 22	280	22	173	15.7	61.8	0.83
chr10	22857233	22857488	CpG: 20	255	20	155	15.7	60.8	0.86
chr10	23090819	23091103	CpG: 23	284	23	175	16.2	61.6	0.87
chr10	23114458	23115142	CpG: 64	684	64	482	18.7	70.5	0.77
chr10	23191365	23191675	CpG: 30	310	30	226	19.4	72.9	0.73
chr10	23192289	23193954	CpG: 167	1665	167	1147	20.1	68.9	0.84
chr10	23210762	23212520	CpG: 218	1758	218	1268	24.8	72.1	0.95
chr10	23213962	23214563	CpG: 62	601	62	412	20.6	68.6	0.88
chr10	23217822	23218608	CpG: 66	786	66	547	16.8	69.6	0.70
chr10	23351264	23351654	CpG: 29	390	29	250	14.9	64.1	0.96
chr10	23363962	23364266	CpG: 37	304	37	218	24.3	71.7	0.95
chr10	23364456	23364772	CpG: 26	316	26	215	16.5	68.0	0.72
chr10	23458792	23460726	CpG: 261	1934	261	1452	27.0	75.1	0.96
chr10	23621654	23621886	CpG: 20	232	20	139	17.2	59.9	0.99
chr10	23713596	23713803	CpG: 21	207	21	136	20.3	65.7	0.95
chr10	23714580	23716192	CpG: 139	1612	139	1096	17.2	68.0	0.75
chr10	24172512	24172786	CpG: 23	274	23	170	16.8	62.0	0.88
chr10	24277189	24277430	CpG: 19	241	19	146	15.8	60.6	0.88
chr10	24380276	24380506	CpG: 16	230	16	137	13.9	59.6	0.80
chr10	24661076	24661306	CpG: 19	230	19	140	16.5	60.9	0.90
chr10	24741296	24743515	CpG: 244	2219	244	1582	22.0	71.3	0.87
chr10	24764544	24764771	CpG: 20	227	20	132	17.6	58.1	1.07
chr10	24844922	24845198	CpG: 22	276	22	168	15.9	60.9	0.87
chr10	24905259	24905544	CpG: 25	285	25	178	17.5	62.5	0.92
chr10	24970438	24971228	CpG: 95	790	95	587	24.1	74.3	0.89
chr10	25034622	25035328	CpG: 68	706	68	472	19.3	66.9	0.86
chr10	25192730	25194943	CpG: 191	2213	191	1463	17.3	66.1	0.79
chr10	25271120	25271547	CpG: 31	427	31	257	14.5	60.2	0.80
chr10	25442661	25443024	CpG: 30	363	30	216	16.5	59.5	0.93
chr10	25545529	25545956	CpG: 33	427	33	261	15.5	61.1	0.83
chr10	25692918	25693199	CpG: 23	281	23	175	16.4	62.3	0.86
chr10	25901813	25902087	CpG: 20	274	20	163	14.6	59.5	0.84
chr10	25958838	25959940	CpG: 98	1102	98	750	17.8	68.1	0.82
chr10	26225917	26226197	CpG: 21	280	21	165	15.0	58.9	0.87
chr10	26236190	26236709	CpG: 40	519	40	338	15.4	65.1	0.73
chr10	26239966	26243017	CpG: 247	3051	247	1910	16.2	62.6	0.83
chr10	26416325	26416842	CpG: 52	517	52	380	20.1	73.5	0.75
chr10	26462773	26463713	CpG: 75	940	75	599	16.0	63.7	0.79
chr10	26569898	26570172	CpG: 25	274	25	171	18.2	62.4	0.95
chr10	26591715	26592091	CpG: 55	376	55	304	29.3	80.9	0.99
chr10	26722244	26723190	CpG: 108	946	108	661	22.8	69.9	0.95
chr10	26850867	26851103	CpG: 17	236	17	142	14.4	60.2	0.80
chr10	26882161	26883224	CpG: 88	1063	88	707	16.6	66.5	0.76
chr10	26904368	26904622	CpG: 19	254	19	147	15.0	57.9	0.92
chr10	26935555	26935804	CpG: 19	249	19	176	15.3	70.7	0.61
chr10	26943706	26944057	CpG: 24	351	24	204	13.7	58.1	0.81
chr10	27101323	27101554	CpG: 17	231	17	137	14.7	59.3	0.84
chr10	27128728	27128961	CpG: 19	233	19	140	16.3	60.1	0.92
chr10	27130267	27130814	CpG: 52	547	52	343	19.0	62.7	0.98
chr10	27181621	27181891	CpG: 19	270	19	169	14.1	62.6	0.74
chr10	27184124	27184754	CpG: 45	630	45	367	14.3	58.3	0.85
chr10	27185227	27186346	CpG: 88	1119	88	679	15.7	60.7	0.86
chr10	27268047	27268294	CpG: 17	247	17	151	13.8	61.1	0.76
chr10	27270306	27272450	CpG: 155	2144	155	1310	14.5	61.1	0.78
chr10	27282383	27282969	CpG: 59	586	59	407	20.1	69.5	0.84
chr10	27286499	27287063	CpG: 51	564	51	434	18.1	77.0	0.67
chr10	27288798	27289532	CpG: 76	734	76	522	20.7	71.1	0.82
chr10	27341688	27341963	CpG: 22	275	22	170	16.0	61.8	0.85
chr10	27349819	27350037	CpG: 28	218	28	170	25.7	78.0	0.85
chr10	27443714	27444724	CpG: 73	1010	73	664	14.5	65.7	0.67
chr10	27534514	27535229	CpG: 72	715	72	496	20.1	69.4	0.84
chr10	27588202	27588479	CpG: 23	277	23	169	16.6	61.0	0.90
chr10	27771999	27777028	CpG: 424	5029	424	3249	16.9	64.6	0.81
chr10	27783915	27784190	CpG: 24	275	24	170	17.5	61.8	0.92
chr10	27855026	27855299	CpG: 23	273	23	173	16.8	63.4	0.85
chr10	28029557	28030296	CpG: 77	739	77	536	20.8	72.5	0.80
chr10	28333564	28334278	CpG: 81	714	81	537	22.7	75.2	0.81
chr10	28387831	28388117	CpG: 21	286	21	168	14.7	58.7	0.86
chr10	28436908	28437146	CpG: 18	238	18	143	15.1	60.1	0.86
chr10	28490769	28490973	CpG: 17	204	17	122	16.7	59.8	0.94
chr10	28505396	28505650	CpG: 20	254	20	155	15.7	61.0	0.87
chr10	28562664	28564738	CpG: 235	2074	235	1458	22.7	70.3	0.92
chr10	28644651	28644909	CpG: 25	258	25	162	19.4	62.8	0.99
chr10	28699859	28700567	CpG: 59	708	59	431	16.7	60.9	0.90
chr10	28708162	28709724	CpG: 187	1562	187	1139	23.9	72.9	0.90
chr10	28753531	28753931	CpG: 33	400	33	250	16.5	62.5	0.84
chr10	28802640	28803440	CpG: 64	800	64	554	16.0	69.2	0.67
chr10	28844996	28845232	CpG: 21	236	21	144	17.8	61.0	0.97
chr10	28847313	28847694	CpG: 39	381	39	280	20.5	73.5	0.76
chr10	28848013	28848290	CpG: 26	277	26	175	18.8	63.2	0.95
chr10	28849980	28850204	CpG: 18	224	18	134	16.1	59.8	0.91
chr10	28928692	28929039	CpG: 35	347	35	258	20.2	74.4	0.73
chr10	28957064	28957375	CpG: 27	311	27	189	17.4	60.8	0.94
chr10	29337951	29338225	CpG: 24	274	24	172	17.5	62.8	0.90
chr10	29404189	29404462	CpG: 23	273	23	172	16.8	63.0	0.86
chr10	29441109	29441791	CpG: 71	682	71	471	20.8	69.1	0.87
chr10	29652959	29653195	CpG: 22	236	22	147	18.6	62.3	0.99
chr10	29766187	29768192	CpG: 234	2005	234	1470	23.3	73.3	0.87
chr10	29776728	29777006	CpG: 26	278	26	174	18.7	62.6	0.97
chr10	30085733	30086010	CpG: 22	277	22	175	15.9	63.2	0.80
chr10	30089711	30090760	CpG: 124	1049	124	789	23.6	75.2	0.84
chr10	30153844	30154068	CpG: 20	224	20	137	17.9	61.2	0.97
chr10	30161695	30161970	CpG: 21	275	21	167	15.3	60.7	0.85
chr10	30380033	30380351	CpG: 26	318	26	181	16.4	56.9	1.03
chr10	30464489	30465818	CpG: 135	1329	135	932	20.3	70.1	0.83
chr10	30743329	30743607	CpG: 25	278	25	175	18.0	62.9	0.92
chr10	30816220	30816818	CpG: 62	598	62	413	20.7	69.1	0.88
chr10	31044314	31044588	CpG: 28	274	28	175	20.4	63.9	1.01
chr10	31055616	31055888	CpG: 21	272	21	162	15.4	59.6	0.88
chr10	31062827	31063897	CpG: 95	1070	95	734	17.8	68.6	0.78
chr10	31165053	31165660	CpG: 49	607	49	421	16.1	69.4	0.67
chr10	31348036	31350903	CpG: 285	2867	285	1921	19.9	67.0	0.89
chr10	31391424	31392242	CpG: 63	818	63	567	15.4	69.3	0.65
chr10	31499098	31499325	CpG: 17	227	17	132	15.0	58.1	0.89
chr10	31632992	31633555	CpG: 59	563	59	415	21.0	73.7	0.78
chr10	31790723	31791901	CpG: 91	1178	91	793	15.4	67.3	0.69
chr10	31896997	31897270	CpG: 19	273	19	160	13.9	58.6	0.81
chr10	31913334	31913564	CpG: 19	230	19	140	16.5	60.9	0.90
chr10	31959360	31960853	CpG: 165	1493	165	1062	22.1	71.1	0.88
chr10	32007778	32008012	CpG: 22	234	22	175	18.8	74.8	0.67
chr10	32052802	32053080	CpG: 22	278	22	172	15.8	61.9	0.84
chr10	32084623	32085643	CpG: 111	1020	111	711	21.8	69.7	0.90
chr10	32138705	32139149	CpG: 33	444	33	276	14.9	62.2	0.77
chr10	32262448	32263315	CpG: 69	867	69	594	15.9	68.5	0.68
chr10	32307510	32307724	CpG: 17	214	17	129	15.9	60.3	0.88
chr10	32375428	32376866	CpG: 169	1438	169	1027	23.5	71.4	0.92
chr10	32528823	32529571	CpG: 53	748	53	514	14.2	68.7	0.60
chr10	32986082	32987518	CpG: 178	1436	178	1068	24.8	74.4	0.90
chr10	33009314	33009673	CpG: 28	359	28	232	15.6	64.6	0.75
chr10	33079047	33079260	CpG: 16	213	16	125	15.0	58.7	0.90
chr10	33187351	33187591	CpG: 23	240	23	144	19.2	60.0	1.09
chr10	33200678	33200952	CpG: 24	274	24	171	17.5	62.4	0.91
chr10	33338786	33339062	CpG: 20	276	20	164	14.5	59.4	0.84
chr10	33363012	33366110	CpG: 252	3098	252	2073	16.3	66.9	0.73
chr10	33545242	33545681	CpG: 32	439	32	265	14.6	60.4	0.80
chr10	34084024	34084419	CpG: 32	395	32	286	16.2	72.4	0.62
chr10	34116040	34116333	CpG: 21	293	21	179	14.3	61.1	0.77
chr10	34380966	34381684	CpG: 55	718	55	494	15.3	68.8	0.65
chr10	34424004	34424289	CpG: 24	285	24	177	16.8	62.1	0.89
chr10	34842739	34844858	CpG: 230	2119	230	1519	21.7	71.7	0.85
chr10	35005017	35005222	CpG: 20	205	20	147	19.5	71.7	0.76
chr10	35010940	35011214	CpG: 24	274	24	170	17.5	62.0	0.92
chr10	35079732	35080131	CpG: 32	399	32	246	16.0	61.7	0.86
chr10	35118469	35119267	CpG: 75	798	75	553	18.8	69.3	0.78
chr10	35131911	35132184	CpG: 24	273	24	169	17.6	61.9	0.93
chr10	35133755	35134054	CpG: 22	299	22	171	14.7	57.2	0.91
chr10	35155124	35156325	CpG: 135	1201	135	836	22.5	69.6	0.93
chr10	35175640	35175917	CpG: 20	277	20	169	14.4	61.0	0.78
chr10	35243476	35243689	CpG: 23	213	23	146	21.6	68.5	0.94
chr10	35256320	35256607	CpG: 22	287	22	175	15.3	61.0	0.83
chr10	35332941	35333216	CpG: 23	275	23	169	16.7	61.5	0.89
chr10	35364536	35366212	CpG: 224	1676	224	1242	26.7	74.1	0.97
chr10	35391505	35391955	CpG: 36	450	36	314	16.0	69.8	0.66
chr10	35458673	35458947	CpG: 24	274	24	171	17.5	62.4	0.91
chr10	35502520	35502726	CpG: 19	206	19	121	18.4	58.7	1.07
chr10	35636038	35636981	CpG: 87	943	87	656	18.5	69.6	0.76
chr10	35669536	35673631	CpG: 461	4095	461	2862	22.5	69.9	0.92
chr10	35711473	35711758	CpG: 24	285	24	180	16.8	63.2	0.86
chr10	35738277	35738551	CpG: 25	274	25	173	18.2	63.1	0.93
chr10	35761945	35762217	CpG: 20	272	20	170	14.7	62.5	0.76
chr10	35797605	35797862	CpG: 21	257	21	179	16.3	69.6	0.74
chr10	36153957	36154231	CpG: 24	274	24	171	17.5	62.4	0.91
chr10	36335616	36335901	CpG: 25	285	25	179	17.5	62.8	0.90
chr10	36405929	36406329	CpG: 29	400	29	233	14.5	58.2	0.86
chr10	36413503	36413745	CpG: 20	242	20	153	16.5	63.2	0.85
chr10	36427416	36427678	CpG: 26	262	26	166	19.8	63.4	1.00
chr10	36469253	36469538	CpG: 24	285	24	178	16.8	62.5	0.88
chr10	36747328	36747599	CpG: 20	271	20	164	14.8	60.5	0.82
chr10	36765209	36765456	CpG: 19	247	19	141	15.4	57.1	0.96
chr10	36794943	36795249	CpG: 20	306	20	178	13.1	58.2	0.78
chr10	36856796	36857074	CpG: 23	278	23	173	16.5	62.2	0.86
chr10	36950646	36951243	CpG: 42	597	42	341	14.1	57.1	0.87
chr10	37044843	37045082	CpG: 18	239	18	141	15.1	59.0	0.89
chr10	37100716	37100979	CpG: 20	263	20	156	15.2	59.3	0.88
chr10	37156745	37156971	CpG: 20	226	20	162	17.7	71.7	0.69
chr10	37157308	37157932	CpG: 51	624	51	428	16.3	68.6	0.71
chr10	37695455	37695707	CpG: 20	252	20	166	15.9	65.9	0.73
chr10	37724167	37725381	CpG: 82	1214	82	815	13.5	67.1	0.60
chr10	37824619	37824979	CpG: 36	360	36	241	20.0	66.9	0.90
chr10	37901544	37902146	CpG: 68	602	68	428	22.6	71.1	0.91
chr10	37941082	37941325	CpG: 20	243	20	147	16.5	60.5	0.91
chr10	38020148	38020796	CpG: 63	648	63	456	19.4	70.4	0.81
chr10	38054404	38055013	CpG: 63	609	63	413	20.7	67.8	0.94
chr10	38138253	38139015	CpG: 62	762	62	485	16.3	63.6	0.82
chr10	38268240	38268528	CpG: 21	288	21	174	14.6	60.4	0.80
chr10	38400181	38400582	CpG: 41	401	41	258	20.4	64.3	1.02
chr10	38446488	38447251	CpG: 106	763	106	557	27.8	73.0	1.04
chr10	38494487	38494786	CpG: 21	299	21	207	14.0	69.2	0.61
chr10	38659006	38659954	CpG: 103	948	103	639	21.7	67.4	1.05
chr10	38790453	38791447	CpG: 95	994	95	693	19.1	69.7	0.81
chr10	38829287	38829520	CpG: 17	233	17	134	14.6	57.5	0.91
chr10	39010446	39011782	CpG: 149	1336	149	900	22.3	67.4	1.04
chr10	39577283	39577575	CpG: 27	292	27	180	18.5	61.6	0.98
chr10	42530293	42531378	CpG: 79	1085	79	737	14.6	67.9	0.63
chr10	42536047	42537170	CpG: 79	1123	79	759	14.1	67.6	0.62
chr10	42544748	42545667	CpG: 68	919	68	615	14.8	66.9	0.66
chr10	42987259	42989606	CpG: 184	2347	184	1422	15.7	60.6	0.92
chr10	43025599	43027189	CpG: 167	1590	167	1053	21.0	66.2	1.00
chr10	43053288	43055537	CpG: 319	2249	319	1590	28.4	70.7	1.27
chr10	43081705	43081931	CpG: 19	226	19	132	16.8	58.4	0.99
chr10	43119366	43121218	CpG: 220	1852	220	1306	23.8	70.5	1.01
chr10	43170825	43171098	CpG: 24	273	24	168	17.6	61.5	0.94
chr10	43244832	43245350	CpG: 36	518	36	317	13.9	61.2	0.74
chr10	43313210	43313453	CpG: 18	243	18	143	14.8	58.8	0.86
chr10	43353287	43353926	CpG: 50	639	50	445	15.6	69.6	0.65
chr10	43354846	43355047	CpG: 18	201	18	132	17.9	65.7	0.83
chr10	43429682	43430570	CpG: 68	888	68	552	15.3	62.2	0.80
chr10	43515560	43516187	CpG: 56	627	56	410	17.9	65.4	0.85
chr10	43623761	43624032	CpG: 21	271	21	167	15.5	61.6	0.83
chr10	43629689	43630004	CpG: 22	315	22	186	14.0	59.0	0.80
chr10	43630544	43632933	CpG: 223	2389	223	1653	18.7	69.2	0.78
chr10	43656244	43656518	CpG: 24	274	24	171	17.5	62.4	0.91
chr10	43659852	43660535	CpG: 64	683	64	442	18.7	64.7	0.90
chr10	43688992	43689274	CpG: 24	282	24	176	17.0	62.4	0.88
chr10	43714382	43714812	CpG: 53	430	53	304	24.7	70.7	0.99
chr10	43743544	43744342	CpG: 84	798	84	548	21.1	68.7	0.89
chr10	43775461	43776402	CpG: 85	941	85	632	18.1	67.2	0.80
chr10	43810197	43811490	CpG: 95	1293	95	881	14.7	68.1	0.64
chr10	43953964	43955466	CpG: 189	1502	189	1108	25.2	73.8	0.93
chr10	43982203	43983220	CpG: 106	1017	106	712	20.8	70.0	0.85
chr10	44015015	44016271	CpG: 139	1256	139	865	22.1	68.9	0.94
chr10	44024486	44024764	CpG: 25	278	25	175	18.0	62.9	0.92
chr10	44030573	44030782	CpG: 19	209	19	127	18.2	60.8	1.01
chr10	44081254	44081703	CpG: 38	449	38	321	16.9	71.5	0.73
chr10	44108006	44109091	CpG: 127	1085	127	821	23.4	75.7	0.82
chr10	44145394	44146410	CpG: 151	1016	151	779	29.7	76.7	1.01
chr10	44183622	44183995	CpG: 36	373	36	249	19.3	66.8	0.88
chr10	44201549	44202079	CpG: 36	530	36	338	13.6	63.8	0.68
chr10	44221279	44221636	CpG: 29	357	29	246	16.2	68.9	0.75
chr10	44226224	44226450	CpG: 19	226	19	139	16.8	61.5	0.92
chr10	44229758	44230075	CpG: 38	317	38	210	24.0	66.2	1.13
chr10	44241009	44241728	CpG: 57	719	57	472	15.9	65.6	0.74
chr10	44274870	44276458	CpG: 149	1588	149	1081	18.8	68.1	0.82
chr10	44286122	44288984	CpG: 259	2862	259	1860	18.1	65.0	0.86
chr10	44292755	44293027	CpG: 20	272	20	166	14.7	61.0	0.80
chr10	44299464	44300142	CpG: 61	678	61	456	18.0	67.3	0.80
chr10	44315354	44315591	CpG: 23	237	23	149	19.4	62.9	1.00
chr10	44317446	44318367	CpG: 85	921	85	639	18.5	69.4	0.77
chr10	44327084	44327634	CpG: 46	550	46	392	16.7	71.3	0.66
chr10	44335978	44336929	CpG: 92	951	92	615	19.3	64.7	0.93
chr10	44454834	44455654	CpG: 84	820	84	559	20.5	68.2	0.89
chr10	44487287	44487840	CpG: 51	553	51	390	18.4	70.5	0.74
chr10	44499167	44499452	CpG: 24	285	24	178	16.8	62.5	0.88
chr10	44529327	44530169	CpG: 97	842	97	604	23.0	71.7	0.90
chr10	44548297	44548978	CpG: 59	681	59	459	17.3	67.4	0.77
chr10	44570484	44571577	CpG: 93	1093	93	713	17.0	65.2	0.81
chr10	44583746	44584021	CpG: 23	275	23	184	16.7	66.9	0.75
chr10	44609264	44609474	CpG: 18	210	18	131	17.1	62.4	0.88
chr10	44886348	44886637	CpG: 24	289	24	167	16.6	57.8	1.00
chr10	44962706	44962987	CpG: 22	281	22	172	15.7	61.2	0.85
chr10	45087275	45087540	CpG: 20	265	20	176	15.1	66.4	0.68
chr10	45119743	45120020	CpG: 23	277	23	176	16.6	63.5	0.83
chr10	45173702	45173965	CpG: 24	263	24	201	18.3	76.4	0.89
chr10	45174207	45174516	CpG: 24	309	24	216	15.5	69.9	0.66
chr10	45191540	45192149	CpG: 60	609	60	443	19.7	72.7	0.75
chr10	45265123	45267796	CpG: 248	2673	248	1812	18.6	67.8	0.81
chr10	45286726	45286997	CpG: 22	271	22	165	16.2	60.9	0.88
chr10	45382368	45382649	CpG: 22	281	22	173	15.7	61.6	0.84
chr10	45482134	45482386	CpG: 18	252	18	152	14.3	60.3	0.80
chr10	45625900	45626166	CpG: 19	266	19	162	14.3	60.9	0.78
chr10	45723474	45723736	CpG: 22	262	22	160	16.8	61.1	0.92
chr10	45745448	45745800	CpG: 34	352	34	222	19.3	63.1	0.97
chr10	45840311	45840990	CpG: 73	679	73	495	21.5	72.9	0.81
chr10	45856037	45856249	CpG: 22	212	22	157	20.8	74.1	0.77
chr10	45881783	45882294	CpG: 75	511	75	395	29.4	77.3	1.02
chr10	46079307	46080479	CpG: 80	1172	80	789	13.7	67.3	0.61
chr10	46105303	46105794	CpG: 46	491	46	301	18.7	61.3	1.00
chr10	46254297	46255735	CpG: 130	1438	130	1017	18.1	70.7	0.73
chr10	46272259	46273125	CpG: 61	866	61	592	14.1	68.4	0.60
chr10	46299933	46300724	CpG: 62	791	62	540	15.7	68.3	0.70
chr10	46308402	46308946	CpG: 48	544	48	370	17.6	68.0	0.77
chr10	46324167	46325220	CpG: 93	1053	93	760	17.7	72.2	0.68
chr10	46330647	46330882	CpG: 20	235	20	142	17.0	60.4	0.96
chr10	46350580	46350812	CpG: 20	232	20	143	17.2	61.6	0.93
chr10	46392549	46393783	CpG: 98	1234	98	869	15.9	70.4	0.64
chr10	46475262	46476020	CpG: 86	758	86	544	22.7	71.8	0.88
chr10	46481596	46482142	CpG: 44	546	44	399	16.1	73.1	0.60
chr10	46512045	46512272	CpG: 17	227	17	135	15.0	59.5	0.87
chr10	46553227	46554192	CpG: 104	965	104	675	21.6	69.9	0.88
chr10	46572150	46572366	CpG: 17	216	17	132	15.7	61.1	0.85
chr10	46580994	46581217	CpG: 19	223	19	149	17.0	66.8	0.77
chr10	46607955	46608826	CpG: 86	871	86	617	19.7	70.8	0.79
chr10	46611668	46611902	CpG: 17	234	17	137	14.5	58.5	0.88
chr10	46715858	46716074	CpG: 17	216	17	131	15.7	60.6	0.86
chr10	46746446	46747330	CpG: 69	884	69	620	15.6	70.1	0.63
chr10	46852779	46853678	CpG: 83	899	83	572	18.5	63.6	0.91
chr10	46904075	46904497	CpG: 42	422	42	305	19.9	72.3	0.79
chr10	46911048	46911625	CpG: 53	577	53	402	18.4	69.7	0.77
chr10	46929990	46930213	CpG: 20	223	20	134	17.9	60.1	1.01
chr10	46987058	46987739	CpG: 71	681	71	513	20.9	75.3	0.74
chr10	46999310	46999576	CpG: 23	266	23	166	17.3	62.4	0.90
chr10	47003143	47003359	CpG: 17	216	17	132	15.7	61.1	0.85
chr10	47012007	47012224	CpG: 18	217	18	145	16.6	66.8	0.75
chr10	47041706	47041984	CpG: 25	278	25	175	18.0	62.9	0.92
chr10	47163110	47163777	CpG: 70	667	70	497	21.0	74.5	0.76
chr10	47170579	47171281	CpG: 80	702	80	521	22.8	74.2	0.83
chr10	47244529	47244752	CpG: 17	223	17	147	15.2	65.9	0.71
chr10	47284195	47284476	CpG: 33	281	33	198	23.5	70.5	0.95
chr10	47351821	47352113	CpG: 33	292	33	231	22.6	79.1	0.74
chr10	47363348	47363623	CpG: 19	275	19	162	13.8	58.9	0.82
chr10	47427555	47427919	CpG: 37	364	37	262	20.3	72.0	0.79
chr10	47442676	47443524	CpG: 93	848	93	640	21.9	75.5	0.79
chr10	47464419	47465985	CpG: 143	1566	143	1099	18.3	70.2	0.74
chr10	47484377	47484604	CpG: 30	227	30	168	26.4	74.0	0.97
chr10	47521856	47522281	CpG: 63	425	63	304	29.6	71.5	1.17
chr10	47534515	47534756	CpG: 21	241	21	146	17.4	60.6	0.96
chr10	47588785	47589250	CpG: 36	465	36	274	15.5	58.9	0.91
chr10	47662422	47663315	CpG: 92	893	92	665	20.6	74.5	0.75
chr10	47674518	47675211	CpG: 67	693	67	455	19.3	65.7	0.91
chr10	47755369	47755639	CpG: 23	270	23	169	17.0	62.6	0.88
chr10	47765019	47765296	CpG: 23	277	23	176	16.6	63.5	0.83
chr10	47799971	47800530	CpG: 49	559	49	391	17.5	69.9	0.77
chr10	47883142	47883422	CpG: 23	280	23	172	16.4	61.4	0.88
chr10	48191137	48192046	CpG: 114	909	114	693	25.1	76.2	0.87
chr10	48200987	48201790	CpG: 70	803	70	546	17.4	68.0	0.76
chr10	48210544	48210774	CpG: 20	230	20	142	17.4	61.7	0.92
chr10	48216803	48217030	CpG: 19	227	19	138	16.7	60.8	0.92
chr10	48241283	48241639	CpG: 31	356	31	238	17.4	66.9	0.79
chr10	48259794	48260053	CpG: 19	259	19	174	14.7	67.2	0.66
chr10	48275461	48276199	CpG: 75	738	75	548	20.3	74.3	0.74
chr10	48352634	48352983	CpG: 36	349	36	240	20.6	68.8	0.87
chr10	48444498	48445191	CpG: 66	693	66	455	19.0	65.7	0.90
chr10	48456244	48457349	CpG: 107	1105	107	794	19.4	71.9	0.76
chr10	48530486	48530950	CpG: 36	464	36	274	15.5	59.1	0.91
chr10	48584680	48584921	CpG: 20	241	20	144	16.6	59.8	0.94
chr10	48597151	48597577	CpG: 63	426	63	305	29.6	71.6	1.17
chr10	48635016	48635243	CpG: 29	227	29	168	25.6	74.0	0.94
chr10	48653598	48655164	CpG: 141	1566	141	1098	18.0	70.1	0.73
chr10	48676078	48676850	CpG: 90	772	90	592	23.3	76.7	0.81
chr10	48683560	48683809	CpG: 20	249	20	176	16.1	70.7	0.66
chr10	48691606	48691965	CpG: 36	359	36	257	20.1	71.6	0.79
chr10	48755959	48756234	CpG: 20	275	20	164	14.5	59.6	0.84
chr10	48767422	48767714	CpG: 33	292	33	231	22.6	79.1	0.74
chr10	48835586	48835867	CpG: 31	281	31	196	22.1	69.8	0.91
chr10	48989030	48989569	CpG: 47	539	47	375	17.4	69.6	0.78
chr10	49155310	49156379	CpG: 144	1069	144	797	26.9	74.6	0.97
chr10	49299353	49300235	CpG: 80	882	80	628	18.1	71.2	0.72
chr10	49315274	49315985	CpG: 87	711	87	526	24.5	74.0	0.91
chr10	49372480	49373669	CpG: 133	1189	133	892	22.4	75.0	0.80
chr10	49388363	49388637	CpG: 24	274	24	170	17.5	62.0	0.92
chr10	49453848	49454348	CpG: 44	500	44	332	17.6	66.4	0.80
chr10	49504873	49505844	CpG: 90	971	90	708	18.5	72.9	0.70
chr10	49532611	49532884	CpG: 21	273	21	168	15.4	61.5	0.82
chr10	49964027	49964578	CpG: 86	551	86	453	31.2	82.2	0.94
chr10	49980727	49981015	CpG: 20	288	20	187	13.9	64.9	0.66
chr10	50175009	50175439	CpG: 36	430	36	295	16.7	68.6	0.76
chr10	50188972	50189253	CpG: 23	281	23	174	16.4	61.9	0.87
chr10	50243728	50247522	CpG: 263	3794	263	2322	13.9	61.2	0.74
chr10	50387225	50388002	CpG: 73	777	73	496	18.8	63.8	0.93
chr10	50457855	50458069	CpG: 18	214	18	150	16.8	70.1	0.69
chr10	50458361	50461116	CpG: 278	2755	278	1898	20.2	68.9	0.85
chr10	50462247	50462448	CpG: 16	201	16	121	15.9	60.2	0.89
chr10	50463110	50463426	CpG: 33	316	33	238	20.9	75.3	0.74
chr10	50528331	50528628	CpG: 34	297	34	212	22.9	71.4	0.90
chr10	50611295	50612242	CpG: 93	947	93	669	19.6	70.6	0.79
chr10	50617982	50618772	CpG: 85	790	85	578	21.5	73.2	0.80
chr10	50791108	50792007	CpG: 84	899	84	574	18.7	63.8	0.92
chr10	50874470	50874740	CpG: 24	270	24	184	17.8	68.1	0.77
chr10	50900837	50901042	CpG: 18	205	18	121	17.6	59.0	1.03
chr10	50917300	50918171	CpG: 81	871	81	609	18.6	69.9	0.76
chr10	50921011	50921245	CpG: 18	234	18	140	15.4	59.8	0.88
chr10	51001037	51001359	CpG: 26	322	26	216	16.1	67.1	0.72
chr10	51170739	51171020	CpG: 24	281	24	175	17.1	62.3	0.90
chr10	51203618	51204248	CpG: 43	630	43	418	13.7	66.3	0.62
chr10	51266155	51266613	CpG: 53	458	53	312	23.1	68.1	1.00
chr10	51327242	51327523	CpG: 23	281	23	173	16.4	61.6	0.88
chr10	51411104	51411383	CpG: 22	279	22	170	15.8	60.9	0.86
chr10	51412003	51412277	CpG: 24	274	24	171	17.5	62.4	0.91
chr10	51471347	51474112	CpG: 267	2765	267	1883	19.3	68.1	0.84
chr10	51523494	51523714	CpG: 24	220	24	158	21.8	71.8	0.85
chr10	51588212	51588841	CpG: 63	629	63	413	20.0	65.7	0.95
chr10	51814720	51814986	CpG: 23	266	23	170	17.3	63.9	0.86
chr10	51839788	51840600	CpG: 92	812	92	553	22.7	68.1	0.98
chr10	51922390	51923603	CpG: 99	1213	99	797	16.3	65.7	0.76
chr10	52012174	52012424	CpG: 22	250	22	154	17.6	61.6	0.93
chr10	52029870	52030151	CpG: 24	281	24	176	17.1	62.6	0.88
chr10	52313644	52313918	CpG: 24	274	24	171	17.5	62.4	0.91
chr10	52477713	52477994	CpG: 24	281	24	177	17.1	63.0	0.88
chr10	52519469	52519743	CpG: 22	274	22	169	16.1	61.7	0.85
chr10	52548510	52549018	CpG: 40	508	40	270	15.7	53.1	1.13
chr10	52667737	52668011	CpG: 21	274	21	168	15.3	61.3	0.82
chr10	52733256	52733529	CpG: 24	273	24	168	17.6	61.5	0.94
chr10	52917012	52917285	CpG: 24	273	24	169	17.6	61.9	0.92
chr10	53020920	53021201	CpG: 24	281	24	175	17.1	62.3	0.89
chr10	53082397	53082808	CpG: 33	411	33	251	16.1	61.1	0.87
chr10	53160807	53161645	CpG: 64	838	64	527	15.3	62.9	0.78
chr10	53168361	53168576	CpG: 20	215	20	133	18.6	61.9	0.99
chr10	53257567	53257774	CpG: 21	207	21	152	20.3	73.4	0.75
chr10	53448964	53449203	CpG: 20	239	20	145	16.7	60.7	0.94
chr10	53482972	53483245	CpG: 26	273	26	170	19.0	62.3	0.99
chr10	53528089	53528364	CpG: 23	275	23	167	16.7	60.7	0.91
chr10	53553857	53554144	CpG: 24	287	24	177	16.7	61.7	0.89
chr10	53625500	53625834	CpG: 29	334	29	234	17.4	70.1	0.72
chr10	53733942	53734217	CpG: 24	275	24	176	17.5	64.0	0.86
chr10	53737588	53737806	CpG: 17	218	17	130	15.6	59.6	0.88
chr10	53867983	53868191	CpG: 19	208	19	129	18.3	62.0	0.96
chr10	53895232	53895505	CpG: 21	273	21	171	15.4	62.6	0.79
chr10	54062855	54063138	CpG: 24	283	24	169	17.0	59.7	0.96
chr10	54096942	54097212	CpG: 22	270	22	166	16.3	61.5	0.87
chr10	54230471	54230765	CpG: 21	294	21	175	14.3	59.5	0.82
chr10	54293697	54293955	CpG: 19	258	19	154	14.7	59.7	0.83
chr10	54535776	54536012	CpG: 20	236	20	145	16.9	61.4	0.91
chr10	54736440	54736699	CpG: 20	259	20	158	15.4	61.0	0.83
chr10	54772894	54773119	CpG: 19	225	19	163	16.9	72.4	0.65
chr10	55047392	55047622	CpG: 20	230	20	140	17.4	60.9	0.95
chr10	55069467	55069697	CpG: 20	230	20	139	17.4	60.4	0.96
chr10	55072452	55072726	CpG: 23	274	23	169	16.8	61.7	0.89
chr10	55145082	55145357	CpG: 23	275	23	172	16.7	62.5	0.86
chr10	55271272	55271553	CpG: 24	281	24	175	17.1	62.3	0.90
chr10	55528971	55529245	CpG: 23	274	23	167	16.8	60.9	0.92
chr10	55625385	55625614	CpG: 21	229	21	142	18.3	62.0	0.99
chr10	55720362	55720597	CpG: 20	235	20	142	17.0	60.4	0.95
chr10	55754758	55755036	CpG: 24	278	24	171	17.3	61.5	0.92
chr10	55770353	55770618	CpG: 20	265	20	151	15.1	57.0	0.94
chr10	55992761	55993036	CpG: 24	275	24	171	17.5	62.2	0.91
chr10	56088601	56088842	CpG: 18	241	18	143	14.9	59.3	0.87
chr10	56284560	56284771	CpG: 15	211	15	122	14.2	57.8	0.91
chr10	56452413	56452659	CpG: 19	246	19	150	15.4	61.0	0.83
chr10	56478674	56479141	CpG: 37	467	37	284	15.8	60.8	0.87
chr10	56480952	56481828	CpG: 76	876	76	565	17.4	64.5	0.84
chr10	56545953	56546226	CpG: 23	273	23	171	16.8	62.6	0.88
chr10	56719571	56719847	CpG: 23	276	23	171	16.7	62.0	0.88
chr10	56804812	56805092	CpG: 24	280	24	174	17.1	62.1	0.91
chr10	57005200	57005586	CpG: 41	386	41	290	21.2	75.1	0.75
chr10	57008566	57008798	CpG: 18	232	18	141	15.5	60.8	0.85
chr10	57064921	57065195	CpG: 24	274	24	171	17.5	62.4	0.91
chr10	57124158	57124429	CpG: 24	271	24	165	17.7	60.9	0.96
chr10	57211638	57211854	CpG: 28	216	28	143	25.9	66.2	1.21
chr10	57574255	57574522	CpG: 20	267	20	161	15.0	60.3	0.83
chr10	57605040	57605247	CpG: 16	207	16	118	15.5	57.0	0.97
chr10	57844650	57844918	CpG: 19	268	19	161	14.2	60.1	0.81
chr10	58104660	58104863	CpG: 15	203	15	141	14.8	69.5	0.61
chr10	58110502	58110783	CpG: 23	281	23	174	16.4	61.9	0.87
chr10	58125170	58125409	CpG: 18	239	18	147	15.1	61.5	0.81
chr10	58148733	58149018	CpG: 24	285	24	178	16.8	62.5	0.88
chr10	58176510	58176856	CpG: 27	346	27	248	15.6	71.7	0.61
chr10	58282553	58282786	CpG: 18	233	18	140	15.5	60.1	0.87
chr10	58391134	58391408	CpG: 23	274	23	170	16.8	62.0	0.88
chr10	58445490	58445749	CpG: 21	259	21	143	16.2	55.2	1.07
chr10	58476367	58476648	CpG: 23	281	23	174	16.4	61.9	0.87
chr10	58521665	58521894	CpG: 19	229	19	144	16.6	62.9	0.85
chr10	58960725	58961141	CpG: 34	416	34	256	16.3	61.5	0.88
chr10	59002213	59002487	CpG: 24	274	24	171	17.5	62.4	0.91
chr10	59051476	59051750	CpG: 21	274	21	163	15.3	59.5	0.87
chr10	59097561	59098617	CpG: 77	1056	77	734	14.6	69.5	0.60
chr10	59121355	59123590	CpG: 188	2235	188	1392	16.8	62.3	0.87
chr10	59125170	59125448	CpG: 24	278	24	173	17.3	62.2	0.90
chr10	59189030	59189655	CpG: 71	625	71	461	22.7	73.8	0.84
chr10	59239067	59239679	CpG: 60	612	60	404	19.6	66.0	0.90
chr10	59264830	59265104	CpG: 24	274	24	169	17.5	61.7	0.93
chr10	59366882	59367867	CpG: 126	985	126	721	25.6	73.2	0.96
chr10	59956875	59957111	CpG: 17	236	17	140	14.4	59.3	0.84
chr10	60030027	60031248	CpG: 138	1221	138	840	22.6	68.8	0.96
chr10	60079125	60079399	CpG: 24	274	24	171	17.5	62.4	0.91
chr10	60198324	60198742	CpG: 30	418	30	244	14.4	58.4	0.87
chr10	60216864	60217094	CpG: 27	230	27	171	23.5	74.3	0.85
chr10	60532643	60532924	CpG: 24	281	24	175	17.1	62.3	0.90
chr10	60550101	60550920	CpG: 60	819	60	561	14.7	68.5	0.63
chr10	60562589	60563978	CpG: 119	1389	119	970	17.1	69.8	0.71
chr10	60597543	60597821	CpG: 20	278	20	178	14.4	64.0	0.71
chr10	60597923	60598286	CpG: 31	363	31	264	17.1	72.7	0.65
chr10	60735778	60737350	CpG: 96	1572	96	946	12.2	60.2	1.14
chr10	60760605	60761743	CpG: 113	1138	113	806	19.9	70.8	0.79
chr10	60785110	60785387	CpG: 21	277	21	166	15.2	59.9	0.85
chr10	61099879	61100153	CpG: 21	274	21	167	15.3	60.9	0.84
chr10	61291054	61291322	CpG: 26	268	26	169	19.4	63.1	0.99
chr10	61580657	61580889	CpG: 20	232	20	141	17.2	60.8	0.95
chr10	61589757	61590348	CpG: 65	591	65	438	22.0	74.1	0.80
chr10	61609125	61609336	CpG: 15	211	15	125	14.2	59.2	0.85
chr10	61634950	61635842	CpG: 69	892	69	580	15.5	65.0	0.74
chr10	61697562	61697858	CpG: 20	296	20	177	13.5	59.8	0.77
chr10	61800310	61801293	CpG: 99	983	99	692	20.1	70.4	0.82
chr10	61802657	61802896	CpG: 20	239	20	143	16.7	59.8	0.95
chr10	61846772	61847039	CpG: 18	267	18	158	13.5	59.2	0.78
chr10	61858030	61858599	CpG: 70	569	70	449	24.6	78.9	0.81
chr10	62031082	62031307	CpG: 17	225	17	135	15.1	60.0	0.85
chr10	62309503	62310017	CpG: 40	514	40	328	15.6	63.8	0.77
chr10	62350595	62350869	CpG: 21	274	21	167	15.3	60.9	0.85
chr10	62519554	62520136	CpG: 63	582	63	418	21.6	71.8	0.85
chr10	62522395	62522669	CpG: 25	274	25	172	18.2	62.8	0.94
chr10	62626415	62626644	CpG: 17	229	17	136	14.8	59.4	0.85
chr10	62673747	62674032	CpG: 25	285	25	179	17.5	62.8	0.90
chr10	62724508	62724903	CpG: 40	395	40	291	20.3	73.7	0.75
chr10	62746261	62746540	CpG: 24	279	24	171	17.2	61.3	0.93
chr10	62759980	62760393	CpG: 44	413	44	301	21.3	72.9	0.82
chr10	62766204	62766478	CpG: 21	274	21	171	15.3	62.4	0.79
chr10	63124899	63125564	CpG: 67	665	67	464	20.2	69.8	0.83
chr10	63135754	63135990	CpG: 17	236	17	142	14.4	60.2	0.83
chr10	63136999	63137409	CpG: 33	410	33	297	16.1	72.4	0.62
chr10	63138033	63138388	CpG: 25	355	25	192	14.1	54.1	0.98
chr10	63231882	63232511	CpG: 70	629	70	460	22.3	73.1	0.83
chr10	63261214	63261453	CpG: 19	239	19	146	15.9	61.1	0.87
chr10	63446349	63446579	CpG: 18	230	18	139	15.7	60.4	0.87
chr10	63466212	63466439	CpG: 22	227	22	135	19.4	59.5	1.10
chr10	63488801	63489076	CpG: 24	275	24	172	17.5	62.5	0.90
chr10	63608973	63609251	CpG: 23	278	23	173	16.5	62.2	0.86
chr10	63660868	63661131	CpG: 19	263	19	155	14.4	58.9	0.84
chr10	63662818	63664201	CpG: 152	1383	152	982	22.0	71.0	0.87
chr10	63671553	63671868	CpG: 26	315	26	202	16.5	64.1	0.86
chr10	63673042	63677160	CpG: 329	4118	329	2578	16.0	62.6	0.82
chr10	63730235	63730486	CpG: 18	251	18	143	14.3	57.0	0.92
chr10	63786975	63787250	CpG: 24	275	24	202	17.5	73.5	0.65
chr10	63883323	63883597	CpG: 24	274	24	170	17.5	62.0	0.92
chr10	63890606	63890840	CpG: 17	234	17	144	14.5	61.5	0.79
chr10	63891741	63892178	CpG: 45	437	45	326	20.6	74.6	0.74
chr10	63991222	63991679	CpG: 44	457	44	306	19.3	67.0	0.86
chr10	64038902	64039132	CpG: 18	230	18	139	15.7	60.4	0.87
chr10	64323249	64324339	CpG: 133	1090	133	778	24.4	71.4	0.96
chr10	64379260	64380411	CpG: 142	1151	142	857	24.7	74.5	0.89
chr10	64414782	64415056	CpG: 24	274	24	171	17.5	62.4	0.91
chr10	64454504	64454788	CpG: 24	284	24	176	16.9	62.0	0.90
chr10	64456958	64457194	CpG: 16	236	16	138	13.6	58.5	0.81
chr10	64488518	64489478	CpG: 81	960	81	651	16.9	67.8	0.74
chr10	64642500	64642773	CpG: 24	273	24	168	17.6	61.5	0.94
chr10	64729582	64729819	CpG: 18	237	18	138	15.2	58.2	0.92
chr10	64831266	64831575	CpG: 30	309	30	207	19.4	67.0	0.89
chr10	64899372	64899601	CpG: 24	229	24	173	21.0	75.5	0.74
chr10	65028725	65028998	CpG: 35	273	35	181	25.6	66.3	1.17
chr10	65054595	65055163	CpG: 59	568	59	424	20.8	74.6	0.75
chr10	65367023	65367302	CpG: 25	279	25	176	17.9	63.1	0.91
chr10	65498124	65498352	CpG: 16	228	16	137	14.0	60.1	0.79
chr10	65770477	65770717	CpG: 21	240	21	150	17.5	62.5	0.92
chr10	65782309	65782527	CpG: 17	218	17	128	15.6	58.7	0.91
chr10	65836932	65837213	CpG: 23	281	23	170	16.4	60.5	0.91
chr10	65909735	65910232	CpG: 37	497	37	332	14.9	66.8	0.67
chr10	65911730	65912156	CpG: 43	426	43	315	20.2	73.9	0.75
chr10	65935162	65935436	CpG: 23	274	23	169	16.8	61.7	0.89
chr10	65951958	65952234	CpG: 24	276	24	170	17.4	61.6	0.93
chr10	66126210	66126448	CpG: 17	238	17	144	14.3	60.5	0.82
chr10	66288770	66289119	CpG: 30	349	30	255	17.2	73.1	0.65
chr10	66324496	66324733	CpG: 19	237	19	146	16.0	61.6	0.86
chr10	66405197	66405435	CpG: 17	238	17	137	14.3	57.6	0.88
chr10	66887318	66887592	CpG: 20	274	20	165	14.6	60.2	0.82
chr10	67045608	67045886	CpG: 23	278	23	170	16.5	61.2	0.90
chr10	67344733	67345003	CpG: 21	270	21	166	15.6	61.5	0.84
chr10	67350462	67350762	CpG: 23	300	23	178	15.3	59.3	0.88
chr10	67514866	67515073	CpG: 19	207	19	155	18.4	74.9	0.67
chr10	67693912	67694146	CpG: 19	234	19	143	16.2	61.1	0.89
chr10	67776173	67776458	CpG: 25	285	25	175	17.5	61.4	0.95
chr10	67908683	67908914	CpG: 20	231	20	151	17.3	65.4	0.81
chr10	68052901	68053227	CpG: 27	326	27	194	16.6	59.5	0.94
chr10	68100164	68100466	CpG: 23	302	23	191	15.2	63.2	0.77
chr10	68239215	68239481	CpG: 22	266	22	165	16.5	62.0	0.87
chr10	68248060	68248334	CpG: 23	274	23	170	16.8	62.0	0.88
chr10	68255378	68255758	CpG: 28	380	28	227	14.7	59.7	0.83
chr10	68392443	68392702	CpG: 22	259	22	161	17.0	62.2	0.89
chr10	68599978	68600251	CpG: 18	273	18	162	13.2	59.3	0.76
chr10	68632536	68633041	CpG: 48	505	48	293	19.0	58.0	1.13
chr10	68633549	68633786	CpG: 20	237	20	142	16.9	59.9	0.96
chr10	68666252	68666469	CpG: 17	217	17	131	15.7	60.4	0.87
chr10	68687495	68687771	CpG: 20	276	20	166	14.5	60.1	0.82
chr10	68718466	68718711	CpG: 17	245	17	136	13.9	55.5	0.93
chr10	68719015	68719262	CpG: 18	247	18	150	14.6	60.7	0.81
chr10	68753156	68754165	CpG: 129	1009	129	755	25.6	74.8	0.93
chr10	68754715	68754984	CpG: 23	269	23	162	17.1	60.2	0.95
chr10	68889255	68889532	CpG: 23	277	23	169	16.6	61.0	0.90
chr10	68943464	68944287	CpG: 74	823	74	591	18.0	71.8	0.70
chr10	69099936	69100566	CpG: 79	630	79	457	25.1	72.5	0.95
chr10	69103951	69104232	CpG: 23	281	23	173	16.4	61.6	0.88
chr10	69148172	69148931	CpG: 69	759	69	539	18.2	71.0	0.72
chr10	69200507	69202025	CpG: 128	1518	128	953	16.9	62.8	0.86
chr10	69275675	69276811	CpG: 117	1136	117	828	20.6	72.9	0.78
chr10	69281469	69281743	CpG: 24	274	24	171	17.5	62.4	0.91
chr10	69340876	69341277	CpG: 38	401	38	263	19.0	65.6	0.91
chr10	69381591	69381829	CpG: 21	238	21	145	17.6	60.9	0.97
chr10	69390833	69391111	CpG: 24	278	24	171	17.3	61.5	0.92
chr10	69396419	69397063	CpG: 61	644	61	438	18.9	68.0	0.82
chr10	69429595	69430287	CpG: 73	692	73	516	21.1	74.6	0.76
chr10	69583405	69583643	CpG: 20	238	20	142	16.8	59.7	0.97
chr10	69588130	69588377	CpG: 22	247	22	150	17.8	60.7	0.99
chr10	69590165	69591059	CpG: 89	894	89	597	19.9	66.8	0.90
chr10	69695641	69695881	CpG: 21	240	21	146	17.5	60.8	0.96
chr10	69696309	69697265	CpG: 132	956	132	734	27.6	76.8	0.94
chr10	69769578	69770526	CpG: 75	948	75	608	15.8	64.1	0.77
chr10	69825614	69826441	CpG: 74	827	74	522	17.9	63.1	0.92
chr10	69858112	69859011	CpG: 73	899	73	555	16.2	61.7	0.86
chr10	69890586	69890822	CpG: 18	236	18	140	15.3	59.3	0.89
chr10	69992314	69993001	CpG: 82	687	82	510	23.9	74.2	0.89
chr10	69995691	69995937	CpG: 20	246	20	154	16.3	62.6	0.85
chr10	70032134	70032410	CpG: 21	276	21	168	15.2	60.9	0.83
chr10	70048477	70048885	CpG: 38	408	38	272	18.6	66.7	0.85
chr10	70116560	70116766	CpG: 17	206	17	138	16.5	67.0	0.75
chr10	70153216	70153442	CpG: 16	226	16	136	14.2	60.2	0.82
chr10	70161976	70162204	CpG: 16	228	16	139	14.0	61.0	0.77
chr10	70186238	70187669	CpG: 157	1431	157	1026	21.9	71.7	0.86
chr10	70276628	70277239	CpG: 60	611	60	442	19.6	72.3	0.76
chr10	70298278	70298517	CpG: 17	239	17	133	14.2	55.6	0.96
chr10	70319407	70320276	CpG: 77	869	77	588	17.7	67.7	0.77
chr10	70436904	70437401	CpG: 36	497	36	312	14.5	62.8	0.75
chr10	70439691	70439933	CpG: 18	242	18	156	14.9	64.5	0.73
chr10	70440168	70441634	CpG: 133	1466	133	992	18.1	67.7	0.79
chr10	70445833	70446923	CpG: 74	1090	74	675	13.6	61.9	0.71
chr10	70498155	70498648	CpG: 63	493	63	381	25.6	77.3	0.86
chr10	70669743	70671317	CpG: 140	1574	140	1031	17.8	65.5	0.83
chr10	70718597	70718871	CpG: 23	274	23	170	16.8	62.0	0.88
chr10	70921556	70923035	CpG: 155	1479	155	1028	21.0	69.5	0.87
chr10	70951136	70951375	CpG: 18	239	18	145	15.1	60.7	0.84
chr10	71001318	71002028	CpG: 78	710	78	491	22.0	69.2	0.94
chr10	71014380	71015840	CpG: 152	1460	152	1025	20.8	70.2	0.85
chr10	71016821	71017095	CpG: 19	274	19	164	13.9	59.9	0.79
chr10	71033972	71034202	CpG: 20	230	20	142	17.4	61.7	0.92
chr10	71038918	71039772	CpG: 77	854	77	577	18.0	67.6	0.81
chr10	71101499	71102552	CpG: 107	1053	107	721	20.3	68.5	0.87
chr10	71123970	71124889	CpG: 97	919	97	642	21.1	69.9	0.88
chr10	71152574	71153098	CpG: 56	524	56	402	21.4	76.7	0.73
chr10	71171706	71171980	CpG: 21	274	21	165	15.3	60.2	0.85
chr10	71250860	71251937	CpG: 109	1077	109	749	20.2	69.5	0.84
chr10	71252168	71252399	CpG: 18	231	18	140	15.6	60.6	0.86
chr10	71272988	71273874	CpG: 115	886	115	638	26.0	72.0	1.03
chr10	71309741	71311044	CpG: 117	1303	117	861	18.0	66.1	0.83
chr10	71327662	71328146	CpG: 53	484	53	359	21.9	74.2	0.80
chr10	71347326	71348486	CpG: 132	1160	132	854	22.8	73.6	0.85
chr10	71468252	71468533	CpG: 20	281	20	193	14.2	68.7	0.60
chr10	71470200	71470550	CpG: 25	350	25	236	14.3	67.4	0.63
chr10	71481299	71481569	CpG: 24	270	24	169	17.8	62.6	0.92
chr10	71541871	71542630	CpG: 96	759	96	590	25.3	77.7	0.84
chr10	71685569	71686358	CpG: 94	789	94	603	23.8	76.4	0.87
chr10	71731460	71731667	CpG: 20	207	20	149	19.3	72.0	0.75
chr10	71732462	71732668	CpG: 16	206	16	116	15.5	56.3	0.99
chr10	71757700	71758467	CpG: 78	767	78	566	20.3	73.8	0.75
chr10	71788361	71788563	CpG: 26	202	26	152	25.7	75.2	1.01
chr10	72081948	72083768	CpG: 176	1820	176	1205	19.3	66.2	0.89
chr10	72086990	72087641	CpG: 55	651	55	432	16.9	66.4	0.79
chr10	72188647	72188971	CpG: 42	324	42	249	25.9	76.9	0.89
chr10	72246758	72247139	CpG: 37	381	37	261	19.4	68.5	0.83
chr10	72265951	72267741	CpG: 205	1790	205	1300	22.9	72.6	0.87
chr10	72531557	72531781	CpG: 20	224	20	179	17.9	79.9	0.95
chr10	72644066	72644467	CpG: 51	401	51	300	25.4	74.8	0.91
chr10	72676539	72676797	CpG: 26	258	26	173	20.2	67.1	0.91
chr10	72721628	72722114	CpG: 42	486	42	345	17.3	71.0	0.69
chr10	72723648	72723882	CpG: 18	234	18	141	15.4	60.3	0.86
chr10	72746575	72747396	CpG: 63	821	63	565	15.3	68.8	0.65
chr10	72759537	72760003	CpG: 46	466	46	294	19.7	63.1	1.00
chr10	72782949	72783223	CpG: 22	274	22	169	16.1	61.7	0.85
chr10	72800048	72800273	CpG: 17	225	17	136	15.1	60.4	0.85
chr10	72834778	72835837	CpG: 115	1059	115	777	21.7	73.4	0.81
chr10	72878231	72879454	CpG: 122	1223	122	845	20.0	69.1	0.84
chr10	72957881	72959308	CpG: 133	1427	133	1027	18.6	72.0	0.73
chr10	73086983	73087427	CpG: 44	444	44	297	19.8	66.9	0.90
chr10	73088264	73088501	CpG: 20	237	20	144	16.9	60.8	0.94
chr10	73131964	73132293	CpG: 25	329	25	224	15.2	68.1	0.68
chr10	73144435	73145966	CpG: 122	1531	122	1000	15.9	65.3	0.75
chr10	73168183	73168441	CpG: 18	258	18	157	14.0	60.9	0.77
chr10	73168681	73169305	CpG: 61	624	61	446	19.6	71.5	0.78
chr10	73171640	73172025	CpG: 42	385	42	287	21.8	74.5	0.79
chr10	73190602	73191127	CpG: 53	525	53	389	20.2	74.1	0.74
chr10	73196991	73197380	CpG: 38	389	38	290	19.5	74.6	0.71
chr10	73225087	73226064	CpG: 86	977	86	629	17.6	64.4	0.85
chr10	73482377	73482583	CpG: 18	206	18	126	17.5	61.2	0.95
chr10	73497055	73497629	CpG: 42	574	42	364	14.6	63.4	0.73
chr10	73542377	73542602	CpG: 20	225	20	139	17.8	61.8	0.96
chr10	73562509	73562743	CpG: 17	234	17	136	14.5	58.1	0.88
chr10	73563434	73564203	CpG: 85	769	85	566	22.1	73.6	0.82
chr10	73910033	73910307	CpG: 23	274	23	169	16.8	61.7	0.89
chr10	73967492	73968619	CpG: 103	1127	103	746	18.3	66.2	0.83
chr10	73976528	73976805	CpG: 22	277	22	166	15.9	59.9	0.90
chr10	74039277	74039698	CpG: 40	421	40	292	19.0	69.4	0.80
chr10	74118252	74118807	CpG: 68	555	68	385	24.5	69.4	1.02
chr10	74123749	74124395	CpG: 57	646	57	397	17.6	61.5	0.94
chr10	74157584	74157814	CpG: 16	230	16	137	13.9	59.6	0.81
chr10	74229862	74230336	CpG: 36	474	36	287	15.2	60.5	0.84
chr10	74244040	74244249	CpG: 15	209	15	125	14.4	59.8	0.82
chr10	74285068	74285607	CpG: 55	539	55	396	20.4	73.5	0.76
chr10	74289268	74289543	CpG: 24	275	24	170	17.5	61.8	0.92
chr10	74296814	74297072	CpG: 18	258	18	153	14.0	59.3	0.80
chr10	74366690	74367465	CpG: 72	775	72	554	18.6	71.5	0.73
chr10	74414874	74415078	CpG: 16	204	16	123	15.7	60.3	0.88
chr10	74496748	74497660	CpG: 67	912	67	568	14.7	62.3	0.79
chr10	74519079	74519372	CpG: 26	293	26	199	17.7	67.9	0.78
chr10	74546020	74546243	CpG: 18	223	18	148	16.1	66.4	0.74
chr10	74600627	74600905	CpG: 21	278	21	167	15.1	60.1	0.85
chr10	74601603	74602210	CpG: 57	607	57	394	18.8	64.9	0.91
chr10	74604149	74605080	CpG: 103	931	103	701	22.1	75.3	0.79
chr10	74615631	74615880	CpG: 22	249	22	161	17.7	64.7	0.90
chr10	74643628	74644475	CpG: 111	847	111	612	26.2	72.3	1.01
chr10	74653199	74653848	CpG: 60	649	60	417	18.5	64.3	0.90
chr10	74655791	74656051	CpG: 19	260	19	155	14.6	59.6	0.84
chr10	74656906	74657766	CpG: 80	860	80	599	18.6	69.7	0.77
chr10	74682334	74683450	CpG: 139	1116	139	864	24.9	77.4	0.84
chr10	74710897	74711125	CpG: 25	228	25	169	21.9	74.1	0.81
chr10	74745070	74746429	CpG: 155	1359	155	1057	22.8	77.8	0.78
chr10	74782329	74783012	CpG: 74	683	74	499	21.7	73.1	0.81
chr10	74816059	74816284	CpG: 19	225	19	165	16.9	73.3	0.63
chr10	74834247	74834521	CpG: 21	274	21	167	15.3	60.9	0.84
chr10	74868229	74868466	CpG: 18	237	18	139	15.2	58.6	0.90
chr10	74869115	74870218	CpG: 115	1103	115	759	20.9	68.8	0.88
chr10	74888452	74888726	CpG: 24	274	24	171	17.5	62.4	0.91
chr10	75022463	75023107	CpG: 50	644	50	435	15.5	67.5	0.71
chr10	75047839	75048610	CpG: 77	771	77	513	20.0	66.5	0.90
chr10	75056940	75057225	CpG: 23	285	23	171	16.1	60.0	0.91
chr10	75227396	75227677	CpG: 23	281	23	174	16.4	61.9	0.87
chr10	75327723	75327978	CpG: 19	255	19	152	14.9	59.6	0.86
chr10	75684906	75685218	CpG: 35	312	35	232	22.4	74.4	0.83
chr10	75698387	75700597	CpG: 207	2210	207	1565	18.7	70.8	0.77
chr10	75702145	75702381	CpG: 18	236	18	143	15.3	60.6	0.85
chr10	75818061	75818334	CpG: 22	273	22	166	16.1	60.8	0.88
chr10	75917132	75917629	CpG: 58	497	58	347	23.3	69.8	0.98
chr10	75984811	75985376	CpG: 70	565	70	427	24.8	75.6	0.87
chr10	76025740	76026014	CpG: 23	274	23	169	16.8	61.7	0.89
chr10	76058022	76058329	CpG: 23	307	23	183	15.0	59.6	0.85
chr10	76083719	76084729	CpG: 109	1010	109	723	21.6	71.6	0.84
chr10	76107642	76109703	CpG: 186	2061	186	1478	18.0	71.7	0.70
chr10	76133160	76133434	CpG: 25	274	25	172	18.2	62.8	0.94
chr10	76150131	76150354	CpG: 18	223	18	146	16.1	65.5	0.76
chr10	76168259	76168843	CpG: 56	584	56	403	19.2	69.0	0.81
chr10	76269420	76283892	CpG: 1057	14472	1057	8886	14.6	61.4	0.77
chr10	76305353	76305863	CpG: 67	510	67	385	26.3	75.5	0.92
chr10	76986384	76986606	CpG: 19	222	19	151	17.1	68.0	0.74
chr10	77125249	77125577	CpG: 27	328	27	192	16.5	58.5	0.98
chr10	77219100	77219380	CpG: 25	280	25	172	17.9	61.4	0.96
chr10	77257509	77257790	CpG: 23	281	23	173	16.4	61.6	0.88
chr10	78163889	78164170	CpG: 23	281	23	174	16.4	61.9	0.87
chr10	78458953	78459330	CpG: 31	377	31	276	16.4	73.2	0.61
chr10	78505050	78507456	CpG: 263	2406	263	1713	21.9	71.2	0.86
chr10	78561552	78561826	CpG: 24	274	24	171	17.5	62.4	0.91
chr10	78580257	78580720	CpG: 40	463	40	326	17.3	70.4	0.70
chr10	78581933	78582165	CpG: 17	232	17	140	14.7	60.3	0.82
chr10	78795012	78796343	CpG: 162	1331	162	1032	24.3	77.5	0.81
chr10	78898420	78898722	CpG: 26	302	26	184	17.2	60.9	0.96
chr10	78899576	78899800	CpG: 18	224	18	132	16.1	58.9	0.94
chr10	78902782	78903240	CpG: 43	458	43	300	18.8	65.5	0.89
chr10	78944802	78945565	CpG: 55	763	55	517	14.4	67.8	0.63
chr10	78957640	78957864	CpG: 18	224	18	133	16.1	59.4	0.91
chr10	78970022	78970301	CpG: 25	279	25	176	17.9	63.1	0.91
chr10	79172085	79172892	CpG: 80	807	80	557	19.8	69.0	0.83
chr10	79636719	79636993	CpG: 24	274	24	171	17.5	62.4	0.91
chr10	79842798	79843515	CpG: 70	717	70	509	19.5	71.0	0.78
chr10	79936284	79940158	CpG: 363	3874	363	2665	18.7	68.8	0.80
chr10	80086508	80086746	CpG: 18	238	18	141	15.1	59.2	0.88
chr10	80090579	80090798	CpG: 20	219	20	150	18.3	68.5	0.79
chr10	80111639	80113291	CpG: 208	1652	208	1231	25.2	74.5	0.91
chr10	80148345	80148831	CpG: 42	486	42	362	17.3	74.5	0.62
chr10	80216670	80217535	CpG: 99	865	99	636	22.9	73.5	0.85
chr10	80255543	80255782	CpG: 22	239	22	171	18.4	71.5	0.72
chr10	80313771	80315130	CpG: 141	1359	141	984	20.8	72.4	0.79
chr10	80315605	80315864	CpG: 22	259	22	184	17.0	71.0	0.70
chr10	80334842	80335077	CpG: 19	235	19	141	16.2	60.0	0.92
chr10	80516557	80516827	CpG: 22	270	22	161	16.3	59.6	0.93
chr10	80532235	80532525	CpG: 25	290	25	173	17.2	59.7	0.97
chr10	80553709	80554020	CpG: 22	311	22	189	14.1	60.8	0.77
chr10	80569969	80570289	CpG: 32	320	32	219	20.0	68.4	0.86
chr10	80584839	80585076	CpG: 17	237	17	140	14.3	59.1	0.86
chr10	80694936	80696569	CpG: 182	1633	182	1164	22.3	71.3	0.88
chr10	80708133	80708453	CpG: 35	320	35	220	21.9	68.8	0.93
chr10	80774030	80774717	CpG: 62	687	62	452	18.0	65.8	0.85
chr10	80850713	80851778	CpG: 110	1065	110	780	20.7	73.2	0.77
chr10	80852612	80853032	CpG: 36	420	36	294	17.1	70.0	0.76
chr10	80947762	80948481	CpG: 65	719	65	477	18.1	66.3	0.83
chr10	80986186	80986424	CpG: 17	238	17	138	14.3	58.0	0.87
chr10	80998580	80998820	CpG: 19	240	19	140	15.8	58.3	0.95
chr10	80999298	80999537	CpG: 19	239	19	146	15.9	61.1	0.87
chr10	81001591	81002033	CpG: 50	442	50	329	22.6	74.4	0.83
chr10	81068271	81068502	CpG: 16	231	16	132	13.9	57.1	0.86
chr10	81074038	81074914	CpG: 95	876	95	672	21.7	76.7	0.74
chr10	81075974	81076873	CpG: 61	899	61	559	13.6	62.2	0.70
chr10	81218015	81218294	CpG: 24	279	24	176	17.2	63.1	0.88
chr10	81225548	81226466	CpG: 93	918	93	654	20.3	71.2	0.87
chr10	81228586	81228967	CpG: 31	381	31	272	16.3	71.4	0.64
chr10	81262483	81262723	CpG: 17	240	17	131	14.2	54.6	0.97
chr10	81272857	81273300	CpG: 36	443	36	259	16.3	58.5	0.97
chr10	81277406	81278259	CpG: 100	853	100	609	23.4	71.4	0.93
chr10	81322899	81324102	CpG: 163	1203	163	930	27.1	77.3	0.91
chr10	81404839	81405530	CpG: 56	691	56	461	16.2	66.7	0.74
chr10	81412368	81412704	CpG: 32	336	32	248	19.0	73.8	0.70
chr10	81432222	81432500	CpG: 22	278	22	171	15.8	61.5	0.84
chr10	81600257	81600533	CpG: 23	276	23	161	16.7	58.3	0.99
chr10	81775514	81775760	CpG: 18	246	18	144	14.6	58.5	0.86
chr10	81851767	81852049	CpG: 24	282	24	174	17.0	61.7	0.90
chr10	81871945	81872181	CpG: 21	236	21	146	17.8	61.9	0.95
chr10	82183224	82183668	CpG: 37	444	37	327	16.7	73.6	0.62
chr10	82353773	82354000	CpG: 20	227	20	139	17.6	61.2	0.95
chr10	82376396	82376637	CpG: 20	241	20	169	16.6	70.1	0.68
chr10	82453634	82453870	CpG: 21	236	21	144	17.8	61.0	0.97
chr10	82487035	82487309	CpG: 23	274	23	170	16.8	62.0	0.88
chr10	82583475	82583902	CpG: 30	427	30	252	14.1	59.0	0.81
chr10	82646746	82647023	CpG: 23	277	23	164	16.6	59.2	0.96
chr10	82747887	82749796	CpG: 228	1909	228	1407	23.9	73.7	0.88
chr10	82797075	82797334	CpG: 26	259	26	161	20.1	62.2	1.05
chr10	82836975	82837256	CpG: 25	281	25	177	17.8	63.0	0.91
chr10	83223612	83223929	CpG: 25	317	25	187	15.8	59.0	0.91
chr10	83543104	83543348	CpG: 19	244	19	150	15.6	61.5	0.85
chr10	83924949	83925223	CpG: 24	274	24	171	17.5	62.4	0.91
chr10	84443189	84443492	CpG: 24	303	24	195	15.8	64.4	0.77
chr10	84664941	84665193	CpG: 21	252	21	151	16.7	59.9	0.93
chr10	84720021	84720299	CpG: 25	278	25	175	18.0	62.9	0.91
chr10	84901846	84902124	CpG: 24	278	24	174	17.3	62.6	0.89
chr10	85017447	85018029	CpG: 51	582	51	388	17.5	66.7	0.79
chr10	85036102	85036376	CpG: 23	274	23	169	16.8	61.7	0.89
chr10	85072967	85074071	CpG: 93	1104	93	772	16.8	69.9	0.69
chr10	85115864	85116182	CpG: 32	318	32	235	20.1	73.9	0.75
chr10	85158510	85158869	CpG: 26	359	26	208	14.5	57.9	0.86
chr10	85206922	85207693	CpG: 106	771	106	599	27.5	77.7	0.94
chr10	85225865	85226861	CpG: 78	996	78	709	15.7	71.2	0.62
chr10	85314555	85315100	CpG: 40	545	40	305	14.7	56.0	0.94
chr10	85419199	85419753	CpG: 49	554	49	374	17.7	67.5	0.78
chr10	85503396	85503677	CpG: 25	281	25	176	17.8	62.6	0.92
chr10	85595579	85595860	CpG: 24	281	24	175	17.1	62.3	0.90
chr10	85768545	85768819	CpG: 24	274	24	171	17.5	62.4	0.91
chr10	85769894	85770174	CpG: 24	280	24	179	17.1	63.9	0.84
chr10	85807031	85807316	CpG: 22	285	22	176	15.4	61.8	0.82
chr10	85898432	85898698	CpG: 21	266	21	160	15.8	60.2	0.88
chr10	85976945	85977175	CpG: 20	230	20	141	17.4	61.3	0.94
chr10	86021550	86021939	CpG: 33	389	33	284	17.0	73.0	0.64
chr10	86046314	86046595	CpG: 24	281	24	174	17.1	61.9	0.91
chr10	86223769	86224008	CpG: 18	239	18	143	15.1	59.8	0.86
chr10	86235661	86236088	CpG: 31	427	31	251	14.5	58.8	0.84
chr10	87088285	87088562	CpG: 23	277	23	169	16.6	61.0	0.90
chr10	87143443	87144082	CpG: 47	639	47	381	14.7	59.6	0.83
chr10	87217412	87217649	CpG: 17	237	17	140	14.3	59.1	0.82
chr10	87243700	87248140	CpG: 413	4440	413	3090	18.6	69.6	0.78
chr10	87257424	87258068	CpG: 65	644	65	452	20.2	70.2	0.82
chr10	87269302	87269629	CpG: 26	327	26	197	15.9	60.2	0.88
chr10	87270031	87270503	CpG: 46	472	46	337	19.5	71.4	0.76
chr10	87280374	87282377	CpG: 189	2003	189	1408	18.9	70.3	0.76
chr10	87335282	87335693	CpG: 41	411	41	314	20.0	76.4	0.68
chr10	87404989	87406443	CpG: 154	1454	154	1022	21.2	70.3	0.86
chr10	87419638	87421053	CpG: 107	1415	107	889	15.1	62.8	0.77
chr10	87516148	87516644	CpG: 51	496	51	361	20.6	72.8	0.78
chr10	87595285	87596314	CpG: 121	1029	121	745	23.5	72.4	0.90
chr10	87638758	87639037	CpG: 20	279	20	172	14.3	61.6	0.77
chr10	87639739	87641530	CpG: 217	1791	217	1302	24.2	72.7	0.92
chr10	87822830	87823405	CpG: 42	575	42	332	14.6	57.7	0.88
chr10	87826270	87827277	CpG: 108	1007	108	703	21.4	69.8	0.89
chr10	87851991	87852672	CpG: 59	681	59	478	17.3	70.2	0.70
chr10	87854506	87855584	CpG: 94	1078	94	735	17.4	68.2	0.75
chr10	87869617	87869902	CpG: 22	285	22	174	15.4	61.1	0.84
chr10	87893311	87893534	CpG: 19	223	19	149	17.0	66.8	0.77
chr10	87977633	87979437	CpG: 200	1804	200	1304	22.2	72.3	0.86
chr10	88038623	88038859	CpG: 18	236	18	139	15.3	58.9	0.89
chr10	88087235	88087484	CpG: 33	249	33	186	26.5	74.7	0.96
chr10	88106574	88106842	CpG: 28	268	28	185	20.9	69.0	0.88
chr10	88121396	88121633	CpG: 17	237	17	138	14.3	58.2	0.87
chr10	88218123	88218402	CpG: 23	279	23	168	16.5	60.2	0.92
chr10	88225245	88226861	CpG: 175	1616	175	1149	21.7	71.1	0.86
chr10	88233176	88233448	CpG: 24	272	24	167	17.6	61.4	0.94
chr10	88238721	88239031	CpG: 31	310	31	212	20.0	68.4	0.86
chr10	88388210	88389211	CpG: 101	1001	101	692	20.2	69.1	0.85
chr10	88485974	88486205	CpG: 18	231	18	137	15.6	59.3	0.90
chr10	88497517	88497802	CpG: 25	285	25	180	17.5	63.2	0.90
chr10	88543438	88544119	CpG: 75	681	75	495	22.0	72.7	0.83
chr10	88549140	88549351	CpG: 15	211	15	123	14.2	58.3	0.85
chr10	88701632	88702438	CpG: 62	806	62	500	15.4	62.0	0.80
chr10	88745918	88748273	CpG: 213	2355	213	1564	18.1	66.4	0.82
chr10	88833882	88834155	CpG: 21	273	21	166	15.4	60.8	0.84
chr10	88867036	88867310	CpG: 22	274	22	167	16.1	60.9	0.87
chr10	88876218	88876487	CpG: 20	269	20	161	14.9	59.9	0.83
chr10	89119066	89119309	CpG: 17	243	17	144	14.0	59.3	0.84
chr10	89466845	89467538	CpG: 64	693	64	476	18.5	68.7	0.79
chr10	89707505	89707783	CpG: 26	278	26	177	18.7	63.7	0.93
chr10	89763972	89764808	CpG: 95	836	95	580	22.7	69.4	0.95
chr10	89874403	89875250	CpG: 68	847	68	566	16.1	66.8	0.73
chr10	89901688	89901903	CpG: 15	215	15	118	14.0	54.9	0.94
chr10	90045433	90045648	CpG: 16	215	16	142	14.9	66.0	0.71
chr10	90091695	90092040	CpG: 42	345	42	239	24.3	69.3	1.02
chr10	90135417	90135956	CpG: 46	539	46	368	17.1	68.3	0.74
chr10	90298491	90299252	CpG: 87	761	87	536	22.9	70.4	0.92
chr10	90419025	90420004	CpG: 100	979	100	703	20.4	71.8	0.79
chr10	90528372	90529183	CpG: 100	811	100	613	24.7	75.6	0.87
chr10	90585039	90585795	CpG: 54	756	54	455	14.3	60.2	0.79
chr10	90720716	90721534	CpG: 63	818	63	547	15.4	66.9	0.69
chr10	90844102	90844337	CpG: 20	235	20	141	17.0	60.0	0.96
chr10	91215023	91215304	CpG: 24	281	24	176	17.1	62.6	0.89
chr10	91275694	91275931	CpG: 19	237	19	147	16.0	62.0	0.84
chr10	91689999	91690262	CpG: 20	263	20	159	15.2	60.5	0.85
chr10	91740737	91741954	CpG: 156	1217	156	892	25.6	73.3	0.96
chr10	91854369	91854572	CpG: 16	203	16	127	15.8	62.6	0.82
chr10	91939337	91939618	CpG: 23	281	23	175	16.4	62.3	0.86
chr10	92037323	92037627	CpG: 32	304	32	207	21.1	68.1	0.91
chr10	92046211	92047822	CpG: 213	1611	213	1178	26.4	73.1	0.99
chr10	92103837	92104562	CpG: 87	725	87	561	24.0	77.4	0.81
chr10	92293085	92294170	CpG: 135	1085	135	788	24.9	72.6	0.95
chr10	92360246	92360539	CpG: 23	293	23	180	15.7	61.4	0.85
chr10	92386754	92387060	CpG: 25	306	25	187	16.3	61.1	0.88
chr10	92455940	92456221	CpG: 23	281	23	174	16.4	61.9	0.87
chr10	92516135	92516615	CpG: 47	480	47	337	19.6	70.2	0.80
chr10	92681467	92682206	CpG: 100	739	100	548	27.1	74.2	0.98
chr10	92692652	92692914	CpG: 20	262	20	158	15.3	60.3	0.85
chr10	92769378	92769719	CpG: 44	341	44	245	25.8	71.8	1.00
chr10	92790347	92791116	CpG: 100	769	100	566	26.0	73.6	0.96
chr10	92805784	92806193	CpG: 58	409	58	290	28.4	70.9	1.13
chr10	92855731	92856009	CpG: 24	278	24	174	17.3	62.6	0.89
chr10	92928162	92928521	CpG: 35	359	35	260	19.5	72.4	0.75
chr10	92997417	92997727	CpG: 31	310	31	216	20.0	69.7	0.82
chr10	93110033	93110270	CpG: 18	237	18	145	15.2	61.2	0.83
chr10	93121754	93122638	CpG: 93	884	93	623	21.0	70.5	0.88
chr10	93173033	93174022	CpG: 99	989	99	697	20.0	70.5	0.81
chr10	93201670	93201944	CpG: 22	274	22	166	16.1	60.6	0.88
chr10	93250769	93251016	CpG: 20	247	20	144	16.2	58.3	1.00
chr10	93277549	93277785	CpG: 21	236	21	145	17.8	61.4	0.96
chr10	93299864	93300303	CpG: 42	439	42	257	19.1	58.5	1.13
chr10	93322905	93323145	CpG: 21	240	21	143	17.5	59.6	0.99
chr10	93435189	93435501	CpG: 24	312	24	185	15.4	59.3	0.89
chr10	93452492	93454046	CpG: 147	1554	147	1044	18.9	67.2	0.84
chr10	93470936	93472739	CpG: 126	1803	126	1020	14.0	56.6	0.87
chr10	93568583	93570369	CpG: 209	1786	209	1304	23.4	73.0	0.88
chr10	93571219	93571627	CpG: 34	408	34	267	16.7	65.4	0.78
chr10	93572090	93572318	CpG: 21	228	21	153	18.4	67.1	0.83
chr10	93575414	93575808	CpG: 46	394	46	289	23.4	73.4	0.88
chr10	93579145	93579482	CpG: 26	337	26	208	15.4	61.7	0.81
chr10	93703120	93703401	CpG: 25	281	25	176	17.8	62.6	0.92
chr10	93727950	93728952	CpG: 132	1002	132	754	26.3	75.2	0.93
chr10	93917648	93917878	CpG: 24	230	24	147	20.9	63.9	1.06
chr10	93940167	93943388	CpG: 254	3221	254	2097	15.8	65.1	0.75
chr10	93945682	93946449	CpG: 80	767	80	527	20.9	68.7	0.89
chr10	93948231	93949169	CpG: 86	938	86	606	18.3	64.6	0.88
chr10	93951640	93952450	CpG: 60	810	60	490	14.8	60.5	0.81
chr10	93953410	93955394	CpG: 173	1984	173	1317	17.4	66.4	0.80
chr10	94021532	94021798	CpG: 17	266	17	159	12.8	59.8	0.73
chr10	94227239	94227524	CpG: 25	285	25	179	17.5	62.8	0.90
chr10	94376374	94376921	CpG: 63	547	63	385	23.0	70.4	0.94
chr10	94446426	94447305	CpG: 93	879	93	620	21.2	70.5	0.85
chr10	94480583	94481581	CpG: 114	998	114	724	22.8	72.5	0.87
chr10	94582333	94582670	CpG: 40	337	40	231	23.7	68.5	1.04
chr10	94646473	94646712	CpG: 21	239	21	144	17.6	60.3	0.99
chr10	94724322	94724577	CpG: 21	255	21	190	16.5	74.5	0.61
chr10	94772959	94773499	CpG: 72	540	72	406	26.7	75.2	0.95
chr10	94849257	94850192	CpG: 74	935	74	651	15.8	69.6	0.65
chr10	94872683	94873537	CpG: 106	854	106	642	24.8	75.2	0.88
chr10	94973056	94973336	CpG: 25	280	25	176	17.9	62.9	0.91
chr10	95241880	95242244	CpG: 39	364	39	242	21.4	66.5	0.97
chr10	95281365	95282819	CpG: 175	1454	175	1053	24.1	72.4	0.92
chr10	95323893	95324128	CpG: 19	235	19	141	16.2	60.0	0.93
chr10	95394043	95394283	CpG: 22	240	22	149	18.3	62.1	0.97
chr10	95424471	95425248	CpG: 60	777	60	468	15.4	60.2	0.89
chr10	95456892	95457176	CpG: 24	284	24	174	16.9	61.3	0.91
chr10	95696858	95697110	CpG: 20	252	20	149	15.9	59.1	0.93
chr10	95880404	95880674	CpG: 20	270	20	163	14.8	60.4	0.82
chr10	95920620	95920901	CpG: 23	281	23	175	16.4	62.3	0.86
chr10	96062566	96063108	CpG: 71	542	71	410	26.2	75.6	0.92
chr10	96169606	96170545	CpG: 123	939	123	694	26.2	73.9	0.96
chr10	96174550	96174870	CpG: 33	320	33	204	20.6	63.8	1.03
chr10	96439857	96440916	CpG: 106	1059	106	728	20.0	68.7	0.85
chr10	96535227	96536069	CpG: 91	842	91	593	21.6	70.4	0.88
chr10	96548863	96549136	CpG: 23	273	23	173	16.8	63.4	0.85
chr10	96558721	96558998	CpG: 25	277	25	174	18.1	62.8	0.92
chr10	96572828	96573363	CpG: 48	535	48	347	17.9	64.9	0.86
chr10	96736986	96737214	CpG: 20	228	20	136	17.5	59.6	1.00
chr10	96786576	96787310	CpG: 70	734	70	498	19.1	67.8	0.83
chr10	96922426	96923817	CpG: 145	1391	145	965	20.8	69.4	0.87
chr10	96969123	96969650	CpG: 42	527	42	322	15.9	61.1	0.85
chr10	96997027	96997301	CpG: 25	274	25	170	18.2	62.0	0.96
chr10	97009164	97009940	CpG: 72	776	72	479	18.6	61.7	0.98
chr10	97074102	97074375	CpG: 23	273	23	168	16.8	61.5	0.90
chr10	97249234	97249573	CpG: 29	339	29	216	17.1	63.7	0.86
chr10	97393585	97395317	CpG: 154	1732	154	1167	17.8	67.4	0.78
chr10	97467446	97468461	CpG: 125	1015	125	775	24.6	76.4	0.86
chr10	97543724	97544011	CpG: 25	287	25	179	17.4	62.4	0.91
chr10	97601139	97601901	CpG: 77	762	77	545	20.2	71.5	0.79
chr10	97603037	97603305	CpG: 23	268	23	162	17.2	60.4	0.95
chr10	97631695	97631904	CpG: 17	209	17	133	16.3	63.6	0.82
chr10	97632850	97633112	CpG: 25	262	25	165	19.1	63.0	0.97
chr10	97648015	97648290	CpG: 20	275	20	164	14.5	59.6	0.82
chr10	97698665	97698892	CpG: 18	227	18	132	15.9	58.1	0.97
chr10	97700798	97701054	CpG: 23	256	23	161	18.0	62.9	0.93
chr10	97712863	97714429	CpG: 211	1566	211	1196	26.9	76.4	0.92
chr10	97789692	97789928	CpG: 18	236	18	142	15.3	60.2	0.86
chr10	97924186	97924555	CpG: 27	369	27	245	14.6	66.4	0.68
chr10	98066168	98067347	CpG: 109	1179	109	829	18.5	70.3	0.76
chr10	98077111	98077402	CpG: 41	291	41	212	28.2	72.9	1.09
chr10	98092617	98092857	CpG: 18	240	18	142	15.0	59.2	0.89
chr10	98172379	98172935	CpG: 48	556	48	350	17.3	62.9	0.88
chr10	98179366	98179601	CpG: 18	235	18	141	15.3	60.0	0.87
chr10	98199087	98201489	CpG: 214	2402	214	1585	17.8	66.0	0.82
chr10	98213849	98215831	CpG: 218	1982	218	1377	22.0	69.5	0.91
chr10	98228760	98229033	CpG: 23	273	23	173	16.8	63.4	0.85
chr10	98269330	98269574	CpG: 19	244	19	149	15.6	61.1	0.85
chr10	98278256	98278529	CpG: 22	273	22	169	16.1	61.9	0.86
chr10	98281236	98281538	CpG: 25	302	25	185	16.6	61.3	0.88
chr10	98305944	98307172	CpG: 132	1228	132	828	21.5	67.4	0.95
chr10	98325899	98326697	CpG: 65	798	65	504	16.3	63.2	0.82
chr10	98378376	98379956	CpG: 163	1580	163	1152	20.6	72.9	0.78
chr10	98450382	98450626	CpG: 20	244	20	168	16.4	68.9	0.69
chr10	98458415	98458667	CpG: 28	252	28	174	22.2	69.0	0.96
chr10	98513229	98513818	CpG: 48	589	48	393	16.3	66.7	0.78
chr10	98520708	98521427	CpG: 91	719	91	524	25.3	72.9	0.96
chr10	98540262	98540498	CpG: 18	236	18	142	15.3	60.2	0.86
chr10	98567091	98567795	CpG: 76	704	76	500	21.6	71.0	0.86
chr10	98593487	98595067	CpG: 171	1580	171	1142	21.6	72.3	0.83
chr10	98617048	98617850	CpG: 72	802	72	546	18.0	68.1	0.77
chr10	98651423	98652366	CpG: 117	943	117	712	24.8	75.5	0.87
chr10	98721156	98722073	CpG: 67	917	67	634	14.6	69.1	0.62
chr10	98729805	98730496	CpG: 90	691	90	545	26.0	78.9	0.85
chr10	98855250	98855688	CpG: 38	438	38	292	17.4	66.7	0.84
chr10	98907271	98907533	CpG: 20	262	20	163	15.3	62.2	0.80
chr10	98909863	98911952	CpG: 214	2089	214	1512	20.5	72.4	0.78
chr10	99014890	99015539	CpG: 60	649	60	427	18.5	65.8	0.86
chr10	99032458	99033437	CpG: 83	979	83	692	17.0	70.7	0.68
chr10	99148154	99148902	CpG: 83	748	83	562	22.2	75.1	0.79
chr10	99326527	99326999	CpG: 52	472	52	340	22.0	72.0	0.85
chr10	99347634	99348048	CpG: 37	414	37	278	17.9	67.1	0.79
chr10	99424421	99424698	CpG: 23	277	23	172	16.6	62.1	0.87
chr10	99626481	99626727	CpG: 17	246	17	144	13.8	58.5	0.83
chr10	99670210	99670434	CpG: 19	224	19	134	17.0	59.8	0.95
chr10	99967987	99968265	CpG: 24	278	24	174	17.3	62.6	0.89
chr10	100034461	100034704	CpG: 22	243	22	144	18.1	59.3	1.04
chr10	100042206	100042480	CpG: 23	274	23	170	16.8	62.0	0.88
chr10	100062651	100062931	CpG: 25	280	25	176	17.9	62.9	0.91
chr10	100113748	100114475	CpG: 55	727	55	454	15.1	62.4	0.78
chr10	100115607	100115975	CpG: 38	368	38	232	20.7	63.0	1.05
chr10	100209919	100210220	CpG: 23	301	23	161	15.3	53.5	1.08
chr10	100211132	100212777	CpG: 170	1645	170	1161	20.7	70.6	0.83
chr10	100309254	100309485	CpG: 16	231	16	137	13.9	59.3	0.81
chr10	100311005	100311274	CpG: 19	269	19	158	14.1	58.7	0.84
chr10	100312458	100313094	CpG: 55	636	55	400	17.3	62.9	0.88
chr10	100402146	100402587	CpG: 38	441	38	273	17.2	61.9	0.90
chr10	100403327	100404321	CpG: 83	994	83	612	16.7	61.6	0.88
chr10	100404931	100405175	CpG: 21	244	21	169	17.2	69.3	0.73
chr10	100409368	100409880	CpG: 41	512	41	353	16.0	68.9	0.67
chr10	100412232	100412545	CpG: 24	313	24	217	15.3	69.3	0.65
chr10	100412832	100413385	CpG: 42	553	42	364	15.2	65.8	0.74
chr10	100414832	100415058	CpG: 20	226	20	157	17.7	69.5	0.74
chr10	100415222	100415445	CpG: 17	223	17	139	15.2	62.3	0.81
chr10	100416650	100419911	CpG: 264	3261	264	2071	16.2	63.5	0.80
chr10	100422204	100423090	CpG: 76	886	76	614	17.2	69.3	0.73
chr10	100486340	100486622	CpG: 24	282	24	170	17.0	60.3	0.95
chr10	100502831	100504567	CpG: 170	1736	170	1189	19.6	68.5	0.84
chr10	100542115	100542836	CpG: 71	721	71	507	19.7	70.3	0.80
chr10	100614913	100615813	CpG: 83	900	83	577	18.4	64.1	0.90
chr10	100721198	100724206	CpG: 287	3008	287	2391	19.1	79.5	0.60
chr10	100775100	100776028	CpG: 74	928	74	667	15.9	71.9	0.62
chr10	100893162	100893988	CpG: 113	826	113	620	27.4	75.1	0.99
chr10	100915235	100915509	CpG: 19	274	19	165	13.9	60.2	0.78
chr10	100948934	100949159	CpG: 18	225	18	144	16.0	64.0	0.80
chr10	100999395	100999676	CpG: 40	281	40	218	28.5	77.6	0.99
chr10	101029565	101029795	CpG: 17	230	17	139	14.8	60.4	0.81
chr10	101039777	101040051	CpG: 22	274	22	170	16.1	62.0	0.84
chr10	101070056	101070392	CpG: 43	336	43	245	25.6	72.9	0.98
chr10	101094360	101094634	CpG: 24	274	24	171	17.5	62.4	0.91
chr10	101113627	101114033	CpG: 43	406	43	274	21.2	67.5	0.95
chr10	101128635	101128914	CpG: 19	279	19	165	13.6	59.1	0.79
chr10	101150917	101151232	CpG: 24	315	24	175	15.2	55.6	0.99
chr10	101151598	101151989	CpG: 32	391	32	227	16.4	58.1	1.00
chr10	101155117	101155334	CpG: 18	217	18	125	16.6	57.6	1.00
chr10	101170679	101171169	CpG: 45	490	45	334	18.4	68.2	0.83
chr10	101230647	101232188	CpG: 133	1541	133	1005	17.3	65.2	0.81
chr10	101257495	101258030	CpG: 35	535	35	330	13.1	61.7	0.70
chr10	101365329	101365908	CpG: 58	579	58	400	20.0	69.1	0.84
chr10	101402509	101403077	CpG: 67	568	67	411	23.6	72.4	0.90
chr10	101412478	101413070	CpG: 47	592	47	364	15.9	61.5	0.85
chr10	101418878	101419240	CpG: 30	362	30	230	16.6	63.5	0.83
chr10	101445138	101446065	CpG: 81	927	81	633	17.5	68.3	0.76
chr10	101480484	101480714	CpG: 19	230	19	141	16.5	61.3	0.89
chr10	101504497	101504961	CpG: 37	464	37	302	15.9	65.1	0.76
chr10	101537373	101540287	CpG: 215	2914	215	1847	14.8	63.4	0.77
chr10	101542718	101543239	CpG: 46	521	46	296	17.7	56.8	1.10
chr10	101554265	101554687	CpG: 52	422	52	306	24.6	72.5	0.94
chr10	101564158	101564589	CpG: 41	431	41	276	19.0	64.0	0.93
chr10	101573788	101574061	CpG: 22	273	22	172	16.1	63.0	0.82
chr10	101593385	101593920	CpG: 54	535	54	388	20.2	72.5	0.77
chr10	101596785	101597605	CpG: 63	820	63	539	15.4	65.7	0.71
chr10	101598855	101599158	CpG: 34	303	34	222	22.4	73.3	0.85
chr10	101607311	101608055	CpG: 79	744	79	488	21.2	65.6	1.00
chr10	101612949	101614617	CpG: 134	1668	134	1036	16.1	62.1	0.84
chr10	101618716	101619213	CpG: 66	497	66	375	26.6	75.5	0.97
chr10	101620754	101621275	CpG: 45	521	45	337	17.3	64.7	0.83
chr10	101622338	101623247	CpG: 84	909	84	623	18.5	68.5	0.82
chr10	101625307	101625838	CpG: 39	531	39	363	14.7	68.4	0.64
chr10	101627518	101629751	CpG: 188	2233	188	1505	16.8	67.4	0.74
chr10	101631087	101633251	CpG: 156	2164	156	1370	14.4	63.3	0.72
chr10	101641587	101641802	CpG: 18	215	18	131	16.7	60.9	0.92
chr10	101709730	101713224	CpG: 275	3494	275	2285	15.7	65.4	0.75
chr10	101713722	101714002	CpG: 27	280	27	179	19.3	63.9	0.95
chr10	101795981	101796773	CpG: 71	792	71	537	17.9	67.8	0.79
chr10	101852637	101853328	CpG: 65	691	65	492	18.8	71.2	0.74
chr10	101870151	101871119	CpG: 96	968	96	636	19.8	65.7	0.93
chr10	101872488	101872706	CpG: 15	218	15	125	13.8	57.3	0.84
chr10	101879492	101879764	CpG: 19	272	19	160	14.0	58.8	0.82
chr10	101880324	101883416	CpG: 254	3092	254	2127	16.4	68.8	0.71
chr10	101888823	101889066	CpG: 22	243	22	170	18.1	70.0	0.75
chr10	101889939	101890311	CpG: 30	372	30	264	16.1	71.0	0.67
chr10	101902266	101902584	CpG: 33	318	33	232	20.8	73.0	0.79
chr10	101913420	101913637	CpG: 19	217	19	147	17.5	67.7	0.78
chr10	101914463	101914692	CpG: 21	229	21	161	18.3	70.3	0.75
chr10	101915686	101915910	CpG: 26	224	26	158	23.2	70.5	0.93
chr10	101926278	101926524	CpG: 23	246	23	146	18.7	59.3	1.20
chr10	101931399	101931896	CpG: 46	497	46	333	18.5	67.0	0.85
chr10	101933512	101933907	CpG: 37	395	37	260	18.7	65.8	0.87
chr10	101944113	101946499	CpG: 184	2386	184	1577	15.4	66.1	0.71
chr10	101949554	101951318	CpG: 119	1764	119	1122	13.5	63.6	0.67
chr10	102006594	102007168	CpG: 56	574	56	404	19.5	70.4	0.79
chr10	102014584	102018687	CpG: 273	4103	273	2634	13.3	64.2	0.65
chr10	102019970	102020293	CpG: 30	323	30	208	18.6	64.4	0.90
chr10	102022805	102023117	CpG: 24	312	24	204	15.4	65.4	0.73
chr10	102023450	102023891	CpG: 49	441	49	314	22.2	71.2	0.88
chr10	102029342	102030321	CpG: 80	979	80	634	16.3	64.8	0.78
chr10	102097097	102097311	CpG: 19	214	19	131	17.8	61.2	0.95
chr10	102099566	102101693	CpG: 152	2127	152	1278	14.3	60.1	0.79
chr10	102105900	102113790	CpG: 566	7890	566	4915	14.3	62.3	0.74
chr10	102119625	102120237	CpG: 48	612	48	395	15.7	64.5	0.76
chr10	102167393	102167957	CpG: 51	564	51	390	18.1	69.1	0.81
chr10	102175368	102176667	CpG: 120	1299	120	882	18.5	67.9	0.83
chr10	102194546	102194759	CpG: 21	213	21	158	19.7	74.2	0.76
chr10	102228375	102228637	CpG: 18	262	18	159	13.7	60.7	0.75
chr10	102231784	102232023	CpG: 22	239	22	149	18.4	62.3	0.97
chr10	102237735	102238626	CpG: 74	891	74	586	16.6	65.8	0.80
chr10	102393335	102393601	CpG: 23	266	23	165	17.3	62.0	0.91
chr10	102401976	102402254	CpG: 24	278	24	174	17.3	62.6	0.89
chr10	102450459	102450995	CpG: 53	536	53	362	19.8	67.5	0.87
chr10	102453609	102453818	CpG: 18	209	18	146	17.2	69.9	0.71
chr10	102454135	102454594	CpG: 48	459	48	341	20.9	74.3	0.81
chr10	102471959	102472550	CpG: 42	591	42	393	14.2	66.5	0.66
chr10	102564441	102564711	CpG: 19	270	19	163	14.1	60.4	0.78
chr10	102577223	102578358	CpG: 124	1135	124	839	21.9	73.9	0.82
chr10	102659135	102660245	CpG: 153	1110	153	881	27.6	79.4	0.89
chr10	102662243	102663726	CpG: 119	1483	119	960	16.0	64.7	0.78
chr10	102666449	102667028	CpG: 47	579	47	375	16.2	64.8	0.81
chr10	102698844	102699078	CpG: 18	234	18	136	15.4	58.1	0.93
chr10	102699485	102699747	CpG: 20	262	20	156	15.3	59.5	0.87
chr10	102701126	102701988	CpG: 69	862	69	579	16.0	67.2	0.74
chr10	102712640	102712981	CpG: 25	341	25	225	14.7	66.0	0.69
chr10	102714013	102714537	CpG: 44	524	44	366	16.8	69.8	0.77
chr10	102723278	102723579	CpG: 31	301	31	225	20.6	74.8	0.74
chr10	102724275	102724965	CpG: 49	690	49	431	14.2	62.5	0.73
chr10	102726898	102727374	CpG: 44	476	44	346	18.5	72.7	0.70
chr10	102920537	102921329	CpG: 69	792	69	567	17.4	71.6	0.68
chr10	102939863	102940109	CpG: 19	246	19	137	15.4	55.7	1.00
chr10	102940757	102941360	CpG: 72	603	72	429	23.9	71.1	0.96
chr10	102950149	102951033	CpG: 107	884	107	676	24.2	76.5	0.83
chr10	102999526	103000060	CpG: 44	534	44	385	16.5	72.1	0.65
chr10	103004890	103005885	CpG: 120	995	120	725	24.1	72.9	0.91
chr10	103013817	103014166	CpG: 27	349	27	205	15.5	58.7	0.91
chr10	103017885	103018816	CpG: 90	931	90	650	19.3	69.8	0.82
chr10	103036919	103037769	CpG: 70	850	70	523	16.5	61.5	0.87
chr10	103054677	103054953	CpG: 24	276	24	171	17.4	62.0	0.92
chr10	103059268	103059500	CpG: 17	232	17	144	14.7	62.1	0.78
chr10	103066335	103066609	CpG: 22	274	22	164	16.1	59.9	0.92
chr10	103111082	103111476	CpG: 40	394	40	258	20.3	65.5	0.96
chr10	103115443	103117059	CpG: 163	1616	163	1149	20.2	71.1	0.82
chr10	103125484	103126971	CpG: 113	1487	113	993	15.2	66.8	0.69
chr10	103130370	103130823	CpG: 33	453	33	273	14.6	60.3	0.80
chr10	103173375	103173685	CpG: 28	310	28	187	18.1	60.3	1.01
chr10	103186425	103187118	CpG: 53	693	53	460	15.3	66.4	0.70
chr10	103222067	103222346	CpG: 20	279	20	172	14.3	61.6	0.77
chr10	103278920	103280748	CpG: 145	1828	145	1206	15.9	66.0	0.73
chr10	103284288	103284778	CpG: 63	490	63	365	25.7	74.5	0.93
chr10	103293751	103294346	CpG: 92	595	92	464	30.9	78.0	1.02
chr10	103295361	103296065	CpG: 55	704	55	482	15.6	68.5	0.67
chr10	103303735	103307249	CpG: 251	3514	251	2238	14.3	63.7	0.71
chr10	103317199	103317742	CpG: 46	543	46	358	16.9	65.9	0.78
chr10	103333848	103334125	CpG: 19	277	19	171	13.7	61.7	0.73
chr10	103335325	103336215	CpG: 118	890	118	668	26.5	75.1	0.94
chr10	103346214	103346518	CpG: 35	304	35	215	23.0	70.7	0.94
chr10	103348219	103348454	CpG: 20	235	20	137	17.0	58.3	1.01
chr10	103372668	103372910	CpG: 19	242	19	149	15.7	61.6	0.85
chr10	103385269	103385505	CpG: 20	236	20	142	16.9	60.2	0.96
chr10	103387454	103387754	CpG: 29	300	29	193	19.3	64.3	0.94
chr10	103388906	103389385	CpG: 57	479	57	352	23.8	73.5	0.91
chr10	103527847	103530996	CpG: 329	3149	329	2173	20.9	69.0	0.88
chr10	103542590	103543200	CpG: 45	610	45	415	14.8	68.0	0.65
chr10	103597289	103597531	CpG: 21	242	21	149	17.4	61.6	0.93
chr10	103599458	103601101	CpG: 117	1643	117	1094	14.2	66.6	0.64
chr10	103654193	103654478	CpG: 22	285	22	173	15.4	60.7	0.86
chr10	103740027	103740353	CpG: 28	326	28	191	17.2	58.6	1.02
chr10	103755065	103755506	CpG: 42	441	42	309	19.0	70.1	0.78
chr10	103771322	103771596	CpG: 24	274	24	171	17.5	62.4	0.91
chr10	103802718	103802945	CpG: 19	227	19	136	16.7	59.9	0.97
chr10	103803335	103805332	CpG: 198	1997	198	1344	19.8	67.3	0.88
chr10	103959836	103960118	CpG: 22	282	22	172	15.6	61.0	0.85
chr10	104078734	104079724	CpG: 117	990	117	702	23.6	70.9	0.94
chr10	104165494	104166950	CpG: 179	1456	179	1029	24.6	70.7	0.98
chr10	104236919	104238553	CpG: 134	1634	134	1020	16.4	62.4	0.84
chr10	104255119	104256002	CpG: 96	883	96	612	21.7	69.3	0.91
chr10	104282627	104282894	CpG: 21	267	21	165	15.7	61.8	0.83
chr10	104283363	104284027	CpG: 56	664	56	408	16.9	61.4	0.91
chr10	104284788	104284993	CpG: 16	205	16	123	15.6	60.0	0.88
chr10	104308986	104309245	CpG: 21	259	21	157	16.2	60.6	0.90
chr10	104339499	104339855	CpG: 31	356	31	245	17.4	68.8	0.74
chr10	104342601	104343009	CpG: 30	408	30	265	14.7	65.0	0.70
chr10	104345515	104345951	CpG: 40	436	40	297	18.3	68.1	0.80
chr10	104360464	104360999	CpG: 41	535	41	355	15.3	66.4	0.70
chr10	104380738	104381975	CpG: 148	1237	148	914	23.9	73.9	0.88
chr10	104442404	104442811	CpG: 52	407	52	325	25.6	79.9	0.86
chr10	104471733	104472599	CpG: 138	866	138	637	31.9	73.6	1.18
chr10	104489362	104489766	CpG: 32	404	32	271	15.8	67.1	0.72
chr10	104490127	104490405	CpG: 20	278	20	179	14.4	64.4	0.70
chr10	104490747	104491092	CpG: 24	345	24	235	13.9	68.1	0.60
chr10	104493957	104494933	CpG: 77	976	77	687	15.8	70.4	0.64
chr10	104548280	104548913	CpG: 52	633	52	450	16.4	71.1	0.66
chr10	104549764	104550045	CpG: 23	281	23	174	16.4	61.9	0.87
chr10	104556096	104556304	CpG: 18	208	18	140	17.3	67.3	0.79
chr10	104579928	104580820	CpG: 88	892	88	630	19.7	70.6	0.80
chr10	104677473	104677739	CpG: 18	266	18	160	13.5	60.2	0.75
chr10	104742306	104743290	CpG: 114	984	114	759	23.2	77.1	0.78
chr10	104805032	104805842	CpG: 72	810	72	533	17.8	65.8	0.86
chr10	104853376	104853641	CpG: 24	265	24	164	18.1	61.9	0.96
chr10	104854169	104854908	CpG: 125	739	125	591	33.8	80.0	1.06
chr10	104861568	104861846	CpG: 24	278	24	171	17.3	61.5	0.92
chr10	105009802	105010300	CpG: 61	498	61	333	24.5	66.9	1.10
chr10	105120160	105120582	CpG: 49	422	49	298	23.2	70.6	0.94
chr10	105142624	105143466	CpG: 72	842	72	567	17.1	67.3	0.78
chr10	105156896	105157425	CpG: 50	529	50	365	18.9	69.0	0.80
chr10	105158172	105158446	CpG: 25	274	25	171	18.2	62.4	0.95
chr10	105160774	105161003	CpG: 19	229	19	144	16.6	62.9	0.85
chr10	105162954	105163183	CpG: 21	229	21	158	18.3	69.0	0.79
chr10	105203359	105203762	CpG: 27	403	27	262	13.4	65.0	0.63
chr10	105203953	105204185	CpG: 19	232	19	153	16.4	65.9	0.79
chr10	105225971	105227414	CpG: 115	1443	115	873	15.9	60.5	0.87
chr10	105328023	105328262	CpG: 18	239	18	145	15.1	60.7	0.83
chr10	105527884	105531129	CpG: 294	3245	294	2145	18.1	66.1	0.83
chr10	106145127	106145396	CpG: 23	269	23	169	17.1	62.8	0.88
chr10	106226384	106226662	CpG: 21	278	21	173	15.1	62.2	0.79
chr10	106273222	106273514	CpG: 25	292	25	178	17.1	61.0	0.92
chr10	106670981	106671408	CpG: 28	427	28	254	13.1	59.5	0.74
chr10	106807888	106808157	CpG: 22	269	22	165	16.4	61.3	0.88
chr10	106975164	106975400	CpG: 17	236	17	145	14.4	61.4	0.78
chr10	107021723	107022018	CpG: 24	295	24	175	16.3	59.3	0.93
chr10	107681473	107681696	CpG: 17	223	17	134	15.2	60.1	0.86
chr10	107723146	107723423	CpG: 20	277	20	166	14.4	59.9	0.82
chr10	107737121	107737431	CpG: 24	310	24	192	15.5	61.9	0.81
chr10	107815043	107815422	CpG: 38	379	38	280	20.1	73.9	0.73
chr10	108050965	108051990	CpG: 136	1025	136	781	26.5	76.2	0.92
chr10	108234796	108235017	CpG: 19	221	19	139	17.2	62.9	0.90
chr10	108284212	108284442	CpG: 17	230	17	136	14.8	59.1	0.86
chr10	108351439	108351720	CpG: 23	281	23	173	16.4	61.6	0.88
chr10	108362570	108362851	CpG: 24	281	24	174	17.1	61.9	0.91
chr10	108382790	108383020	CpG: 17	230	17	141	14.8	61.3	0.80
chr10	108478975	108479180	CpG: 17	205	17	123	16.6	60.0	0.94
chr10	108487706	108487958	CpG: 21	252	21	151	16.7	59.9	0.94
chr10	108561219	108561455	CpG: 21	236	21	141	17.8	59.7	1.01
chr10	108801337	108802105	CpG: 80	768	80	545	20.8	71.0	0.83
chr10	108837332	108837601	CpG: 24	269	24	195	17.8	72.5	0.68
chr10	108867006	108867280	CpG: 23	274	23	170	16.8	62.0	0.88
chr10	109002649	109002962	CpG: 23	313	23	185	14.7	59.1	0.84
chr10	109297355	109297638	CpG: 25	283	25	179	17.7	63.3	0.90
chr10	109354861	109355398	CpG: 63	537	63	402	23.5	74.9	0.84
chr10	109801807	109802409	CpG: 43	602	43	397	14.3	65.9	0.66
chr10	109898881	109899118	CpG: 17	237	17	136	14.3	57.4	0.89
chr10	110166531	110166804	CpG: 23	273	23	168	16.8	61.5	0.90
chr10	110181863	110182138	CpG: 23	275	23	170	16.7	61.8	0.88
chr10	110346768	110347247	CpG: 52	479	52	355	21.7	74.1	0.79
chr10	110423445	110423726	CpG: 24	281	24	175	17.1	62.3	0.90
chr10	110806869	110807573	CpG: 94	704	94	532	26.7	75.6	0.94
chr10	110817249	110817457	CpG: 17	208	17	127	16.3	61.1	0.90
chr10	110891181	110892449	CpG: 131	1268	131	909	20.7	71.7	0.82
chr10	111091335	111094833	CpG: 257	3498	257	2162	14.7	61.8	0.77
chr10	111109681	111111339	CpG: 201	1658	201	1220	24.2	73.6	1.14
chr10	111188254	111188976	CpG: 75	722	75	499	20.8	69.1	0.87
chr10	111203023	111203266	CpG: 18	243	18	138	14.8	56.8	0.93
chr10	111246441	111246664	CpG: 18	223	18	133	16.1	59.6	0.92
chr10	111381134	111382734	CpG: 213	1600	213	1162	26.6	72.6	1.01
chr10	111399817	111400090	CpG: 21	273	21	171	15.4	62.6	0.79
chr10	111413977	111414335	CpG: 27	358	27	232	15.1	64.8	0.72
chr10	111451087	111452204	CpG: 92	1117	92	736	16.5	65.9	0.76
chr10	111526929	111528480	CpG: 153	1551	153	1047	19.7	67.5	0.87
chr10	111555806	111556397	CpG: 55	591	55	385	18.6	65.1	0.88
chr10	111581671	111581930	CpG: 18	259	18	155	13.9	59.8	0.79
chr10	111650657	111651882	CpG: 105	1225	105	897	17.1	73.2	0.64
chr10	111755440	111756502	CpG: 105	1062	105	757	19.8	71.3	0.79
chr10	111802328	111803915	CpG: 145	1587	145	1066	18.3	67.2	0.82
chr10	111890244	111890484	CpG: 21	240	21	148	17.5	61.7	0.94
chr10	111960077	111963390	CpG: 347	3313	347	2250	20.9	67.9	0.91
chr10	112286788	112287037	CpG: 20	249	20	148	16.1	59.4	0.92
chr10	112475116	112475410	CpG: 23	294	23	177	15.6	60.2	0.86
chr10	112563326	112563569	CpG: 19	243	19	145	15.6	59.7	0.91
chr10	112576221	112576469	CpG: 20	248	20	147	16.1	59.3	0.94
chr10	112580708	112580986	CpG: 23	278	23	172	16.5	61.9	0.87
chr10	112843929	112844199	CpG: 21	270	21	165	15.6	61.1	0.84
chr10	112953441	112953852	CpG: 32	411	32	246	15.6	59.9	0.88
chr10	113074548	113074922	CpG: 35	374	35	256	18.7	68.4	0.80
chr10	113240575	113241142	CpG: 51	567	51	414	18.0	73.0	0.68
chr10	113337513	113338229	CpG: 58	716	58	438	16.2	61.2	0.87
chr10	113441761	113442032	CpG: 23	271	23	169	17.0	62.4	0.88
chr10	113463411	113463629	CpG: 21	218	21	132	19.3	60.6	1.06
chr10	113466852	113467118	CpG: 24	266	24	165	18.0	62.0	0.95
chr10	113488521	113488795	CpG: 24	274	24	175	17.5	63.9	0.88
chr10	113501435	113501708	CpG: 22	273	22	169	16.1	61.9	0.85
chr10	113702233	113702497	CpG: 24	264	24	167	18.2	63.3	0.93
chr10	113841181	113841614	CpG: 34	433	34	278	15.7	64.2	0.97
chr10	113842051	113844078	CpG: 167	2027	167	1332	16.5	65.7	0.77
chr10	113882550	113882795	CpG: 17	245	17	154	13.9	62.9	0.71
chr10	114017976	114018259	CpG: 40	283	40	224	28.3	79.2	0.91
chr10	114057040	114057269	CpG: 16	229	16	151	14.0	65.9	0.74
chr10	114163415	114163696	CpG: 23	281	23	174	16.4	61.9	0.87
chr10	114171020	114171296	CpG: 21	276	21	170	15.2	61.6	0.81
chr10	114381811	114382092	CpG: 24	281	24	175	17.1	62.3	0.90
chr10	114389809	114390090	CpG: 24	281	24	175	17.1	62.3	0.90
chr10	114571090	114572279	CpG: 100	1189	100	775	16.8	65.2	0.79
chr10	114641233	114641469	CpG: 22	236	22	147	18.6	62.3	0.99
chr10	114670534	114670796	CpG: 19	262	19	157	14.5	59.9	0.83
chr10	114746183	114746866	CpG: 66	683	66	452	19.3	66.2	0.89
chr10	114934982	114937367	CpG: 290	2385	290	1727	24.3	72.4	0.93
chr10	114994560	114994974	CpG: 35	414	35	262	16.9	63.3	0.84
chr10	114995615	114995889	CpG: 24	274	24	171	17.5	62.4	0.91
chr10	115067244	115068127	CpG: 65	883	65	583	14.7	66.0	0.68
chr10	115072827	115073157	CpG: 28	330	28	223	17.0	67.6	0.81
chr10	115132875	115133470	CpG: 70	595	70	423	23.5	71.1	0.93
chr10	115180106	115180464	CpG: 28	358	28	241	15.6	67.3	0.71
chr10	115233342	115233605	CpG: 25	263	25	161	19.0	61.2	1.02
chr10	115263382	115263616	CpG: 20	234	20	142	17.1	60.7	0.95
chr10	115297711	115298919	CpG: 120	1208	120	869	19.9	71.9	0.78
chr10	115391478	115391731	CpG: 18	253	18	146	14.2	57.7	0.86
chr10	115461995	115462280	CpG: 23	285	23	177	16.1	62.1	0.85
chr10	115525761	115526253	CpG: 46	492	46	305	18.7	62.0	0.98
chr10	115528253	115528489	CpG: 21	236	21	145	17.8	61.4	0.97
chr10	115661875	115662825	CpG: 106	950	106	705	22.3	74.2	0.81
chr10	115715676	115716779	CpG: 129	1103	129	836	23.4	75.8	0.81
chr10	115832438	115832921	CpG: 39	483	39	300	16.1	62.1	0.84
chr10	115975699	115975973	CpG: 22	274	22	169	16.1	61.7	0.86
chr10	115982041	115982271	CpG: 19	230	19	140	16.5	60.9	0.90
chr10	115986769	115988602	CpG: 212	1833	212	1334	23.1	72.8	0.88
chr10	116262162	116262387	CpG: 23	225	23	136	20.4	60.4	1.12
chr10	116302031	116302312	CpG: 25	281	25	176	17.8	62.6	0.92
chr10	116516673	116516910	CpG: 17	237	17	141	14.3	59.5	0.84
chr10	116762956	116763230	CpG: 24	274	24	172	17.5	62.8	0.90
chr10	116838384	116838662	CpG: 26	278	26	176	18.7	63.3	0.94
chr10	117019427	117019643	CpG: 18	216	18	132	16.7	61.1	0.91
chr10	117100688	117100926	CpG: 22	238	22	147	18.5	61.8	1.01
chr10	117165049	117168693	CpG: 294	3644	294	2339	16.1	64.2	0.79
chr10	117183075	117183344	CpG: 23	269	23	166	17.1	61.7	0.92
chr10	117287569	117288114	CpG: 44	545	44	393	16.1	72.1	0.62
chr10	117288637	117289027	CpG: 28	390	28	213	14.4	54.6	1.00
chr10	117383130	117383414	CpG: 22	284	22	171	15.5	60.2	0.87
chr10	117411644	117411891	CpG: 19	247	19	145	15.4	58.7	0.91
chr10	117418073	117418297	CpG: 20	224	20	138	17.9	61.6	0.97
chr10	117427672	117427946	CpG: 20	274	20	160	14.6	58.4	0.87
chr10	117503173	117504619	CpG: 101	1446	101	897	14.0	62.0	0.73
chr10	117521604	117522063	CpG: 51	459	51	345	22.2	75.2	0.79
chr10	117564251	117564674	CpG: 34	423	34	301	16.1	71.2	0.63
chr10	117635656	117637507	CpG: 211	1851	211	1377	22.8	74.4	0.83
chr10	117682424	117682642	CpG: 19	218	19	130	17.4	59.6	0.98
chr10	117743388	117744166	CpG: 65	778	65	499	16.7	64.1	0.81
chr10	117751064	117751274	CpG: 15	210	15	129	14.3	61.4	0.78
chr10	117799254	117799536	CpG: 22	282	22	174	15.6	61.7	0.84
chr10	117857377	117857614	CpG: 21	237	21	144	17.7	60.8	0.99
chr10	117898950	117899868	CpG: 92	918	92	632	20.0	68.8	0.85
chr10	117906093	117906329	CpG: 17	236	17	140	14.4	59.3	0.85
chr10	117978966	117979208	CpG: 22	242	22	147	18.2	60.7	0.99
chr10	118020321	118021329	CpG: 91	1008	91	695	18.1	68.9	0.82
chr10	118027139	118027617	CpG: 36	478	36	282	15.1	59.0	0.87
chr10	118028505	118029410	CpG: 99	905	99	646	21.9	71.4	0.86
chr10	118030941	118033012	CpG: 198	2071	198	1390	19.1	67.1	0.85
chr10	118034183	118035307	CpG: 93	1124	93	774	16.5	68.9	0.70
chr10	118057315	118058484	CpG: 113	1169	113	823	19.3	70.4	0.78
chr10	118060234	118060492	CpG: 26	258	26	177	20.2	68.6	0.86
chr10	118061984	118063554	CpG: 121	1570	121	1017	15.4	64.8	0.75
chr10	118069701	118070147	CpG: 36	446	36	289	16.1	64.8	0.77
chr10	118111028	118111685	CpG: 59	657	59	459	18.0	69.9	0.74
chr10	118135411	118136506	CpG: 131	1095	131	825	23.9	75.3	0.85
chr10	118268733	118270562	CpG: 210	1829	210	1291	23.0	70.6	0.92
chr10	118428799	118432557	CpG: 270	3758	270	2356	14.4	62.7	0.73
chr10	118436200	118440240	CpG: 324	4040	324	2481	16.0	61.4	0.85
chr10	118446070	118446970	CpG: 67	900	67	571	14.9	63.4	0.74
chr10	118447632	118448429	CpG: 77	797	77	542	19.3	68.0	0.84
chr10	118629414	118629912	CpG: 46	498	46	331	18.5	66.5	0.86
chr10	118732880	118733190	CpG: 26	310	26	194	16.8	62.6	0.86
chr10	118940363	118941082	CpG: 85	719	85	546	23.6	75.9	0.82
chr10	118973071	118973310	CpG: 21	239	21	149	17.6	62.3	0.92
chr10	119237039	119237412	CpG: 33	373	33	252	17.7	67.6	0.79
chr10	119242407	119242642	CpG: 16	235	16	137	13.6	58.3	0.83
chr10	119489319	119491448	CpG: 171	2129	171	1369	16.1	64.3	0.78
chr10	119514312	119514524	CpG: 16	212	16	126	15.1	59.4	0.88
chr10	119594913	119595153	CpG: 18	240	18	144	15.0	60.0	0.86
chr10	119649663	119651183	CpG: 138	1520	138	985	18.2	64.8	0.87
chr10	119655312	119655855	CpG: 47	543	47	394	17.3	72.6	0.66
chr10	119678093	119678473	CpG: 30	380	30	271	15.8	71.3	0.62
chr10	119842956	119843192	CpG: 17	236	17	142	14.4	60.2	0.81
chr10	119924691	119926283	CpG: 238	1592	238	1231	29.9	77.3	1.00
chr10	119937554	119938119	CpG: 39	565	39	343	13.8	60.7	0.81
chr10	119975525	119976413	CpG: 99	888	99	641	22.3	72.2	0.86
chr10	119977128	119978004	CpG: 56	876	56	497	12.8	56.7	0.80
chr10	119999349	120000337	CpG: 110	988	110	752	22.3	76.1	0.79
chr10	120010849	120011081	CpG: 20	232	20	141	17.2	60.8	0.94
chr10	120060687	120061495	CpG: 86	808	86	565	21.3	69.9	0.88
chr10	120073932	120074322	CpG: 37	390	37	275	19.0	70.5	0.77
chr10	120102038	120103528	CpG: 179	1490	179	1080	24.0	72.5	0.92
chr10	120156351	120157228	CpG: 68	877	68	609	15.5	69.4	0.64
chr10	120307834	120308064	CpG: 18	230	18	162	15.7	70.4	0.64
chr10	120437567	120439258	CpG: 190	1691	190	1223	22.5	72.3	0.86
chr10	120457025	120457898	CpG: 65	873	65	601	14.9	68.8	0.63
chr10	120493877	120495022	CpG: 92	1145	92	750	16.1	65.5	0.76
chr10	120548637	120549898	CpG: 159	1261	159	944	25.2	74.9	0.90
chr10	120619154	120620093	CpG: 70	939	70	662	14.9	70.5	0.60
chr10	120623127	120624195	CpG: 125	1068	125	807	23.4	75.6	0.84
chr10	120715598	120716454	CpG: 83	856	83	576	19.4	67.3	0.86
chr10	120769686	120771136	CpG: 168	1450	168	1032	23.2	71.2	0.92
chr10	120790032	120790536	CpG: 48	504	48	325	19.0	64.5	0.92
chr10	120856593	120856828	CpG: 20	235	20	144	17.0	61.3	0.92
chr10	120909134	120909576	CpG: 36	442	36	288	16.3	65.2	0.77
chr10	121112693	121113994	CpG: 104	1301	104	941	16.0	72.3	0.61
chr10	121269663	121269873	CpG: 15	210	15	122	14.3	58.1	0.88
chr10	121293204	121293478	CpG: 24	274	24	170	17.5	62.0	0.92
chr10	121354824	121355942	CpG: 127	1118	127	824	22.7	73.7	0.84
chr10	121424008	121424286	CpG: 22	278	22	171	15.8	61.5	0.85
chr10	121459435	121459716	CpG: 24	281	24	175	17.1	62.3	0.90
chr10	121546266	121546547	CpG: 24	281	24	175	17.1	62.3	0.90
chr10	121588903	121589139	CpG: 21	236	21	143	17.8	60.6	1.00
chr10	121695049	121695455	CpG: 37	406	37	295	18.2	72.7	0.69
chr10	121736911	121737115	CpG: 14	204	14	120	13.7	58.8	0.80
chr10	121747714	121748088	CpG: 32	374	32	240	17.1	64.2	0.84
chr10	121765714	121765953	CpG: 22	239	22	148	18.4	61.9	0.98
chr10	121807651	121807888	CpG: 20	237	20	145	16.9	61.2	0.90
chr10	121820386	121820777	CpG: 37	391	37	287	18.9	73.4	0.70
chr10	121838335	121838637	CpG: 21	302	21	182	13.9	60.3	0.78
chr10	121845191	121846013	CpG: 71	822	71	547	17.3	66.5	0.78
chr10	121875579	121876080	CpG: 58	501	58	331	23.2	66.1	1.10
chr10	121889734	121889964	CpG: 19	230	19	140	16.5	60.9	0.90
chr10	121927816	121928047	CpG: 17	231	17	134	14.7	58.0	0.89
chr10	121931672	121931930	CpG: 22	258	22	187	17.1	72.5	0.65
chr10	122256952	122257226	CpG: 24	274	24	170	17.5	62.0	0.93
chr10	122261698	122262024	CpG: 27	326	27	237	16.6	72.7	0.63
chr10	122278276	122278621	CpG: 27	345	27	245	15.7	71.0	0.62
chr10	122493258	122494927	CpG: 206	1669	206	1208	24.7	72.4	0.95
chr10	122504814	122505367	CpG: 56	553	56	394	20.3	71.2	0.81
chr10	122625843	122626121	CpG: 24	278	24	174	17.3	62.6	0.89
chr10	122711252	122711528	CpG: 22	276	22	171	15.9	62.0	0.84
chr10	122713354	122713564	CpG: 16	210	16	125	15.2	59.5	0.87
chr10	122772783	122773019	CpG: 20	236	20	145	16.9	61.4	0.92
chr10	122823796	122824933	CpG: 141	1137	141	821	24.8	72.2	0.95
chr10	122870758	122871691	CpG: 123	933	123	681	26.4	73.0	0.99
chr10	123008965	123010308	CpG: 144	1343	144	932	21.4	69.4	0.89
chr10	123018424	123018695	CpG: 19	271	19	160	14.0	59.0	0.81
chr10	123059660	123060373	CpG: 87	713	87	521	24.4	73.1	0.92
chr10	123099528	123100327	CpG: 64	799	64	561	16.0	70.2	0.65
chr10	123270749	123271813	CpG: 147	1064	147	801	27.6	75.3	0.98
chr10	123356675	123358577	CpG: 223	1902	223	1337	23.4	70.3	0.95
chr10	123518185	123518491	CpG: 21	306	21	192	13.7	62.7	0.70
chr10	123573890	123574179	CpG: 24	289	24	174	16.6	60.2	0.93
chr10	123662455	123662728	CpG: 24	273	24	168	17.6	61.5	0.94
chr10	123693599	123693916	CpG: 41	317	41	238	25.9	75.1	0.92
chr10	123754215	123755265	CpG: 104	1050	104	682	19.8	65.0	0.94
chr10	123828129	123828361	CpG: 21	232	21	145	18.1	62.5	0.94
chr10	123828736	123829716	CpG: 90	980	90	644	18.4	65.7	0.85
chr10	123855259	123855759	CpG: 67	500	67	364	26.8	72.8	1.02
chr10	123883237	123884376	CpG: 99	1139	99	768	17.4	67.4	0.77
chr10	123974689	123974962	CpG: 23	273	23	167	16.8	61.2	0.91
chr10	124007762	124008833	CpG: 71	1071	71	636	13.3	59.4	0.75
chr10	124009571	124012862	CpG: 329	3291	329	2248	20.0	68.3	0.86
chr10	124013226	124013461	CpG: 18	235	18	140	15.3	59.6	0.87
chr10	124015206	124015579	CpG: 33	373	33	248	17.7	66.5	0.80
chr10	124017409	124018119	CpG: 55	710	55	469	15.5	66.1	0.71
chr10	124021136	124021663	CpG: 52	527	52	333	19.7	63.2	0.99
chr10	124022785	124026537	CpG: 284	3752	284	2315	15.1	61.7	0.80
chr10	124029137	124030232	CpG: 93	1095	93	706	17.0	64.5	0.82
chr10	124159630	124159845	CpG: 19	215	19	125	17.7	58.1	1.07
chr10	124160465	124160818	CpG: 34	353	34	264	19.3	74.8	0.69
chr10	124535526	124535775	CpG: 20	249	20	148	16.1	59.4	0.94
chr10	124542781	124543918	CpG: 136	1137	136	823	23.9	72.4	0.91
chr10	124734404	124734676	CpG: 25	272	25	177	18.4	65.1	0.99
chr10	124768210	124768843	CpG: 72	633	72	485	22.7	76.6	0.78
chr10	124800337	124800611	CpG: 24	274	24	172	17.5	62.8	0.90
chr10	124823502	124823862	CpG: 28	360	28	201	15.6	55.8	1.00
chr10	124849838	124850500	CpG: 56	662	56	437	16.9	66.0	0.78
chr10	124868801	124869653	CpG: 90	852	90	599	21.1	70.3	0.87
chr10	124921685	124922063	CpG: 29	378	29	243	15.3	64.3	0.75
chr10	124933956	124934211	CpG: 26	255	26	174	20.4	68.2	0.91
chr10	124968819	124971562	CpG: 269	2743	269	1873	19.6	68.3	0.85
chr10	125267016	125267686	CpG: 70	670	70	467	20.9	69.7	0.86
chr10	125296426	125297470	CpG: 111	1044	111	760	21.3	72.8	0.81
chr10	125325455	125328542	CpG: 252	3087	252	2003	16.3	64.9	0.78
chr10	125339879	125340535	CpG: 79	656	79	477	24.1	72.7	0.92
chr10	125400259	125400496	CpG: 16	237	16	142	13.5	59.9	0.78
chr10	125448354	125448572	CpG: 18	218	18	132	16.5	60.6	0.90
chr10	125448801	125449023	CpG: 17	222	17	134	15.3	60.4	0.84
chr10	125470150	125470355	CpG: 16	205	16	142	15.6	69.3	0.65
chr10	125473243	125473469	CpG: 17	226	17	148	15.0	65.5	0.72
chr10	125496277	125496696	CpG: 37	419	37	286	17.7	68.3	0.91
chr10	125507145	125507435	CpG: 26	290	26	185	17.9	63.8	0.88
chr10	125623753	125625724	CpG: 235	1971	235	1362	23.8	69.1	1.00
chr10	125663329	125663607	CpG: 23	278	23	173	16.5	62.2	0.87
chr10	125671889	125672126	CpG: 17	237	17	142	14.3	59.9	0.82
chr10	125672588	125674059	CpG: 124	1471	124	905	16.9	61.5	0.90
chr10	125682034	125682387	CpG: 23	353	23	195	13.0	55.2	0.88
chr10	125682647	125683420	CpG: 73	773	73	527	18.9	68.2	0.81
chr10	125797624	125798716	CpG: 158	1092	158	839	28.9	76.8	0.98
chr10	125800744	125800980	CpG: 18	236	18	139	15.3	58.9	0.92
chr10	125808038	125808303	CpG: 21	265	21	166	15.8	62.6	0.81
chr10	125878999	125879340	CpG: 26	341	26	221	15.2	64.8	0.73
chr10	125904467	125904685	CpG: 18	218	18	152	16.5	69.7	0.68
chr10	125908182	125908383	CpG: 14	201	14	132	13.9	65.7	0.65
chr10	126032254	126033497	CpG: 106	1243	106	855	17.1	68.8	0.72
chr10	126039687	126043790	CpG: 444	4103	444	2889	21.6	70.4	0.88
chr10	126104667	126104897	CpG: 16	230	16	134	13.9	58.3	0.84
chr10	126109027	126109909	CpG: 64	882	64	555	14.5	62.9	0.92
chr10	126400684	126401087	CpG: 38	403	38	294	18.9	73.0	0.71
chr10	126518704	126518920	CpG: 15	216	15	122	13.9	56.5	0.89
chr10	126601371	126602448	CpG: 95	1077	95	709	17.6	65.8	0.81
chr10	126656111	126656868	CpG: 80	757	80	570	21.1	75.3	0.75
chr10	126658037	126658266	CpG: 18	229	18	156	15.7	68.1	0.71
chr10	126705197	126706094	CpG: 89	897	89	614	19.8	68.5	0.85
chr10	126743739	126743961	CpG: 16	222	16	132	14.4	59.5	0.84
chr10	126775788	126776016	CpG: 18	228	18	139	15.8	61.0	0.87
chr10	126778157	126779446	CpG: 157	1289	157	932	24.4	72.3	0.93
chr10	126827859	126828101	CpG: 19	242	19	143	15.7	59.1	0.90
chr10	126852739	126853156	CpG: 32	417	32	284	15.3	68.1	0.66
chr10	127220772	127221046	CpG: 24	274	24	172	17.5	62.8	0.90
chr10	127270090	127271418	CpG: 153	1328	153	938	23.0	70.6	0.93
chr10	127275356	127275590	CpG: 18	234	18	139	15.4	59.4	0.92
chr10	127386951	127387171	CpG: 16	220	16	138	14.5	62.7	0.74
chr10	127414756	127414992	CpG: 18	236	18	141	15.3	59.7	0.88
chr10	127738688	127738921	CpG: 19	233	19	144	16.3	61.8	0.87
chr10	127764978	127765221	CpG: 19	243	19	146	15.6	60.1	0.87
chr10	127788726	127790165	CpG: 185	1439	185	1076	25.7	74.8	0.92
chr10	127796132	127796368	CpG: 21	236	21	147	17.8	62.3	0.94
chr10	127825213	127825429	CpG: 16	216	16	131	14.8	60.6	0.82
chr10	127888353	127888815	CpG: 38	462	38	319	16.5	69.0	0.69
chr10	128068924	128069398	CpG: 32	474	32	306	13.5	64.6	0.65
chr10	128088835	128090500	CpG: 194	1665	194	1215	23.3	73.0	0.87
chr10	128173944	128174218	CpG: 24	274	24	172	17.5	62.8	0.90
chr10	128291786	128292056	CpG: 18	270	18	148	13.3	54.8	0.90
chr10	128384370	128384649	CpG: 23	279	23	170	16.5	60.9	0.89
chr10	128470157	128470435	CpG: 25	278	25	175	18.0	62.9	0.92
chr10	128632444	128635532	CpG: 257	3088	257	2087	16.6	67.6	0.73
chr10	128702763	128703033	CpG: 20	270	20	164	14.8	60.7	0.81
chr10	128747343	128747601	CpG: 22	258	22	164	17.1	63.6	0.85
chr10	128805482	128806502	CpG: 132	1020	132	781	25.9	76.6	0.89
chr10	129024081	129025230	CpG: 124	1149	124	786	21.6	68.4	0.93
chr10	129029420	129029694	CpG: 24	274	24	172	17.5	62.8	0.90
chr10	129035882	129036155	CpG: 24	273	24	173	17.6	63.4	0.88
chr10	129046853	129047139	CpG: 25	286	25	179	17.5	62.6	0.91
chr10	129048010	129049381	CpG: 133	1371	133	921	19.4	67.2	0.87
chr10	129092838	129093106	CpG: 22	268	22	167	16.4	62.3	0.85
chr10	129108842	129109904	CpG: 112	1062	112	793	21.1	74.7	0.76
chr10	129164465	129164776	CpG: 33	311	33	208	21.2	66.9	0.99
chr10	129185543	129185931	CpG: 59	388	59	308	30.4	79.4	0.97
chr10	129301707	129301981	CpG: 24	274	24	171	17.5	62.4	0.91
chr10	129424898	129425198	CpG: 22	300	22	189	14.7	63.0	0.74
chr10	129464740	129465039	CpG: 27	299	27	226	18.1	75.6	0.63
chr10	129465570	129465821	CpG: 20	251	20	139	15.9	55.4	1.05
chr10	129635326	129635617	CpG: 39	291	39	214	26.8	73.5	0.99
chr10	129996254	129996644	CpG: 33	390	33	284	16.9	72.8	0.64
chr10	130073566	130073840	CpG: 22	274	22	169	16.1	61.7	0.85
chr10	130391795	130392557	CpG: 99	762	99	564	26.0	74.0	0.96
chr10	130665189	130665432	CpG: 18	243	18	144	14.8	59.3	0.84
chr10	130706198	130706492	CpG: 26	294	26	184	17.7	62.6	0.91
chr10	130721429	130721652	CpG: 19	223	19	139	17.0	62.3	0.88
chr10	130766155	130766367	CpG: 22	212	22	141	20.8	66.5	0.94
chr10	130767621	130767897	CpG: 25	276	25	173	18.1	62.7	0.95
chr10	130795067	130795366	CpG: 30	299	30	194	20.1	64.9	0.96
chr10	130815408	130815638	CpG: 19	230	19	138	16.5	60.0	0.92
chr10	130823718	130823977	CpG: 26	259	26	199	20.1	76.8	0.68
chr10	130826123	130826456	CpG: 32	333	32	205	19.2	61.6	1.04
chr10	130885618	130887715	CpG: 203	2097	203	1397	19.4	66.6	0.87
chr10	130890097	130900624	CpG: 882	10527	882	6516	16.8	61.9	0.88
chr10	130942055	130942290	CpG: 17	235	17	150	14.5	63.8	0.71
chr10	130972578	130973741	CpG: 89	1163	89	768	15.3	66.0	0.71
chr10	131039215	131040613	CpG: 110	1398	110	917	15.7	65.6	0.73
chr10	131058039	131058254	CpG: 22	215	22	157	20.5	73.0	0.78
chr10	131061659	131061900	CpG: 18	241	18	145	14.9	60.2	0.85
chr10	131065255	131066059	CpG: 96	804	96	610	23.9	75.9	0.83
chr10	131117991	131120065	CpG: 170	2074	170	1396	16.4	67.3	0.73
chr10	131120382	131120632	CpG: 19	250	19	153	15.2	61.2	0.81
chr10	131131945	131132233	CpG: 22	288	22	200	15.3	69.4	0.71
chr10	131142338	131142662	CpG: 30	324	30	208	18.5	64.2	0.90
chr10	131276402	131276683	CpG: 24	281	24	174	17.1	61.9	0.91
chr10	131289512	131289734	CpG: 22	222	22	135	19.8	60.8	1.48
chr10	131496731	131497025	CpG: 30	294	30	201	20.4	68.4	0.88
chr10	131713729	131714173	CpG: 36	444	36	287	16.2	64.6	0.78
chr10	131995321	131995641	CpG: 27	320	27	191	16.9	59.7	0.96
chr10	132010433	132010652	CpG: 20	219	20	154	18.3	70.3	0.74
chr10	132030205	132030465	CpG: 21	260	21	188	16.2	72.3	0.63
chr10	132145112	132145317	CpG: 16	205	16	119	15.6	58.0	0.94
chr10	132196056	132196388	CpG: 32	332	32	227	19.3	68.4	0.84
chr10	132217838	132218074	CpG: 18	236	18	142	15.3	60.2	0.86
chr10	132246551	132248424	CpG: 245	1873	245	1450	26.2	77.4	0.87
chr10	132279866	132280171	CpG: 30	305	30	204	19.7	66.9	0.97
chr10	132457419	132457715	CpG: 25	296	25	194	16.9	65.5	0.85
chr10	132549772	132550390	CpG: 44	618	44	354	14.2	57.3	0.87
chr10	132558448	132560155	CpG: 138	1707	138	1139	16.2	66.7	0.73
chr10	132577612	132577886	CpG: 23	274	23	170	16.8	62.0	0.88
chr10	132609983	132610220	CpG: 18	237	18	142	15.2	59.9	0.85
chr10	132746317	132746579	CpG: 20	262	20	156	15.3	59.5	0.92
chr10	132778177	132778457	CpG: 18	280	18	199	12.9	71.1	0.60
chr10	132789620	132789871	CpG: 25	251	25	151	19.9	60.2	1.11
chr10	132824393	132824675	CpG: 22	282	22	200	15.6	70.9	0.62
chr10	132839319	132840936	CpG: 205	1617	205	1200	25.4	74.2	0.93
chr10	132877860	132878095	CpG: 19	235	19	158	16.2	67.2	0.72
chr10	132885218	132885451	CpG: 16	233	16	143	13.7	61.4	0.74
chr10	132910024	132910259	CpG: 18	235	18	148	15.3	63.0	0.77
chr10	132920174	132920395	CpG: 22	221	22	139	19.9	62.9	1.03
chr10	132921154	132921385	CpG: 20	231	20	153	17.3	66.2	0.79
chr10	132921646	132923364	CpG: 214	1718	214	1266	24.9	73.7	0.93
chr10	132976356	132977610	CpG: 145	1254	145	892	23.1	71.1	0.92
chr10	132987936	132988208	CpG: 24	272	24	189	17.6	69.5	0.74
chr10	133004634	133004902	CpG: 20	268	20	180	14.9	67.2	0.66
chr10	133005750	133006000	CpG: 23	250	23	175	18.4	70.0	0.75
chr10	133057488	133058067	CpG: 43	579	43	372	14.9	64.2	0.76
chr10	133074928	133075280	CpG: 31	352	31	206	17.6	58.5	1.05
chr10	133078300	133078614	CpG: 39	314	39	222	24.8	70.7	1.19
chr10	133080451	133080885	CpG: 32	434	32	284	14.7	65.4	0.70
chr10	133089566	133089844	CpG: 25	278	25	228	18.0	82.0	0.84
chr10	133123804	133124018	CpG: 34	214	34	141	31.8	65.9	2.00
chr10	133128636	133131190	CpG: 273	2554	273	1880	21.4	73.6	0.79
chr10	133143727	133143961	CpG: 18	234	18	153	15.4	65.4	0.74
chr10	133148810	133149088	CpG: 20	278	20	184	14.4	66.2	0.66
chr10	133169510	133169730	CpG: 16	220	16	144	14.5	65.5	0.68
chr10	133170817	133171102	CpG: 23	285	23	181	16.1	63.5	0.80
chr10	133201113	133201335	CpG: 17	222	17	150	15.3	67.6	0.67
chr10	133221124	133221393	CpG: 19	269	19	165	14.1	61.3	0.76
chr10	133224630	133224963	CpG: 25	333	25	232	15.0	69.7	0.62
chr10	133238254	133238513	CpG: 19	259	19	154	14.7	59.5	0.85
chr10	133249591	133251553	CpG: 238	1962	238	1466	24.3	74.7	0.87
chr10	133274237	133275166	CpG: 100	929	100	672	21.5	72.3	0.84
chr10	133294283	133295453	CpG: 90	1170	90	815	15.4	69.7	0.65
chr10	133323448	133323679	CpG: 18	231	18	137	15.6	59.3	0.90
chr10	133334218	133336082	CpG: 264	1864	264	1584	28.3	85.0	1.03
chr10	133343428	133345174	CpG: 246	1746	246	1390	28.2	79.6	0.89
chr10	133352363	133353710	CpG: 137	1347	137	950	20.3	70.5	0.82
chr10	133373459	133374055	CpG: 61	596	61	385	20.5	64.6	1.03
chr10	133401816	133402089	CpG: 36	273	36	212	26.4	77.7	0.88
chr10	133436055	133436352	CpG: 23	297	23	186	15.5	62.6	0.79
chr10	133439624	133439847	CpG: 14	223	14	133	12.6	59.6	0.71
chr10	133454342	133454608	CpG: 22	266	22	167	16.5	62.8	0.89
chr10	133485800	133487238	CpG: 199	1438	199	1127	27.7	78.4	0.91
chr10	133495040	133495287	CpG: 19	247	19	167	15.4	67.6	0.70
chr10	133496366	133496591	CpG: 16	225	16	154	14.2	68.4	0.61
chr10	133546738	133546978	CpG: 19	240	19	159	15.8	66.2	0.76
chr10	133552905	133553122	CpG: 19	217	19	160	17.5	73.7	0.71
chr10	133555632	133556074	CpG: 30	442	30	258	13.6	58.4	0.80
chr10	133596120	133596325	CpG: 20	205	20	144	19.5	70.2	0.79
chr10	133602149	133602443	CpG: 22	294	22	189	15.0	64.3	0.73
chr10	133604661	133604928	CpG: 20	267	20	163	15.0	61.0	0.81
chr10	133613144	133613361	CpG: 20	217	20	139	18.4	64.1	0.90
chr10	133630017	133630400	CpG: 35	383	35	281	18.3	73.4	0.68
chr10	133640265	133641436	CpG: 100	1171	100	701	17.1	59.9	0.98
chr10	133663586	133663935	CpG: 35	349	35	236	20.1	67.6	0.88
chr10	133671801	133672081	CpG: 25	280	25	183	17.9	65.4	0.85
chr10	133675631	133675840	CpG: 17	209	17	133	16.3	63.6	0.83
chr10	133685421	133685674	CpG: 23	253	23	168	18.2	66.4	0.83
chr10	133690912	133691137	CpG: 21	225	21	123	18.7	54.7	1.25
chr10	133698500	133699088	CpG: 38	588	38	380	12.9	64.6	0.62
chr10	133702306	133702781	CpG: 35	475	35	297	14.7	62.5	0.75
chr10	133706631	133706969	CpG: 31	338	31	212	18.3	62.7	0.95
chr10	133717394	133717744	CpG: 24	350	24	229	13.7	65.4	0.67
chr10	133728914	133729256	CpG: 31	342	31	202	18.1	59.1	1.04
chr10	133730972	133731373	CpG: 30	401	30	236	15.0	58.9	0.87
chr10	133733040	133738332	CpG: 672	5292	672	3831	25.4	72.4	0.97
chr10	133741267	133742071	CpG: 66	804	66	533	16.4	66.3	0.77
chr10	133743106	133743563	CpG: 36	457	36	320	15.8	70.0	0.65
chr10	133747236	133748821	CpG: 116	1585	116	1095	14.6	69.1	0.62
chr10	133750118	133750500	CpG: 36	382	36	282	18.8	73.8	0.69
chr10	133753273	133753523	CpG: 20	250	20	194	16.0	77.6	0.70
chr10	133756810	133757110	CpG: 27	300	27	212	18.0	70.7	0.73
chr10	133758162	133758380	CpG: 19	218	19	160	17.4	73.4	0.65
chr10	133759623	133760014	CpG: 27	391	27	262	13.8	67.0	0.62
chr10	133777972	133778195	CpG: 18	223	18	139	16.1	62.3	0.85
chr10	133786582	133787242	CpG: 46	660	46	366	13.9	55.5	0.98
chr10	133808532	133808767	CpG: 16	235	16	156	13.6	66.4	0.66
chr10	133818863	133819080	CpG: 21	217	21	149	19.4	68.7	0.82
chr10	133829014	133829415	CpG: 34	401	34	287	17.0	71.6	0.66
chr10	133834816	133835131	CpG: 22	315	22	180	14.0	57.1	0.87
chr10	133856143	133856507	CpG: 33	364	33	244	18.1	67.0	0.84
chr10	133858255	133858501	CpG: 18	246	18	157	14.6	63.8	0.72
chr10	133863086	133863424	CpG: 25	338	25	206	14.8	60.9	0.82
chr10	133864989	133865289	CpG: 30	300	30	194	20.0	64.7	0.97
chr10	133865743	133865967	CpG: 17	224	17	131	15.2	58.5	0.90
chr10	133867378	133867958	CpG: 49	580	49	382	16.9	65.9	1.01
chr10	133868546	133869722	CpG: 79	1176	79	751	13.4	63.9	0.66
chr10	133871917	133872199	CpG: 26	282	26	196	18.4	69.5	0.77
chr10	133874163	133874649	CpG: 37	486	37	313	15.2	64.4	0.74
chr10	133876746	133876978	CpG: 27	232	27	171	23.3	73.7	0.86
chr10	133891608	133892797	CpG: 121	1189	121	838	20.4	70.5	0.82
chr10	133910165	133910437	CpG: 22	272	22	190	16.2	69.9	0.67
chr10	133914635	133914923	CpG: 20	288	20	171	13.9	59.4	1.12
chr10	133926622	133926845	CpG: 23	223	23	145	20.6	65.0	0.98
chr10	133927356	133927568	CpG: 23	212	23	142	21.7	67.0	0.97
chr10	133929808	133930353	CpG: 38	545	38	365	13.9	67.0	0.62
chr10	133932341	133932738	CpG: 29	397	29	284	14.6	71.5	0.85
chr10	133933050	133933595	CpG: 51	545	51	335	18.7	61.5	0.99
chr10	133939894	133940156	CpG: 23	262	23	185	17.6	70.6	0.71
chr10	133942884	133943153	CpG: 23	269	23	158	17.1	58.7	1.00
chr10	133957454	133957658	CpG: 16	204	16	143	15.7	70.1	0.64
chr10	133962605	133963318	CpG: 56	713	56	454	15.7	63.7	0.78
chr10	133966996	133968576	CpG: 121	1580	121	994	15.3	62.9	0.78
chr10	133971043	133972266	CpG: 88	1223	88	774	14.4	63.3	0.72
chr10	133979832	133980197	CpG: 29	365	29	239	15.9	65.5	0.82
chr10	133980863	133981355	CpG: 41	492	41	299	16.7	60.8	0.91
chr10	133989503	133989724	CpG: 17	221	17	151	15.4	68.3	0.66
chr10	133991389	133992086	CpG: 48	697	48	495	13.8	71.0	0.68
chr10	133997594	133997988	CpG: 34	394	34	252	17.3	64.0	0.86
chr10	134012750	134014959	CpG: 172	2209	172	1336	15.6	60.5	0.86
chr10	134020846	134021066	CpG: 18	220	18	147	16.4	66.8	0.74
chr10	134027430	134029608	CpG: 208	2178	208	1387	19.1	63.7	0.96
chr10	134032896	134033357	CpG: 36	461	36	303	15.6	65.7	0.72
chr10	134037404	134038825	CpG: 173	1421	173	1060	24.3	74.6	0.88
chr10	134048190	134048697	CpG: 38	507	38	327	15.0	64.5	0.75
chr10	134049757	134050253	CpG: 34	496	34	331	13.7	66.7	0.62
chr10	134050523	134050800	CpG: 24	277	24	180	17.3	65.0	0.82
chr10	134054969	134055189	CpG: 17	220	17	137	15.5	62.3	0.80
chr10	134068077	134069140	CpG: 90	1063	90	604	16.9	56.8	1.16
chr10	134078948	134079455	CpG: 34	507	34	317	13.4	62.5	0.69
chr10	134080227	134080742	CpG: 50	515	50	365	19.4	70.9	0.78
chr10	134082595	134083136	CpG: 44	541	44	379	16.3	70.1	0.67
chr10	134084186	134085262	CpG: 96	1076	96	758	17.8	70.4	0.72
chr10	134086772	134087053	CpG: 20	281	20	173	14.2	61.6	0.75
chr10	134087592	134088074	CpG: 36	482	36	305	14.9	63.3	0.79
chr10	134098690	134098982	CpG: 24	292	24	213	16.4	72.9	0.63
chr10	134114899	134115127	CpG: 17	228	17	140	14.9	61.4	0.79
chr10	134116585	134117493	CpG: 114	908	114	717	25.1	79.0	0.81
chr10	134121058	134121276	CpG: 17	218	17	147	15.6	67.4	0.69
chr10	134122023	134122254	CpG: 17	231	17	152	14.7	65.8	0.68
chr10	134123430	134124251	CpG: 67	821	67	543	16.3	66.1	0.75
chr10	134136223	134136426	CpG: 20	203	20	133	19.7	65.5	0.92
chr10	134139434	134140102	CpG: 62	668	62	475	18.6	71.1	0.81
chr10	134142667	134142978	CpG: 25	311	25	225	16.1	72.3	0.62
chr10	134145864	134146130	CpG: 22	266	22	189	16.5	71.1	0.66
chr10	134157821	134158520	CpG: 54	699	54	482	15.5	69.0	0.65
chr10	134159497	134160522	CpG: 72	1025	72	667	14.0	65.1	0.67
chr10	134163688	134164002	CpG: 29	314	29	211	18.5	67.2	0.82
chr10	134172134	134172401	CpG: 22	267	22	181	16.5	67.8	0.72
chr10	134176343	134177198	CpG: 89	855	89	660	20.8	77.2	0.72
chr10	134178159	134178466	CpG: 27	307	27	196	17.6	63.8	0.87
chr10	134180072	134180493	CpG: 31	421	31	264	14.7	62.7	0.75
chr10	134181924	134182280	CpG: 24	356	24	217	13.5	61.0	0.73
chr10	134185022	134186980	CpG: 256	1958	256	1468	26.1	75.0	0.93
chr10	134190027	134190288	CpG: 21	261	21	184	16.1	70.5	0.85
chr10	134190783	134194063	CpG: 279	3280	279	2335	17.0	71.2	0.67
chr10	134203369	134203760	CpG: 29	391	29	269	14.8	68.8	0.63
chr10	134217124	134217905	CpG: 103	781	103	593	26.4	75.9	0.97
chr10	134225852	134226075	CpG: 15	223	15	145	13.5	65.0	0.64
chr10	134232086	134232608	CpG: 55	522	55	392	21.1	75.1	0.75
chr10	134239610	134239895	CpG: 21	285	21	192	14.7	67.4	0.65
chr10	134240636	134241324	CpG: 54	688	54	428	15.7	62.2	0.82
chr10	134243500	134244079	CpG: 43	579	43	404	14.9	69.8	0.61
chr10	134245390	134245678	CpG: 25	288	25	183	17.4	63.5	0.87
chr10	134262924	134264042	CpG: 132	1118	132	835	23.6	74.7	0.85
chr10	134264171	134264381	CpG: 16	210	16	134	15.2	63.8	0.75
chr10	134273028	134273480	CpG: 44	452	44	314	19.5	69.5	0.81
chr10	134278270	134278528	CpG: 20	258	20	154	15.5	59.7	0.88
chr10	134279703	134280738	CpG: 113	1035	113	758	21.8	73.2	0.82
chr10	134284340	134285144	CpG: 59	804	59	480	14.7	59.7	0.84
chr10	134289842	134292246	CpG: 224	2404	224	1714	18.6	71.3	0.73
chr10	134312257	134313566	CpG: 120	1309	120	970	18.3	74.1	0.67
chr10	134327857	134328846	CpG: 106	989	106	764	21.4	77.2	0.74
chr10	134333098	134334821	CpG: 188	1723	188	1268	21.8	73.6	0.84
chr10	134342633	134342838	CpG: 18	205	18	124	17.6	60.5	0.97
chr10	134344578	134344793	CpG: 22	215	22	160	20.5	74.4	0.74
chr10	134348935	134349541	CpG: 79	606	79	460	26.1	75.9	0.91
chr10	134357852	134358324	CpG: 35	472	35	264	14.8	55.9	1.03
chr10	134369448	134370155	CpG: 46	707	46	462	13.0	65.3	0.63
chr10	134378109	134380141	CpG: 203	2032	203	1498	20.0	73.7	0.74
chr10	134387192	134387621	CpG: 36	429	36	317	16.8	73.9	0.62
chr10	134395427	134395791	CpG: 34	364	34	248	18.7	68.1	0.89
chr10	134400192	134400960	CpG: 75	768	75	583	19.5	75.9	0.69
chr10	134411555	134411833	CpG: 23	278	23	191	16.5	68.7	0.70
chr10	134412642	134412916	CpG: 32	274	32	206	23.4	75.2	0.84
chr10	134413772	134414457	CpG: 80	685	80	508	23.4	74.2	0.86
chr10	134419486	134419886	CpG: 51	400	51	309	25.5	77.2	0.90
chr10	134471852	134472144	CpG: 29	292	29	215	19.9	73.6	0.73
chr10	134479337	134480643	CpG: 125	1306	125	868	19.1	66.5	0.87
chr10	134516883	134517767	CpG: 85	884	85	622	19.2	70.4	0.78
chr10	134519475	134521450	CpG: 174	1975	174	1420	17.6	71.9	0.68
chr10	134528543	134528898	CpG: 30	355	30	265	16.9	74.6	0.61
chr10	134573676	134574734	CpG: 100	1058	100	652	18.9	61.6	1.00
chr10	134588795	134589779	CpG: 73	984	73	679	14.8	69.0	0.65
chr10	134591863	134592441	CpG: 69	578	69	417	23.9	72.1	0.92
chr10	134615845	134726446	CpG: 10769	110601	10769	80186	19.5	72.5	0.74
chr10	134753649	134754700	CpG: 145	1051	145	774	27.6	73.6	1.03
chr11	1988	2805	CpG: 123	817	123	615	30.1	75.3	1.08
chr11	20301	21376	CpG: 116	1075	116	787	21.6	73.2	0.83
chr11	43227	43500	CpG: 32	273	32	192	23.4	70.3	0.96
chr11	51247	51521	CpG: 25	274	25	170	18.2	62.0	0.96
chr11	153497	153936	CpG: 30	439	30	296	13.7	67.4	0.63
chr11	230112	230568	CpG: 57	456	57	333	25.0	73.0	0.95
chr11	248153	250423	CpG: 201	2270	201	1510	17.7	66.5	0.80
chr11	275467	275708	CpG: 19	241	19	145	15.8	60.2	0.90
chr11	276910	278296	CpG: 131	1386	131	929	18.9	67.0	0.85
chr11	320243	322871	CpG: 276	2628	276	1850	21.0	70.4	0.85
chr11	329314	330652	CpG: 148	1338	148	990	22.1	74.0	0.81
chr11	330949	331188	CpG: 20	239	20	163	16.7	68.2	0.74
chr11	332674	333254	CpG: 39	580	39	384	13.4	66.2	0.64
chr11	340610	340856	CpG: 21	246	21	171	17.1	69.5	0.71
chr11	345300	345720	CpG: 53	420	53	299	25.2	71.2	1.00
chr11	351962	352974	CpG: 99	1012	99	727	19.6	71.8	0.76
chr11	354323	355275	CpG: 100	952	100	678	21.0	71.2	0.84
chr11	359274	360286	CpG: 99	1012	99	726	19.6	71.7	0.76
chr11	371871	372196	CpG: 23	325	23	222	14.2	68.3	0.61
chr11	373295	373525	CpG: 17	230	17	137	14.8	59.6	0.86
chr11	376225	376489	CpG: 22	264	22	166	16.7	62.9	0.85
chr11	392698	392979	CpG: 24	281	24	173	17.1	61.6	0.91
chr11	396661	397920	CpG: 145	1259	145	935	23.0	74.3	0.83
chr11	398764	399084	CpG: 26	320	26	204	16.2	63.8	0.82
chr11	411335	411570	CpG: 22	235	22	147	18.7	62.6	0.99
chr11	413304	414681	CpG: 201	1377	201	1120	29.2	81.3	0.89
chr11	419986	421703	CpG: 175	1717	175	1241	20.4	72.3	0.78
chr11	423618	425091	CpG: 140	1473	140	1018	19.0	69.1	0.80
chr11	439568	439930	CpG: 38	362	38	273	21.0	75.4	0.75
chr11	441996	444191	CpG: 145	2195	145	1464	13.2	66.7	0.68
chr11	445407	448765	CpG: 397	3358	397	2690	23.6	80.1	0.88
chr11	451856	453236	CpG: 137	1380	137	1003	19.9	72.7	0.75
chr11	461872	463103	CpG: 136	1231	136	915	22.1	74.3	0.80
chr11	465718	466428	CpG: 70	710	70	499	19.7	70.3	0.80
chr11	466803	467060	CpG: 19	257	19	168	14.8	65.4	0.73
chr11	470250	470607	CpG: 66	357	66	261	37.0	73.1	1.81
chr11	476131	477092	CpG: 97	961	97	722	20.2	75.1	0.80
chr11	493181	493660	CpG: 47	479	47	314	19.6	65.6	0.91
chr11	494948	496522	CpG: 169	1574	169	1077	21.5	68.4	0.92
chr11	503584	503847	CpG: 19	263	19	162	14.4	61.6	0.77
chr11	504438	504735	CpG: 23	297	23	179	15.5	60.3	0.90
chr11	505858	506105	CpG: 20	247	20	161	16.2	65.2	0.77
chr11	509651	510075	CpG: 29	424	29	265	13.7	62.5	0.70
chr11	515372	515613	CpG: 19	241	19	167	15.8	69.3	0.66
chr11	516823	517448	CpG: 63	625	63	458	20.2	73.3	0.87
chr11	518084	518368	CpG: 26	284	26	188	18.3	66.2	0.84
chr11	530624	531896	CpG: 147	1272	147	806	23.1	63.4	1.20
chr11	535061	535929	CpG: 63	868	63	588	14.5	67.7	0.64
chr11	540565	540868	CpG: 24	303	24	214	15.8	70.6	0.64
chr11	542924	543578	CpG: 43	654	43	383	13.1	58.6	0.92
chr11	549961	550432	CpG: 52	471	52	346	22.1	73.5	0.83
chr11	552127	553782	CpG: 192	1655	192	1183	23.2	71.5	0.91
chr11	556757	557052	CpG: 24	295	24	175	16.3	59.3	0.94
chr11	564339	566576	CpG: 170	2237	170	1206	15.2	53.9	1.05
chr11	567482	567687	CpG: 15	205	15	122	14.6	59.5	0.88
chr11	581681	584696	CpG: 334	3015	334	2150	22.2	71.3	0.87
chr11	588912	589204	CpG: 24	292	24	210	16.4	71.9	0.84
chr11	594390	594625	CpG: 17	235	17	141	14.5	60.0	0.84
chr11	601698	603564	CpG: 211	1866	211	1385	22.6	74.2	0.84
chr11	607386	608673	CpG: 153	1287	153	970	23.8	75.4	0.85
chr11	614936	616589	CpG: 188	1653	188	1248	22.7	75.5	0.80
chr11	619308	619577	CpG: 20	269	20	165	14.9	61.3	0.80
chr11	622277	623997	CpG: 209	1720	209	1276	24.3	74.2	0.89
chr11	638457	638773	CpG: 27	316	27	207	17.1	65.5	0.85
chr11	646112	646347	CpG: 19	235	19	160	16.2	68.1	0.71
chr11	660337	660589	CpG: 21	252	21	176	16.7	69.8	0.74
chr11	663376	666413	CpG: 227	3037	227	1998	14.9	65.8	0.69
chr11	670579	670796	CpG: 20	217	20	153	18.4	70.5	0.79
chr11	673392	673665	CpG: 20	273	20	189	14.7	69.2	0.62
chr11	675340	677229	CpG: 169	1889	169	1256	17.9	66.5	0.81
chr11	684959	689291	CpG: 401	4332	401	2985	18.5	68.9	0.78
chr11	694506	695004	CpG: 37	498	37	329	14.9	66.1	0.68
chr11	711047	711274	CpG: 18	227	18	161	15.9	70.9	0.64
chr11	721767	721999	CpG: 17	232	17	139	14.7	59.9	0.84
chr11	745431	747242	CpG: 237	1811	237	1300	26.2	71.8	1.02
chr11	756794	757534	CpG: 94	740	94	583	25.4	78.8	0.82
chr11	763608	763813	CpG: 16	205	16	143	15.6	69.8	0.66
chr11	771864	772693	CpG: 77	829	77	603	18.6	72.7	0.72
chr11	776920	778195	CpG: 116	1275	116	935	18.2	73.3	0.68
chr11	785998	788003	CpG: 196	2005	196	1389	19.6	69.3	0.83
chr11	796039	796313	CpG: 21	274	21	169	15.3	61.7	0.81
chr11	797609	797847	CpG: 19	238	19	139	16.0	58.4	0.96
chr11	798355	799510	CpG: 142	1155	142	875	24.6	75.8	0.86
chr11	814670	814937	CpG: 25	267	25	204	18.7	76.4	0.89
chr11	828238	829433	CpG: 156	1195	156	926	26.1	77.5	0.87
chr11	841304	841641	CpG: 46	337	46	262	27.3	77.7	0.91
chr11	843386	843833	CpG: 38	447	38	304	17.0	68.0	0.74
chr11	849072	849976	CpG: 110	904	110	673	24.3	74.4	0.89
chr11	851983	852298	CpG: 28	315	28	221	17.8	70.2	0.74
chr11	856260	857041	CpG: 90	781	90	581	23.0	74.4	0.84
chr11	860636	861966	CpG: 144	1330	144	918	21.7	69.0	0.91
chr11	870410	871707	CpG: 144	1297	144	949	22.2	73.2	0.84
chr11	874995	876317	CpG: 111	1322	111	944	16.8	71.4	0.66
chr11	878376	879060	CpG: 75	684	75	518	21.9	75.7	0.76
chr11	880719	884934	CpG: 321	4215	321	2950	15.2	70.0	0.62
chr11	893408	894824	CpG: 167	1416	167	1044	23.6	73.7	0.87
chr11	900715	902360	CpG: 199	1645	199	1217	24.2	74.0	0.89
chr11	909954	910965	CpG: 74	1011	74	711	14.6	70.3	0.82
chr11	940118	940415	CpG: 22	297	22	211	14.8	71.0	0.62
chr11	941625	941940	CpG: 24	315	24	216	15.2	68.6	0.65
chr11	961670	963009	CpG: 151	1339	151	990	22.6	73.9	0.85
chr11	976611	977946	CpG: 167	1335	167	1007	25.0	75.4	0.89
chr11	981969	982199	CpG: 18	230	18	140	15.7	60.9	0.85
chr11	995102	995580	CpG: 36	478	36	291	15.1	60.9	0.99
chr11	1031653	1032218	CpG: 55	565	55	361	19.5	63.9	0.98
chr11	1033391	1033635	CpG: 18	244	18	162	14.8	66.4	0.67
chr11	1036465	1038099	CpG: 149	1634	149	1190	18.2	72.8	0.72
chr11	1044897	1045177	CpG: 22	280	22	169	15.7	60.4	0.87
chr11	1050735	1051533	CpG: 58	798	58	515	14.5	64.5	0.70
chr11	1066738	1067160	CpG: 31	422	31	283	14.7	67.1	0.66
chr11	1068220	1068566	CpG: 43	346	43	280	24.9	80.9	0.76
chr11	1069396	1069670	CpG: 19	274	19	161	13.9	58.8	0.80
chr11	1091962	1092278	CpG: 22	316	22	228	13.9	72.2	0.79
chr11	1098967	1099274	CpG: 24	307	24	214	15.6	69.7	0.67
chr11	1101635	1101885	CpG: 24	250	24	166	19.2	66.4	0.87
chr11	1102968	1103240	CpG: 22	272	22	182	16.2	66.9	0.74
chr11	1104718	1105030	CpG: 26	312	26	228	16.7	73.1	0.65
chr11	1106304	1106711	CpG: 35	407	35	297	17.2	73.0	0.65
chr11	1126208	1126618	CpG: 32	410	32	267	15.6	65.1	0.74
chr11	1146406	1146668	CpG: 20	262	20	189	15.3	72.1	0.80
chr11	1153704	1153928	CpG: 18	224	18	152	16.1	67.9	0.70
chr11	1173913	1174160	CpG: 20	247	20	158	16.2	64.0	0.81
chr11	1185393	1185765	CpG: 26	372	26	248	14.0	66.7	0.63
chr11	1233261	1233646	CpG: 34	385	34	253	17.7	65.7	0.82
chr11	1249713	1249943	CpG: 18	230	18	156	15.7	67.8	0.69
chr11	1250239	1250580	CpG: 30	341	30	240	17.6	70.4	0.72
chr11	1252283	1252617	CpG: 26	334	26	229	15.6	68.6	0.66
chr11	1253269	1253737	CpG: 35	468	35	324	15.0	69.2	0.62
chr11	1265391	1266002	CpG: 60	611	60	406	19.6	66.4	0.89
chr11	1266240	1266483	CpG: 21	243	21	167	17.3	68.7	0.75
chr11	1271587	1271879	CpG: 26	292	26	207	17.8	70.9	0.71
chr11	1278771	1279044	CpG: 21	273	21	187	15.4	68.5	0.66
chr11	1297844	1298154	CpG: 26	310	26	207	16.8	66.8	0.75
chr11	1302160	1302392	CpG: 19	232	19	161	16.4	69.4	0.69
chr11	1303700	1304508	CpG: 62	808	62	550	15.3	68.1	0.67
chr11	1307593	1307815	CpG: 16	222	16	142	14.4	64.0	0.71
chr11	1312091	1312606	CpG: 37	515	37	347	14.4	67.4	0.64
chr11	1323599	1323866	CpG: 19	267	19	186	14.2	69.7	0.63
chr11	1324074	1324275	CpG: 16	201	16	130	15.9	64.7	0.77
chr11	1343110	1344019	CpG: 70	909	70	637	15.4	70.1	0.63
chr11	1344254	1344631	CpG: 26	377	26	214	13.8	56.8	0.87
chr11	1347957	1348424	CpG: 35	467	35	310	15.0	66.4	0.68
chr11	1349223	1349426	CpG: 19	203	19	140	18.7	69.0	0.79
chr11	1352720	1352930	CpG: 17	210	17	146	16.2	69.5	0.67
chr11	1358579	1358990	CpG: 57	411	57	347	27.7	84.4	1.10
chr11	1361257	1361525	CpG: 22	268	22	169	16.4	63.1	0.83
chr11	1362752	1363035	CpG: 35	283	35	219	24.7	77.4	0.93
chr11	1365373	1367535	CpG: 155	2162	155	1265	14.3	58.5	0.85
chr11	1380789	1382056	CpG: 150	1267	150	927	23.7	73.2	0.89
chr11	1408029	1409560	CpG: 187	1531	187	1173	24.4	76.6	0.84
chr11	1410516	1410885	CpG: 26	369	26	230	14.1	62.3	0.73
chr11	1418877	1419167	CpG: 21	290	21	175	14.5	60.3	0.80
chr11	1426915	1427147	CpG: 19	232	19	140	16.4	60.3	0.91
chr11	1454250	1454747	CpG: 48	497	48	364	19.3	73.2	0.75
chr11	1460156	1462383	CpG: 302	2227	302	1713	27.1	76.9	0.92
chr11	1481065	1481960	CpG: 80	895	80	562	17.9	62.8	0.99
chr11	1483338	1483751	CpG: 48	413	48	313	23.2	75.8	0.81
chr11	1507092	1507432	CpG: 30	340	30	213	17.6	62.6	0.92
chr11	1509513	1510062	CpG: 54	549	54	429	19.7	78.1	0.93
chr11	1517503	1518131	CpG: 55	628	55	459	17.5	73.1	0.66
chr11	1519499	1520405	CpG: 72	906	72	641	15.9	70.8	0.64
chr11	1523243	1523598	CpG: 30	355	30	252	16.9	71.0	0.67
chr11	1524549	1524805	CpG: 24	256	24	187	18.8	73.0	0.73
chr11	1534594	1534819	CpG: 20	225	20	160	17.8	71.1	0.76
chr11	1534979	1535844	CpG: 80	865	80	620	18.5	71.7	0.75
chr11	1536916	1537156	CpG: 18	240	18	148	15.0	61.7	0.79
chr11	1544403	1544731	CpG: 25	328	25	227	15.2	69.2	0.66
chr11	1545725	1545961	CpG: 17	236	17	146	14.4	61.9	0.76
chr11	1590346	1590570	CpG: 17	224	17	154	15.2	68.8	0.66
chr11	1614284	1615408	CpG: 129	1124	129	808	23.0	71.9	0.93
chr11	1627559	1628526	CpG: 113	967	113	731	23.4	75.6	0.82
chr11	1637807	1639193	CpG: 157	1386	157	1051	22.7	75.8	0.79
chr11	1652603	1656238	CpG: 369	3635	369	2679	20.3	73.7	0.75
chr11	1707365	1707602	CpG: 17	237	17	143	14.3	60.3	0.80
chr11	1736573	1736963	CpG: 29	390	29	241	14.9	61.8	0.78
chr11	1742382	1742602	CpG: 16	220	16	118	14.5	53.6	1.02
chr11	1779656	1780311	CpG: 44	655	44	416	13.4	63.5	0.67
chr11	1833299	1835032	CpG: 167	1733	167	1241	19.3	71.6	0.76
chr11	1838908	1839360	CpG: 36	452	36	317	15.9	70.1	0.65
chr11	1849235	1849983	CpG: 99	748	99	587	26.5	78.5	0.86
chr11	1889782	1890000	CpG: 31	218	31	177	28.4	81.2	1.42
chr11	1894031	1894242	CpG: 15	211	15	127	14.2	60.2	0.82
chr11	1956602	1957121	CpG: 45	519	45	357	17.3	68.8	0.75
chr11	1967742	1967998	CpG: 19	256	19	178	14.8	69.5	0.61
chr11	1990341	1990768	CpG: 35	427	35	275	16.4	64.4	0.81
chr11	1991725	1991998	CpG: 20	273	20	183	14.7	67.0	0.69
chr11	1993161	1993466	CpG: 25	305	25	219	16.4	71.8	0.64
chr11	2001748	2002061	CpG: 24	313	24	215	15.3	68.7	0.65
chr11	2018046	2018282	CpG: 17	236	17	143	14.4	60.6	0.82
chr11	2034634	2035615	CpG: 118	981	118	768	24.1	78.3	0.84
chr11	2040479	2040773	CpG: 22	294	22	199	15.0	67.7	0.67
chr11	2043963	2044205	CpG: 27	242	27	178	22.3	73.6	0.85
chr11	2052439	2052786	CpG: 27	347	27	242	15.6	69.7	0.64
chr11	2079777	2080063	CpG: 22	286	22	190	15.4	66.4	0.70
chr11	2083349	2083564	CpG: 18	215	18	143	16.7	66.5	0.83
chr11	2083906	2084700	CpG: 64	794	64	556	16.1	70.0	0.66
chr11	2086012	2086310	CpG: 28	298	28	203	18.8	68.1	0.81
chr11	2100036	2100320	CpG: 23	284	23	195	16.2	68.7	0.69
chr11	2169212	2169447	CpG: 19	235	19	143	16.2	60.9	0.90
chr11	2220456	2220810	CpG: 28	354	28	240	15.8	67.8	0.74
chr11	2225373	2228907	CpG: 377	3534	377	2555	21.3	72.3	0.82
chr11	2231558	2232094	CpG: 66	536	66	379	24.6	70.7	0.99
chr11	2243257	2243461	CpG: 21	204	21	145	20.6	71.1	0.85
chr11	2255624	2256381	CpG: 76	757	76	556	20.1	73.4	0.74
chr11	2264431	2264667	CpG: 18	236	18	144	15.3	61.0	0.85
chr11	2279010	2279291	CpG: 20	281	20	165	14.2	58.7	0.84
chr11	2347165	2347411	CpG: 21	246	21	152	17.1	61.8	0.92
chr11	2358333	2361161	CpG: 338	2828	338	2042	23.9	72.2	0.92
chr11	2442270	2442474	CpG: 16	204	16	120	15.7	58.8	0.93
chr11	2466361	2467736	CpG: 157	1375	157	1044	22.8	75.9	0.79
chr11	2474892	2475155	CpG: 25	263	25	175	19.0	66.5	0.86
chr11	2485770	2486113	CpG: 27	343	27	224	15.7	65.3	0.74
chr11	2489161	2490650	CpG: 133	1489	133	1008	17.9	67.7	0.78
chr11	2499541	2499743	CpG: 19	202	19	138	18.8	68.3	0.81
chr11	2503388	2504744	CpG: 114	1356	114	957	16.8	70.6	0.68
chr11	2510163	2510495	CpG: 28	332	28	234	16.9	70.5	0.69
chr11	2533264	2534912	CpG: 172	1648	172	1239	20.9	75.2	0.74
chr11	2622205	2622700	CpG: 34	495	34	302	13.7	61.0	0.76
chr11	2623507	2623720	CpG: 16	213	16	145	15.0	68.1	0.65
chr11	2641987	2642227	CpG: 20	240	20	125	16.7	52.1	1.35
chr11	2662089	2662331	CpG: 19	242	19	151	15.7	62.4	0.81
chr11	2664508	2664737	CpG: 21	229	21	171	18.3	74.7	0.72
chr11	2671354	2671603	CpG: 20	249	20	167	16.1	67.1	0.72
chr11	2788519	2790195	CpG: 174	1676	174	1207	20.8	72.0	0.80
chr11	2838846	2839058	CpG: 19	212	19	112	17.9	52.8	1.31
chr11	2880541	2881522	CpG: 87	981	87	679	17.7	69.2	0.74
chr11	2886113	2886507	CpG: 29	394	29	247	14.7	62.7	0.75
chr11	2896562	2897001	CpG: 34	439	34	279	15.5	63.6	0.77
chr11	2939448	2940006	CpG: 46	558	46	375	16.5	67.2	0.74
chr11	2951518	2952451	CpG: 107	933	107	676	22.9	72.5	0.88
chr11	2958380	2959329	CpG: 125	949	125	667	26.3	70.3	1.07
chr11	2973034	2975688	CpG: 364	2654	364	2030	27.4	76.5	0.94
chr11	2989663	2989896	CpG: 20	233	20	143	17.2	61.4	0.94
chr11	2991316	2991832	CpG: 47	516	47	374	18.2	72.5	0.69
chr11	2998305	2999108	CpG: 82	803	82	607	20.4	75.6	0.71
chr11	3010175	3010466	CpG: 23	291	23	175	15.8	60.1	0.88
chr11	3017655	3019623	CpG: 211	1968	211	1391	21.4	70.7	0.86
chr11	3033773	3034090	CpG: 23	317	23	206	14.5	65.0	0.69
chr11	3080811	3082193	CpG: 152	1382	152	960	22.0	69.5	0.94
chr11	3083099	3083367	CpG: 20	268	20	160	14.9	59.7	0.84
chr11	3100559	3100799	CpG: 19	240	19	143	15.8	59.6	0.90
chr11	3146134	3146976	CpG: 78	842	78	587	18.5	69.7	0.78
chr11	3182730	3182998	CpG: 20	268	20	181	14.9	67.5	0.68
chr11	3210650	3210885	CpG: 16	235	16	153	13.6	65.1	0.64
chr11	3233523	3233981	CpG: 32	458	32	288	14.0	62.9	0.71
chr11	3250614	3251160	CpG: 43	546	43	349	15.8	63.9	0.80
chr11	3255171	3255789	CpG: 89	618	89	498	28.8	80.6	0.90
chr11	3293772	3294327	CpG: 44	555	44	396	15.9	71.4	0.62
chr11	3308959	3309730	CpG: 66	771	66	539	17.1	69.9	0.71
chr11	3313556	3313770	CpG: 15	214	15	140	14.0	65.4	0.67
chr11	3323489	3323707	CpG: 20	218	20	148	18.3	67.9	0.80
chr11	3323960	3324197	CpG: 17	237	17	145	14.3	61.2	0.77
chr11	3346654	3346943	CpG: 23	289	23	173	15.9	59.9	0.90
chr11	3362829	3363091	CpG: 25	262	25	164	19.1	62.6	0.99
chr11	3424162	3424582	CpG: 37	420	37	297	17.6	70.7	0.71
chr11	3432415	3432993	CpG: 47	578	47	375	16.3	64.9	0.78
chr11	3459213	3459419	CpG: 17	206	17	135	16.5	65.5	0.78
chr11	3467424	3469075	CpG: 144	1651	144	1152	17.4	69.8	0.76
chr11	3574712	3574975	CpG: 21	263	21	160	16.0	60.8	0.87
chr11	3626093	3626858	CpG: 87	765	87	571	22.7	74.6	0.83
chr11	3636893	3637128	CpG: 20	235	20	160	17.0	68.1	0.74
chr11	3687255	3688006	CpG: 66	751	66	538	17.6	71.6	0.69
chr11	3732518	3733150	CpG: 83	632	83	459	26.3	72.6	1.00
chr11	3814365	3814646	CpG: 23	281	23	173	16.4	61.6	0.88
chr11	3862554	3863414	CpG: 99	860	99	601	23.0	69.9	0.94
chr11	3864041	3864279	CpG: 18	238	18	146	15.1	61.3	0.81
chr11	3873804	3874112	CpG: 31	308	31	227	20.1	73.7	0.74
chr11	3887408	3887648	CpG: 19	240	19	144	15.8	60.0	0.91
chr11	3905958	3907099	CpG: 100	1141	100	844	17.5	74.0	0.64
chr11	3920381	3921527	CpG: 116	1146	116	826	20.2	72.1	0.78
chr11	4083440	4083724	CpG: 24	284	24	175	16.9	61.6	0.91
chr11	4159724	4160576	CpG: 73	852	73	534	17.1	62.7	0.88
chr11	4240931	4241359	CpG: 31	428	31	255	14.5	59.6	0.82
chr11	4252277	4252979	CpG: 78	702	78	515	22.2	73.4	0.84
chr11	4348399	4349149	CpG: 57	750	57	508	15.2	67.7	0.66
chr11	4399573	4400323	CpG: 57	750	57	508	15.2	67.7	0.66
chr11	4538024	4538298	CpG: 20	274	20	170	14.6	62.0	0.78
chr11	4673158	4673590	CpG: 35	432	35	295	16.2	68.3	0.70
chr11	4741746	4741974	CpG: 17	228	17	137	14.9	60.1	0.85
chr11	5015897	5016155	CpG: 21	258	21	157	16.3	60.9	0.89
chr11	5203762	5204132	CpG: 32	370	32	275	17.3	74.3	0.63
chr11	5353786	5354118	CpG: 31	332	31	244	18.7	73.5	0.69
chr11	5524236	5524466	CpG: 20	230	20	143	17.4	62.2	0.92
chr11	5649303	5649581	CpG: 28	278	28	207	20.1	74.5	0.73
chr11	5740811	5741106	CpG: 28	295	28	217	19.0	73.6	0.70
chr11	5751290	5751526	CpG: 18	236	18	146	15.3	61.9	0.82
chr11	5757099	5757380	CpG: 24	281	24	174	17.1	61.9	0.91
chr11	5921817	5922095	CpG: 24	278	24	170	17.3	61.2	0.94
chr11	6018899	6019653	CpG: 57	754	57	520	15.1	69.0	0.64
chr11	6179578	6179863	CpG: 23	285	23	178	16.1	62.5	0.84
chr11	6243938	6244246	CpG: 24	308	24	186	15.6	60.4	0.86
chr11	6292987	6293398	CpG: 51	411	51	285	24.8	69.3	1.04
chr11	6294106	6294383	CpG: 22	277	22	168	15.9	60.6	0.87
chr11	6298557	6298952	CpG: 32	395	32	236	16.2	59.7	0.93
chr11	6309116	6309390	CpG: 23	274	23	170	16.8	62.0	0.88
chr11	6318152	6318517	CpG: 38	365	38	275	20.8	75.3	0.78
chr11	6328540	6328760	CpG: 23	220	23	147	20.9	66.8	0.94
chr11	6329458	6329895	CpG: 37	437	37	280	16.9	64.1	0.83
chr11	6353987	6354223	CpG: 18	236	18	145	15.3	61.4	0.83
chr11	6377638	6379102	CpG: 108	1464	108	982	14.8	67.1	0.66
chr11	6406424	6406702	CpG: 21	278	21	173	15.1	62.2	0.78
chr11	6435975	6436249	CpG: 20	274	20	168	14.6	61.3	0.79
chr11	6448573	6449193	CpG: 63	620	63	442	20.3	71.3	0.80
chr11	6466254	6466535	CpG: 24	281	24	174	17.1	61.9	0.91
chr11	6477093	6478064	CpG: 110	971	110	714	22.7	73.5	0.84
chr11	6514837	6515412	CpG: 54	575	54	389	18.8	67.7	0.82
chr11	6531966	6532694	CpG: 78	728	78	526	21.4	72.3	0.85
chr11	6539665	6540169	CpG: 54	504	54	326	21.4	64.7	1.03
chr11	6555049	6555286	CpG: 16	237	16	140	13.5	59.1	0.80
chr11	6629201	6630036	CpG: 74	835	74	532	17.7	63.7	0.88
chr11	6661763	6662315	CpG: 61	552	61	385	22.1	69.7	0.91
chr11	6670116	6671024	CpG: 102	908	102	642	22.5	70.7	0.91
chr11	6688141	6689315	CpG: 146	1174	146	826	24.9	70.4	1.00
chr11	6713723	6714579	CpG: 126	856	126	677	29.4	79.1	1.04
chr11	6741532	6742179	CpG: 62	647	62	417	19.2	64.5	0.93
chr11	6869679	6869917	CpG: 18	238	18	136	15.1	57.1	0.95
chr11	6984724	6985397	CpG: 57	673	57	419	16.9	62.3	0.91
chr11	7078219	7079096	CpG: 66	877	66	537	15.1	61.2	0.80
chr11	7129955	7130236	CpG: 24	281	24	175	17.1	62.3	0.90
chr11	7147636	7148880	CpG: 156	1244	156	870	25.1	69.9	1.03
chr11	7246819	7247097	CpG: 26	278	26	176	18.7	63.3	0.94
chr11	7285242	7285521	CpG: 22	279	22	171	15.8	61.3	0.85
chr11	7310235	7311713	CpG: 143	1478	143	1043	19.4	70.6	0.79
chr11	7425826	7426104	CpG: 23	278	23	168	16.5	60.4	0.92
chr11	7571683	7572856	CpG: 107	1173	107	819	18.2	69.8	0.76
chr11	7703119	7703355	CpG: 22	236	22	147	18.6	62.3	0.98
chr11	7731868	7732842	CpG: 105	974	105	675	21.6	69.3	0.90
chr11	7793002	7793244	CpG: 22	242	22	147	18.2	60.7	0.99
chr11	7940337	7940543	CpG: 17	206	17	118	16.5	57.3	1.01
chr11	8041433	8041647	CpG: 17	214	17	128	15.9	59.8	0.90
chr11	8066059	8066300	CpG: 18	241	18	128	14.9	53.1	1.11
chr11	8066497	8066877	CpG: 34	380	34	262	17.9	68.9	0.78
chr11	8098034	8099183	CpG: 134	1149	134	865	23.3	75.3	0.83
chr11	8132706	8133030	CpG: 27	324	27	188	16.7	58.0	0.99
chr11	8159969	8160838	CpG: 110	869	110	652	25.3	75.0	0.90
chr11	8207931	8208195	CpG: 19	264	19	164	14.4	62.1	0.76
chr11	8230454	8230689	CpG: 20	235	20	142	17.0	60.4	0.95
chr11	8249623	8250150	CpG: 55	527	55	349	20.9	66.2	0.95
chr11	8282225	8282499	CpG: 22	274	22	171	16.1	62.4	0.83
chr11	8287735	8287952	CpG: 18	217	18	141	16.6	65.0	0.79
chr11	8337156	8337430	CpG: 20	274	20	169	14.6	61.7	0.78
chr11	8343853	8344783	CpG: 117	930	117	682	25.2	73.3	0.95
chr11	8349285	8350075	CpG: 112	790	112	605	28.4	76.6	0.97
chr11	8506036	8506312	CpG: 25	276	25	172	18.1	62.3	0.94
chr11	8604425	8605289	CpG: 65	864	65	605	15.0	70.0	0.61
chr11	8675596	8676088	CpG: 55	492	55	360	22.4	73.2	0.84
chr11	8762909	8763139	CpG: 19	230	19	137	16.5	59.6	0.95
chr11	8763990	8764823	CpG: 72	833	72	543	17.3	65.2	0.81
chr11	8770574	8771018	CpG: 44	444	44	288	19.8	64.9	0.94
chr11	8812504	8812751	CpG: 20	247	20	163	16.2	66.0	0.74
chr11	8900066	8901692	CpG: 136	1626	136	1211	16.7	74.5	0.60
chr11	8943514	8943757	CpG: 21	243	21	149	17.3	61.3	0.95
chr11	8954671	8955393	CpG: 90	722	90	542	24.9	75.1	0.89
chr11	8995106	8996311	CpG: 100	1205	100	778	16.6	64.6	0.80
chr11	9020631	9020852	CpG: 16	221	16	128	14.5	57.9	0.88
chr11	9048105	9049160	CpG: 88	1055	88	732	16.7	69.4	0.70
chr11	9087755	9088975	CpG: 149	1220	149	900	24.4	73.8	0.90
chr11	9175690	9176685	CpG: 124	995	124	772	24.9	77.6	0.83
chr11	9347602	9347884	CpG: 23	282	23	176	16.3	62.4	0.84
chr11	9348213	9348691	CpG: 39	478	39	289	16.3	60.5	0.89
chr11	9349571	9350389	CpG: 113	818	113	625	27.6	76.4	0.96
chr11	9355305	9355512	CpG: 15	207	15	120	14.5	58.0	0.88
chr11	9391236	9391517	CpG: 21	281	21	166	14.9	59.1	0.86
chr11	9392641	9392864	CpG: 16	223	16	135	14.3	60.5	0.82
chr11	9394405	9394679	CpG: 25	274	25	173	18.2	63.1	0.93
chr11	9399287	9400091	CpG: 86	804	86	554	21.4	68.9	0.93
chr11	9419672	9419908	CpG: 18	236	18	142	15.3	60.2	0.88
chr11	9421417	9421628	CpG: 17	211	17	126	16.1	59.7	0.91
chr11	9449452	9449855	CpG: 54	403	54	297	26.8	73.7	1.00
chr11	9467278	9467514	CpG: 20	236	20	140	16.9	59.3	0.98
chr11	9469105	9469403	CpG: 24	298	24	167	16.1	56.0	1.03
chr11	9469698	9470292	CpG: 63	594	63	420	21.2	70.7	0.86
chr11	9489733	9490041	CpG: 23	308	23	173	14.9	56.2	0.95
chr11	9541627	9541864	CpG: 19	237	19	141	16.0	59.5	0.92
chr11	9544094	9544432	CpG: 24	338	24	188	14.2	55.6	0.92
chr11	9545691	9546734	CpG: 93	1043	93	677	17.8	64.9	0.85
chr11	9607677	9608051	CpG: 27	374	27	215	14.4	57.5	0.89
chr11	9630209	9630436	CpG: 18	227	18	135	15.9	59.5	0.90
chr11	9657019	9659209	CpG: 252	2190	252	1548	23.0	70.7	0.92
chr11	9697586	9698682	CpG: 78	1096	78	672	14.2	61.3	0.76
chr11	9707177	9707380	CpG: 17	203	17	143	16.7	70.4	0.70
chr11	9747261	9747507	CpG: 17	246	17	144	13.8	58.5	0.81
chr11	9748126	9748656	CpG: 50	530	50	383	18.9	72.3	0.74
chr11	9842755	9843633	CpG: 91	878	91	632	20.7	72.0	0.81
chr11	9906695	9906931	CpG: 17	236	17	142	14.4	60.2	0.82
chr11	9992781	9993013	CpG: 17	232	17	137	14.7	59.1	0.85
chr11	10042782	10043011	CpG: 18	229	18	143	15.7	62.4	0.82
chr11	10192932	10193206	CpG: 22	274	22	171	16.1	62.4	0.83
chr11	10217678	10217881	CpG: 15	203	15	142	14.8	70.0	0.64
chr11	10228126	10228358	CpG: 19	232	19	135	16.4	58.2	1.00
chr11	10336996	10337257	CpG: 19	261	19	156	14.6	59.8	0.83
chr11	10378237	10378891	CpG: 90	654	90	509	27.5	77.8	0.93
chr11	10379190	10379427	CpG: 23	237	23	170	19.4	71.7	0.75
chr11	10387230	10387785	CpG: 44	555	44	345	15.9	62.2	0.82
chr11	10389005	10389546	CpG: 43	541	43	375	15.9	69.3	0.67
chr11	10389969	10392787	CpG: 200	2818	200	1719	14.2	61.0	0.76
chr11	10527051	10527347	CpG: 26	296	26	184	17.6	62.2	0.93
chr11	10534953	10535809	CpG: 95	856	95	646	22.2	75.5	0.78
chr11	10554238	10554532	CpG: 25	294	25	179	17.0	60.9	0.93
chr11	10625189	10625906	CpG: 70	717	70	489	19.5	68.2	0.85
chr11	10700469	10701052	CpG: 42	583	42	316	14.4	54.2	0.99
chr11	10785346	10785629	CpG: 23	283	23	174	16.3	61.5	0.87
chr11	10814104	10814323	CpG: 16	219	16	132	14.6	60.3	0.81
chr11	10835860	10836456	CpG: 63	596	63	393	21.1	65.9	0.97
chr11	10892793	10894553	CpG: 148	1760	148	1149	16.8	65.3	0.79
chr11	10942535	10943886	CpG: 110	1351	110	838	16.3	62.0	0.85
chr11	10989097	10989320	CpG: 20	223	20	136	17.9	61.0	1.01
chr11	11015781	11016503	CpG: 86	722	86	541	23.8	74.9	0.86
chr11	11065329	11065560	CpG: 20	231	20	144	17.3	62.3	0.91
chr11	11118875	11119118	CpG: 20	243	20	149	16.5	61.3	0.89
chr11	11320455	11320729	CpG: 23	274	23	171	16.8	62.4	0.87
chr11	11332068	11334398	CpG: 159	2330	159	1512	13.6	64.9	0.71
chr11	11709488	11711471	CpG: 171	1983	171	1313	17.2	66.2	0.79
chr11	11901112	11901344	CpG: 16	232	16	135	13.8	58.2	0.84
chr11	11930884	11931630	CpG: 76	746	76	518	20.4	69.4	0.87
chr11	12100060	12101437	CpG: 142	1377	142	1007	20.6	73.1	0.81
chr11	12202123	12203326	CpG: 119	1203	119	859	19.8	71.4	0.78
chr11	12222873	12223154	CpG: 23	281	23	175	16.4	62.3	0.86
chr11	12404858	12405092	CpG: 17	234	17	138	14.5	59.0	0.86
chr11	12469404	12470302	CpG: 111	898	111	656	24.7	73.1	0.93
chr11	12766373	12767940	CpG: 223	1567	223	1189	28.5	75.9	0.99
chr11	12977850	12978056	CpG: 14	206	14	121	13.6	58.7	0.79
chr11	13014744	13014989	CpG: 20	245	20	150	16.3	61.2	0.88
chr11	13101360	13103836	CpG: 237	2476	237	1664	19.1	67.2	0.85
chr11	13185449	13185726	CpG: 22	277	22	167	15.9	60.3	0.89
chr11	13194039	13194314	CpG: 24	275	24	170	17.5	61.8	0.92
chr11	13206582	13206856	CpG: 23	274	23	170	16.8	62.0	0.88
chr11	13256492	13256768	CpG: 24	276	24	171	17.4	62.0	0.92
chr11	13369975	13371915	CpG: 206	1940	206	1385	21.2	71.4	0.84
chr11	13551817	13552049	CpG: 20	232	20	140	17.2	60.3	0.96
chr11	13555465	13556482	CpG: 82	1017	82	647	16.1	63.6	0.80
chr11	13760349	13761485	CpG: 135	1136	135	834	23.8	73.4	0.88
chr11	13883716	13883998	CpG: 22	282	22	174	15.6	61.7	0.84
chr11	13938857	13939130	CpG: 23	273	23	167	16.8	61.2	0.91
chr11	14055112	14057395	CpG: 204	2283	204	1527	17.9	66.9	0.80
chr11	14183896	14184285	CpG: 31	389	31	280	15.9	72.0	0.62
chr11	14206189	14206461	CpG: 23	272	23	169	16.9	62.1	0.89
chr11	14351727	14352150	CpG: 33	423	33	287	15.6	67.8	0.68
chr11	14414979	14415264	CpG: 23	285	23	177	16.1	62.1	0.85
chr11	14453545	14454618	CpG: 140	1073	140	819	26.1	76.3	0.90
chr11	14476334	14476820	CpG: 52	486	52	350	21.4	72.0	0.83
chr11	14594625	14595223	CpG: 48	598	48	393	16.1	65.7	0.76
chr11	14599061	14599290	CpG: 19	229	19	139	16.6	60.7	0.94
chr11	14615351	14615976	CpG: 52	625	52	388	16.6	62.1	0.87
chr11	14616742	14616995	CpG: 18	253	18	142	14.2	56.1	0.91
chr11	14738802	14740423	CpG: 166	1621	166	1131	20.5	69.8	0.84
chr11	14756765	14756981	CpG: 17	216	17	128	15.7	59.3	0.90
chr11	14811338	14811562	CpG: 19	224	19	134	17.0	59.8	0.95
chr11	14986974	14987212	CpG: 22	238	22	141	18.5	59.2	1.08
chr11	14987501	14988593	CpG: 90	1092	90	693	16.5	63.5	0.82
chr11	15001292	15002587	CpG: 96	1295	96	824	14.8	63.6	0.74
chr11	15068263	15068765	CpG: 36	502	36	310	14.3	61.8	0.78
chr11	15069939	15070719	CpG: 64	780	64	483	16.4	61.9	0.86
chr11	15169774	15170689	CpG: 68	915	68	572	14.9	62.5	0.76
chr11	15210923	15211410	CpG: 47	487	47	352	19.3	72.3	0.74
chr11	15287461	15287700	CpG: 18	239	18	144	15.1	60.3	0.84
chr11	15436120	15436398	CpG: 23	278	23	169	16.5	60.8	0.91
chr11	15641985	15642260	CpG: 23	275	23	171	16.7	62.2	0.88
chr11	15658724	15659302	CpG: 51	578	51	431	17.6	74.6	0.64
chr11	15748066	15748291	CpG: 25	225	25	165	22.2	73.3	0.85
chr11	16036274	16036496	CpG: 20	222	20	142	18.0	64.0	0.88
chr11	16039301	16039642	CpG: 32	341	32	236	18.8	69.2	0.79
chr11	16174714	16174999	CpG: 23	285	23	177	16.1	62.1	0.85
chr11	16299547	16299821	CpG: 24	274	24	171	17.5	62.4	0.91
chr11	16524488	16524762	CpG: 24	274	24	170	17.5	62.0	0.92
chr11	16547134	16547412	CpG: 22	278	22	171	15.8	61.5	0.84
chr11	16564468	16564747	CpG: 23	279	23	173	16.5	62.0	0.87
chr11	16701881	16705008	CpG: 227	3127	227	1854	14.5	59.3	0.83
chr11	16708336	16708553	CpG: 21	217	21	141	19.4	65.0	0.92
chr11	16710786	16711798	CpG: 78	1012	78	628	15.4	62.1	0.80
chr11	16835777	16836218	CpG: 36	441	36	269	16.3	61.0	0.88
chr11	17003845	17004854	CpG: 78	1009	78	718	15.5	71.2	0.61
chr11	17021999	17023005	CpG: 93	1006	93	679	18.5	67.5	0.82
chr11	17110469	17112031	CpG: 186	1562	186	1153	23.8	73.8	0.88
chr11	17175176	17175843	CpG: 56	667	56	414	16.8	62.1	0.89
chr11	17176577	17176834	CpG: 19	257	19	153	14.8	59.5	0.83
chr11	17177127	17177362	CpG: 19	235	19	139	16.2	59.1	0.94
chr11	17305129	17305951	CpG: 70	822	70	586	17.0	71.3	0.67
chr11	17373883	17374709	CpG: 81	826	81	586	19.6	70.9	0.79
chr11	17434180	17434410	CpG: 22	230	22	145	19.1	63.0	0.98
chr11	17449132	17451529	CpG: 181	2397	181	1412	15.1	58.9	0.87
chr11	17485505	17485745	CpG: 18	240	18	161	15.0	67.1	0.67
chr11	17486489	17487340	CpG: 96	851	96	633	22.6	74.4	0.84
chr11	17509548	17509778	CpG: 20	230	20	141	17.4	61.3	0.95
chr11	17573510	17574673	CpG: 110	1163	110	818	18.9	70.3	0.76
chr11	17641952	17642782	CpG: 62	830	62	518	14.9	62.4	0.77
chr11	17793397	17793903	CpG: 61	506	61	394	24.1	77.9	0.85
chr11	17816930	17819922	CpG: 249	2992	249	1936	16.6	64.7	0.80
chr11	17832216	17834446	CpG: 263	2230	263	1632	23.6	73.2	0.88
chr11	17869427	17870110	CpG: 51	683	51	412	14.9	60.3	0.82
chr11	17877177	17877428	CpG: 24	251	24	167	19.1	66.5	0.87
chr11	17981616	17982146	CpG: 37	530	37	338	14.0	63.8	0.70
chr11	18110213	18111352	CpG: 124	1139	124	816	21.8	71.6	0.85
chr11	18143790	18144002	CpG: 28	212	28	159	26.4	75.0	0.95
chr11	18201286	18201709	CpG: 48	423	48	296	22.7	70.0	0.93
chr11	18203342	18203623	CpG: 24	281	24	176	17.1	62.6	0.87
chr11	18216104	18217009	CpG: 69	905	69	624	15.2	69.0	0.64
chr11	18268846	18269179	CpG: 22	333	22	190	13.2	57.1	0.85
chr11	18284852	18285191	CpG: 25	339	25	193	14.7	56.9	0.92
chr11	18304580	18304867	CpG: 29	287	29	198	20.2	69.0	0.87
chr11	18371889	18372171	CpG: 27	282	27	208	19.1	73.8	0.71
chr11	18417614	18418453	CpG: 76	839	76	537	18.1	64.0	0.88
chr11	18486284	18486520	CpG: 20	236	20	145	16.9	61.4	0.91
chr11	18492506	18493264	CpG: 73	758	73	503	19.3	66.4	0.87
chr11	18494251	18494509	CpG: 31	258	31	171	24.0	66.3	1.10
chr11	18551970	18552184	CpG: 18	214	18	129	16.8	60.3	0.97
chr11	18553826	18554284	CpG: 39	458	39	299	17.0	65.3	0.80
chr11	18624564	18625133	CpG: 53	569	53	391	18.6	68.7	0.79
chr11	18686542	18686995	CpG: 38	453	38	304	16.8	67.1	0.77
chr11	18732367	18733038	CpG: 57	671	57	425	17.0	63.3	0.85
chr11	18733481	18733755	CpG: 23	274	23	169	16.8	61.7	0.89
chr11	18751259	18751493	CpG: 17	234	17	141	14.5	60.3	0.82
chr11	18796596	18797336	CpG: 94	740	94	556	25.4	75.1	0.90
chr11	18803835	18804242	CpG: 41	407	41	277	20.1	68.1	0.88
chr11	18819179	18820002	CpG: 59	823	59	534	14.3	64.9	0.69
chr11	18889065	18890572	CpG: 148	1507	148	1050	19.6	69.7	0.81
chr11	19209929	19210203	CpG: 23	274	23	171	16.8	62.4	0.87
chr11	19218942	19219210	CpG: 23	268	23	166	17.2	61.9	0.90
chr11	19237075	19237794	CpG: 59	719	59	509	16.4	70.8	0.70
chr11	19330643	19330874	CpG: 22	231	22	147	19.0	63.6	0.96
chr11	19360452	19360696	CpG: 18	244	18	140	14.8	57.4	0.92
chr11	19361013	19362937	CpG: 184	1924	184	1299	19.1	67.5	0.85
chr11	19380700	19381334	CpG: 45	634	45	366	14.2	57.7	0.86
chr11	19407500	19407776	CpG: 23	276	23	171	16.7	62.0	0.88
chr11	19433949	19434179	CpG: 20	230	20	141	17.4	61.3	0.94
chr11	19465155	19466736	CpG: 120	1581	120	1017	15.2	64.3	0.75
chr11	19653748	19654022	CpG: 24	274	24	171	17.5	62.4	0.91
chr11	19832843	19834244	CpG: 140	1401	140	951	20.0	67.9	0.87
chr11	19897433	19897845	CpG: 60	412	60	331	29.1	80.3	0.92
chr11	19956705	19956988	CpG: 24	283	24	178	17.0	62.9	0.88
chr11	20035248	20035529	CpG: 23	281	23	174	16.4	61.9	0.87
chr11	20252777	20253081	CpG: 21	304	21	190	13.8	62.5	0.71
chr11	20276693	20277909	CpG: 99	1216	99	800	16.3	65.8	0.76
chr11	20280281	20281406	CpG: 86	1125	86	688	15.3	61.2	0.82
chr11	20283652	20284579	CpG: 70	927	70	552	15.1	59.5	0.87
chr11	20484306	20484818	CpG: 55	512	55	381	21.5	74.4	0.78
chr11	20507890	20508916	CpG: 112	1026	112	720	21.8	70.2	0.89
chr11	20717458	20719181	CpG: 123	1723	123	1075	14.3	62.4	0.74
chr11	20721981	20722660	CpG: 68	679	68	475	20.0	70.0	0.82
chr11	20771498	20771772	CpG: 23	274	23	170	16.8	62.0	0.88
chr11	20789797	20791063	CpG: 134	1266	134	879	21.2	69.4	0.89
chr11	20917927	20918195	CpG: 19	268	19	159	14.2	59.3	0.83
chr11	20933318	20933591	CpG: 23	273	23	174	16.8	63.7	0.84
chr11	20983737	20984556	CpG: 64	819	64	571	15.6	69.7	0.64
chr11	21015544	21015819	CpG: 24	275	24	171	17.5	62.2	0.91
chr11	21873769	21874268	CpG: 44	499	44	362	17.6	72.5	0.67
chr11	21932787	21933064	CpG: 27	277	27	176	19.5	63.5	0.98
chr11	21997059	21997295	CpG: 20	236	20	145	16.9	61.4	0.92
chr11	22063696	22063970	CpG: 23	274	23	170	16.8	62.0	0.88
chr11	22272935	22273163	CpG: 17	228	17	134	14.9	58.8	0.89
chr11	22302329	22302603	CpG: 23	274	23	171	16.8	62.4	0.87
chr11	22313134	22314282	CpG: 89	1148	89	788	15.5	68.6	0.70
chr11	22405491	22405710	CpG: 19	219	19	130	17.4	59.4	0.99
chr11	22461891	22462406	CpG: 38	515	38	337	14.8	65.4	0.69
chr11	22503948	22504200	CpG: 20	252	20	162	15.9	64.3	0.79
chr11	22553473	22553691	CpG: 20	218	20	129	18.3	59.2	1.08
chr11	22605691	22605965	CpG: 25	274	25	171	18.2	62.4	0.95
chr11	22649589	22649948	CpG: 24	359	24	210	13.4	58.5	0.78
chr11	22745916	22746651	CpG: 61	735	61	468	16.6	63.7	0.82
chr11	22773233	22773593	CpG: 26	360	26	213	14.4	59.2	0.83
chr11	22787400	22787732	CpG: 31	332	31	240	18.7	72.3	0.72
chr11	22884913	22885158	CpG: 20	245	20	147	16.3	60.0	0.93
chr11	22910189	22910429	CpG: 20	240	20	142	16.7	59.2	0.98
chr11	22949881	22950708	CpG: 82	827	82	541	19.8	65.4	0.97
chr11	22956005	22956241	CpG: 20	236	20	142	16.9	60.2	0.96
chr11	23054122	23054403	CpG: 22	281	22	172	15.7	61.2	0.85
chr11	23080495	23080730	CpG: 19	235	19	142	16.2	60.4	0.90
chr11	23400321	23400557	CpG: 19	236	19	143	16.1	60.6	0.90
chr11	23424489	23424799	CpG: 24	310	24	189	15.5	61.0	0.84
chr11	23527213	23527430	CpG: 35	217	35	179	32.3	82.5	0.95
chr11	23529220	23529617	CpG: 27	397	27	260	13.6	65.5	0.63
chr11	23674382	23674656	CpG: 25	274	25	172	18.2	62.8	0.94
chr11	23753746	23753978	CpG: 21	232	21	144	18.1	62.1	0.95
chr11	23779529	23779752	CpG: 16	223	16	133	14.3	59.6	0.84
chr11	23854624	23855117	CpG: 39	493	39	311	15.8	63.1	0.80
chr11	24091231	24091509	CpG: 25	278	25	175	18.0	62.9	0.92
chr11	24136802	24137072	CpG: 22	270	22	166	16.3	61.5	0.87
chr11	24276625	24276896	CpG: 20	271	20	163	14.8	60.1	0.82
chr11	24452423	24452849	CpG: 34	426	34	257	16.0	60.3	0.88
chr11	24532684	24532957	CpG: 25	273	25	169	18.3	61.9	0.96
chr11	24547159	24547435	CpG: 22	276	22	198	15.9	71.7	0.62
chr11	24627739	24628253	CpG: 57	514	57	343	22.2	66.7	1.01
chr11	24956879	24957136	CpG: 21	257	21	155	16.3	60.3	0.91
chr11	25247082	25247363	CpG: 24	281	24	176	17.1	62.6	0.88
chr11	25248906	25249143	CpG: 21	237	21	148	17.7	62.4	0.93
chr11	25252954	25253228	CpG: 24	274	24	171	17.5	62.4	0.91
chr11	25723012	25723285	CpG: 23	273	23	170	16.8	62.3	0.89
chr11	25772282	25772563	CpG: 23	281	23	175	16.4	62.3	0.86
chr11	25947066	25947297	CpG: 16	231	16	133	13.9	57.6	0.86
chr11	26310151	26310436	CpG: 25	285	25	180	17.5	63.2	0.90
chr11	26446865	26447150	CpG: 20	285	20	165	14.0	57.9	0.85
chr11	26472859	26473134	CpG: 30	275	30	188	21.8	68.4	0.93
chr11	26490481	26490721	CpG: 20	240	20	148	16.7	61.7	0.89
chr11	26582030	26582304	CpG: 22	274	22	169	16.1	61.7	0.85
chr11	26662724	26662994	CpG: 20	270	20	165	14.8	61.1	0.81
chr11	26764504	26764708	CpG: 16	204	16	119	15.7	58.3	0.93
chr11	27105657	27106052	CpG: 33	395	33	243	16.7	61.5	0.89
chr11	27360323	27360624	CpG: 26	301	26	188	17.3	62.5	0.89
chr11	27426868	27427152	CpG: 23	284	23	176	16.2	62.0	0.86
chr11	27503316	27503827	CpG: 49	511	49	344	19.2	67.3	0.85
chr11	27612181	27613296	CpG: 123	1115	123	820	22.1	73.5	0.82
chr11	27645519	27645759	CpG: 17	240	17	143	14.2	59.6	0.81
chr11	27646786	27647440	CpG: 51	654	51	407	15.6	62.2	0.81
chr11	27840542	27841517	CpG: 108	975	108	688	22.2	70.6	0.90
chr11	27859528	27860120	CpG: 57	592	57	407	19.3	68.8	0.82
chr11	27860943	27861157	CpG: 14	214	14	121	13.1	56.5	0.84
chr11	27862355	27863447	CpG: 81	1092	81	661	14.8	60.5	0.83
chr11	27908450	27908679	CpG: 19	229	19	136	16.6	59.4	0.95
chr11	27916077	27916355	CpG: 22	278	22	171	15.8	61.5	0.85
chr11	28248849	28249101	CpG: 28	252	28	172	22.2	68.3	0.96
chr11	28250980	28251338	CpG: 25	358	25	194	14.0	54.2	0.95
chr11	28354392	28354597	CpG: 14	205	14	115	13.7	56.1	0.88
chr11	28408604	28408878	CpG: 21	274	21	167	15.3	60.9	0.83
chr11	28494318	28494603	CpG: 24	285	24	179	16.8	62.8	0.87
chr11	28642488	28642730	CpG: 18	242	18	145	14.9	59.9	0.85
chr11	29039441	29039651	CpG: 16	210	16	127	15.2	60.5	0.85
chr11	29734993	29735382	CpG: 32	389	32	281	16.5	72.2	0.63
chr11	29861780	29862061	CpG: 26	281	26	176	18.5	62.6	0.96
chr11	30134640	30134914	CpG: 24	274	24	171	17.5	62.4	0.91
chr11	30150221	30150493	CpG: 25	272	25	160	18.4	58.8	1.07
chr11	30151069	30151370	CpG: 38	301	38	221	25.2	73.4	0.94
chr11	30151481	30151695	CpG: 16	214	16	148	15.0	69.2	0.63
chr11	30152618	30152844	CpG: 17	226	17	140	15.0	61.9	0.80
chr11	30160708	30160945	CpG: 21	237	21	145	17.7	61.2	0.97
chr11	30457290	30457700	CpG: 37	410	37	283	18.0	69.0	0.78
chr11	30593197	30593429	CpG: 20	232	20	141	17.2	60.8	0.94
chr11	30627432	30627665	CpG: 23	233	23	146	19.7	62.7	1.02
chr11	30718266	30718508	CpG: 17	242	17	149	14.0	61.6	0.74
chr11	30718714	30720838	CpG: 191	2124	191	1419	18.0	66.8	0.81
chr11	31090122	31090348	CpG: 17	226	17	132	15.0	58.4	0.90
chr11	31457065	31457492	CpG: 30	427	30	253	14.1	59.3	0.80
chr11	31505377	31505788	CpG: 37	411	37	245	18.0	59.6	1.08
chr11	31645422	31645792	CpG: 33	370	33	224	17.8	60.5	0.99
chr11	31669278	31669525	CpG: 17	247	17	139	13.8	56.3	0.89
chr11	31934317	31935673	CpG: 98	1356	98	820	14.5	60.5	0.79
chr11	31940001	31942180	CpG: 145	2179	145	1364	13.3	62.6	0.68
chr11	31945879	31954071	CpG: 530	8192	530	5014	12.9	61.2	0.69
chr11	31955574	31956262	CpG: 54	688	54	456	15.7	66.3	0.71
chr11	31961393	31962219	CpG: 58	826	58	543	14.0	65.7	0.65
chr11	31962748	31963090	CpG: 42	342	42	257	24.6	75.1	0.87
chr11	32030986	32031264	CpG: 24	278	24	173	17.3	62.2	0.90
chr11	32123130	32123516	CpG: 56	386	56	285	29.0	73.8	1.07
chr11	32226720	32227603	CpG: 113	883	113	666	25.6	75.4	0.90
chr11	32227805	32228153	CpG: 25	348	25	210	14.4	60.3	0.80
chr11	32363935	32364165	CpG: 19	230	19	141	16.5	61.3	0.89
chr11	32384812	32385039	CpG: 21	227	21	139	18.5	61.2	1.03
chr11	32443817	32444095	CpG: 19	278	19	166	13.7	59.7	0.79
chr11	32468705	32469429	CpG: 63	724	63	472	17.4	65.2	0.82
chr11	32474278	32474548	CpG: 21	270	21	166	15.6	61.5	0.83
chr11	32562204	32563687	CpG: 102	1483	102	948	13.8	63.9	0.68
chr11	32566083	32566647	CpG: 53	564	53	386	18.8	68.4	0.80
chr11	32568813	32571250	CpG: 198	2437	198	1557	16.2	63.9	0.80
chr11	32573361	32573817	CpG: 33	456	33	289	14.5	63.4	0.72
chr11	32574525	32574943	CpG: 41	418	41	282	19.6	67.5	0.87
chr11	32719151	32720195	CpG: 98	1044	98	638	18.8	61.1	1.01
chr11	32742613	32742887	CpG: 23	274	23	170	16.8	62.0	0.88
chr11	32964896	32965687	CpG: 91	791	91	571	23.0	72.2	0.89
chr11	33005762	33006043	CpG: 24	281	24	175	17.1	62.3	0.90
chr11	33028027	33029558	CpG: 183	1531	183	1144	23.9	74.7	0.86
chr11	33151217	33151955	CpG: 87	738	87	526	23.6	71.3	0.93
chr11	33174318	33175873	CpG: 147	1555	147	995	18.9	64.0	0.92
chr11	33231088	33231365	CpG: 23	277	23	176	16.6	63.5	0.83
chr11	33296976	33297253	CpG: 24	277	24	175	17.3	63.2	0.87
chr11	33354359	33354621	CpG: 18	262	18	161	13.7	61.5	0.74
chr11	33369522	33369788	CpG: 26	266	26	170	19.5	63.9	0.97
chr11	33378550	33379481	CpG: 70	931	70	642	15.0	69.0	0.64
chr11	33392550	33394062	CpG: 174	1512	174	1107	23.0	73.2	0.86
chr11	33511418	33512420	CpG: 154	1002	154	803	30.7	80.1	0.96
chr11	33542939	33543169	CpG: 19	230	19	137	16.5	59.6	0.95
chr11	33576023	33576298	CpG: 23	275	23	169	16.7	61.5	0.89
chr11	33595549	33595828	CpG: 23	279	23	174	16.5	62.4	0.86
chr11	33837179	33838066	CpG: 93	887	93	645	21.0	72.7	0.80
chr11	33872458	33873589	CpG: 93	1131	93	707	16.4	62.5	0.85
chr11	33910855	33911782	CpG: 80	927	80	636	17.3	68.6	0.74
chr11	33965968	33966487	CpG: 49	519	49	373	18.9	71.9	0.74
chr11	33973649	33973965	CpG: 25	316	25	189	15.8	59.8	0.91
chr11	34005856	34007613	CpG: 174	1757	174	1195	19.8	68.0	0.86
chr11	34108914	34109191	CpG: 21	277	21	168	15.2	60.6	0.84
chr11	34127227	34127613	CpG: 33	386	33	279	17.1	72.3	0.66
chr11	34130976	34131249	CpG: 23	273	23	172	16.8	63.0	0.86
chr11	34188467	34190186	CpG: 188	1719	188	1203	21.9	70.0	0.90
chr11	34224367	34224641	CpG: 23	274	23	169	16.8	61.7	0.90
chr11	34242283	34243028	CpG: 60	745	60	447	16.1	60.0	0.90
chr11	34311069	34311715	CpG: 45	646	45	407	13.9	63.0	0.70
chr11	34410590	34410871	CpG: 23	281	23	174	16.4	61.9	0.87
chr11	34493418	34495182	CpG: 173	1764	173	1208	19.6	68.5	0.84
chr11	34495677	34495899	CpG: 23	222	23	154	20.7	69.4	0.87
chr11	34575457	34576149	CpG: 60	692	60	471	17.3	68.1	0.75
chr11	34692647	34692887	CpG: 20	240	20	148	16.7	61.7	0.89
chr11	34830506	34830749	CpG: 20	243	20	145	16.5	59.7	0.93
chr11	34999271	34999505	CpG: 19	234	19	140	16.2	59.8	0.93
chr11	35053721	35054765	CpG: 94	1044	94	704	18.0	67.4	0.79
chr11	35089086	35089325	CpG: 18	239	18	142	15.1	59.4	0.89
chr11	35276891	35277516	CpG: 53	625	53	425	17.0	68.0	0.74
chr11	35557659	35559167	CpG: 155	1508	155	1036	20.6	68.7	0.87
chr11	35633219	35633455	CpG: 17	236	17	140	14.4	59.3	0.85
chr11	35664376	35664633	CpG: 19	257	19	179	14.8	69.6	0.61
chr11	35742634	35742908	CpG: 25	274	25	165	18.2	60.2	1.01
chr11	35756846	35758702	CpG: 227	1856	227	1372	24.5	73.9	0.90
chr11	35801520	35802118	CpG: 77	598	77	444	25.8	74.2	0.96
chr11	36069782	36070016	CpG: 19	234	19	136	16.2	58.1	1.00
chr11	36082544	36083598	CpG: 119	1054	119	749	22.6	71.1	0.91
chr11	36177714	36177950	CpG: 20	236	20	144	16.9	61.0	0.92
chr11	36395215	36395490	CpG: 24	275	24	173	17.5	62.9	0.89
chr11	36518834	36520306	CpG: 125	1472	125	957	17.0	65.0	0.82
chr11	36531175	36531461	CpG: 22	286	22	172	15.4	60.1	0.85
chr11	36652788	36653638	CpG: 82	850	82	597	19.3	70.2	0.81
chr11	36659514	36659793	CpG: 23	279	23	172	16.5	61.6	0.88
chr11	36700366	36700793	CpG: 33	427	33	258	15.5	60.4	0.85
chr11	36837715	36837947	CpG: 17	232	17	136	14.7	58.6	0.86
chr11	36945080	36945316	CpG: 20	236	20	144	16.9	61.0	0.92
chr11	37018566	37018849	CpG: 23	283	23	174	16.3	61.5	0.87
chr11	37082389	37082630	CpG: 19	241	19	149	15.8	61.8	0.85
chr11	37147044	37147274	CpG: 20	230	20	141	17.4	61.3	0.94
chr11	37389670	37389917	CpG: 19	247	19	147	15.4	59.5	0.87
chr11	37827985	37828262	CpG: 23	277	23	171	16.6	61.7	0.88
chr11	38085146	38085381	CpG: 21	235	21	142	17.9	60.4	1.00
chr11	38169065	38169339	CpG: 23	274	23	171	16.8	62.4	0.87
chr11	38222644	38222919	CpG: 24	275	24	173	17.5	62.9	0.89
chr11	38481532	38481774	CpG: 21	242	21	150	17.4	62.0	0.92
chr11	38778806	38779074	CpG: 23	268	23	168	17.2	62.7	0.89
chr11	38923977	38924251	CpG: 24	274	24	170	17.5	62.0	0.92
chr11	39169035	39169318	CpG: 23	283	23	174	16.3	61.5	0.87
chr11	39240494	39240779	CpG: 25	285	25	178	17.5	62.5	0.92
chr11	39308289	39308575	CpG: 27	286	27	189	18.9	66.1	0.87
chr11	39363762	39364041	CpG: 23	279	23	174	16.5	62.4	0.86
chr11	39439131	39439367	CpG: 20	236	20	141	16.9	59.7	0.97
chr11	39458416	39458662	CpG: 19	246	19	177	15.4	72.0	0.60
chr11	39517087	39517324	CpG: 23	237	23	143	19.4	60.3	1.09
chr11	39785380	39785640	CpG: 18	260	18	151	13.8	58.1	0.84
chr11	39800364	39800570	CpG: 15	206	15	120	14.6	58.3	0.86
chr11	39918544	39918822	CpG: 22	278	22	169	15.8	60.8	0.86
chr11	40049630	40049860	CpG: 19	230	19	138	16.5	60.0	0.93
chr11	40100233	40100507	CpG: 25	274	25	172	18.2	62.8	0.94
chr11	40105335	40105613	CpG: 20	278	20	169	14.4	60.8	0.79
chr11	40569969	40570243	CpG: 24	274	24	172	17.5	62.8	0.90
chr11	40619065	40619339	CpG: 24	274	24	171	17.5	62.4	0.91
chr11	40701633	40701888	CpG: 23	255	23	159	18.0	62.4	0.94
chr11	40775085	40775356	CpG: 21	271	21	168	15.5	62.0	0.82
chr11	41269836	41270110	CpG: 23	274	23	170	16.8	62.0	0.88
chr11	41295772	41296051	CpG: 23	279	23	173	16.5	62.0	0.87
chr11	41947427	41947709	CpG: 23	282	23	175	16.3	62.1	0.86
chr11	42281410	42281684	CpG: 24	274	24	171	17.5	62.4	0.91
chr11	42581668	42582024	CpG: 25	356	25	206	14.0	57.9	0.84
chr11	43112268	43112490	CpG: 16	222	16	130	14.4	58.6	0.87
chr11	43467324	43467773	CpG: 49	449	49	306	21.8	68.2	0.95
chr11	43507052	43507525	CpG: 36	473	36	288	15.2	60.9	0.83
chr11	43514116	43514915	CpG: 71	799	71	530	17.8	66.3	0.81
chr11	43616460	43616745	CpG: 25	285	25	179	17.5	62.8	0.91
chr11	43677669	43677920	CpG: 20	251	20	153	15.9	61.0	0.87
chr11	43702755	43703692	CpG: 94	937	94	688	20.1	73.4	0.75
chr11	43730806	43731152	CpG: 28	346	28	231	16.2	66.8	0.73
chr11	43734528	43735270	CpG: 85	742	85	512	22.9	69.0	0.98
chr11	43736361	43737031	CpG: 61	670	61	434	18.2	64.8	0.87
chr11	43835494	43836412	CpG: 80	918	80	574	17.4	62.5	0.89
chr11	43858662	43858898	CpG: 21	236	21	145	17.8	61.4	0.96
chr11	43912767	43913048	CpG: 24	281	24	175	17.1	62.3	0.90
chr11	43983580	43983854	CpG: 23	274	23	169	16.8	61.7	0.89
chr11	44011329	44011603	CpG: 23	274	23	170	16.8	62.0	0.88
chr11	44036083	44036357	CpG: 27	274	27	184	19.7	67.2	0.90
chr11	44097426	44099848	CpG: 262	2422	262	1683	21.6	69.5	0.90
chr11	44221301	44221948	CpG: 63	647	63	430	19.5	66.5	0.89
chr11	44250914	44251791	CpG: 90	877	90	634	20.5	72.3	0.79
chr11	44320269	44320543	CpG: 24	274	24	172	17.5	62.8	0.90
chr11	44369507	44369748	CpG: 18	241	18	144	14.9	59.8	0.87
chr11	44371225	44371506	CpG: 23	281	23	171	16.4	60.9	0.90
chr11	44458635	44458847	CpG: 19	212	19	141	17.9	66.5	0.84
chr11	44459417	44460277	CpG: 71	860	71	543	16.5	63.1	0.83
chr11	44461000	44461692	CpG: 55	692	55	442	15.9	63.9	0.78
chr11	44464302	44465537	CpG: 130	1235	130	861	21.1	69.7	0.87
chr11	44466089	44467014	CpG: 63	925	63	563	13.6	60.9	0.74
chr11	44471329	44472574	CpG: 107	1245	107	808	17.2	64.9	0.82
chr11	44475056	44475548	CpG: 45	492	45	322	18.3	65.4	0.86
chr11	44654881	44655162	CpG: 24	281	24	167	17.1	59.4	0.98
chr11	44675359	44675792	CpG: 35	433	35	289	16.2	66.7	0.74
chr11	44721068	44721870	CpG: 73	802	73	575	18.2	71.7	0.75
chr11	44883394	44885104	CpG: 179	1710	179	1265	20.9	74.0	0.78
chr11	45106492	45108124	CpG: 178	1632	178	1217	21.8	74.6	0.79
chr11	45114054	45114469	CpG: 35	415	35	265	16.9	63.9	0.83
chr11	45304008	45305071	CpG: 153	1063	153	787	28.8	74.0	1.06
chr11	45337753	45338698	CpG: 110	945	110	746	23.3	78.9	0.75
chr11	45352146	45352420	CpG: 24	274	24	171	17.5	62.4	0.91
chr11	45370207	45370413	CpG: 15	206	15	138	14.6	67.0	0.66
chr11	45443418	45443952	CpG: 52	534	52	389	19.5	72.8	0.74
chr11	45474319	45474593	CpG: 25	274	25	172	18.2	62.8	0.94
chr11	45512889	45513201	CpG: 25	312	25	199	16.0	63.8	0.79
chr11	45805355	45806570	CpG: 116	1215	116	816	19.1	67.2	0.85
chr11	45820318	45821653	CpG: 169	1335	169	1035	25.3	77.5	0.85
chr11	45959391	45959622	CpG: 17	231	17	134	14.7	58.0	0.89
chr11	45960030	45961409	CpG: 129	1379	129	979	18.7	71.0	0.75
chr11	45970889	45971162	CpG: 21	273	21	167	15.4	61.2	0.84
chr11	45996873	45997089	CpG: 18	216	18	129	16.7	59.7	0.96
chr11	46003117	46003825	CpG: 72	708	72	498	20.3	70.3	0.83
chr11	46041391	46042194	CpG: 95	803	95	601	23.7	74.8	0.85
chr11	46055766	46056546	CpG: 101	780	101	600	25.9	76.9	0.88
chr11	46058359	46059106	CpG: 52	747	52	498	13.9	66.7	0.64
chr11	46073672	46074855	CpG: 81	1183	81	736	13.7	62.2	0.71
chr11	46077889	46079909	CpG: 182	2020	182	1444	18.0	71.5	0.71
chr11	46170698	46170972	CpG: 24	274	24	171	17.5	62.4	0.91
chr11	46173972	46174246	CpG: 23	274	23	169	16.8	61.7	0.90
chr11	46275817	46276500	CpG: 65	683	65	462	19.0	67.6	0.84
chr11	46277434	46278152	CpG: 106	718	106	560	29.5	78.0	0.97
chr11	46299101	46299302	CpG: 15	201	15	135	14.9	67.2	0.66
chr11	46375919	46376185	CpG: 21	266	21	160	15.8	60.2	0.89
chr11	46387234	46387507	CpG: 19	273	19	165	13.9	60.4	0.77
chr11	46393786	46395467	CpG: 153	1681	153	1104	18.2	65.7	0.85
chr11	46399495	46399857	CpG: 32	362	32	233	17.7	64.4	0.85
chr11	46433946	46434750	CpG: 69	804	69	556	17.2	69.2	0.72
chr11	46451398	46452008	CpG: 56	610	56	425	18.4	69.7	0.76
chr11	46488616	46489715	CpG: 124	1099	124	802	22.6	73.0	0.85
chr11	46501402	46501627	CpG: 17	225	17	158	15.1	70.2	0.62
chr11	46503176	46504186	CpG: 133	1010	133	764	26.3	75.6	0.94
chr11	46522431	46523061	CpG: 48	630	48	451	15.2	71.6	0.61
chr11	46523600	46523904	CpG: 21	304	21	201	13.8	66.1	0.69
chr11	46531509	46531727	CpG: 22	218	22	153	20.2	70.2	0.82
chr11	46536394	46538665	CpG: 209	2271	209	1640	18.4	72.2	0.71
chr11	46541429	46541966	CpG: 41	537	41	357	15.3	66.5	0.70
chr11	46545446	46549212	CpG: 364	3766	364	2666	19.3	70.8	0.77
chr11	46749706	46750173	CpG: 45	467	45	310	19.3	66.4	0.88
chr11	46752127	46752576	CpG: 32	449	32	262	14.3	58.4	0.86
chr11	46773125	46773975	CpG: 76	850	76	521	17.9	61.3	0.96
chr11	46856445	46856894	CpG: 34	449	34	286	15.1	63.7	0.84
chr11	46861199	46861491	CpG: 25	292	25	199	17.1	68.2	0.75
chr11	46978367	46978602	CpG: 17	235	17	141	14.5	60.0	0.84
chr11	47002522	47003405	CpG: 93	883	93	602	21.1	68.2	0.91
chr11	47066163	47066456	CpG: 25	293	25	181	17.1	61.8	0.92
chr11	47074675	47075616	CpG: 118	941	118	713	25.1	75.8	0.89
chr11	47093488	47093847	CpG: 26	359	26	230	14.5	64.1	0.73
chr11	47094459	47094701	CpG: 20	242	20	148	16.5	61.2	0.89
chr11	47121210	47121442	CpG: 18	232	18	138	15.5	59.5	0.89
chr11	47153195	47153424	CpG: 17	229	17	135	14.8	59.0	0.87
chr11	47333230	47334088	CpG: 93	858	93	583	21.7	67.9	0.94
chr11	47342391	47344379	CpG: 178	1988	178	1358	17.9	68.3	0.77
chr11	47371146	47371395	CpG: 20	249	20	150	16.1	60.2	0.90
chr11	47371604	47372133	CpG: 36	529	36	344	13.6	65.0	0.65
chr11	47376573	47376792	CpG: 16	219	16	130	14.6	59.4	0.85
chr11	47405441	47405840	CpG: 36	399	36	254	18.0	63.7	0.90
chr11	47426292	47427390	CpG: 118	1098	118	813	21.5	74.0	0.80
chr11	47439934	47440170	CpG: 17	236	17	141	14.4	59.7	0.83
chr11	47495221	47495484	CpG: 19	263	19	168	14.4	63.9	0.71
chr11	47511794	47512624	CpG: 70	830	70	586	16.9	70.6	0.68
chr11	47537055	47537273	CpG: 16	218	16	151	14.7	69.3	0.63
chr11	47553664	47553905	CpG: 19	241	19	167	15.8	69.3	0.69
chr11	47558997	47559320	CpG: 32	323	32	250	19.8	77.4	0.66
chr11	47567085	47567872	CpG: 104	787	104	607	26.4	77.1	0.91
chr11	47585050	47586155	CpG: 86	1105	86	651	15.6	58.9	0.90
chr11	47587251	47587525	CpG: 24	274	24	173	17.5	63.1	0.89
chr11	47587951	47588240	CpG: 21	289	21	170	14.5	58.8	0.84
chr11	47712158	47713146	CpG: 104	988	104	706	21.1	71.5	0.83
chr11	47717308	47717923	CpG: 51	615	51	372	16.6	60.5	0.91
chr11	47725722	47726481	CpG: 87	759	87	560	22.9	73.8	0.84
chr11	47738999	47739797	CpG: 69	798	69	525	17.3	65.8	0.81
chr11	47749982	47751282	CpG: 176	1300	176	937	27.1	72.1	1.05
chr11	47754554	47754899	CpG: 38	345	38	261	22.0	75.7	0.88
chr11	47763116	47763351	CpG: 16	235	16	139	13.6	59.1	0.80
chr11	47806985	47807739	CpG: 81	754	81	530	21.5	70.3	0.88
chr11	47841528	47841789	CpG: 20	261	20	159	15.3	60.9	0.83
chr11	47862642	47862854	CpG: 17	212	17	122	16.0	57.5	0.99
chr11	47880195	47880562	CpG: 34	367	34	244	18.5	66.5	0.84
chr11	47931613	47932435	CpG: 96	822	96	577	23.4	70.2	0.95
chr11	48013184	48013747	CpG: 58	563	58	375	20.6	66.6	0.94
chr11	48057772	48058566	CpG: 63	794	63	553	15.9	69.6	0.66
chr11	48062305	48063045	CpG: 55	740	55	515	14.9	69.6	0.61
chr11	48100747	48100984	CpG: 22	237	22	146	18.6	61.6	1.01
chr11	48112968	48113242	CpG: 18	274	18	162	13.1	59.1	0.76
chr11	48149615	48151181	CpG: 196	1566	196	1200	25.0	76.6	0.87
chr11	48268086	48268359	CpG: 23	273	23	168	16.8	61.5	0.90
chr11	48478372	48478608	CpG: 17	236	17	143	14.4	60.6	0.80
chr11	48594870	48595121	CpG: 24	251	24	160	19.1	63.7	0.96
chr11	49022272	49022496	CpG: 19	224	19	131	17.0	58.5	0.99
chr11	49068068	49069085	CpG: 83	1017	83	707	16.3	69.5	0.68
chr11	49145064	49145373	CpG: 25	309	25	210	16.2	68.0	0.70
chr11	49179655	49179935	CpG: 21	280	21	171	15.0	61.1	0.82
chr11	49212569	49212804	CpG: 18	235	18	144	15.3	61.3	0.86
chr11	49225317	49226319	CpG: 83	1002	83	695	16.6	69.4	0.69
chr11	49227034	49227361	CpG: 35	327	35	226	21.4	69.1	0.90
chr11	49279564	49279773	CpG: 17	209	17	151	16.3	72.2	0.65
chr11	49385303	49385626	CpG: 38	323	38	228	23.5	70.6	0.96
chr11	49438290	49438573	CpG: 26	283	26	178	18.4	62.9	0.94
chr11	49611630	49611906	CpG: 48	276	48	216	34.8	78.3	1.14
chr11	49657657	49657935	CpG: 25	278	25	175	18.0	62.9	0.92
chr11	49735622	49735969	CpG: 37	347	37	238	21.3	68.6	0.92
chr11	49839685	49839960	CpG: 21	275	21	169	15.3	61.5	0.82
chr11	49995061	49995349	CpG: 25	288	25	195	17.4	67.7	0.77
chr11	50027840	50028254	CpG: 33	414	33	277	15.9	66.9	0.71
chr11	50028891	50029926	CpG: 88	1035	88	724	17.0	70.0	0.70
chr11	50069084	50070100	CpG: 85	1016	85	714	16.7	70.3	0.68
chr11	50070708	50071137	CpG: 33	429	33	291	15.4	67.8	0.67
chr11	50357299	50358205	CpG: 83	906	83	586	18.3	64.7	0.88
chr11	50376848	50377062	CpG: 19	214	19	137	17.8	64.0	0.93
chr11	50387743	50388038	CpG: 25	295	25	214	16.9	72.5	0.65
chr11	50416268	50416541	CpG: 26	273	26	170	19.0	62.3	0.99
chr11	55375067	55375307	CpG: 21	240	21	145	17.5	60.4	0.98
chr11	55548380	55548653	CpG: 20	273	20	164	14.7	60.1	0.82
chr11	55659813	55660095	CpG: 25	282	25	177	17.7	62.8	0.91
chr11	55810901	55811919	CpG: 93	1018	93	714	18.3	70.1	0.75
chr11	55812544	55812954	CpG: 33	410	33	274	16.1	66.8	0.72
chr11	55838252	55838530	CpG: 24	278	24	174	17.3	62.6	0.89
chr11	56081997	56082375	CpG: 34	378	34	277	18.0	73.3	0.67
chr11	56167853	56168090	CpG: 16	237	16	139	13.5	58.6	0.81
chr11	56578491	56578765	CpG: 24	274	24	171	17.5	62.4	0.91
chr11	56695122	56695396	CpG: 22	274	22	169	16.1	61.7	0.85
chr11	56910167	56910400	CpG: 18	233	18	136	15.5	58.4	0.92
chr11	57129913	57130151	CpG: 19	238	19	158	16.0	66.4	0.88
chr11	57273631	57274848	CpG: 117	1217	117	860	19.2	70.7	0.77
chr11	57284858	57285447	CpG: 66	589	66	428	22.4	72.7	0.85
chr11	57299332	57299592	CpG: 20	260	20	170	15.4	65.4	0.73
chr11	57299849	57300069	CpG: 17	220	17	130	15.5	59.1	0.90
chr11	57377034	57377344	CpG: 36	310	36	235	23.2	75.8	0.89
chr11	57408495	57411449	CpG: 228	2954	228	1944	15.4	65.8	0.71
chr11	57415055	57415315	CpG: 26	260	26	167	20.0	64.2	0.98
chr11	57416277	57416516	CpG: 17	239	17	137	14.2	57.3	0.89
chr11	57426426	57427208	CpG: 94	782	94	581	24.0	74.3	0.88
chr11	57432680	57433582	CpG: 76	902	76	629	16.9	69.7	0.71
chr11	57449725	57449931	CpG: 21	206	21	153	20.4	74.3	0.76
chr11	57464376	57466010	CpG: 139	1634	139	1100	17.0	67.3	0.75
chr11	57480886	57481311	CpG: 35	425	35	246	16.5	57.9	0.99
chr11	57510844	57511084	CpG: 18	240	18	143	15.0	59.6	0.88
chr11	57517661	57518517	CpG: 97	856	97	610	22.7	71.3	0.90
chr11	57597086	57597365	CpG: 20	279	20	186	14.3	66.7	0.70
chr11	57607638	57607963	CpG: 36	325	36	211	22.2	64.9	1.09
chr11	57617243	57617489	CpG: 21	246	21	166	17.1	67.5	0.78
chr11	57617904	57618846	CpG: 123	942	123	666	26.1	70.7	1.05
chr11	57661555	57661823	CpG: 19	268	19	157	14.2	58.6	0.83
chr11	57662191	57663012	CpG: 67	821	67	477	16.3	58.1	0.97
chr11	57691588	57692427	CpG: 72	839	72	546	17.2	65.1	0.81
chr11	57703192	57703613	CpG: 36	421	36	276	17.1	65.6	0.80
chr11	57894082	57894752	CpG: 46	670	46	448	13.7	66.9	0.62
chr11	58144836	58145117	CpG: 23	281	23	175	16.4	62.3	0.86
chr11	58178359	58178640	CpG: 24	281	24	174	17.1	61.9	0.90
chr11	58184112	58184345	CpG: 17	233	17	138	14.6	59.2	0.85
chr11	58417432	58417654	CpG: 20	222	20	137	18.0	61.7	0.96
chr11	58527705	58529355	CpG: 154	1650	154	1081	18.7	65.5	0.87
chr11	58780250	58780543	CpG: 23	293	23	193	15.7	65.9	0.74
chr11	58854879	58855316	CpG: 39	437	39	292	17.8	66.8	0.80
chr11	58913352	58913576	CpG: 19	224	19	135	17.0	60.3	0.94
chr11	59011765	59012441	CpG: 49	676	49	429	14.5	63.5	0.72
chr11	59051506	59051777	CpG: 21	271	21	166	15.5	61.3	0.83
chr11	59055590	59056187	CpG: 49	597	49	390	16.4	65.3	0.77
chr11	59091828	59092285	CpG: 36	457	36	295	15.8	64.6	0.77
chr11	59120748	59122010	CpG: 130	1262	130	887	20.6	70.3	0.86
chr11	59122532	59122754	CpG: 17	222	17	145	15.3	65.3	0.77
chr11	59419124	59419360	CpG: 20	236	20	143	16.9	60.6	0.94
chr11	59508422	59508825	CpG: 27	403	27	221	13.4	54.8	0.90
chr11	59510332	59510578	CpG: 20	246	20	144	16.3	58.5	0.97
chr11	59511587	59511957	CpG: 34	370	34	224	18.4	60.5	1.02
chr11	59512360	59512624	CpG: 21	264	21	157	15.9	59.5	0.90
chr11	59516730	59517014	CpG: 29	284	29	187	20.4	65.8	0.94
chr11	59536072	59536531	CpG: 41	459	41	335	17.9	73.0	0.67
chr11	59566137	59566860	CpG: 86	723	86	523	23.8	72.3	0.92
chr11	59582256	59582538	CpG: 22	282	22	176	15.6	62.4	0.82
chr11	59620046	59621077	CpG: 100	1031	100	674	19.4	65.4	0.91
chr11	59650457	59651260	CpG: 63	803	63	560	15.7	69.7	0.65
chr11	59704939	59705172	CpG: 19	233	19	130	16.3	55.8	1.05
chr11	59706238	59707116	CpG: 90	878	90	620	20.5	70.6	0.82
chr11	59761541	59762197	CpG: 54	656	54	412	16.5	62.8	0.84
chr11	59775567	59775838	CpG: 20	271	20	166	14.8	61.3	0.80
chr11	59849407	59849685	CpG: 31	278	31	196	22.3	70.5	0.90
chr11	59970721	59970968	CpG: 19	247	19	139	15.4	56.3	1.02
chr11	59971766	59972030	CpG: 22	264	22	194	16.7	73.5	0.62
chr11	59994251	59994487	CpG: 17	236	17	140	14.4	59.3	0.83
chr11	60050332	60050569	CpG: 16	237	16	140	13.5	59.1	0.79
chr11	60261316	60261596	CpG: 24	280	24	172	17.1	61.4	0.92
chr11	60386732	60387043	CpG: 24	311	24	190	15.4	61.1	0.83
chr11	60401995	60402968	CpG: 75	973	75	689	15.4	70.8	0.62
chr11	60436051	60436332	CpG: 24	281	24	173	17.1	61.6	0.92
chr11	60466447	60466709	CpG: 21	262	21	176	16.0	67.2	0.71
chr11	60477086	60477367	CpG: 23	281	23	174	16.4	61.9	0.87
chr11	60483768	60484068	CpG: 24	300	24	183	16.0	61.0	0.86
chr11	60598347	60598600	CpG: 25	253	25	178	19.8	70.4	0.81
chr11	60665102	60665387	CpG: 22	285	22	176	15.4	61.8	0.83
chr11	60718584	60718822	CpG: 24	238	24	169	20.2	71.0	0.80
chr11	60755173	60755393	CpG: 16	220	16	133	14.5	60.5	0.82
chr11	60793039	60793433	CpG: 41	394	41	267	20.8	67.8	0.91
chr11	60803515	60804757	CpG: 128	1242	128	854	20.6	68.8	0.88
chr11	60857270	60857857	CpG: 68	587	68	403	23.2	68.7	0.99
chr11	60865230	60865946	CpG: 80	716	80	495	22.3	69.1	0.94
chr11	60873093	60873297	CpG: 16	204	16	146	15.7	71.6	0.61
chr11	60875464	60876211	CpG: 82	747	82	554	22.0	74.2	0.80
chr11	60885356	60885893	CpG: 54	537	54	388	20.1	72.3	0.77
chr11	60902086	60902707	CpG: 85	621	85	473	27.4	76.2	0.95
chr11	60958759	60959269	CpG: 56	510	56	379	22.0	74.3	0.80
chr11	60959733	60960028	CpG: 28	295	28	209	19.0	70.8	0.77
chr11	61112580	61113282	CpG: 97	702	97	540	27.6	76.9	0.95
chr11	61117840	61118658	CpG: 62	818	62	562	15.2	68.7	0.64
chr11	61138671	61138950	CpG: 19	279	19	169	13.6	60.6	0.75
chr11	61270609	61270923	CpG: 25	314	25	222	15.9	70.7	0.68
chr11	61283159	61284579	CpG: 147	1420	147	1014	20.7	71.4	0.81
chr11	61321607	61322453	CpG: 96	846	96	596	22.7	70.4	0.92
chr11	61328191	61328408	CpG: 17	217	17	143	15.7	65.9	0.74
chr11	61349300	61349542	CpG: 19	242	19	146	15.7	60.3	0.88
chr11	61350169	61351015	CpG: 74	846	74	542	17.5	64.1	0.85
chr11	61370226	61370469	CpG: 19	243	19	147	15.6	60.5	0.88
chr11	61381259	61381708	CpG: 44	449	44	305	19.6	67.9	0.85
chr11	61418280	61419123	CpG: 106	843	106	623	25.1	73.9	0.96
chr11	61497233	61498737	CpG: 203	1504	203	1126	27.0	74.9	0.96
chr11	61505272	61505555	CpG: 22	283	22	197	15.5	69.6	0.64
chr11	61535372	61535722	CpG: 27	350	27	237	15.4	67.7	0.67
chr11	61536268	61536478	CpG: 18	210	18	139	17.1	66.2	0.79
chr11	61544129	61544682	CpG: 48	553	48	374	17.4	67.6	0.77
chr11	61556509	61556737	CpG: 30	228	30	174	26.3	76.3	0.92
chr11	61569205	61570435	CpG: 170	1230	170	966	27.6	78.5	0.90
chr11	61576436	61576761	CpG: 39	325	39	232	24.0	71.4	0.94
chr11	61669045	61669719	CpG: 94	674	94	521	27.9	77.3	0.94
chr11	61709581	61709806	CpG: 17	225	17	142	15.1	63.1	0.76
chr11	61732489	61733032	CpG: 45	543	45	381	16.6	70.2	0.67
chr11	61741189	61741802	CpG: 89	613	89	479	29.0	78.1	0.96
chr11	61766172	61767008	CpG: 68	836	68	562	16.3	67.2	0.72
chr11	61781352	61782097	CpG: 65	745	65	494	17.4	66.3	0.80
chr11	61794978	61795261	CpG: 22	283	22	173	15.5	61.1	0.85
chr11	61802599	61802843	CpG: 20	244	20	152	16.4	62.3	0.86
chr11	61804018	61806173	CpG: 197	2155	197	1478	18.3	68.6	0.78
chr11	61816456	61818170	CpG: 151	1714	151	1178	17.6	68.7	0.76
chr11	61879901	61880924	CpG: 128	1023	128	776	25.0	75.9	0.88
chr11	61905924	61906549	CpG: 91	625	91	502	29.1	80.3	0.92
chr11	61944093	61944832	CpG: 63	739	63	510	17.1	69.0	0.72
chr11	61955967	61957300	CpG: 134	1333	134	909	20.1	68.2	0.88
chr11	61969041	61969267	CpG: 16	226	16	128	14.2	56.6	0.90
chr11	62113281	62113809	CpG: 46	528	46	327	17.4	61.9	0.91
chr11	62326588	62327444	CpG: 98	856	98	585	22.9	68.3	0.99
chr11	62360487	62360736	CpG: 30	249	30	189	24.1	75.9	0.86
chr11	62372656	62372922	CpG: 23	266	23	166	17.3	62.4	0.90
chr11	62414230	62414537	CpG: 27	307	27	200	17.6	65.1	0.85
chr11	62424885	62425115	CpG: 19	230	19	141	16.5	61.3	0.89
chr11	62433985	62434192	CpG: 16	207	16	131	15.5	63.3	0.77
chr11	62535260	62537032	CpG: 150	1772	150	1230	16.9	69.4	0.70
chr11	62557412	62557637	CpG: 18	225	18	136	16.0	60.4	0.88
chr11	62563209	62563676	CpG: 39	467	39	293	16.7	62.7	0.88
chr11	62580789	62581650	CpG: 72	861	72	518	16.7	60.2	0.94
chr11	62590430	62592467	CpG: 225	2037	225	1426	22.1	70.0	0.91
chr11	62601614	62602532	CpG: 103	918	103	694	22.4	75.6	0.79
chr11	62611142	62611774	CpG: 70	632	70	445	22.2	70.4	0.90
chr11	62635612	62636273	CpG: 64	661	64	447	19.4	67.6	0.85
chr11	62642525	62642973	CpG: 47	448	47	289	21.0	64.5	1.02
chr11	62643387	62643668	CpG: 24	281	24	175	17.1	62.3	0.90
chr11	62647638	62647860	CpG: 21	222	21	136	18.9	61.3	1.03
chr11	62652889	62653107	CpG: 18	218	18	133	16.5	61.0	0.90
chr11	62654265	62655363	CpG: 94	1098	94	687	17.1	62.6	0.88
chr11	62660041	62660286	CpG: 17	245	17	145	13.9	59.2	0.81
chr11	62660993	62661749	CpG: 62	756	62	494	16.4	65.3	0.78
chr11	62667986	62668561	CpG: 55	575	55	388	19.1	67.5	0.84
chr11	62677020	62677815	CpG: 72	795	72	568	18.1	71.4	0.71
chr11	62695401	62696104	CpG: 65	703	65	475	18.5	67.6	0.82
chr11	62698715	62699426	CpG: 49	711	49	410	13.8	57.7	0.83
chr11	62715916	62717049	CpG: 145	1133	145	830	25.6	73.3	0.99
chr11	62718839	62719068	CpG: 16	229	16	131	14.0	57.2	0.87
chr11	62743284	62743876	CpG: 39	592	39	361	13.2	61.0	0.74
chr11	62750631	62751275	CpG: 50	644	50	410	15.5	63.7	0.77
chr11	62760534	62761170	CpG: 54	636	54	416	17.0	65.4	0.79
chr11	62775985	62777181	CpG: 138	1196	138	835	23.1	69.8	0.95
chr11	62780890	62781475	CpG: 56	585	56	410	19.1	70.1	0.78
chr11	62794484	62795070	CpG: 68	586	68	413	23.2	70.5	0.97
chr11	62820604	62821989	CpG: 111	1385	111	870	16.0	62.8	0.83
chr11	62828466	62830646	CpG: 142	2180	142	1199	13.0	55.0	0.86
chr11	62845282	62845800	CpG: 47	518	47	328	18.1	63.3	0.91
chr11	62870151	62871075	CpG: 81	924	81	619	17.5	67.0	0.78
chr11	62912861	62913375	CpG: 44	514	44	331	17.1	64.4	0.83
chr11	62915253	62916652	CpG: 115	1399	115	893	16.4	63.8	0.81
chr11	63343711	63343954	CpG: 21	243	21	150	17.3	61.7	0.93
chr11	63433877	63434107	CpG: 19	230	19	141	16.5	61.3	0.89
chr11	63480163	63480589	CpG: 53	426	53	310	24.9	72.8	0.98
chr11	63595904	63596138	CpG: 19	234	19	160	16.2	68.4	0.74
chr11	63602412	63602644	CpG: 20	232	20	140	17.2	60.3	0.95
chr11	63602957	63603906	CpG: 92	949	92	655	19.4	69.0	0.83
chr11	63606044	63606309	CpG: 22	265	22	166	16.6	62.6	0.86
chr11	63660168	63661181	CpG: 112	1013	112	731	22.1	72.2	0.86
chr11	63670572	63671254	CpG: 75	682	75	472	22.0	69.2	0.92
chr11	63706043	63706279	CpG: 18	236	18	138	15.3	58.5	0.92
chr11	63751783	63753799	CpG: 212	2016	212	1482	21.0	73.5	0.78
chr11	63754348	63754595	CpG: 21	247	21	183	17.0	74.1	0.63
chr11	63757547	63759330	CpG: 221	1783	221	1391	24.8	78.0	0.82
chr11	63802407	63803626	CpG: 135	1219	135	887	22.1	72.8	0.84
chr11	63809965	63810243	CpG: 25	278	25	173	18.0	62.2	0.94
chr11	63827981	63829341	CpG: 135	1360	135	938	19.9	69.0	0.84
chr11	63898200	63898678	CpG: 40	478	40	302	16.7	63.2	0.84
chr11	63901285	63901520	CpG: 17	235	17	176	14.5	74.9	0.67
chr11	63905624	63906875	CpG: 131	1251	131	934	20.9	74.7	0.75
chr11	63907370	63907849	CpG: 44	479	44	348	18.4	72.7	0.73
chr11	63926973	63927207	CpG: 18	234	18	143	15.4	61.1	0.84
chr11	63928262	63929102	CpG: 93	840	93	609	22.1	72.5	0.85
chr11	63964133	63965031	CpG: 73	898	73	547	16.3	60.9	0.88
chr11	63974828	63975102	CpG: 22	274	22	169	16.1	61.7	0.86
chr11	63975636	63976676	CpG: 84	1040	84	700	16.2	67.3	0.72
chr11	63988289	63991046	CpG: 235	2757	235	1968	17.0	71.4	0.67
chr11	63997615	63997882	CpG: 27	267	27	180	20.2	67.4	0.90
chr11	64025271	64026732	CpG: 172	1461	172	1128	23.5	77.2	0.80
chr11	64050003	64050866	CpG: 68	863	68	568	15.8	65.8	0.73
chr11	64075170	64075449	CpG: 20	279	20	183	14.3	65.6	0.67
chr11	64106148	64107571	CpG: 92	1423	92	909	12.9	63.9	0.65
chr11	64109743	64110164	CpG: 28	421	28	260	13.3	61.8	0.71
chr11	64155479	64156559	CpG: 125	1080	125	788	23.1	73.0	0.87
chr11	64175150	64176701	CpG: 157	1551	157	1062	20.2	68.5	0.88
chr11	64197303	64197522	CpG: 18	219	18	144	16.4	65.8	0.78
chr11	64216007	64216308	CpG: 39	301	39	228	25.9	75.7	0.92
chr11	64220135	64220911	CpG: 62	776	62	531	16.0	68.4	0.68
chr11	64224045	64225185	CpG: 147	1140	147	905	25.8	79.4	0.83
chr11	64230835	64232039	CpG: 118	1204	118	867	19.6	72.0	0.80
chr11	64232250	64232551	CpG: 21	301	21	196	14.0	65.1	0.66
chr11	64236321	64237890	CpG: 165	1569	165	1111	21.0	70.8	0.84
chr11	64240984	64241926	CpG: 96	942	96	689	20.4	73.1	0.76
chr11	64257416	64257622	CpG: 18	206	18	151	17.5	73.3	0.67
chr11	64259227	64260530	CpG: 110	1303	110	853	16.9	65.5	0.79
chr11	64261435	64261777	CpG: 30	342	30	239	17.5	69.9	0.72
chr11	64274544	64276144	CpG: 155	1600	155	1136	19.4	71.0	0.77
chr11	64277659	64277880	CpG: 19	221	19	151	17.2	68.3	0.74
chr11	64281300	64282610	CpG: 156	1310	156	997	23.8	76.1	0.83
chr11	64289253	64291504	CpG: 177	2251	177	1454	15.7	64.6	0.76
chr11	64294559	64296409	CpG: 186	1850	186	1291	20.1	69.8	0.83
chr11	64307155	64308566	CpG: 112	1411	112	886	15.9	62.8	0.81
chr11	64330616	64330942	CpG: 24	326	24	229	14.7	70.2	0.66
chr11	64332359	64332765	CpG: 41	406	41	297	20.2	73.2	0.76
chr11	64334864	64335144	CpG: 23	280	23	208	16.4	74.3	0.66
chr11	64348963	64349493	CpG: 62	530	62	402	23.4	75.8	0.82
chr11	64358342	64361462	CpG: 239	3120	239	2053	15.3	65.8	0.72
chr11	64370118	64370555	CpG: 32	437	32	271	14.6	62.0	0.91
chr11	64438905	64439203	CpG: 21	298	21	197	14.1	66.1	0.66
chr11	64553726	64553938	CpG: 14	212	14	137	13.2	64.6	0.63
chr11	64554789	64555094	CpG: 23	305	23	202	15.1	66.2	0.69
chr11	64560758	64561234	CpG: 37	476	37	335	15.5	70.4	0.63
chr11	64600329	64601277	CpG: 80	948	80	657	16.9	69.3	0.72
chr11	64623153	64623525	CpG: 47	372	47	261	25.3	70.2	1.10
chr11	64630960	64631515	CpG: 39	555	39	365	14.1	65.8	0.65
chr11	64635386	64636762	CpG: 137	1376	137	1017	19.9	73.9	0.78
chr11	64653748	64653969	CpG: 16	221	16	145	14.5	65.6	0.69
chr11	64704607	64705362	CpG: 52	755	52	497	13.8	65.8	0.71
chr11	64705963	64707264	CpG: 181	1301	181	991	27.8	76.2	0.96
chr11	64716042	64716910	CpG: 95	868	95	648	21.9	74.7	0.82
chr11	64735190	64739583	CpG: 341	4393	341	3049	15.5	69.4	0.65
chr11	64758769	64759596	CpG: 56	827	56	528	13.5	63.8	0.69
chr11	64770953	64772518	CpG: 199	1565	199	1139	25.4	72.8	0.96
chr11	64796086	64796739	CpG: 93	653	93	512	28.5	78.4	0.93
chr11	64803112	64804184	CpG: 90	1072	90	729	16.8	68.0	0.73
chr11	64804355	64804565	CpG: 16	210	16	119	15.2	56.7	0.96
chr11	64816442	64816678	CpG: 19	236	19	144	16.1	61.0	0.88
chr11	64820347	64821092	CpG: 56	745	56	488	15.0	65.5	0.70
chr11	64822797	64823341	CpG: 40	544	40	375	14.7	68.9	0.62
chr11	64837560	64838480	CpG: 110	920	110	692	23.9	75.2	0.85
chr11	64847611	64848106	CpG: 47	495	47	330	19.0	66.7	0.86
chr11	64871199	64872336	CpG: 125	1137	125	804	22.0	70.7	0.88
chr11	64888229	64888647	CpG: 32	418	32	291	15.3	69.6	0.64
chr11	64910368	64910595	CpG: 31	227	31	168	27.3	74.0	1.02
chr11	64917841	64918277	CpG: 53	436	53	328	24.3	75.2	0.86
chr11	64964807	64965722	CpG: 82	915	82	592	17.9	64.7	0.86
chr11	64971316	64971570	CpG: 22	254	22	157	17.3	61.8	0.92
chr11	65007241	65008176	CpG: 107	935	107	674	22.9	72.1	0.89
chr11	65020622	65021153	CpG: 44	531	44	333	16.6	62.7	0.85
chr11	65029862	65030090	CpG: 18	228	18	141	15.8	61.8	0.83
chr11	65034142	65035111	CpG: 124	969	124	723	25.6	74.6	0.92
chr11	65040850	65041532	CpG: 51	682	51	456	15.0	66.9	0.68
chr11	65077109	65077634	CpG: 68	525	68	368	25.9	70.1	1.06
chr11	65088761	65088976	CpG: 17	215	17	133	15.8	61.9	0.84
chr11	65089505	65089786	CpG: 31	281	31	202	22.1	71.9	0.88
chr11	65100941	65102050	CpG: 95	1109	95	793	17.1	71.5	0.67
chr11	65104853	65106220	CpG: 118	1367	118	954	17.3	69.8	0.73
chr11	65109922	65111255	CpG: 147	1333	147	910	22.1	68.3	0.94
chr11	65114943	65115738	CpG: 70	795	70	498	17.6	62.6	0.91
chr11	65116020	65116294	CpG: 19	274	19	168	13.9	61.3	0.75
chr11	65127334	65127915	CpG: 65	581	65	409	22.4	70.4	0.90
chr11	65159762	65159994	CpG: 18	232	18	140	15.5	60.3	0.89
chr11	65174490	65175233	CpG: 79	743	79	549	21.3	73.9	0.79
chr11	65177558	65177867	CpG: 24	309	24	217	15.5	70.2	0.69
chr11	65194824	65195099	CpG: 21	275	21	167	15.3	60.7	0.84
chr11	65198003	65198222	CpG: 25	219	25	147	22.8	67.1	1.02
chr11	65219089	65219293	CpG: 23	204	23	142	22.5	69.6	0.93
chr11	65253552	65253865	CpG: 21	313	21	187	13.4	59.7	0.77
chr11	65254894	65255780	CpG: 81	886	81	561	18.3	63.3	0.91
chr11	65307788	65309184	CpG: 136	1396	136	979	19.5	70.1	0.79
chr11	65326651	65327690	CpG: 95	1039	95	691	18.3	66.5	0.83
chr11	65347723	65348544	CpG: 97	821	97	625	23.6	76.1	0.82
chr11	65349205	65349537	CpG: 27	332	27	214	16.3	64.5	0.78
chr11	65358266	65358678	CpG: 40	412	40	251	19.4	60.9	1.06
chr11	65379141	65379419	CpG: 23	278	23	175	16.5	62.9	0.84
chr11	65379578	65380458	CpG: 82	880	82	615	18.6	69.9	0.76
chr11	65398217	65398444	CpG: 17	227	17	151	15.0	66.5	0.68
chr11	65415304	65416136	CpG: 82	832	82	560	19.7	67.3	0.88
chr11	65416665	65416899	CpG: 17	234	17	159	14.5	67.9	0.66
chr11	65448340	65448600	CpG: 31	260	31	178	23.8	68.5	1.02
chr11	65470468	65470962	CpG: 50	494	50	351	20.2	71.1	0.80
chr11	65472168	65472423	CpG: 26	255	26	186	20.4	72.9	0.77
chr11	65490790	65491231	CpG: 50	441	50	315	22.7	71.4	0.91
chr11	65518979	65519671	CpG: 81	692	81	536	23.4	77.5	0.81
chr11	65532664	65535249	CpG: 265	2585	265	1822	20.5	70.5	0.83
chr11	65540595	65542227	CpG: 134	1632	134	1102	16.4	67.5	0.72
chr11	65544808	65545035	CpG: 18	227	18	135	15.9	59.5	0.90
chr11	65547971	65548569	CpG: 48	598	48	435	16.1	72.7	0.61
chr11	65551827	65552968	CpG: 120	1141	120	856	21.0	75.0	0.76
chr11	65563974	65565235	CpG: 113	1261	113	810	17.9	64.2	0.87
chr11	65566534	65570611	CpG: 304	4077	304	2666	14.9	65.4	0.70
chr11	65578993	65579961	CpG: 123	968	123	714	25.4	73.8	0.94
chr11	65586054	65587090	CpG: 113	1036	113	730	21.8	70.5	0.88
chr11	65593553	65593933	CpG: 41	380	41	282	21.6	74.2	0.81
chr11	65601387	65601996	CpG: 70	609	70	425	23.0	69.8	0.95
chr11	65609523	65610556	CpG: 97	1033	97	707	18.8	68.4	0.80
chr11	65629434	65629881	CpG: 33	447	33	294	14.8	65.8	0.70
chr11	65632151	65632467	CpG: 36	316	36	243	22.8	76.9	0.77
chr11	65635043	65635330	CpG: 25	287	25	213	17.4	74.2	0.64
chr11	65636335	65636826	CpG: 45	491	45	335	18.3	68.2	0.79
chr11	65640477	65641902	CpG: 161	1425	161	1047	22.6	73.5	0.84
chr11	65646552	65647226	CpG: 76	674	76	477	22.6	70.8	0.91
chr11	65656841	65657778	CpG: 113	937	113	674	24.1	71.9	0.93
chr11	65664766	65665005	CpG: 18	239	18	142	15.1	59.4	0.87
chr11	65691939	65692203	CpG: 26	264	26	164	19.7	62.1	1.04
chr11	65706037	65706712	CpG: 59	675	59	453	17.5	67.1	0.79
chr11	65714347	65715035	CpG: 78	688	78	483	22.7	70.2	0.93
chr11	65730177	65730455	CpG: 25	278	25	175	18.0	62.9	0.92
chr11	65750687	65750971	CpG: 25	284	25	176	17.6	62.0	0.93
chr11	65757207	65757615	CpG: 38	408	38	309	18.6	75.7	0.65
chr11	65774491	65776253	CpG: 208	1762	208	1337	23.6	75.9	0.82
chr11	65780746	65782570	CpG: 220	1824	220	1308	24.1	71.7	0.94
chr11	65812402	65812897	CpG: 64	495	64	351	25.9	70.9	1.03
chr11	65813543	65813788	CpG: 20	245	20	149	16.3	60.8	0.91
chr11	65827744	65828531	CpG: 70	787	70	540	17.8	68.6	0.77
chr11	65833722	65833952	CpG: 21	230	21	142	18.3	61.7	0.97
chr11	65851495	65855596	CpG: 335	4101	335	2592	16.3	63.2	0.82
chr11	65866836	65868375	CpG: 133	1539	133	1088	17.3	70.7	0.71
chr11	65881060	65881797	CpG: 74	737	74	502	20.1	68.1	0.87
chr11	65883465	65884561	CpG: 121	1096	121	790	22.1	72.1	0.85
chr11	65892272	65893805	CpG: 172	1533	172	1113	22.4	72.6	0.85
chr11	65910707	65910971	CpG: 20	264	20	173	15.2	65.5	0.71
chr11	65911676	65913161	CpG: 178	1485	178	1090	24.0	73.4	0.89
chr11	65924134	65924369	CpG: 17	235	17	137	14.5	58.3	0.89
chr11	65954384	65955257	CpG: 101	873	101	590	23.1	67.6	1.04
chr11	65970556	65970965	CpG: 32	409	32	279	15.6	68.2	0.70
chr11	65995167	65995563	CpG: 30	396	30	222	15.2	56.1	0.97
chr11	65996060	65996965	CpG: 87	905	87	587	19.2	64.9	0.93
chr11	66005962	66006505	CpG: 64	543	64	395	23.6	72.7	0.89
chr11	66016561	66016820	CpG: 26	259	26	185	20.1	71.4	0.82
chr11	66019384	66019620	CpG: 17	236	17	142	14.4	60.2	0.91
chr11	66036655	66037772	CpG: 151	1117	151	789	27.0	70.6	1.10
chr11	66043065	66043397	CpG: 32	332	32	248	19.3	74.7	0.71
chr11	66046028	66046885	CpG: 86	857	86	595	20.1	69.4	0.83
chr11	66063920	66065315	CpG: 174	1395	174	1083	24.9	77.6	0.83
chr11	66080299	66080574	CpG: 23	275	23	173	16.7	62.9	0.85
chr11	66250916	66252459	CpG: 150	1543	150	1092	19.4	70.8	0.78
chr11	66260953	66263012	CpG: 165	2059	165	1324	16.0	64.3	0.78
chr11	66271403	66272398	CpG: 118	995	118	763	23.7	76.7	0.81
chr11	66275942	66276421	CpG: 41	479	41	319	17.1	66.6	0.77
chr11	66282401	66283516	CpG: 111	1115	111	749	19.9	67.2	0.89
chr11	66285255	66286127	CpG: 106	872	106	666	24.3	76.4	0.83
chr11	66288023	66289284	CpG: 146	1261	146	905	23.2	71.8	0.90
chr11	66305274	66307102	CpG: 136	1828	136	1153	14.9	63.1	0.76
chr11	66309754	66309955	CpG: 16	201	16	135	15.9	67.2	0.71
chr11	66328208	66328463	CpG: 22	255	22	187	17.3	73.3	0.64
chr11	66338443	66338995	CpG: 56	552	56	369	20.3	66.8	0.91
chr11	66340162	66340450	CpG: 21	288	21	181	14.6	62.8	0.74
chr11	66340689	66341857	CpG: 139	1168	139	813	23.8	69.6	0.98
chr11	66342374	66342650	CpG: 21	276	21	167	15.2	60.5	0.84
chr11	66351015	66351222	CpG: 17	207	17	122	16.4	58.9	0.96
chr11	66364999	66365922	CpG: 99	923	99	682	21.5	73.9	0.79
chr11	66373261	66373501	CpG: 16	240	16	139	13.3	57.9	0.82
chr11	66394338	66394602	CpG: 22	264	22	163	16.7	61.7	0.88
chr11	66404910	66405605	CpG: 70	695	70	485	20.1	69.8	0.83
chr11	66416251	66418273	CpG: 144	2022	144	1296	14.2	64.1	0.69
chr11	66434850	66435105	CpG: 25	255	25	180	19.6	70.6	0.80
chr11	66437065	66437452	CpG: 38	387	38	288	19.6	74.4	0.71
chr11	66462685	66463750	CpG: 122	1065	122	806	22.9	75.7	0.85
chr11	66471862	66472177	CpG: 27	315	27	225	17.1	71.4	0.67
chr11	66476055	66477035	CpG: 80	980	80	650	16.3	66.3	0.74
chr11	66541940	66543337	CpG: 122	1397	122	951	17.5	68.1	0.75
chr11	66555260	66555687	CpG: 45	427	45	287	21.1	67.2	0.93
chr11	66564351	66564927	CpG: 71	576	71	431	24.7	74.8	0.88
chr11	66575245	66575469	CpG: 18	224	18	136	16.1	60.7	0.87
chr11	66588872	66589609	CpG: 67	737	67	492	18.2	66.8	0.82
chr11	66612345	66613821	CpG: 143	1476	143	984	19.4	66.7	0.87
chr11	66622698	66622906	CpG: 25	208	25	123	24.0	59.1	1.40
chr11	66634515	66635464	CpG: 76	949	76	555	16.0	58.5	0.94
chr11	66639698	66640360	CpG: 48	662	48	395	14.5	59.7	0.81
chr11	66673774	66674248	CpG: 55	474	55	335	23.2	70.7	0.98
chr11	66674953	66675193	CpG: 19	240	19	144	15.8	60.0	0.90
chr11	66687561	66687901	CpG: 31	340	31	228	18.2	67.1	0.81
chr11	66697150	66697353	CpG: 21	203	21	146	20.7	71.9	0.81
chr11	66723716	66725166	CpG: 195	1450	195	1101	26.9	75.9	0.95
chr11	66740169	66740419	CpG: 19	250	19	153	15.2	61.2	0.82
chr11	66740581	66741817	CpG: 129	1236	129	866	20.9	70.1	0.88
chr11	66757347	66757631	CpG: 21	284	21	174	14.8	61.3	0.80
chr11	66758448	66758688	CpG: 27	240	27	178	22.5	74.2	0.83
chr11	66835064	66835300	CpG: 17	236	17	143	14.4	60.6	0.81
chr11	66839169	66840070	CpG: 101	901	101	660	22.4	73.3	0.84
chr11	66852425	66855419	CpG: 286	2994	286	2168	19.1	72.4	0.73
chr11	66860059	66860275	CpG: 17	216	17	139	15.7	64.4	0.78
chr11	66952254	66953405	CpG: 129	1151	129	783	22.4	68.0	0.97
chr11	66954462	66954743	CpG: 23	281	23	173	16.4	61.6	0.88
chr11	66983311	66983689	CpG: 34	378	34	277	18.0	73.3	0.67
chr11	66985617	66985894	CpG: 24	277	24	174	17.3	62.8	0.90
chr11	67017564	67018461	CpG: 116	897	116	667	25.9	74.4	0.94
chr11	67051122	67051625	CpG: 63	503	63	383	25.0	76.1	0.87
chr11	67065921	67066195	CpG: 30	274	30	193	21.9	70.4	0.89
chr11	67109480	67111535	CpG: 256	2055	256	1593	24.9	77.5	0.84
chr11	67244101	67244316	CpG: 17	215	17	145	15.8	67.4	0.71
chr11	67254953	67255193	CpG: 18	240	18	142	15.0	59.2	0.88
chr11	67255420	67255642	CpG: 27	222	27	165	24.3	74.3	0.95
chr11	67260160	67261145	CpG: 145	985	145	780	29.4	79.2	0.94
chr11	67279297	67279615	CpG: 26	318	26	193	16.4	60.7	0.90
chr11	67282436	67283754	CpG: 154	1318	154	1010	23.4	76.6	0.80
chr11	67297230	67298294	CpG: 101	1064	101	795	19.0	74.7	0.68
chr11	67310617	67310833	CpG: 17	216	17	129	15.7	59.7	0.90
chr11	67311180	67312305	CpG: 102	1125	102	757	18.1	67.3	0.80
chr11	67347497	67347869	CpG: 26	372	26	258	14.0	69.4	0.61
chr11	67366531	67367790	CpG: 156	1259	156	985	24.8	78.2	0.83
chr11	67377390	67377657	CpG: 20	267	20	164	15.0	61.4	0.80
chr11	67385715	67386615	CpG: 87	900	87	626	19.3	69.6	0.80
chr11	67392936	67393166	CpG: 17	230	17	150	14.8	65.2	0.70
chr11	67395260	67396176	CpG: 94	916	94	694	20.5	75.8	0.72
chr11	67403589	67403813	CpG: 22	224	22	164	19.6	73.2	0.74
chr11	67409609	67410037	CpG: 61	428	61	343	28.5	80.1	0.90
chr11	67414731	67415523	CpG: 103	792	103	611	26.0	77.1	0.91
chr11	67418055	67418310	CpG: 17	255	17	164	13.3	64.3	0.65
chr11	67422444	67422834	CpG: 45	390	45	267	23.1	68.5	0.99
chr11	67429964	67430307	CpG: 26	343	26	239	15.2	69.7	0.63
chr11	67437255	67437969	CpG: 72	714	72	541	20.2	75.8	0.71
chr11	67458701	67459247	CpG: 46	546	46	381	16.8	69.8	0.69
chr11	67462919	67463608	CpG: 75	689	75	513	21.8	74.5	0.79
chr11	67470223	67470612	CpG: 44	389	44	299	22.6	76.9	0.77
chr11	67476999	67477519	CpG: 46	520	46	333	17.7	64.0	0.86
chr11	67487069	67489381	CpG: 169	2312	169	1577	14.6	68.2	0.64
chr11	67498865	67500148	CpG: 149	1283	149	981	23.2	76.5	0.83
chr11	67502273	67503637	CpG: 131	1364	131	918	19.2	67.3	0.85
chr11	67514441	67514775	CpG: 31	334	31	226	18.6	67.7	0.82
chr11	67578146	67579172	CpG: 96	1026	96	727	18.7	70.9	0.75
chr11	67592736	67593146	CpG: 31	410	31	291	15.1	71.0	0.60
chr11	67601367	67601943	CpG: 61	576	61	407	21.2	70.7	0.85
chr11	67610752	67611024	CpG: 23	272	23	189	16.9	69.5	0.74
chr11	67613730	67614118	CpG: 34	388	34	288	17.5	74.2	0.64
chr11	67616087	67616357	CpG: 21	270	21	154	15.6	57.0	0.97
chr11	67624060	67625510	CpG: 170	1450	170	1072	23.4	73.9	0.87
chr11	67645680	67645913	CpG: 19	233	19	140	16.3	60.1	0.93
chr11	67649719	67650166	CpG: 36	447	36	275	16.1	61.5	0.86
chr11	67660273	67660569	CpG: 24	296	24	194	16.2	65.5	0.76
chr11	67705743	67707026	CpG: 117	1283	117	911	18.2	71.0	0.72
chr11	67726842	67727281	CpG: 45	439	45	297	20.5	67.7	0.91
chr11	67800031	67801579	CpG: 130	1548	130	1087	16.8	70.2	0.74
chr11	67826839	67827265	CpG: 32	426	32	255	15.0	59.9	0.84
chr11	67906858	67907121	CpG: 24	263	24	164	18.3	62.4	0.94
chr11	67958793	67959597	CpG: 88	804	88	590	21.9	73.4	0.82
chr11	67994326	67995617	CpG: 118	1291	118	917	18.3	71.0	0.72
chr11	68001093	68001432	CpG: 25	339	25	227	14.7	67.0	0.72
chr11	68006608	68007863	CpG: 142	1255	142	920	22.6	73.3	0.85
chr11	68025227	68025523	CpG: 24	296	24	193	16.2	65.2	0.77
chr11	68033857	68034598	CpG: 59	741	59	459	15.9	61.9	0.84
chr11	68042425	68042785	CpG: 36	360	36	262	20.0	72.8	0.76
chr11	68124145	68125946	CpG: 211	1801	211	1317	23.4	73.1	0.88
chr11	68126245	68126501	CpG: 21	256	21	144	16.4	56.2	1.06
chr11	68131908	68132279	CpG: 37	371	37	276	19.9	74.4	0.73
chr11	68136667	68136941	CpG: 20	274	20	168	14.6	61.3	0.79
chr11	68216157	68218230	CpG: 281	2073	281	1555	27.1	75.0	0.97
chr11	68231575	68231850	CpG: 21	275	21	168	15.3	61.1	0.84
chr11	68276158	68276796	CpG: 69	638	69	463	21.6	72.6	0.83
chr11	68295941	68296215	CpG: 24	274	24	171	17.5	62.4	0.91
chr11	68316770	68317896	CpG: 177	1126	177	911	31.4	80.9	0.97
chr11	68352277	68352686	CpG: 34	409	34	265	16.6	64.8	0.79
chr11	68376846	68377142	CpG: 39	296	39	224	26.4	75.7	1.03
chr11	68385027	68385257	CpG: 17	230	17	134	14.8	58.3	0.88
chr11	68390985	68391368	CpG: 45	383	45	253	23.5	66.1	1.08
chr11	68395280	68395586	CpG: 33	306	33	216	21.6	70.6	0.87
chr11	68416152	68416400	CpG: 21	248	21	167	16.9	67.3	0.75
chr11	68418320	68418523	CpG: 19	203	19	125	18.7	61.6	0.99
chr11	68427936	68428156	CpG: 21	220	21	148	19.1	67.3	0.85
chr11	68429437	68429792	CpG: 28	355	28	232	15.8	65.4	0.75
chr11	68438552	68438755	CpG: 24	203	24	145	23.6	71.4	0.93
chr11	68443355	68443556	CpG: 18	201	18	131	17.9	65.2	0.85
chr11	68453730	68453988	CpG: 23	258	23	174	17.8	67.4	0.85
chr11	68463903	68464173	CpG: 21	270	21	156	15.6	57.8	0.94
chr11	68465067	68466206	CpG: 130	1139	130	796	22.8	69.9	0.93
chr11	68480387	68481247	CpG: 76	860	76	612	17.7	71.2	0.70
chr11	68501827	68502106	CpG: 20	279	20	164	14.3	58.8	0.85
chr11	68676291	68676671	CpG: 28	380	28	265	14.7	69.7	0.61
chr11	68690011	68691498	CpG: 148	1487	148	1077	19.9	72.4	0.76
chr11	68756322	68757829	CpG: 135	1507	135	1136	17.9	75.4	0.69
chr11	68761554	68761832	CpG: 21	278	21	172	15.1	61.9	0.80
chr11	68788894	68789256	CpG: 29	362	29	235	16.0	64.9	0.76
chr11	68845334	68845982	CpG: 59	648	59	430	18.2	66.4	0.83
chr11	68846807	68848590	CpG: 186	1783	186	1259	20.9	70.6	0.84
chr11	68849902	68850459	CpG: 54	557	54	386	19.4	69.3	0.82
chr11	68860760	68861904	CpG: 94	1144	94	754	16.4	65.9	0.76
chr11	68867075	68867889	CpG: 67	814	67	555	16.5	68.2	0.71
chr11	68901242	68901823	CpG: 59	581	59	416	20.3	71.6	1.35
chr11	68912768	68913643	CpG: 86	875	86	588	19.7	67.2	0.87
chr11	69015556	69016472	CpG: 68	916	68	607	14.8	66.3	0.68
chr11	69021328	69021610	CpG: 32	282	32	217	22.7	77.0	0.79
chr11	69059114	69059724	CpG: 70	610	70	455	23.0	74.6	0.83
chr11	69089575	69089817	CpG: 17	242	17	159	14.0	65.7	0.66
chr11	69093507	69094111	CpG: 52	604	52	313	17.2	51.8	1.28
chr11	69103462	69103665	CpG: 20	203	20	140	19.7	69.0	0.85
chr11	69169551	69169818	CpG: 30	267	30	195	22.5	73.0	0.87
chr11	69394231	69394658	CpG: 39	427	39	282	18.3	66.0	0.94
chr11	69460512	69460907	CpG: 42	395	42	287	21.3	72.7	0.81
chr11	69488078	69488833	CpG: 59	755	59	484	15.6	64.1	0.76
chr11	69500932	69501145	CpG: 16	213	16	150	15.0	70.4	0.61
chr11	69653240	69660703	CpG: 595	7463	595	4694	15.9	62.9	0.81
chr11	69663167	69663485	CpG: 26	318	26	203	16.4	63.8	0.81
chr11	69670919	69671261	CpG: 25	342	25	228	14.6	66.7	0.66
chr11	69677397	69677604	CpG: 17	207	17	122	16.4	58.9	0.97
chr11	69691862	69692597	CpG: 68	735	68	499	18.5	67.9	0.80
chr11	69702740	69703017	CpG: 34	277	34	210	24.5	75.8	0.86
chr11	69719037	69722035	CpG: 249	2998	249	1973	16.6	65.8	0.77
chr11	69790980	69792700	CpG: 196	1720	196	1275	22.8	74.1	0.83
chr11	69813866	69814111	CpG: 23	245	23	151	18.8	61.6	1.00
chr11	69827262	69827672	CpG: 35	410	35	273	17.1	66.6	0.77
chr11	69834173	69836850	CpG: 285	2677	285	1890	21.3	70.6	0.86
chr11	69885497	69885759	CpG: 24	262	24	191	18.3	72.9	0.70
chr11	69908997	69909236	CpG: 18	239	18	158	15.1	66.1	0.69
chr11	69935977	69936234	CpG: 23	257	23	171	17.9	66.5	0.81
chr11	70002517	70003617	CpG: 101	1100	101	804	18.4	73.1	0.69
chr11	70095275	70096134	CpG: 127	859	127	667	29.6	77.6	0.98
chr11	70104856	70105146	CpG: 23	290	23	197	15.9	67.9	0.69
chr11	70142600	70142832	CpG: 17	232	17	137	14.7	59.1	0.86
chr11	70170841	70171076	CpG: 18	235	18	148	15.3	63.0	0.78
chr11	70192145	70192392	CpG: 18	247	18	163	14.6	66.0	0.69
chr11	70217947	70218824	CpG: 101	877	101	620	23.0	70.7	0.92
chr11	70229347	70229621	CpG: 22	274	22	169	16.1	61.7	0.85
chr11	70284994	70286343	CpG: 170	1349	170	1010	25.2	74.9	0.90
chr11	70342446	70342722	CpG: 19	276	19	166	13.8	60.1	0.77
chr11	70407077	70407355	CpG: 22	278	22	154	15.8	55.4	1.05
chr11	70418545	70419317	CpG: 94	772	94	583	24.4	75.5	0.87
chr11	70431595	70431872	CpG: 30	277	30	163	21.7	58.8	1.29
chr11	70477320	70477623	CpG: 27	303	27	231	17.8	76.2	0.62
chr11	70484016	70484702	CpG: 62	686	62	463	18.1	67.5	0.82
chr11	70506584	70507731	CpG: 85	1147	85	751	14.8	65.5	0.69
chr11	70619777	70620006	CpG: 18	229	18	143	15.7	62.4	0.82
chr11	70682070	70682889	CpG: 66	819	66	545	16.1	66.5	0.73
chr11	70691560	70691773	CpG: 19	213	19	134	17.8	62.9	0.90
chr11	70737946	70738156	CpG: 15	210	15	126	14.3	60.0	0.83
chr11	70772812	70773040	CpG: 21	228	21	141	18.4	61.8	0.99
chr11	70841569	70841920	CpG: 34	351	34	250	19.4	71.2	0.77
chr11	70844279	70844529	CpG: 17	250	17	176	13.6	70.4	0.64
chr11	70847977	70848198	CpG: 21	221	21	143	19.0	64.7	0.92
chr11	70912492	70912716	CpG: 18	224	18	139	16.1	62.1	0.85
chr11	71177516	71179504	CpG: 229	1988	229	1457	23.0	73.3	0.86
chr11	71362351	71362771	CpG: 32	420	32	282	15.2	67.1	0.68
chr11	71374924	71376027	CpG: 102	1103	102	780	18.5	70.7	0.74
chr11	71379698	71380589	CpG: 75	891	75	586	16.8	65.8	0.79
chr11	71403087	71403328	CpG: 19	241	19	153	15.8	63.5	0.78
chr11	71445917	71446234	CpG: 27	317	27	231	17.0	72.9	0.64
chr11	71449461	71449866	CpG: 41	405	41	228	20.2	56.3	1.34
chr11	71481196	71481470	CpG: 23	274	23	170	16.8	62.0	0.88
chr11	71504157	71504384	CpG: 20	227	20	146	17.6	64.3	0.85
chr11	71534083	71535351	CpG: 111	1268	111	895	17.5	70.6	0.70
chr11	71566204	71566893	CpG: 81	689	81	509	23.5	73.9	0.87
chr11	71701605	71701918	CpG: 23	313	23	213	14.7	68.1	0.64
chr11	71713439	71714933	CpG: 125	1494	125	1035	16.7	69.3	0.75
chr11	71740414	71740728	CpG: 33	314	33	233	21.0	74.2	0.77
chr11	71758274	71758653	CpG: 36	379	36	295	19.0	77.8	0.63
chr11	71846913	71847142	CpG: 16	229	16	135	14.0	59.0	0.82
chr11	71893791	71894072	CpG: 22	281	22	171	15.7	60.9	0.86
chr11	71999655	71999880	CpG: 17	225	17	138	15.1	61.3	0.83
chr11	72006172	72006444	CpG: 20	272	20	164	14.7	60.3	0.83
chr11	72007243	72007818	CpG: 51	575	51	365	17.7	63.5	0.88
chr11	72030047	72030373	CpG: 42	326	42	237	25.8	72.7	0.98
chr11	72039512	72039819	CpG: 28	307	28	189	18.2	61.6	0.99
chr11	72149819	72151893	CpG: 205	2074	205	1485	19.8	71.6	0.79
chr11	72166388	72166981	CpG: 75	593	75	442	25.3	74.5	0.91
chr11	72167685	72168102	CpG: 36	417	36	268	17.3	64.3	0.84
chr11	72170390	72171267	CpG: 99	877	99	636	22.6	72.5	0.86
chr11	72360586	72361584	CpG: 71	998	71	596	14.2	59.7	0.80
chr11	72487298	72487579	CpG: 21	281	21	155	14.9	55.2	0.99
chr11	72510634	72511407	CpG: 72	773	72	518	18.6	67.0	0.83
chr11	72516768	72517212	CpG: 52	444	52	335	23.4	75.5	0.84
chr11	72570406	72571659	CpG: 137	1253	137	927	21.9	74.0	0.80
chr11	72625241	72625704	CpG: 40	463	40	315	17.3	68.0	0.75
chr11	72654870	72655199	CpG: 23	329	23	237	14.0	72.0	0.63
chr11	72680284	72680909	CpG: 53	625	53	434	17.0	69.4	0.71
chr11	72683076	72683401	CpG: 38	325	38	227	23.4	69.8	0.97
chr11	72709471	72710210	CpG: 94	739	94	587	25.4	79.4	0.81
chr11	72721847	72722309	CpG: 48	462	48	296	20.8	64.1	1.01
chr11	72742188	72743281	CpG: 111	1093	111	773	20.3	70.7	0.81
chr11	72749498	72750957	CpG: 129	1459	129	1021	17.7	70.0	0.73
chr11	72911216	72911490	CpG: 21	274	21	168	15.3	61.3	0.83
chr11	73018442	73018716	CpG: 22	274	22	166	16.1	60.6	0.88
chr11	73069347	73071333	CpG: 199	1986	199	1364	20.0	68.7	0.85
chr11	73146128	73147031	CpG: 95	903	95	646	21.0	71.5	0.86
chr11	73162463	73163207	CpG: 63	744	63	476	16.9	64.0	0.84
chr11	73181120	73181395	CpG: 22	275	22	167	16.0	60.7	0.88
chr11	73193603	73193921	CpG: 31	318	31	234	19.5	73.6	0.73
chr11	73236570	73238681	CpG: 222	2111	222	1511	21.0	71.6	0.82
chr11	73271740	73272394	CpG: 81	654	81	488	24.8	74.6	0.89
chr11	73291210	73291825	CpG: 66	615	66	445	21.5	72.4	0.82
chr11	73305321	73306386	CpG: 142	1065	142	797	26.7	74.8	0.97
chr11	73526888	73527589	CpG: 78	701	78	502	22.3	71.6	0.87
chr11	73589884	73590716	CpG: 63	832	63	534	15.1	64.2	0.74
chr11	73653725	73653942	CpG: 15	217	15	128	13.8	59.0	0.80
chr11	73689375	73690583	CpG: 119	1208	119	834	19.7	69.0	0.84
chr11	73698751	73699055	CpG: 22	304	22	168	14.5	55.3	0.96
chr11	73706683	73706955	CpG: 22	272	22	166	16.2	61.0	0.88
chr11	73708648	73708893	CpG: 18	245	18	161	14.7	65.7	0.70
chr11	73717050	73717368	CpG: 32	318	32	215	20.1	67.6	0.91
chr11	73717683	73717912	CpG: 16	229	16	135	14.0	59.0	0.81
chr11	73805777	73806206	CpG: 45	429	45	277	21.0	64.6	1.03
chr11	73814031	73814261	CpG: 19	230	19	139	16.5	60.4	0.92
chr11	73829854	73830128	CpG: 23	274	23	170	16.8	62.0	0.88
chr11	73911802	73912903	CpG: 101	1101	101	746	18.3	67.8	0.80
chr11	74058465	74059315	CpG: 68	850	68	580	16.0	68.2	0.69
chr11	74100198	74100871	CpG: 58	673	58	423	17.2	62.9	0.87
chr11	74110405	74110690	CpG: 23	285	23	172	16.1	60.4	0.90
chr11	74240726	74241229	CpG: 61	503	61	370	24.3	73.6	0.99
chr11	74257271	74258036	CpG: 51	765	51	507	13.3	66.3	0.61
chr11	74306603	74306837	CpG: 17	234	17	139	14.5	59.4	0.86
chr11	74322017	74322253	CpG: 18	236	18	143	15.3	60.6	0.85
chr11	74325846	74326124	CpG: 22	278	22	173	15.8	62.2	0.83
chr11	74327263	74328306	CpG: 89	1043	89	697	17.1	66.8	0.76
chr11	74363437	74363722	CpG: 24	285	24	178	16.8	62.5	0.88
chr11	74396561	74397187	CpG: 49	626	49	443	15.7	70.8	0.66
chr11	74422523	74423244	CpG: 95	721	95	536	26.4	74.3	0.96
chr11	74521877	74522388	CpG: 49	511	49	344	19.2	67.3	0.87
chr11	74612862	74613213	CpG: 52	351	52	268	29.6	76.4	1.05
chr11	74639450	74639695	CpG: 17	245	17	145	13.9	59.2	0.80
chr11	74660259	74660473	CpG: 16	214	16	144	15.0	67.3	0.66
chr11	74660733	74661347	CpG: 79	614	79	461	25.7	75.1	0.94
chr11	74675662	74675892	CpG: 19	230	19	142	16.5	61.7	0.88
chr11	74678328	74679028	CpG: 95	700	95	530	27.1	75.7	0.95
chr11	74688079	74688322	CpG: 19	243	19	145	15.6	59.7	0.89
chr11	74750892	74751171	CpG: 24	279	24	175	17.2	62.7	0.89
chr11	74853714	74853987	CpG: 21	273	21	165	15.4	60.4	0.85
chr11	74878432	74878862	CpG: 50	430	50	284	23.3	66.0	1.07
chr11	74917100	74917307	CpG: 16	207	16	121	15.5	58.5	0.93
chr11	74918326	74918697	CpG: 36	371	36	253	19.4	68.2	0.84
chr11	75157680	75157909	CpG: 20	229	20	142	17.5	62.0	0.92
chr11	75170209	75172053	CpG: 255	1844	255	1389	27.7	75.3	0.98
chr11	75230278	75230554	CpG: 25	276	25	175	18.1	63.4	0.91
chr11	75280774	75281845	CpG: 126	1071	126	773	23.5	72.2	0.91
chr11	75319148	75319391	CpG: 21	243	21	145	17.3	59.7	1.00
chr11	75329037	75329468	CpG: 43	431	43	279	20.0	64.7	0.96
chr11	75339301	75340379	CpG: 87	1078	87	773	16.1	71.7	0.63
chr11	75354871	75355153	CpG: 33	282	33	207	23.4	73.4	0.87
chr11	75357918	75358281	CpG: 32	363	32	234	17.6	64.5	0.86
chr11	75359201	75360313	CpG: 165	1112	165	832	29.7	74.8	1.06
chr11	75380814	75381153	CpG: 26	339	26	229	15.3	67.6	0.68
chr11	75454524	75455848	CpG: 155	1324	155	982	23.4	74.2	0.85
chr11	75491287	75491953	CpG: 58	666	58	453	17.4	68.0	0.82
chr11	75495699	75496365	CpG: 66	666	66	447	19.8	67.1	0.88
chr11	75512397	75513145	CpG: 74	748	74	536	19.8	71.7	0.77
chr11	75596756	75598412	CpG: 197	1656	197	1201	23.8	72.5	0.91
chr11	75678173	75678407	CpG: 19	234	19	138	16.2	59.0	0.94
chr11	75698140	75698850	CpG: 84	710	84	523	23.7	73.7	0.87
chr11	75744390	75744595	CpG: 16	205	16	135	15.6	65.9	0.73
chr11	75744845	75745605	CpG: 71	760	71	542	18.7	71.3	0.74
chr11	75904121	75904402	CpG: 24	281	24	175	17.1	62.3	0.90
chr11	76094111	76095174	CpG: 73	1063	73	696	13.7	65.5	0.67
chr11	76124389	76124590	CpG: 22	201	22	148	21.9	73.6	0.83
chr11	76135649	76140756	CpG: 462	5107	462	3442	18.1	67.4	0.80
chr11	76140841	76141048	CpG: 15	207	15	122	14.5	58.9	0.84
chr11	76164574	76166255	CpG: 125	1681	125	993	14.9	59.1	0.85
chr11	76251582	76252064	CpG: 55	482	55	356	22.8	73.9	0.85
chr11	76310127	76311319	CpG: 140	1192	140	855	23.5	71.7	0.91
chr11	76374073	76375493	CpG: 102	1420	102	875	14.4	61.6	0.76
chr11	76393056	76393337	CpG: 23	281	23	173	16.4	61.6	0.88
chr11	76512074	76512998	CpG: 63	924	63	620	13.6	67.1	0.61
chr11	76600867	76601729	CpG: 93	862	93	639	21.6	74.1	0.79
chr11	76713311	76714943	CpG: 165	1632	165	1169	20.2	71.6	0.80
chr11	76729553	76729917	CpG: 35	364	35	268	19.2	73.6	0.72
chr11	76773396	76773643	CpG: 19	247	19	146	15.4	59.1	0.91
chr11	76790929	76791540	CpG: 66	611	66	461	21.6	75.5	0.77
chr11	76828900	76829184	CpG: 25	284	25	177	17.6	62.3	0.92
chr11	76864098	76864866	CpG: 57	768	57	516	14.8	67.2	0.66
chr11	76970010	76971093	CpG: 140	1083	140	779	25.9	71.9	1.01
chr11	76976366	76976683	CpG: 39	317	39	232	24.6	73.2	0.95
chr11	76996863	76997748	CpG: 92	885	92	652	20.8	73.7	0.77
chr11	77033497	77033870	CpG: 25	373	25	234	13.4	62.7	0.68
chr11	77068598	77069096	CpG: 60	498	60	367	24.1	73.7	0.89
chr11	77078259	77078712	CpG: 43	453	43	327	19.0	72.2	0.77
chr11	77112115	77112318	CpG: 18	203	18	144	17.7	70.9	0.72
chr11	77122361	77122564	CpG: 18	203	18	129	17.7	63.5	0.88
chr11	77332506	77332780	CpG: 22	274	22	169	16.1	61.7	0.85
chr11	77344618	77344970	CpG: 33	352	33	247	18.8	70.2	0.76
chr11	77392661	77392943	CpG: 24	282	24	179	17.0	63.5	0.86
chr11	77406101	77407412	CpG: 141	1311	141	953	21.5	72.7	0.81
chr11	77422512	77423613	CpG: 85	1101	85	778	15.4	70.7	0.62
chr11	77441675	77442043	CpG: 27	368	27	225	14.7	61.1	0.79
chr11	77521732	77521991	CpG: 23	259	23	165	17.8	63.7	0.89
chr11	77522370	77523401	CpG: 107	1031	107	718	20.8	69.6	0.86
chr11	77570434	77570970	CpG: 39	536	39	339	14.6	63.2	0.73
chr11	77668089	77668321	CpG: 21	232	21	161	18.1	69.4	0.84
chr11	77741767	77742041	CpG: 24	274	24	171	17.5	62.4	0.91
chr11	77746806	77747008	CpG: 16	202	16	115	15.8	56.9	0.98
chr11	77753361	77754437	CpG: 109	1076	109	754	20.3	70.1	0.83
chr11	77866646	77867115	CpG: 34	469	34	311	14.5	66.3	0.66
chr11	77927798	77928233	CpG: 36	435	36	269	16.6	61.8	0.89
chr11	77956190	77956414	CpG: 21	224	21	153	18.8	68.3	0.91
chr11	78012671	78013294	CpG: 65	623	65	406	20.9	65.2	0.98
chr11	78072678	78073041	CpG: 36	363	36	238	19.8	65.6	0.94
chr11	78121566	78122207	CpG: 63	641	63	445	19.7	69.4	0.84
chr11	78129448	78130325	CpG: 111	877	111	647	25.3	73.8	0.94
chr11	78137195	78137469	CpG: 23	274	23	169	16.8	61.7	0.89
chr11	78143350	78143617	CpG: 19	267	19	170	14.2	63.7	0.71
chr11	78275729	78275958	CpG: 16	229	16	135	14.0	59.0	0.81
chr11	78301188	78301399	CpG: 17	211	17	127	16.1	60.2	0.91
chr11	78303265	78303539	CpG: 23	274	23	170	16.8	62.0	0.88
chr11	78350214	78351649	CpG: 181	1435	181	1056	25.2	73.6	0.93
chr11	78454784	78455064	CpG: 23	280	23	175	16.4	62.5	0.85
chr11	78471993	78472229	CpG: 20	236	20	145	16.9	61.4	0.92
chr11	78507657	78508247	CpG: 53	590	53	391	18.0	66.3	0.83
chr11	78563042	78563327	CpG: 21	285	21	173	14.7	60.7	0.82
chr11	78591407	78591612	CpG: 17	205	17	137	16.6	66.8	0.81
chr11	78609423	78609658	CpG: 18	235	18	157	15.3	66.8	0.69
chr11	78616626	78616936	CpG: 25	310	25	190	16.1	61.3	0.86
chr11	78837178	78837570	CpG: 38	392	38	280	19.4	71.4	0.77
chr11	78869054	78869339	CpG: 23	285	23	177	16.1	62.1	0.85
chr11	78895987	78896193	CpG: 19	206	19	139	18.4	67.5	0.82
chr11	79003624	79003996	CpG: 39	372	39	256	21.0	68.8	0.90
chr11	79125520	79126403	CpG: 65	883	65	617	14.7	69.9	0.60
chr11	79282062	79282343	CpG: 25	281	25	175	17.8	62.3	0.93
chr11	79371557	79375456	CpG: 311	3899	311	2530	16.0	64.9	0.76
chr11	79414854	79415135	CpG: 24	281	24	175	17.1	62.3	0.90
chr11	79738750	79739374	CpG: 40	624	40	392	12.8	62.8	0.65
chr11	79833735	79833942	CpG: 19	207	19	126	18.4	60.9	1.01
chr11	80033009	80033287	CpG: 26	278	26	175	18.7	62.9	0.95
chr11	80192388	80192735	CpG: 33	347	33	262	19.0	75.5	0.67
chr11	81142324	81142856	CpG: 42	532	42	377	15.8	70.9	0.63
chr11	81367608	81367882	CpG: 23	274	23	170	16.8	62.0	0.88
chr11	81389065	81389343	CpG: 25	278	25	170	18.0	61.2	0.97
chr11	81780025	81780299	CpG: 22	274	22	169	16.1	61.7	0.85
chr11	82090599	82091040	CpG: 32	441	32	263	14.5	59.6	0.82
chr11	82226273	82226505	CpG: 21	232	21	142	18.1	61.2	0.99
chr11	82244064	82244341	CpG: 25	277	25	175	18.1	63.2	0.91
chr11	82339927	82340320	CpG: 42	393	42	294	21.4	74.8	0.76
chr11	82408412	82408682	CpG: 22	270	22	164	16.3	60.7	0.89
chr11	82438946	82439213	CpG: 21	267	21	159	15.7	59.6	0.90
chr11	82531936	82532210	CpG: 23	274	23	170	16.8	62.0	0.88
chr11	82625971	82626260	CpG: 29	289	29	188	20.1	65.1	0.95
chr11	82668851	82670392	CpG: 190	1541	190	1133	24.7	73.5	0.91
chr11	82793231	82793480	CpG: 19	249	19	148	15.3	59.4	0.87
chr11	82818976	82819254	CpG: 25	278	25	174	18.0	62.6	0.93
chr11	82837677	82838262	CpG: 43	585	43	357	14.7	61.0	0.84
chr11	82906979	82907566	CpG: 62	587	62	435	21.1	74.1	0.77
chr11	82937232	82937504	CpG: 24	272	24	166	17.6	61.0	0.96
chr11	83069223	83070094	CpG: 66	871	66	609	15.2	69.9	0.62
chr11	83093390	83093990	CpG: 59	600	59	392	19.7	65.3	0.93
chr11	83129909	83131091	CpG: 90	1182	90	712	15.2	60.2	0.86
chr11	83152822	83153095	CpG: 22	273	22	173	16.1	63.4	0.81
chr11	83222051	83222945	CpG: 68	894	68	548	15.2	61.3	0.81
chr11	83557105	83557335	CpG: 19	230	19	140	16.5	60.9	0.90
chr11	84244174	84244520	CpG: 26	346	26	176	15.0	50.9	1.20
chr11	84245128	84245588	CpG: 39	460	39	335	17.0	72.8	0.64
chr11	84286504	84286741	CpG: 17	237	17	142	14.3	59.9	0.83
chr11	84339213	84339494	CpG: 20	281	20	172	14.2	61.2	0.76
chr11	84357349	84357585	CpG: 19	236	19	143	16.1	60.6	0.89
chr11	84382258	84382486	CpG: 16	228	16	138	14.0	60.5	0.79
chr11	84463455	84463691	CpG: 18	236	18	140	15.3	59.3	0.90
chr11	84561492	84561774	CpG: 24	282	24	177	17.0	62.8	0.88
chr11	84622345	84622601	CpG: 19	256	19	150	14.8	58.6	0.87
chr11	84677710	84677968	CpG: 25	258	25	164	19.4	63.6	0.97
chr11	84852647	84852925	CpG: 24	278	24	170	17.3	61.2	0.94
chr11	84888849	84889095	CpG: 23	246	23	154	18.7	62.6	0.96
chr11	85024134	85024415	CpG: 24	281	24	175	17.1	62.3	0.90
chr11	85132145	85132426	CpG: 21	281	21	170	14.9	60.5	0.83
chr11	85261436	85261863	CpG: 32	427	32	256	15.0	60.0	0.84
chr11	85564976	85565262	CpG: 24	286	24	180	16.8	62.9	0.85
chr11	85584498	85584859	CpG: 29	361	29	229	16.1	63.4	0.80
chr11	85600502	85601864	CpG: 136	1362	136	922	20.0	67.7	0.88
chr11	85605393	85605671	CpG: 25	278	25	176	18.0	63.3	0.91
chr11	85619237	85619687	CpG: 34	450	34	288	15.1	64.0	0.74
chr11	85670312	85670593	CpG: 23	281	23	174	16.4	61.9	0.87
chr11	85747638	85748054	CpG: 57	416	57	322	27.4	77.4	0.95
chr11	85761857	85762087	CpG: 20	230	20	141	17.4	61.3	0.94
chr11	85789169	85789845	CpG: 52	676	52	461	15.4	68.2	0.66
chr11	85791331	85792093	CpG: 70	762	70	505	18.4	66.3	0.84
chr11	85871366	85871843	CpG: 46	477	46	329	19.3	69.0	0.81
chr11	85919165	85919450	CpG: 22	285	22	174	15.4	61.1	0.84
chr11	85923116	85923404	CpG: 21	288	21	178	14.6	61.8	0.78
chr11	86005334	86006170	CpG: 86	836	86	601	20.6	71.9	0.80
chr11	86144150	86144378	CpG: 19	228	19	139	16.7	61.0	0.94
chr11	86148188	86148454	CpG: 20	266	20	162	15.0	60.9	0.82
chr11	86185817	86186022	CpG: 18	205	18	110	17.6	53.7	1.23
chr11	86186240	86186949	CpG: 67	709	67	453	18.9	63.9	1.00
chr11	86269866	86270091	CpG: 17	225	17	135	15.1	60.0	0.86
chr11	86281631	86281867	CpG: 17	236	17	137	14.4	58.1	0.88
chr11	86317145	86317458	CpG: 23	313	23	205	14.7	65.5	0.69
chr11	86373850	86374147	CpG: 34	297	34	201	22.9	67.7	1.00
chr11	86375984	86376409	CpG: 34	425	34	310	16.0	72.9	0.60
chr11	86611802	86612693	CpG: 82	891	82	626	18.4	70.3	0.75
chr11	86655845	86656075	CpG: 20	230	20	142	17.4	61.7	0.92
chr11	86672444	86673404	CpG: 69	960	69	665	14.4	69.3	0.60
chr11	86711405	86712212	CpG: 65	807	65	545	16.1	67.5	0.71
chr11	86737112	86737386	CpG: 25	274	25	172	18.2	62.8	0.94
chr11	86740890	86741595	CpG: 92	705	92	544	26.1	77.2	0.90
chr11	86764475	86764749	CpG: 25	274	25	171	18.2	62.4	0.95
chr11	86819172	86820664	CpG: 113	1492	113	1053	15.1	70.6	0.61
chr11	86847090	86847311	CpG: 20	221	20	159	18.1	71.9	0.73
chr11	86871312	86871585	CpG: 21	273	21	168	15.4	61.5	0.83
chr11	86895701	86897089	CpG: 136	1388	136	965	19.6	69.5	0.81
chr11	86916176	86916454	CpG: 26	278	26	176	18.7	63.3	0.94
chr11	86962837	86963103	CpG: 23	266	23	166	17.3	62.4	0.90
chr11	86978500	86978933	CpG: 55	433	55	316	25.4	73.0	0.98
chr11	86988201	86988510	CpG: 25	309	25	184	16.2	59.5	0.92
chr11	87009428	87009665	CpG: 18	237	18	145	15.2	61.2	0.84
chr11	87286752	87287179	CpG: 31	427	31	256	14.5	60.0	0.81
chr11	88094055	88094647	CpG: 49	592	49	382	16.6	64.5	0.80
chr11	88104426	88104722	CpG: 28	296	28	178	18.9	60.1	1.06
chr11	88256352	88256893	CpG: 49	541	49	361	18.1	66.7	0.84
chr11	88280005	88280245	CpG: 22	240	22	149	18.3	62.1	0.97
chr11	88368067	88368342	CpG: 21	275	21	168	15.3	61.1	0.83
chr11	88421340	88421582	CpG: 18	242	18	143	14.9	59.1	0.87
chr11	88427689	88428541	CpG: 97	852	97	603	22.8	70.8	0.91
chr11	88735155	88735436	CpG: 24	281	24	174	17.1	61.9	0.91
chr11	88875749	88875998	CpG: 23	249	23	153	18.5	61.4	0.99
chr11	88928808	88929087	CpG: 25	279	25	172	17.9	61.6	0.95
chr11	88984921	88985250	CpG: 40	329	40	232	24.3	70.5	0.99
chr11	89092870	89093148	CpG: 25	278	25	174	18.0	62.6	0.93
chr11	89095185	89095425	CpG: 21	240	21	145	17.5	60.4	0.98
chr11	89410948	89411247	CpG: 38	299	38	227	25.4	75.9	0.88
chr11	89566645	89566876	CpG: 18	231	18	138	15.6	59.7	0.89
chr11	89649962	89650203	CpG: 20	241	20	176	16.6	73.0	0.64
chr11	89664003	89664238	CpG: 22	235	22	143	18.7	60.9	1.02
chr11	89705569	89705990	CpG: 42	421	42	278	20.0	66.0	0.92
chr11	89706598	89707618	CpG: 90	1020	90	711	17.6	69.7	0.73
chr11	89779852	89780701	CpG: 66	849	66	581	15.5	68.4	0.66
chr11	89783536	89784267	CpG: 69	731	69	527	18.9	72.1	0.73
chr11	89784954	89785362	CpG: 39	408	39	291	19.1	71.3	0.76
chr11	89816394	89816638	CpG: 22	244	22	171	18.0	70.1	0.75
chr11	89867725	89867969	CpG: 22	244	22	171	18.0	70.1	0.75
chr11	89899004	89899382	CpG: 37	378	37	269	19.6	71.2	0.78
chr11	89900069	89900800	CpG: 69	731	69	527	18.9	72.1	0.73
chr11	89903635	89904530	CpG: 69	895	69	619	15.4	69.2	0.65
chr11	89971813	89972837	CpG: 88	1024	88	711	17.2	69.4	0.72
chr11	89973512	89973866	CpG: 38	354	38	242	21.5	68.4	0.92
chr11	90015436	90015671	CpG: 18	235	18	140	15.3	59.6	0.86
chr11	90087124	90087615	CpG: 46	491	46	356	18.7	72.5	0.71
chr11	90119437	90119718	CpG: 23	281	23	169	16.4	60.1	0.91
chr11	90142655	90143271	CpG: 65	616	65	409	21.1	66.4	0.98
chr11	90183977	90184216	CpG: 18	239	18	139	15.1	58.2	0.90
chr11	90210648	90210922	CpG: 24	274	24	171	17.5	62.4	0.91
chr11	90270784	90271059	CpG: 23	275	23	170	16.7	61.8	0.89
chr11	90326012	90326371	CpG: 24	359	24	209	13.4	58.2	0.79
chr11	90547888	90548169	CpG: 23	281	23	173	16.4	61.6	0.88
chr11	90893159	90893779	CpG: 44	620	44	378	14.2	61.0	0.77
chr11	91014358	91014617	CpG: 20	259	20	159	15.4	61.4	0.83
chr11	91097394	91097668	CpG: 24	274	24	171	17.5	62.4	0.91
chr11	91190980	91191356	CpG: 33	376	33	277	17.6	73.7	0.65
chr11	91221018	91221299	CpG: 24	281	24	175	17.1	62.3	0.90
chr11	91334633	91334910	CpG: 19	277	19	170	13.7	61.4	0.74
chr11	92147131	92149785	CpG: 230	2654	230	1765	17.3	66.5	0.79
chr11	92254320	92254795	CpG: 46	475	46	372	19.4	78.3	0.65
chr11	92439631	92439871	CpG: 23	240	23	150	19.2	62.5	1.00
chr11	92455208	92455473	CpG: 18	265	18	156	13.6	58.9	0.80
chr11	92795262	92795666	CpG: 34	404	34	258	16.8	63.9	0.83
chr11	92803817	92804091	CpG: 25	274	25	172	18.2	62.8	0.94
chr11	92811474	92812307	CpG: 65	833	65	526	15.6	63.1	0.78
chr11	92844308	92844728	CpG: 42	420	42	279	20.0	66.4	0.91
chr11	92898458	92899103	CpG: 59	645	59	424	18.3	65.7	0.85
chr11	92936757	92937023	CpG: 22	266	22	166	16.5	62.4	0.86
chr11	93119239	93119480	CpG: 19	241	19	149	15.8	61.8	0.84
chr11	93120268	93121036	CpG: 83	768	83	527	21.6	68.6	0.93
chr11	93137853	93138085	CpG: 20	232	20	141	17.2	60.8	0.94
chr11	93166036	93166315	CpG: 25	279	25	175	17.9	62.7	0.92
chr11	93253244	93253775	CpG: 74	531	74	409	27.9	77.0	0.95
chr11	93459027	93460017	CpG: 135	990	135	759	27.3	76.7	0.99
chr11	93577794	93578477	CpG: 69	683	69	462	20.2	67.6	0.89
chr11	93657295	93658291	CpG: 84	996	84	583	16.9	58.5	0.99
chr11	93659778	93660037	CpG: 22	259	22	172	17.0	66.4	0.79
chr11	93700475	93701296	CpG: 76	821	76	529	18.5	64.4	0.89
chr11	93766448	93766878	CpG: 49	430	49	332	22.8	77.2	0.76
chr11	93952544	93952776	CpG: 19	232	19	137	16.4	59.1	0.95
chr11	93953740	93954050	CpG: 25	310	25	191	16.1	61.6	0.85
chr11	94005692	94005928	CpG: 19	236	19	144	16.1	61.0	0.87
chr11	94045170	94046378	CpG: 124	1208	124	806	20.5	66.7	0.93
chr11	94053292	94053558	CpG: 21	266	21	163	15.8	61.3	0.86
chr11	94408095	94408716	CpG: 64	621	64	435	20.6	70.0	0.84
chr11	94409881	94410155	CpG: 22	274	22	170	16.1	62.0	0.84
chr11	94500546	94501286	CpG: 56	740	56	449	15.1	60.7	0.82
chr11	94519428	94519773	CpG: 35	345	35	244	20.3	70.7	0.84
chr11	94549689	94549965	CpG: 20	276	20	166	14.5	60.1	0.80
chr11	94550774	94552793	CpG: 213	2019	213	1425	21.1	70.6	0.85
chr11	94747390	94748440	CpG: 107	1050	107	704	20.4	67.0	0.93
chr11	94775217	94776547	CpG: 135	1330	135	907	20.3	68.2	0.88
chr11	94794468	94794692	CpG: 20	224	20	135	17.9	60.3	0.99
chr11	94841296	94841580	CpG: 21	284	21	175	14.8	61.6	0.80
chr11	94980150	94980914	CpG: 63	764	63	469	16.5	61.4	0.89
chr11	95044479	95045277	CpG: 85	798	85	540	21.3	67.7	0.94
chr11	95074123	95074998	CpG: 108	875	108	602	24.7	68.8	1.06
chr11	95096473	95097490	CpG: 123	1017	123	735	24.2	72.3	0.93
chr11	95114832	95115086	CpG: 23	254	23	150	18.1	59.1	1.05
chr11	95157290	95157520	CpG: 16	230	16	138	13.9	60.0	0.81
chr11	95157602	95158766	CpG: 90	1164	90	745	15.5	64.0	0.76
chr11	95169402	95169681	CpG: 22	279	22	173	15.8	62.0	0.83
chr11	95225794	95226062	CpG: 21	268	21	163	15.7	60.8	0.85
chr11	95237700	95238520	CpG: 96	820	96	595	23.4	72.6	0.91
chr11	95239304	95239535	CpG: 23	231	23	149	19.9	64.5	0.97
chr11	95443415	95443841	CpG: 33	426	33	256	15.5	60.1	0.86
chr11	95489137	95490092	CpG: 71	955	71	663	14.9	69.4	0.62
chr11	95727326	95727571	CpG: 18	245	18	145	14.7	59.2	0.85
chr11	95749898	95750131	CpG: 18	233	18	135	15.5	57.9	0.95
chr11	95796689	95798272	CpG: 136	1583	136	997	17.2	63.0	0.87
chr11	95931161	95931614	CpG: 47	453	47	317	20.8	70.0	0.85
chr11	95964815	95965089	CpG: 24	274	24	171	17.5	62.4	0.91
chr11	96129278	96129527	CpG: 19	249	19	142	15.3	57.0	0.97
chr11	96166921	96167166	CpG: 23	245	23	151	18.8	61.6	1.01
chr11	96328465	96328692	CpG: 18	227	18	139	15.9	61.2	0.85
chr11	96368997	96369253	CpG: 20	256	20	156	15.6	60.9	0.84
chr11	96395376	96396427	CpG: 79	1051	79	672	15.0	63.9	0.74
chr11	96417223	96417663	CpG: 34	440	34	266	15.5	60.5	0.85
chr11	96963807	96964085	CpG: 20	278	20	169	14.4	60.8	0.79
chr11	96984309	96984595	CpG: 23	286	23	179	16.1	62.6	0.83
chr11	97089192	97089469	CpG: 26	277	26	175	18.8	63.2	0.95
chr11	97237282	97237556	CpG: 23	274	23	170	16.8	62.0	0.88
chr11	97514869	97515117	CpG: 23	248	23	158	18.5	63.7	0.93
chr11	97724563	97724863	CpG: 24	300	24	217	16.0	72.3	0.62
chr11	97752285	97752618	CpG: 27	333	27	244	16.2	73.3	0.61
chr11	97920458	97920731	CpG: 23	273	23	169	16.8	61.9	0.89
chr11	98667164	98667400	CpG: 17	236	17	135	14.4	57.2	0.90
chr11	98764056	98764318	CpG: 21	262	21	163	16.0	62.2	0.83
chr11	98776353	98777028	CpG: 50	675	50	474	14.8	70.2	0.60
chr11	99027500	99027778	CpG: 34	278	34	195	24.5	70.1	1.02
chr11	99097430	99097708	CpG: 23	278	23	173	16.5	62.2	0.86
chr11	99246349	99246625	CpG: 24	276	24	173	17.4	62.7	0.90
chr11	99302300	99302581	CpG: 21	281	21	173	14.9	61.6	0.80
chr11	99854631	99854905	CpG: 24	274	24	172	17.5	62.8	0.90
chr11	100295044	100295403	CpG: 28	359	28	213	15.6	59.3	0.89
chr11	100490651	100491010	CpG: 27	359	27	209	15.0	58.2	0.89
chr11	100688131	100688408	CpG: 21	277	21	158	15.2	57.0	0.93
chr11	100696250	100696868	CpG: 89	618	89	466	28.8	75.4	1.02
chr11	100734815	100735049	CpG: 18	234	18	140	15.4	59.8	0.88
chr11	100817599	100817880	CpG: 24	281	24	175	17.1	62.3	0.90
chr11	100919844	100920129	CpG: 24	285	24	178	16.8	62.5	0.88
chr11	101033688	101033927	CpG: 20	239	20	149	16.7	62.3	0.89
chr11	101136813	101138557	CpG: 177	1744	177	1236	20.3	70.9	0.81
chr11	101138730	101139221	CpG: 32	491	32	290	13.0	59.1	0.75
chr11	101290644	101290935	CpG: 23	291	23	176	15.8	60.5	0.87
chr11	101428295	101428535	CpG: 21	240	21	151	17.5	62.9	0.91
chr11	101428984	101429265	CpG: 24	281	24	176	17.1	62.6	0.89
chr11	101592105	101593432	CpG: 114	1327	114	871	17.2	65.6	0.80
chr11	101720893	101721174	CpG: 25	281	25	172	17.8	61.2	0.96
chr11	101902026	101902292	CpG: 21	266	21	152	15.8	57.1	0.99
chr11	101915974	101916508	CpG: 54	534	54	371	20.2	69.5	0.84
chr11	101939816	101940089	CpG: 22	273	22	168	16.1	61.5	0.87
chr11	102016305	102016518	CpG: 19	213	19	131	17.8	61.5	0.96
chr11	102040042	102040306	CpG: 22	264	22	164	16.7	62.1	0.87
chr11	102049425	102049845	CpG: 40	420	40	282	19.0	67.1	0.85
chr11	102111992	102113689	CpG: 191	1697	191	1201	22.5	70.8	0.90
chr11	102185867	102186142	CpG: 24	275	24	171	17.5	62.2	0.91
chr11	102249718	102249992	CpG: 24	274	24	172	17.5	62.8	0.90
chr11	102270795	102271023	CpG: 19	228	19	163	16.7	71.5	0.65
chr11	102279754	102280026	CpG: 20	272	20	166	14.7	61.0	0.80
chr11	102289611	102289875	CpG: 23	264	23	166	17.4	62.9	0.89
chr11	102319567	102319828	CpG: 23	261	23	167	17.6	64.0	0.92
chr11	102348964	102349640	CpG: 83	676	83	467	24.6	69.1	1.03
chr11	102376939	102377298	CpG: 24	359	24	205	13.4	57.1	0.82
chr11	102453925	102455158	CpG: 124	1233	124	806	20.1	65.4	0.94
chr11	102603346	102603651	CpG: 27	305	27	183	17.7	60.0	0.99
chr11	102646653	102646861	CpG: 16	208	16	112	15.4	53.8	1.07
chr11	102650157	102650430	CpG: 22	273	22	172	16.1	63.0	0.82
chr11	102750838	102751132	CpG: 23	294	23	174	15.6	59.2	0.90
chr11	103003220	103003507	CpG: 23	287	23	175	16.0	61.0	0.87
chr11	103036157	103036431	CpG: 22	274	22	169	16.1	61.7	0.86
chr11	103095272	103096047	CpG: 66	775	66	508	17.0	65.5	0.79
chr11	103334156	103334437	CpG: 23	281	23	173	16.4	61.6	0.88
chr11	103462926	103463200	CpG: 24	274	24	171	17.5	62.4	0.91
chr11	103463569	103463850	CpG: 24	281	24	175	17.1	62.3	0.90
chr11	103925418	103925693	CpG: 23	275	23	170	16.7	61.8	0.89
chr11	103958768	103959042	CpG: 24	274	24	170	17.5	62.0	0.92
chr11	104040559	104041144	CpG: 43	585	43	382	14.7	65.3	0.70
chr11	104143674	104143982	CpG: 22	308	22	176	14.3	57.1	0.89
chr11	104167728	104168250	CpG: 54	522	54	339	20.7	64.9	0.98
chr11	104240461	104240691	CpG: 18	230	18	138	15.7	60.0	0.88
chr11	104278321	104278599	CpG: 25	278	25	175	18.0	62.9	0.92
chr11	104370721	104370994	CpG: 33	273	33	208	24.2	76.2	0.83
chr11	104389752	104389973	CpG: 16	221	16	134	14.5	60.6	0.81
chr11	104568287	104568572	CpG: 23	285	23	177	16.1	62.1	0.85
chr11	104622069	104622343	CpG: 22	274	22	169	16.1	61.7	0.86
chr11	105020508	105020748	CpG: 17	240	17	140	14.2	58.3	0.83
chr11	105184848	105185126	CpG: 26	278	26	176	18.7	63.3	0.94
chr11	105253974	105254249	CpG: 21	275	21	168	15.3	61.1	0.83
chr11	105294202	105294485	CpG: 22	283	22	173	15.5	61.1	0.84
chr11	105425346	105425627	CpG: 23	281	23	174	16.4	61.9	0.87
chr11	105478629	105478850	CpG: 18	221	18	136	16.3	61.5	0.87
chr11	105519901	105520179	CpG: 24	278	24	170	17.3	61.2	0.94
chr11	105556530	105556762	CpG: 19	232	19	143	16.4	61.6	0.88
chr11	105614653	105614949	CpG: 31	296	31	204	20.9	68.9	0.99
chr11	105892581	105892820	CpG: 19	239	19	143	15.9	59.8	0.91
chr11	105899052	105899333	CpG: 23	281	23	174	16.4	61.9	0.87
chr11	105969596	105969877	CpG: 22	281	22	171	15.7	60.9	0.86
chr11	106026591	106026818	CpG: 26	227	26	160	22.9	70.5	0.97
chr11	106082004	106082715	CpG: 69	711	69	467	19.4	65.7	0.90
chr11	106113641	106113919	CpG: 25	278	25	177	18.0	63.7	0.90
chr11	106178474	106178748	CpG: 24	274	24	170	17.5	62.0	0.92
chr11	106305603	106305881	CpG: 25	278	25	175	18.0	62.9	0.92
chr11	106457245	106457474	CpG: 20	229	20	141	17.5	61.6	0.93
chr11	106538249	106538519	CpG: 21	270	21	159	15.6	58.9	0.91
chr11	106706276	106706508	CpG: 17	232	17	139	14.7	59.9	0.83
chr11	106834855	106835063	CpG: 21	208	21	132	20.2	63.5	1.00
chr11	107024702	107026581	CpG: 187	1879	187	1313	19.9	69.9	0.82
chr11	107134828	107135105	CpG: 25	277	25	175	18.1	63.2	0.92
chr11	107233242	107233446	CpG: 17	204	17	120	16.7	58.8	0.98
chr11	107292373	107292643	CpG: 21	270	21	164	15.6	60.7	0.86
chr11	107369118	107369410	CpG: 23	292	23	174	15.8	59.6	0.89
chr11	107464879	107465129	CpG: 20	250	20	133	16.0	53.2	1.15
chr11	107487388	107487609	CpG: 16	221	16	133	14.5	60.2	0.81
chr11	107492615	107492855	CpG: 18	240	18	146	15.0	60.8	0.83
chr11	107598083	107598988	CpG: 93	905	93	646	20.6	71.4	0.81
chr11	107706345	107706607	CpG: 20	262	20	156	15.3	59.5	0.87
chr11	107865352	107866062	CpG: 70	710	70	494	19.7	69.6	0.83
chr11	107919034	107920072	CpG: 84	1038	84	739	16.2	71.2	0.64
chr11	107935332	107936354	CpG: 94	1022	94	707	18.4	69.2	0.80
chr11	108015811	108016709	CpG: 88	898	88	592	19.6	65.9	0.91
chr11	108128814	108129541	CpG: 71	727	71	483	19.5	66.4	0.89
chr11	108197152	108197426	CpG: 24	274	24	171	17.5	62.4	0.91
chr11	108230026	108230784	CpG: 74	758	74	467	19.5	61.6	1.04
chr11	108268168	108268525	CpG: 29	357	29	212	16.2	59.4	0.93
chr11	108381184	108381401	CpG: 19	217	19	135	17.5	62.2	0.90
chr11	108434931	108435204	CpG: 20	273	20	164	14.7	60.1	0.82
chr11	108435383	108435619	CpG: 20	236	20	143	16.9	60.6	0.94
chr11	108505267	108506176	CpG: 101	909	101	632	22.2	69.5	0.92
chr11	108600395	108600900	CpG: 54	505	54	355	21.4	70.3	0.88
chr11	108633927	108634186	CpG: 21	259	21	158	16.2	61.0	0.89
chr11	108672394	108673006	CpG: 58	612	58	388	19.0	63.4	0.95
chr11	108692710	108692934	CpG: 21	224	21	136	18.8	60.7	1.02
chr11	109119046	109119288	CpG: 19	242	19	147	15.7	60.7	0.88
chr11	109128945	109129219	CpG: 24	274	24	169	17.5	61.7	0.93
chr11	109193352	109193665	CpG: 26	313	26	194	16.6	62.0	0.87
chr11	109307897	109308171	CpG: 25	274	25	172	18.2	62.8	0.94
chr11	109326036	109326317	CpG: 23	281	23	175	16.4	62.3	0.86
chr11	109432231	109434426	CpG: 147	2195	147	1409	13.4	64.2	0.65
chr11	110102771	110104201	CpG: 180	1430	180	1054	25.2	73.7	0.94
chr11	110218943	110219238	CpG: 25	295	25	180	16.9	61.0	0.92
chr11	110250268	110250520	CpG: 22	252	22	152	17.5	60.3	0.99
chr11	110305674	110306869	CpG: 147	1195	147	872	24.6	73.0	0.92
chr11	110310748	110311107	CpG: 32	359	32	262	17.8	73.0	0.67
chr11	110416104	110416389	CpG: 25	285	25	181	17.5	63.5	0.88
chr11	110440041	110440801	CpG: 103	760	103	575	27.1	75.7	0.95
chr11	110721120	110723165	CpG: 198	2045	198	1413	19.4	69.1	0.81
chr11	110984223	110984508	CpG: 24	285	24	178	16.8	62.5	0.88
chr11	111229040	111229281	CpG: 17	241	17	144	14.1	59.8	0.82
chr11	111232053	111232594	CpG: 50	541	50	394	18.5	72.8	0.70
chr11	111241116	111241326	CpG: 15	210	15	123	14.3	58.6	0.84
chr11	111308768	111310177	CpG: 130	1409	130	992	18.5	70.4	0.75
chr11	111522558	111523315	CpG: 85	757	85	547	22.5	72.3	0.87
chr11	111524760	111525135	CpG: 31	375	31	243	16.5	64.8	0.80
chr11	111550352	111551619	CpG: 112	1267	112	870	17.7	68.7	0.75
chr11	111612134	111613350	CpG: 139	1216	139	893	22.9	73.4	0.85
chr11	111776020	111776694	CpG: 75	674	75	478	22.3	70.9	0.92
chr11	111881473	111881811	CpG: 40	338	40	246	23.7	72.8	0.91
chr11	111889089	111889597	CpG: 47	508	47	322	18.5	63.4	0.93
chr11	111929443	111929674	CpG: 18	231	18	137	15.6	59.3	0.89
chr11	111937071	111937547	CpG: 39	476	39	335	16.4	70.4	0.70
chr11	111947125	111947721	CpG: 62	596	62	407	20.8	68.3	0.90
chr11	111987130	111987918	CpG: 72	788	72	562	18.3	71.3	0.72
chr11	112035094	112035965	CpG: 77	871	77	573	17.7	65.8	0.83
chr11	112037129	112038025	CpG: 72	896	72	631	16.1	70.4	0.65
chr11	112084587	112084980	CpG: 28	393	28	245	14.2	62.3	0.74
chr11	112096882	112097211	CpG: 30	329	30	206	18.2	62.6	0.93
chr11	112145167	112145452	CpG: 26	285	26	180	18.2	63.2	0.93
chr11	112146955	112147238	CpG: 24	283	24	174	17.0	61.5	0.91
chr11	112191530	112191808	CpG: 23	278	23	173	16.5	62.2	0.86
chr11	112236647	112237172	CpG: 64	525	64	383	24.4	73.0	0.95
chr11	112300370	112300756	CpG: 45	386	45	285	23.3	73.8	0.89
chr11	112570609	112570843	CpG: 21	234	21	143	17.9	61.1	0.99
chr11	112972218	112974184	CpG: 192	1966	192	1337	19.5	68.0	0.85
chr11	113055206	113055489	CpG: 23	283	23	171	16.3	60.4	0.89
chr11	113226643	113226923	CpG: 25	280	25	179	17.9	63.9	0.88
chr11	113269522	113269796	CpG: 24	274	24	171	17.5	62.4	0.91
chr11	113324786	113325405	CpG: 59	619	59	446	19.1	72.1	0.74
chr11	113398224	113398602	CpG: 39	378	39	275	20.6	72.8	0.78
chr11	113484830	113486091	CpG: 133	1261	133	909	21.1	72.1	0.81
chr11	113534182	113534726	CpG: 36	544	36	347	13.2	63.8	0.65
chr11	113754431	113754662	CpG: 19	231	19	143	16.5	61.9	0.87
chr11	113783897	113784255	CpG: 37	358	37	228	20.7	63.7	1.03
chr11	113800372	113800663	CpG: 22	291	22	179	15.1	61.5	0.82
chr11	113873990	113874301	CpG: 23	311	23	184	14.8	59.2	0.85
chr11	113884326	113884568	CpG: 20	242	20	144	16.5	59.5	0.94
chr11	113885421	113886298	CpG: 103	877	103	630	23.5	71.8	0.95
chr11	113922628	113922880	CpG: 18	252	18	151	14.3	59.9	0.80
chr11	113932916	113933195	CpG: 20	279	20	165	14.3	59.1	0.83
chr11	114046550	114046962	CpG: 33	412	33	278	16.0	67.5	0.70
chr11	114069266	114071823	CpG: 244	2557	244	1723	19.1	67.4	0.85
chr11	114080482	114080763	CpG: 23	281	23	173	16.4	61.6	0.88
chr11	114093254	114093473	CpG: 18	219	18	140	16.4	63.9	0.81
chr11	114209514	114209768	CpG: 24	254	24	188	18.9	74.0	0.73
chr11	114215499	114215740	CpG: 18	241	18	143	14.9	59.3	0.88
chr11	114259840	114260121	CpG: 22	281	22	173	15.7	61.6	0.84
chr11	114410496	114411387	CpG: 86	891	86	561	19.3	63.0	0.98
chr11	114433652	114433888	CpG: 19	236	19	144	16.1	61.0	0.89
chr11	114449696	114450281	CpG: 56	585	56	401	19.1	68.5	0.87
chr11	114457377	114457639	CpG: 25	262	25	164	19.1	62.6	0.99
chr11	114501294	114501579	CpG: 23	285	23	176	16.1	61.8	0.86
chr11	114744473	114744706	CpG: 17	233	17	136	14.6	58.4	0.87
chr11	114772903	114773189	CpG: 26	286	26	181	18.2	63.3	0.92
chr11	114833850	114834090	CpG: 17	240	17	142	14.2	59.2	0.83
chr11	115166740	115167077	CpG: 32	337	32	214	19.0	63.5	0.95
chr11	115515975	115518282	CpG: 189	2307	189	1532	16.4	66.4	0.75
chr11	115605653	115605937	CpG: 22	284	22	174	15.5	61.3	0.84
chr11	115647046	115647599	CpG: 44	553	44	395	15.9	71.4	0.62
chr11	115672441	115672992	CpG: 46	551	46	374	16.7	67.9	0.73
chr11	115772825	115773544	CpG: 67	719	67	509	18.6	70.8	0.75
chr11	116360599	116361673	CpG: 85	1074	85	754	15.8	70.2	0.64
chr11	116508822	116509084	CpG: 26	262	26	166	19.8	63.4	1.00
chr11	116514605	116515029	CpG: 36	424	36	287	17.0	67.7	0.79
chr11	116594027	116595280	CpG: 115	1253	115	771	18.4	61.5	0.97
chr11	116721804	116722307	CpG: 45	503	45	329	17.9	65.4	0.84
chr11	116787219	116787802	CpG: 67	583	67	406	23.0	69.6	0.96
chr11	116802319	116802803	CpG: 52	484	52	341	21.5	70.5	0.89
chr11	116804942	116805318	CpG: 34	376	34	256	18.1	68.1	0.79
chr11	116836341	116836794	CpG: 38	453	38	297	16.8	65.6	0.78
chr11	116850872	116851301	CpG: 48	429	48	293	22.4	68.3	0.96
chr11	116856893	116857167	CpG: 23	274	23	170	16.8	62.0	0.88
chr11	117104389	117104627	CpG: 17	238	17	139	14.3	58.4	0.85
chr11	117113085	117114059	CpG: 125	974	125	746	25.7	76.6	0.88
chr11	117118974	117119216	CpG: 22	242	22	147	18.2	60.7	1.01
chr11	117159291	117160152	CpG: 85	861	85	602	19.7	69.9	0.81
chr11	117193978	117194813	CpG: 75	835	75	573	18.0	68.6	0.77
chr11	117247324	117248523	CpG: 130	1199	130	879	21.7	73.3	0.81
chr11	117332432	117333067	CpG: 59	635	59	488	18.6	76.9	0.64
chr11	117344354	117344881	CpG: 52	527	52	358	19.7	67.9	0.89
chr11	117444913	117445147	CpG: 19	234	19	168	16.2	71.8	0.64
chr11	117498632	117498902	CpG: 22	270	22	178	16.3	65.9	0.77
chr11	117535037	117535322	CpG: 28	285	28	187	19.6	65.6	0.92
chr11	117688415	117688670	CpG: 19	255	19	156	14.9	61.2	0.81
chr11	117775035	117775276	CpG: 17	241	17	142	14.1	58.9	0.82
chr11	117796914	117797127	CpG: 24	213	24	140	22.5	65.7	1.11
chr11	117812331	117813838	CpG: 139	1507	139	1068	18.4	70.9	0.74
chr11	117892784	117893399	CpG: 59	615	59	435	19.2	70.7	0.77
chr11	117994866	117995249	CpG: 31	383	31	278	16.2	72.6	0.62
chr11	118002303	118002963	CpG: 69	660	69	476	20.9	72.1	0.81
chr11	118043418	118043699	CpG: 23	281	23	175	16.4	62.3	0.86
chr11	118161932	118162679	CpG: 77	747	77	540	20.6	72.3	0.79
chr11	118169041	118169883	CpG: 90	842	90	604	21.4	71.7	0.84
chr11	118232529	118232744	CpG: 15	215	15	125	14.0	58.1	0.83
chr11	118375708	118375912	CpG: 22	204	22	129	21.6	63.2	1.08
chr11	118417797	118418082	CpG: 32	285	32	196	22.5	68.8	0.99
chr11	118454009	118456292	CpG: 200	2283	200	1511	17.5	66.2	0.80
chr11	118502537	118502773	CpG: 18	236	18	145	15.3	61.4	0.83
chr11	118511676	118511918	CpG: 20	242	20	147	16.5	60.7	0.91
chr11	118538086	118538291	CpG: 15	205	15	118	14.6	57.6	0.90
chr11	118549782	118550643	CpG: 109	861	109	647	25.3	75.1	0.90
chr11	118591587	118592201	CpG: 47	614	47	421	15.3	68.6	0.65
chr11	118626766	118630410	CpG: 289	3644	289	2511	15.9	68.9	0.69
chr11	118640583	118640784	CpG: 26	201	26	157	25.9	78.1	0.85
chr11	118654016	118654415	CpG: 36	399	36	285	18.0	71.4	0.71
chr11	118665206	118665440	CpG: 19	234	19	143	16.2	61.1	0.89
chr11	118708170	118708558	CpG: 32	388	32	279	16.5	71.9	0.64
chr11	118809667	118811388	CpG: 157	1721	157	1182	18.2	68.7	0.77
chr11	118857504	118857778	CpG: 24	274	24	171	17.5	62.4	0.91
chr11	118860175	118860407	CpG: 16	232	16	139	13.8	59.9	0.78
chr11	118873208	118873494	CpG: 21	286	21	172	14.7	60.1	0.84
chr11	118930587	118931262	CpG: 64	675	64	498	19.0	73.8	0.70
chr11	118945482	118946354	CpG: 83	872	83	628	19.0	72.0	0.73
chr11	118988078	118988312	CpG: 17	234	17	142	14.5	60.7	0.81
chr11	118992079	118992636	CpG: 53	557	53	392	19.0	70.4	0.77
chr11	119011917	119012759	CpG: 68	842	68	585	16.2	69.5	0.67
chr11	119018284	119018848	CpG: 53	564	53	395	18.8	70.0	0.78
chr11	119033846	119034076	CpG: 18	230	18	140	15.7	60.9	0.86
chr11	119038529	119039961	CpG: 102	1432	102	856	14.2	59.8	0.80
chr11	119050637	119051400	CpG: 73	763	73	529	19.1	69.3	0.80
chr11	119051603	119051865	CpG: 20	262	20	159	15.3	60.7	0.84
chr11	119077014	119078053	CpG: 117	1039	117	749	22.5	72.1	0.88
chr11	119079543	119080168	CpG: 58	625	58	444	18.6	71.0	0.74
chr11	119087840	119088462	CpG: 45	622	45	370	14.5	59.5	0.82
chr11	119105255	119105513	CpG: 26	258	26	176	20.2	68.2	0.87
chr11	119114690	119116137	CpG: 160	1447	160	1001	22.1	69.2	0.92
chr11	119121852	119122080	CpG: 17	228	17	143	14.9	62.7	0.76
chr11	119127549	119128456	CpG: 103	907	103	672	22.7	74.1	0.83
chr11	119141552	119142417	CpG: 74	865	74	553	17.1	63.9	0.84
chr11	119169301	119170545	CpG: 118	1244	118	899	19.0	72.3	0.73
chr11	119183228	119183466	CpG: 18	238	18	141	15.1	59.2	0.88
chr11	119189088	119189603	CpG: 59	515	59	393	22.9	76.3	0.80
chr11	119226304	119227217	CpG: 113	913	113	696	24.8	76.2	0.86
chr11	119250581	119250806	CpG: 18	225	18	137	16.0	60.9	0.89
chr11	119291101	119291375	CpG: 24	274	24	171	17.5	62.4	0.91
chr11	119331319	119331593	CpG: 19	274	19	179	13.9	65.3	0.66
chr11	119336870	119338069	CpG: 113	1199	113	855	18.8	71.3	0.74
chr11	119341458	119342105	CpG: 59	647	59	464	18.2	71.7	0.71
chr11	119354950	119355495	CpG: 50	545	50	347	18.3	63.7	0.92
chr11	119360217	119361585	CpG: 138	1368	138	1003	20.2	73.3	0.76
chr11	119377916	119378620	CpG: 59	704	59	452	16.8	64.2	0.82
chr11	119385299	119386033	CpG: 97	734	97	568	26.4	77.4	0.88
chr11	119402951	119403385	CpG: 42	434	42	294	19.4	67.7	0.85
chr11	119408034	119408305	CpG: 19	271	19	165	14.0	60.9	0.77
chr11	119443522	119443724	CpG: 22	202	22	142	21.8	70.3	0.89
chr11	119444153	119444776	CpG: 48	623	48	436	15.4	70.0	0.66
chr11	119606474	119607423	CpG: 81	949	81	628	17.1	66.2	0.78
chr11	119687720	119688153	CpG: 38	433	38	291	17.6	67.2	0.79
chr11	119750498	119752616	CpG: 221	2118	221	1476	20.9	69.7	0.86
chr11	119764179	119764612	CpG: 39	433	39	303	18.0	70.0	0.74
chr11	119764964	119765609	CpG: 45	645	45	410	14.0	63.6	0.69
chr11	119871509	119871739	CpG: 20	230	20	140	17.4	60.9	0.95
chr11	120049093	120049681	CpG: 55	588	55	433	18.7	73.6	0.69
chr11	120160176	120160840	CpG: 49	664	49	433	14.8	65.2	0.69
chr11	120191707	120192416	CpG: 84	709	84	506	23.7	71.4	0.95
chr11	120233617	120234475	CpG: 111	858	111	638	25.9	74.4	0.94
chr11	120262580	120263124	CpG: 53	544	53	395	19.5	72.6	0.74
chr11	120347898	120348465	CpG: 75	567	75	434	26.5	76.5	0.91
chr11	120359498	120360687	CpG: 148	1189	148	873	24.9	73.4	0.93
chr11	120517177	120517412	CpG: 18	235	18	136	15.3	57.9	0.94
chr11	120534917	120535975	CpG: 147	1058	147	841	27.8	79.5	0.92
chr11	120580761	120581042	CpG: 22	281	22	174	15.7	61.9	0.84
chr11	120587142	120588257	CpG: 116	1115	116	789	20.8	70.8	0.83
chr11	120707728	120707936	CpG: 18	208	18	126	17.3	60.6	0.96
chr11	120934983	120935218	CpG: 21	235	21	143	17.9	60.9	0.99
chr11	121009660	121010153	CpG: 61	493	61	362	24.7	73.4	0.92
chr11	121045411	121045802	CpG: 41	391	41	294	21.0	75.2	0.74
chr11	121047726	121048119	CpG: 44	393	44	294	22.4	74.8	0.82
chr11	121151671	121152171	CpG: 38	500	38	320	15.2	64.0	0.75
chr11	121181879	121182234	CpG: 38	355	38	218	21.4	61.4	1.18
chr11	121214500	121214771	CpG: 20	271	20	164	14.8	60.5	0.81
chr11	121233947	121234221	CpG: 24	274	24	171	17.5	62.4	0.91
chr11	121317593	121318301	CpG: 75	708	75	490	21.2	69.2	0.91
chr11	121389239	121389492	CpG: 39	253	39	193	30.8	76.3	1.08
chr11	121453420	121453638	CpG: 37	218	37	174	33.9	79.8	1.07
chr11	121478015	121478779	CpG: 100	764	100	553	26.2	72.4	1.00
chr11	121850132	121850356	CpG: 19	224	19	134	17.0	59.8	0.95
chr11	121923231	121923494	CpG: 24	263	24	164	18.3	62.4	0.95
chr11	122077018	122077246	CpG: 16	228	16	136	14.0	59.6	0.80
chr11	122171501	122171744	CpG: 19	243	19	146	15.6	60.1	0.89
chr11	122310878	122311115	CpG: 18	237	18	145	15.2	61.2	0.83
chr11	122326553	122326783	CpG: 18	230	18	139	15.7	60.4	0.87
chr11	122374157	122374382	CpG: 17	225	17	133	15.1	59.1	0.89
chr11	122436003	122436377	CpG: 31	374	31	222	16.6	59.4	0.97
chr11	122584344	122584604	CpG: 31	260	31	196	23.8	75.4	0.84
chr11	122683207	122684408	CpG: 119	1201	119	852	19.8	70.9	0.79
chr11	122742632	122742854	CpG: 19	222	19	136	17.1	61.3	0.93
chr11	122910441	122911006	CpG: 74	565	74	431	26.2	76.3	0.93
chr11	123004506	123005620	CpG: 86	1114	86	706	15.4	63.4	0.79
chr11	123006549	123007305	CpG: 60	756	60	470	15.9	62.2	0.82
chr11	123009425	123009713	CpG: 21	288	21	196	14.6	68.1	0.66
chr11	123011959	123012611	CpG: 55	652	55	437	16.9	67.0	0.76
chr11	123052010	123052285	CpG: 21	275	21	169	15.3	61.5	0.82
chr11	123060911	123061202	CpG: 24	291	24	183	16.5	62.9	0.85
chr11	123090049	123091679	CpG: 125	1630	125	1046	15.3	64.2	0.75
chr11	123104031	123104266	CpG: 19	235	19	139	16.2	59.1	0.95
chr11	123171211	123171496	CpG: 25	285	25	180	17.5	63.2	0.90
chr11	123223233	123224793	CpG: 121	1560	121	1030	15.5	66.0	0.71
chr11	123239303	123239567	CpG: 20	264	20	158	15.2	59.8	0.85
chr11	123313362	123313639	CpG: 26	277	26	175	18.8	63.2	0.95
chr11	123330170	123330841	CpG: 57	671	57	439	17.0	65.4	0.79
chr11	123386856	123387203	CpG: 42	347	42	257	24.2	74.1	0.88
chr11	123458684	123459784	CpG: 112	1100	112	766	20.4	69.6	0.84
chr11	123605752	123606041	CpG: 27	289	27	195	18.7	67.5	0.82
chr11	123682998	123683951	CpG: 96	953	96	676	20.1	70.9	0.81
chr11	123701304	123701532	CpG: 17	228	17	144	14.9	63.2	0.78
chr11	123769976	123770623	CpG: 64	647	64	450	19.8	69.6	0.83
chr11	124164126	124164400	CpG: 25	274	25	172	18.2	62.8	0.93
chr11	124199226	124199579	CpG: 39	353	39	262	22.1	74.2	0.80
chr11	124432028	124432659	CpG: 53	631	53	428	16.8	67.8	0.73
chr11	124619690	124619920	CpG: 17	230	17	136	14.8	59.1	0.86
chr11	124651432	124651921	CpG: 44	489	44	320	18.0	65.4	0.84
chr11	124702146	124702808	CpG: 55	662	55	423	16.6	63.9	0.82
chr11	124733206	124733434	CpG: 23	228	23	185	20.2	81.1	0.61
chr11	124746852	124747200	CpG: 32	348	32	238	18.4	68.4	0.79
chr11	124768319	124769238	CpG: 76	919	76	625	16.5	68.0	0.72
chr11	124774156	124775773	CpG: 111	1617	111	1036	13.7	64.1	0.67
chr11	124787135	124788358	CpG: 82	1223	82	777	13.4	63.5	0.66
chr11	124788491	124788694	CpG: 17	203	17	144	16.7	70.9	0.67
chr11	124790831	124792007	CpG: 113	1176	113	804	19.2	68.4	0.83
chr11	124828151	124829294	CpG: 129	1143	129	829	22.6	72.5	0.86
chr11	124865400	124865631	CpG: 19	231	19	138	16.5	59.7	0.93
chr11	124868000	124868735	CpG: 85	735	85	527	23.1	71.7	0.90
chr11	124871678	124872146	CpG: 42	468	42	303	17.9	64.7	0.86
chr11	124893795	124895191	CpG: 111	1396	111	907	15.9	65.0	0.75
chr11	124897438	124897737	CpG: 39	299	39	210	26.1	70.2	1.06
chr11	124904637	124905501	CpG: 73	864	73	601	16.9	69.6	0.71
chr11	124949555	124950095	CpG: 77	540	77	405	28.5	75.0	1.01
chr11	124982540	124983076	CpG: 45	536	45	338	16.8	63.1	0.85
chr11	125091498	125092425	CpG: 82	927	82	638	17.7	68.8	0.75
chr11	125118163	125118560	CpG: 36	397	36	293	18.1	73.8	0.67
chr11	125140084	125140534	CpG: 38	450	38	280	16.9	62.2	0.93
chr11	125193015	125195447	CpG: 214	2432	214	1629	17.6	67.0	0.82
chr11	125444725	125444999	CpG: 24	274	24	172	17.5	62.8	0.90
chr11	125523935	125525098	CpG: 116	1163	116	800	19.9	68.8	0.85
chr11	125526379	125526611	CpG: 19	232	19	142	16.4	61.2	0.89
chr11	125565283	125565657	CpG: 28	374	28	222	15.0	59.4	0.85
chr11	125597874	125598482	CpG: 78	608	78	461	25.7	75.8	0.90
chr11	125621085	125621646	CpG: 49	561	49	340	17.5	60.6	0.95
chr11	125653960	125654593	CpG: 57	633	57	403	18.0	63.7	0.90
chr11	125668891	125669126	CpG: 20	235	20	145	17.0	61.7	0.91
chr11	125732454	125732701	CpG: 19	247	19	143	15.4	57.9	0.94
chr11	125797819	125798094	CpG: 22	275	22	169	16.0	61.5	0.86
chr11	125890749	125893020	CpG: 207	2271	207	1762	18.2	77.6	0.61
chr11	125895530	125895804	CpG: 23	274	23	169	16.8	61.7	0.89
chr11	125899948	125900179	CpG: 20	231	20	141	17.3	61.0	0.94
chr11	125916032	125917084	CpG: 105	1052	105	706	20.0	67.1	0.89
chr11	125917361	125917624	CpG: 22	263	22	166	16.7	63.1	0.85
chr11	125929602	125929867	CpG: 22	265	22	169	16.6	63.8	0.83
chr11	125932993	125933539	CpG: 71	546	71	416	26.0	76.2	0.90
chr11	125936179	125936415	CpG: 17	236	17	143	14.4	60.6	0.81
chr11	126090998	126092273	CpG: 136	1275	136	928	21.3	72.8	0.81
chr11	126098221	126098502	CpG: 25	281	25	176	17.8	62.6	0.93
chr11	126240972	126241665	CpG: 62	693	62	442	17.9	63.8	0.88
chr11	126243601	126243840	CpG: 18	239	18	143	15.1	59.8	0.86
chr11	126297948	126298755	CpG: 77	807	77	530	19.1	65.7	0.92
chr11	126314227	126314905	CpG: 80	678	80	495	23.6	73.0	0.89
chr11	126334341	126334615	CpG: 24	274	24	160	17.5	58.4	1.03
chr11	126335071	126335574	CpG: 45	503	45	331	17.9	65.8	0.83
chr11	126359462	126359684	CpG: 18	222	18	152	16.2	68.5	0.78
chr11	126386865	126387583	CpG: 92	718	92	549	25.6	76.5	0.89
chr11	126447994	126448413	CpG: 49	419	49	304	23.4	72.6	0.89
chr11	126616432	126616669	CpG: 19	237	19	142	16.0	59.9	0.91
chr11	127033461	127033787	CpG: 27	326	27	203	16.6	62.3	0.86
chr11	127036326	127037045	CpG: 63	719	63	504	17.5	70.1	0.71
chr11	127344268	127344494	CpG: 17	226	17	131	15.0	58.0	0.94
chr11	127356256	127356537	CpG: 22	281	22	172	15.7	61.2	0.85
chr11	127396282	127396509	CpG: 20	227	20	138	17.6	60.8	0.96
chr11	127513041	127513308	CpG: 25	267	25	165	18.7	61.8	0.99
chr11	127761756	127762030	CpG: 23	274	23	170	16.8	62.0	0.88
chr11	127815305	127815631	CpG: 25	326	25	194	15.3	59.5	0.87
chr11	127825616	127825852	CpG: 17	236	17	143	14.4	60.6	0.82
chr11	127857427	127857700	CpG: 23	273	23	166	16.8	60.8	0.92
chr11	128032298	128032565	CpG: 20	267	20	163	15.0	61.0	0.82
chr11	128206345	128206581	CpG: 21	236	21	145	17.8	61.4	0.97
chr11	128270309	128270698	CpG: 38	389	38	284	19.5	73.0	0.73
chr11	128485111	128485345	CpG: 20	234	20	154	17.1	65.8	0.79
chr11	128555149	128556048	CpG: 101	899	101	623	22.5	69.3	0.94
chr11	128582561	128582955	CpG: 36	394	36	259	18.3	65.7	0.87
chr11	128604502	128604848	CpG: 25	346	25	213	14.5	61.6	0.77
chr11	128720197	128720458	CpG: 30	261	30	173	23.0	66.3	1.05
chr11	128723019	128723870	CpG: 60	851	60	524	14.1	61.6	0.75
chr11	128726004	128728371	CpG: 207	2367	207	1579	17.5	66.7	0.79
chr11	128843600	128843811	CpG: 16	211	16	133	15.2	63.0	0.77
chr11	128856671	128857275	CpG: 56	604	56	429	18.5	71.0	0.77
chr11	128925477	128926269	CpG: 85	792	85	568	21.5	71.7	0.84
chr11	129037792	129038016	CpG: 18	224	18	137	16.1	61.2	0.89
chr11	129064448	129064681	CpG: 17	233	17	138	14.6	59.2	0.85
chr11	129121427	129121663	CpG: 17	236	17	142	14.4	60.2	0.82
chr11	129163651	129164454	CpG: 61	803	61	570	15.2	71.0	0.60
chr11	129209567	129209794	CpG: 17	227	17	133	15.0	58.6	0.87
chr11	129314114	129315531	CpG: 212	1417	212	1102	29.9	77.8	0.99
chr11	129399721	129399951	CpG: 17	230	17	140	14.8	60.9	0.80
chr11	129408134	129412000	CpG: 309	3866	309	2370	16.0	61.3	0.85
chr11	129472257	129472480	CpG: 17	223	17	153	15.2	68.6	0.68
chr11	129498434	129498704	CpG: 23	270	23	169	17.0	62.6	0.88
chr11	129520405	129520627	CpG: 17	222	17	134	15.3	60.4	0.86
chr11	129562704	129562934	CpG: 17	230	17	138	14.8	60.0	0.83
chr11	129615598	129615941	CpG: 25	343	25	268	14.6	78.1	0.64
chr11	129653790	129654134	CpG: 37	344	37	251	21.5	73.0	0.81
chr11	129695898	129696159	CpG: 26	261	26	167	19.9	64.0	0.99
chr11	129729439	129729672	CpG: 16	233	16	137	13.7	58.8	0.82
chr11	129851333	129851957	CpG: 64	624	64	463	20.5	74.2	0.78
chr11	129852401	129852730	CpG: 22	329	22	188	13.4	57.1	0.84
chr11	129883874	129884092	CpG: 22	218	22	140	20.2	64.2	0.98
chr11	129898457	129898720	CpG: 21	263	21	159	16.0	60.5	0.89
chr11	129925374	129925648	CpG: 25	274	25	172	18.2	62.8	0.94
chr11	129931277	129931749	CpG: 60	472	60	366	25.4	77.5	0.86
chr11	129967653	129967900	CpG: 20	247	20	149	16.2	60.3	0.93
chr11	129980338	129980569	CpG: 21	231	21	143	18.2	61.9	0.97
chr11	130007819	130008198	CpG: 34	379	34	276	17.9	72.8	0.68
chr11	130037821	130039554	CpG: 177	1733	177	1204	20.4	69.5	0.85
chr11	130057666	130058069	CpG: 41	403	41	301	20.3	74.7	0.73
chr11	130058618	130058833	CpG: 17	215	17	117	15.8	54.4	1.11
chr11	130068936	130069337	CpG: 47	401	47	278	23.4	69.3	0.98
chr11	130076402	130077130	CpG: 55	728	55	454	15.1	62.4	0.78
chr11	130080274	130080839	CpG: 44	565	44	388	15.6	68.7	0.66
chr11	130105154	130107133	CpG: 223	1979	223	1417	22.5	71.6	0.89
chr11	130126940	130128249	CpG: 108	1309	108	966	16.5	73.8	0.61
chr11	130159298	130159571	CpG: 23	273	23	163	16.8	59.7	0.95
chr11	130195233	130196036	CpG: 95	803	95	604	23.7	75.2	0.85
chr11	130225300	130225524	CpG: 22	224	22	159	19.6	71.0	0.78
chr11	130242036	130242251	CpG: 17	215	17	135	15.8	62.8	0.81
chr11	130244085	130244579	CpG: 37	494	37	322	15.0	65.2	0.71
chr11	130245111	130245553	CpG: 37	442	37	302	16.7	68.3	0.72
chr11	130349890	130350960	CpG: 119	1070	119	793	22.2	74.1	0.83
chr11	130463320	130464436	CpG: 135	1116	135	853	24.2	76.4	0.83
chr11	130484061	130486025	CpG: 172	1964	172	1277	17.5	65.0	0.83
chr11	130504209	130504445	CpG: 18	236	18	143	15.3	60.6	0.85
chr11	130508782	130509478	CpG: 51	696	51	474	14.7	68.1	0.63
chr11	130582629	130582927	CpG: 20	298	20	184	13.4	61.7	0.71
chr11	130676871	130677154	CpG: 25	283	25	177	17.7	62.5	0.91
chr11	130951970	130952494	CpG: 70	524	70	377	26.7	71.9	1.03
chr11	131119973	131120841	CpG: 63	868	63	599	14.5	69.0	0.61
chr11	131668579	131668855	CpG: 20	276	20	165	14.5	59.8	0.82
chr11	131727752	131727955	CpG: 16	203	16	127	15.8	62.6	0.81
chr11	131728333	131729123	CpG: 67	790	67	554	17.0	70.1	0.70
chr11	131947709	131948913	CpG: 144	1204	144	852	23.9	70.8	0.96
chr11	132252277	132252554	CpG: 25	277	25	174	18.1	62.8	0.92
chr11	132479749	132480024	CpG: 23	275	23	173	16.7	62.9	0.85
chr11	132504773	132505051	CpG: 21	278	21	163	15.1	58.6	0.88
chr11	132981198	132981611	CpG: 33	413	33	286	16.0	69.2	0.68
chr11	132982098	132982931	CpG: 113	833	113	630	27.1	75.6	0.95
chr11	133103986	133104218	CpG: 20	232	20	163	17.2	70.3	0.71
chr11	133123098	133123884	CpG: 99	786	99	599	25.2	76.2	0.89
chr11	133329710	133329976	CpG: 24	266	24	167	18.0	62.8	0.93
chr11	133402572	133403333	CpG: 56	761	56	510	14.7	67.0	0.66
chr11	133431731	133432004	CpG: 24	273	24	157	17.6	57.5	1.08
chr11	133682499	133682725	CpG: 21	226	21	135	18.6	59.7	1.04
chr11	133730980	133731257	CpG: 23	277	23	172	16.6	62.1	0.87
chr11	133829114	133829725	CpG: 47	611	47	393	15.4	64.3	0.74
chr11	133874129	133876107	CpG: 176	1978	176	1482	17.8	74.9	0.74
chr11	133907098	133907561	CpG: 33	463	33	293	14.3	63.3	0.71
chr11	133936030	133936273	CpG: 19	243	19	147	15.6	60.5	0.87
chr11	133973005	133973252	CpG: 21	247	21	176	17.0	71.3	0.67
chr11	133982449	133983556	CpG: 127	1107	127	617	22.9	55.7	1.78
chr11	133998224	134000345	CpG: 221	2121	221	1508	20.8	71.1	0.83
chr11	134045621	134046016	CpG: 39	395	39	299	19.7	75.7	0.69
chr11	134079624	134080367	CpG: 65	743	65	519	17.5	69.9	0.72
chr11	134081221	134081495	CpG: 24	274	24	170	17.5	62.0	0.92
chr11	134093382	134093860	CpG: 37	478	37	316	15.5	66.1	0.73
chr11	134111896	134112675	CpG: 83	779	83	580	21.3	74.5	0.79
chr11	134166949	134167330	CpG: 47	381	47	263	24.7	69.0	1.05
chr11	134265509	134267436	CpG: 197	1927	197	1308	20.4	67.9	0.89
chr11	134280504	134280728	CpG: 17	224	17	135	15.2	60.3	0.86
chr11	134294713	134294932	CpG: 17	219	17	117	15.5	53.4	1.09
chr11	134295160	134295947	CpG: 83	787	83	574	21.1	72.9	0.81
chr11	134317491	134319112	CpG: 162	1621	162	1135	20.0	70.0	0.83
chr11	134328320	134328595	CpG: 21	275	21	172	15.3	62.5	0.80
chr11	134373180	134374142	CpG: 114	962	114	719	23.7	74.7	0.89
chr11	134383510	134384330	CpG: 76	820	76	569	18.5	69.4	0.77
chr11	134403446	134403677	CpG: 21	231	21	156	18.2	67.5	0.81
chr11	134425168	134425870	CpG: 86	702	86	498	24.5	70.9	0.98
chr11	134429149	134429352	CpG: 16	203	16	130	15.8	64.0	0.78
chr11	134453185	134454742	CpG: 192	1557	192	1202	24.7	77.2	0.83
chr11	134508658	134508868	CpG: 16	210	16	135	15.2	64.3	0.74
chr11	134525766	134526002	CpG: 19	236	19	130	16.1	55.1	1.09
chr11	134565839	134566562	CpG: 124	723	124	594	34.3	82.2	1.05
chr11	134756363	134756696	CpG: 34	333	34	229	20.4	68.8	0.89
chr11	134779203	134779948	CpG: 56	745	56	474	15.0	63.6	1.05
chr11	134806573	134807511	CpG: 83	938	83	661	17.7	70.5	0.73
chr11	135009354	135010188	CpG: 80	834	80	553	19.2	66.3	0.98
chr11	135075759	135076043	CpG: 23	284	23	169	16.2	59.5	0.92
chr11	135124195	135125126	CpG: 192	931	192	754	41.2	81.0	1.27
chr12	3446	4356	CpG: 159	910	159	711	34.9	78.1	1.16
chr12	21851	22853	CpG: 111	1002	111	732	22.2	73.1	0.85
chr12	58621	59355	CpG: 79	734	79	539	21.5	73.4	0.80
chr12	69891	70638	CpG: 92	747	92	576	24.6	77.1	0.83
chr12	96544	96887	CpG: 30	343	30	289	17.5	84.3	0.80
chr12	97584	98048	CpG: 41	464	41	305	17.7	65.7	0.82
chr12	100464	100697	CpG: 18	233	18	143	15.5	61.4	0.84
chr12	131274	132320	CpG: 102	1046	102	740	19.5	70.7	0.78
chr12	184097	185320	CpG: 97	1223	97	841	15.9	68.8	0.67
chr12	200347	201087	CpG: 87	740	87	535	23.5	72.3	0.91
chr12	385785	386638	CpG: 77	853	77	534	18.1	62.6	0.92
chr12	398244	398512	CpG: 25	268	25	171	18.7	63.8	0.92
chr12	443636	443910	CpG: 21	274	21	169	15.3	61.7	0.82
chr12	448625	449958	CpG: 114	1333	114	861	17.1	64.6	0.82
chr12	455073	456733	CpG: 190	1660	190	1207	22.9	72.7	0.87
chr12	502278	502514	CpG: 19	236	19	143	16.1	60.6	0.90
chr12	542700	543174	CpG: 44	474	44	320	18.6	67.5	0.82
chr12	565755	566095	CpG: 35	340	35	227	20.6	66.8	0.92
chr12	572179	572621	CpG: 38	442	38	284	17.2	64.3	0.83
chr12	604728	605117	CpG: 66	389	66	278	33.9	71.5	1.33
chr12	638089	639504	CpG: 139	1415	139	971	19.6	68.6	0.84
chr12	748140	750111	CpG: 207	1971	207	1390	21.0	70.5	0.85
chr12	803479	803719	CpG: 23	240	23	150	19.2	62.5	1.00
chr12	840652	840888	CpG: 20	236	20	144	16.9	61.0	0.93
chr12	944492	946297	CpG: 131	1805	131	1099	14.5	60.9	0.78
chr12	967650	967871	CpG: 17	221	17	137	15.4	62.0	0.81
chr12	986282	987512	CpG: 148	1230	148	886	24.1	72.0	0.93
chr12	1173845	1174119	CpG: 21	274	21	169	15.3	61.7	0.81
chr12	1237205	1237492	CpG: 23	287	23	178	16.0	62.0	0.85
chr12	1258688	1258956	CpG: 20	268	20	163	14.9	60.8	0.82
chr12	1299121	1299327	CpG: 17	206	17	126	16.5	61.2	0.89
chr12	1340944	1341229	CpG: 23	285	23	178	16.1	62.5	0.85
chr12	1379599	1379876	CpG: 21	277	21	171	15.2	61.7	0.81
chr12	1502951	1503190	CpG: 19	239	19	148	15.9	61.9	0.85
chr12	1524208	1525926	CpG: 253	1718	253	1354	29.5	78.8	0.95
chr12	1540708	1540924	CpG: 16	216	16	129	14.8	59.7	0.83
chr12	1563771	1564007	CpG: 17	236	17	141	14.4	59.7	0.82
chr12	1589030	1590624	CpG: 197	1594	197	1194	24.7	74.9	0.89
chr12	1626494	1627041	CpG: 56	547	56	407	20.5	74.4	0.76
chr12	1635559	1636259	CpG: 63	700	63	463	18.0	66.1	0.82
chr12	1642192	1642438	CpG: 23	246	23	173	18.7	70.3	0.76
chr12	1657717	1659964	CpG: 158	2247	158	1613	14.1	71.8	0.66
chr12	1687323	1688188	CpG: 101	865	101	602	23.4	69.6	0.96
chr12	1792212	1793922	CpG: 150	1710	150	1187	17.5	69.4	0.73
chr12	1813758	1814354	CpG: 48	596	48	399	16.1	66.9	0.72
chr12	1816464	1816667	CpG: 19	203	19	136	18.7	67.0	0.85
chr12	1860734	1861953	CpG: 99	1219	99	770	16.2	63.2	0.82
chr12	1904133	1905317	CpG: 117	1184	117	798	19.8	67.4	0.90
chr12	2000305	2000843	CpG: 48	538	48	358	17.8	66.5	0.85
chr12	2039804	2040077	CpG: 21	273	21	168	15.4	61.5	0.83
chr12	2048504	2050508	CpG: 254	2004	254	1461	25.3	72.9	0.96
chr12	2111042	2111278	CpG: 19	236	19	163	16.1	69.1	0.68
chr12	2124270	2124507	CpG: 19	237	19	139	16.0	58.6	0.95
chr12	2131676	2132102	CpG: 31	426	31	255	14.6	59.9	0.81
chr12	2225559	2226254	CpG: 59	695	59	484	17.0	69.6	0.74
chr12	2380830	2381104	CpG: 24	274	24	171	17.5	62.4	0.91
chr12	2476123	2476355	CpG: 16	232	16	136	13.8	58.6	0.81
chr12	2568894	2569178	CpG: 25	284	25	179	17.6	63.0	0.90
chr12	2581874	2582148	CpG: 25	274	25	172	18.2	62.8	0.94
chr12	2586991	2587312	CpG: 38	321	38	238	23.7	74.1	0.87
chr12	2683431	2683682	CpG: 22	251	22	165	17.5	65.7	0.88
chr12	2687262	2687465	CpG: 16	203	16	105	15.8	51.7	1.91
chr12	2696410	2697347	CpG: 91	937	91	640	19.4	68.3	0.84
chr12	2758172	2759041	CpG: 73	869	73	603	16.8	69.4	0.70
chr12	2768420	2768651	CpG: 19	231	19	140	16.5	60.6	0.91
chr12	2799671	2799875	CpG: 17	204	17	120	16.7	58.8	0.96
chr12	2800222	2802022	CpG: 218	1800	218	1337	24.2	74.3	0.88
chr12	2817026	2817265	CpG: 19	239	19	143	15.9	59.8	0.90
chr12	2818683	2818961	CpG: 27	278	27	177	19.4	63.7	0.98
chr12	2882823	2883484	CpG: 78	661	78	496	23.6	75.0	0.85
chr12	2896441	2897414	CpG: 100	973	100	665	20.6	68.3	0.89
chr12	2935051	2935289	CpG: 21	238	21	148	17.6	62.2	0.93
chr12	2949905	2950147	CpG: 17	242	17	143	14.0	59.1	0.81
chr12	2951081	2951301	CpG: 18	220	18	135	16.4	61.4	0.90
chr12	2964914	2966399	CpG: 188	1485	188	1117	25.3	75.2	0.90
chr12	3060196	3060413	CpG: 18	217	18	132	16.6	60.8	0.91
chr12	3082976	3083933	CpG: 113	957	113	732	23.6	76.5	0.81
chr12	3101584	3102135	CpG: 52	551	52	404	18.9	73.3	0.70
chr12	3180671	3180907	CpG: 20	236	20	144	16.9	61.0	0.95
chr12	3206141	3207599	CpG: 160	1458	160	1028	21.9	70.5	0.88
chr12	3372359	3373004	CpG: 85	645	85	489	26.4	75.8	0.93
chr12	3404310	3404626	CpG: 24	316	24	198	15.2	62.7	0.78
chr12	3497342	3500384	CpG: 222	3042	222	1935	14.6	63.6	0.72
chr12	3511327	3511619	CpG: 24	292	24	178	16.4	61.0	0.89
chr12	3513752	3513959	CpG: 18	207	18	124	17.4	59.9	1.00
chr12	3759477	3760015	CpG: 59	538	59	395	21.9	73.4	0.82
chr12	3791536	3791761	CpG: 17	225	17	131	15.1	58.2	0.92
chr12	3828993	3829272	CpG: 24	279	24	176	17.2	63.1	0.88
chr12	3845429	3846127	CpG: 95	698	95	511	27.2	73.2	1.02
chr12	3879742	3880204	CpG: 44	462	44	303	19.0	65.6	0.91
chr12	3959073	3959314	CpG: 20	241	20	149	16.6	61.8	0.89
chr12	3986240	3986506	CpG: 19	266	19	162	14.3	60.9	0.79
chr12	4037701	4038603	CpG: 88	902	88	621	19.5	68.8	0.82
chr12	4045783	4046005	CpG: 16	222	16	135	14.4	60.8	0.79
chr12	4131051	4131321	CpG: 24	270	24	171	17.8	63.3	0.89
chr12	4156222	4156462	CpG: 19	240	19	147	15.8	61.2	0.86
chr12	4171397	4172069	CpG: 54	672	54	451	16.1	67.1	0.74
chr12	4188444	4188704	CpG: 19	260	19	159	14.6	61.2	0.80
chr12	4250517	4250820	CpG: 39	303	39	197	25.7	65.0	1.57
chr12	4275962	4281998	CpG: 405	6036	405	3682	13.4	61.0	0.72
chr12	4326670	4326914	CpG: 19	244	19	147	15.6	60.2	0.88
chr12	4327482	4328364	CpG: 83	882	83	584	18.8	66.2	0.86
chr12	4331351	4331597	CpG: 23	246	23	158	18.7	64.2	0.91
chr12	4377133	4377584	CpG: 38	451	38	293	16.9	65.0	0.81
chr12	4452023	4452318	CpG: 22	295	22	196	14.9	66.4	0.68
chr12	4515821	4516130	CpG: 24	309	24	187	15.5	60.5	0.85
chr12	4545465	4545674	CpG: 20	209	20	129	19.1	61.7	1.06
chr12	4568930	4569325	CpG: 39	395	39	247	19.7	62.5	1.02
chr12	4655851	4656105	CpG: 22	254	22	150	17.3	59.1	1.03
chr12	4816126	4817510	CpG: 138	1384	138	969	19.9	70.0	0.83
chr12	4893949	4894208	CpG: 21	259	21	165	16.2	63.7	0.81
chr12	4916466	4919052	CpG: 202	2586	202	1640	15.6	63.4	0.78
chr12	5050165	5051548	CpG: 128	1383	128	952	18.5	68.8	0.78
chr12	5055365	5055650	CpG: 24	285	24	180	16.8	63.2	0.86
chr12	5128334	5128795	CpG: 33	461	33	274	14.3	59.4	0.82
chr12	5149438	5149733	CpG: 25	295	25	149	16.9	50.5	2.31
chr12	5149925	5150147	CpG: 19	222	19	137	17.1	61.7	0.93
chr12	5176527	5176764	CpG: 21	237	21	146	17.7	61.6	0.96
chr12	5296691	5297000	CpG: 24	309	24	193	15.5	62.5	0.80
chr12	5400109	5400389	CpG: 25	280	25	176	17.9	62.9	0.91
chr12	5436963	5437771	CpG: 56	808	56	472	13.9	58.4	0.81
chr12	5438171	5440031	CpG: 150	1860	150	1203	16.1	64.7	0.77
chr12	5501211	5501614	CpG: 32	403	32	236	15.9	58.6	0.93
chr12	5835308	5835517	CpG: 17	209	17	145	16.3	69.4	0.68
chr12	5895651	5895906	CpG: 19	255	19	147	14.9	57.6	0.93
chr12	5952730	5953113	CpG: 53	383	53	290	27.7	75.7	0.98
chr12	6008085	6008322	CpG: 19	237	19	142	16.0	59.9	0.92
chr12	6026765	6027051	CpG: 24	286	24	182	16.8	63.6	0.83
chr12	6064381	6065702	CpG: 97	1321	97	793	14.7	60.0	0.82
chr12	6095027	6095262	CpG: 21	235	21	147	17.9	62.6	0.95
chr12	6095801	6096013	CpG: 17	212	17	123	16.0	58.0	0.97
chr12	6140225	6140479	CpG: 29	254	29	190	22.8	74.8	0.82
chr12	6149804	6150195	CpG: 30	391	30	278	15.3	71.1	0.61
chr12	6152048	6152586	CpG: 38	538	38	312	14.1	58.0	0.84
chr12	6152915	6153221	CpG: 22	306	22	187	14.4	61.1	0.78
chr12	6167033	6167476	CpG: 40	443	40	322	18.1	72.7	0.68
chr12	6192981	6193212	CpG: 18	231	18	140	15.6	60.6	0.87
chr12	6198466	6198856	CpG: 35	390	35	284	17.9	72.8	0.68
chr12	6207596	6208836	CpG: 110	1240	110	866	17.7	69.8	0.74
chr12	6286136	6286884	CpG: 86	748	86	542	23.0	72.5	0.88
chr12	6297739	6299248	CpG: 134	1509	134	880	17.8	58.3	1.07
chr12	6319692	6320352	CpG: 77	660	77	514	23.3	77.9	0.78
chr12	6338498	6339157	CpG: 77	659	77	467	23.4	70.9	0.94
chr12	6359575	6359851	CpG: 24	276	24	170	17.4	61.6	0.93
chr12	6363073	6363308	CpG: 19	235	19	147	16.2	62.6	0.85
chr12	6373369	6374215	CpG: 74	846	74	591	17.5	69.9	0.73
chr12	6375976	6376212	CpG: 17	236	17	137	14.4	58.1	0.87
chr12	6393785	6394418	CpG: 55	633	55	462	17.4	73.0	0.68
chr12	6480727	6481601	CpG: 77	874	77	565	17.6	64.6	0.85
chr12	6488003	6488295	CpG: 22	292	22	203	15.1	69.5	0.62
chr12	6503545	6503771	CpG: 22	226	22	154	19.5	68.1	0.87
chr12	6504104	6504491	CpG: 41	387	41	256	21.2	66.1	0.97
chr12	6544451	6545797	CpG: 123	1346	123	913	18.3	67.8	0.80
chr12	6550867	6551087	CpG: 21	220	21	143	19.1	65.0	0.91
chr12	6556903	6557143	CpG: 18	240	18	141	15.0	58.8	0.89
chr12	6558919	6559165	CpG: 21	246	21	175	17.1	71.1	0.68
chr12	6565618	6566529	CpG: 91	911	91	649	20.0	71.2	0.80
chr12	6578193	6579032	CpG: 75	839	75	537	17.9	64.0	0.89
chr12	6579148	6579384	CpG: 18	236	18	136	15.3	57.6	0.92
chr12	6616696	6617987	CpG: 122	1291	122	948	18.9	73.4	0.70
chr12	6630434	6631496	CpG: 118	1062	118	731	22.2	68.8	0.95
chr12	6657201	6657879	CpG: 55	678	55	445	16.2	65.6	0.78
chr12	6673459	6673780	CpG: 27	321	27	181	16.8	56.4	1.09
chr12	6699302	6700111	CpG: 74	809	74	543	18.3	67.1	0.82
chr12	6710269	6711267	CpG: 110	998	110	760	22.0	76.2	0.77
chr12	6715454	6715720	CpG: 23	266	23	164	17.3	61.7	0.93
chr12	6718672	6718997	CpG: 25	325	25	232	15.4	71.4	0.60
chr12	6726403	6726787	CpG: 34	384	34	282	17.7	73.4	0.66
chr12	6732779	6733052	CpG: 23	273	23	165	16.8	60.4	0.93
chr12	6734242	6734675	CpG: 41	433	41	283	18.9	65.4	0.92
chr12	6758372	6758656	CpG: 25	284	25	195	17.6	68.7	0.75
chr12	6762220	6762804	CpG: 56	584	56	424	19.2	72.6	0.75
chr12	6763071	6763388	CpG: 22	317	22	209	13.9	65.9	0.67
chr12	6775845	6777323	CpG: 173	1478	173	1069	23.4	72.3	0.92
chr12	6783255	6783584	CpG: 44	329	44	262	26.7	79.6	0.85
chr12	6816169	6816409	CpG: 20	240	20	147	16.7	61.2	0.91
chr12	6833403	6833732	CpG: 23	329	23	200	14.0	60.8	0.77
chr12	6837691	6838768	CpG: 120	1077	120	785	22.3	72.9	0.85
chr12	6861140	6862008	CpG: 77	868	77	557	17.7	64.2	0.86
chr12	6873707	6873943	CpG: 18	236	18	140	15.3	59.3	0.89
chr12	6876525	6877527	CpG: 112	1002	112	729	22.4	72.8	0.85
chr12	6882453	6883070	CpG: 61	617	61	437	19.8	70.8	0.81
chr12	6890985	6891221	CpG: 20	236	20	145	16.9	61.4	0.92
chr12	6900326	6900819	CpG: 59	493	59	345	23.9	70.0	0.99
chr12	6925277	6926105	CpG: 80	828	80	587	19.3	70.9	0.79
chr12	6938730	6939953	CpG: 149	1223	149	951	24.4	77.8	0.81
chr12	6948240	6949362	CpG: 106	1122	106	774	18.9	69.0	0.80
chr12	6955152	6955930	CpG: 66	778	66	492	17.0	63.2	0.86
chr12	6961226	6961514	CpG: 20	288	20	163	13.9	56.6	0.88
chr12	6983091	6983331	CpG: 20	240	20	141	16.7	58.8	0.99
chr12	6983812	6984441	CpG: 52	629	52	398	16.5	63.3	0.83
chr12	7002857	7003074	CpG: 17	217	17	130	15.7	59.9	0.90
chr12	7013776	7014009	CpG: 16	233	16	141	13.7	60.5	0.76
chr12	7017103	7017388	CpG: 24	285	24	178	16.8	62.5	0.88
chr12	7031700	7032522	CpG: 88	822	88	565	21.4	68.7	0.91
chr12	7050901	7051250	CpG: 31	349	31	255	17.8	73.1	0.67
chr12	7111070	7111344	CpG: 23	274	23	169	16.8	61.7	0.89
chr12	7202634	7203358	CpG: 64	724	64	518	17.7	71.5	0.69
chr12	7213230	7214120	CpG: 75	890	75	631	16.9	70.9	0.67
chr12	7293261	7293536	CpG: 24	275	24	171	17.5	62.2	0.91
chr12	7453198	7453822	CpG: 77	624	77	453	24.7	72.6	0.97
chr12	7464824	7465055	CpG: 20	231	20	140	17.3	60.6	0.95
chr12	7575503	7575784	CpG: 23	281	23	174	16.4	61.9	0.87
chr12	7642184	7643096	CpG: 169	912	169	765	37.1	83.9	1.12
chr12	7654084	7654489	CpG: 47	405	47	309	23.2	76.3	0.80
chr12	7685974	7686247	CpG: 23	273	23	171	16.8	62.6	0.87
chr12	7705644	7705875	CpG: 18	231	18	139	15.6	60.2	0.88
chr12	7720675	7721077	CpG: 33	402	33	258	16.4	64.2	0.81
chr12	7726614	7726939	CpG: 23	325	23	177	14.2	54.5	0.97
chr12	7766687	7767070	CpG: 35	383	35	285	18.3	74.4	0.66
chr12	7779896	7780132	CpG: 19	236	19	139	16.1	58.9	0.96
chr12	7876650	7876855	CpG: 20	205	20	144	19.5	70.2	0.82
chr12	7887034	7887636	CpG: 64	602	64	409	21.3	67.9	0.93
chr12	7895487	7895837	CpG: 36	350	36	261	20.6	74.6	0.74
chr12	7929469	7929717	CpG: 20	248	20	147	16.1	59.3	0.94
chr12	7929992	7930316	CpG: 29	324	29	233	17.9	71.9	0.70
chr12	7933666	7933902	CpG: 17	236	17	142	14.4	60.2	0.82
chr12	7953087	7953328	CpG: 20	241	20	140	16.6	58.1	1.01
chr12	7956217	7956419	CpG: 19	202	19	120	18.8	59.4	1.10
chr12	7967790	7968071	CpG: 20	281	20	168	14.2	59.8	0.81
chr12	7969146	7969676	CpG: 38	530	38	310	14.3	58.5	0.86
chr12	7976905	7977187	CpG: 23	282	23	169	16.3	59.9	0.92
chr12	7981203	7981443	CpG: 17	240	17	145	14.2	60.4	0.80
chr12	7984467	7985126	CpG: 52	659	52	389	15.8	59.0	0.91
chr12	8012973	8013209	CpG: 20	236	20	143	16.9	60.6	0.95
chr12	8032324	8032805	CpG: 50	481	50	326	20.8	67.8	0.91
chr12	8041004	8041291	CpG: 23	287	23	172	16.0	59.9	0.90
chr12	8045981	8046616	CpG: 83	635	83	480	26.1	75.6	0.93
chr12	8095693	8096024	CpG: 38	331	38	202	23.0	61.0	1.25
chr12	8108861	8109142	CpG: 24	281	24	175	17.1	62.3	0.90
chr12	8127900	8128136	CpG: 17	236	17	144	14.4	61.0	0.80
chr12	8193797	8194202	CpG: 42	405	42	297	20.7	73.3	0.78
chr12	8223806	8224080	CpG: 25	274	25	172	18.2	62.8	0.93
chr12	8235435	8235672	CpG: 18	237	18	135	15.2	57.0	0.94
chr12	8256528	8258190	CpG: 135	1662	135	1153	16.2	69.4	0.71
chr12	8352046	8352287	CpG: 21	241	21	149	17.4	61.8	0.92
chr12	8403944	8404723	CpG: 83	779	83	574	21.3	73.7	0.79
chr12	8410292	8410883	CpG: 71	591	71	449	24.0	76.0	0.84
chr12	8418246	8418584	CpG: 29	338	29	239	17.2	70.7	0.69
chr12	8501107	8501362	CpG: 20	255	20	149	15.7	58.4	0.94
chr12	8588609	8588938	CpG: 29	329	29	212	17.6	64.4	0.85
chr12	8616217	8616448	CpG: 19	231	19	140	16.5	60.6	0.91
chr12	8617140	8617418	CpG: 22	278	22	171	15.8	61.5	0.84
chr12	8626535	8626761	CpG: 22	226	22	140	19.5	61.9	1.05
chr12	8639402	8639626	CpG: 17	224	17	136	15.2	60.7	0.86
chr12	8665810	8666085	CpG: 25	275	25	179	18.2	65.1	0.88
chr12	8669808	8670047	CpG: 20	239	20	138	16.7	57.7	1.01
chr12	8680691	8682143	CpG: 187	1452	187	1059	25.8	72.9	0.98
chr12	8803719	8803955	CpG: 19	236	19	145	16.1	61.4	0.88
chr12	8828902	8829135	CpG: 19	233	19	139	16.3	59.7	0.93
chr12	8896595	8897129	CpG: 63	534	63	427	23.6	80.0	0.75
chr12	8905795	8906071	CpG: 20	276	20	167	14.5	60.5	0.80
chr12	8931787	8932440	CpG: 58	653	58	416	17.8	63.7	0.88
chr12	9046488	9047306	CpG: 79	818	79	600	19.3	73.3	0.72
chr12	9077961	9078242	CpG: 25	281	25	176	17.8	62.6	0.92
chr12	9111783	9112033	CpG: 19	250	19	146	15.2	58.4	0.89
chr12	9142871	9143094	CpG: 18	223	18	133	16.1	59.6	0.93
chr12	9176716	9176990	CpG: 21	274	21	169	15.3	61.7	0.81
chr12	9198841	9199118	CpG: 25	277	25	173	18.1	62.5	0.94
chr12	9222379	9222606	CpG: 18	227	18	126	15.9	55.5	1.03
chr12	9249135	9249377	CpG: 22	242	22	148	18.2	61.2	0.99
chr12	9266125	9266562	CpG: 39	437	39	279	17.8	63.8	0.91
chr12	9269910	9270112	CpG: 18	202	18	122	17.8	60.4	1.01
chr12	9331713	9332170	CpG: 31	457	31	306	13.6	67.0	0.61
chr12	9386626	9386974	CpG: 26	348	26	252	14.9	72.4	0.64
chr12	9387177	9388498	CpG: 109	1321	109	1009	16.5	76.4	0.60
chr12	9427008	9427250	CpG: 19	242	19	148	15.7	61.2	0.87
chr12	9430555	9431121	CpG: 50	566	50	367	17.7	64.8	0.87
chr12	9433129	9433496	CpG: 42	367	42	276	22.9	75.2	0.81
chr12	9462676	9463002	CpG: 27	326	27	194	16.6	59.5	0.94
chr12	9534188	9534499	CpG: 35	311	35	228	22.5	73.3	0.84
chr12	9557519	9557756	CpG: 20	237	20	146	16.9	61.6	0.91
chr12	9625757	9626322	CpG: 53	565	53	416	18.8	73.6	0.69
chr12	9888902	9889138	CpG: 19	236	19	143	16.1	60.6	0.91
chr12	9918861	9919098	CpG: 18	237	18	136	15.2	57.4	0.95
chr12	9934498	9934739	CpG: 22	241	22	151	18.3	62.7	0.97
chr12	9968083	9968322	CpG: 21	239	21	145	17.6	60.7	0.98
chr12	9998140	9998517	CpG: 38	377	38	246	20.2	65.3	0.96
chr12	10001828	10002068	CpG: 18	240	18	138	15.0	57.5	0.94
chr12	10010156	10010437	CpG: 23	281	23	173	16.4	61.6	0.88
chr12	10040121	10040551	CpG: 34	430	34	280	15.8	65.1	0.76
chr12	10098708	10099230	CpG: 38	522	38	302	14.6	57.9	0.87
chr12	10099474	10100200	CpG: 58	726	58	465	16.0	64.0	0.78
chr12	10112336	10112739	CpG: 37	403	37	291	18.4	72.2	0.71
chr12	10192672	10192907	CpG: 19	235	19	139	16.2	59.1	0.95
chr12	10199447	10199695	CpG: 18	248	18	145	14.5	58.5	0.86
chr12	10422256	10422541	CpG: 26	285	26	181	18.2	63.5	0.92
chr12	10486662	10487038	CpG: 40	376	40	235	21.3	62.5	1.12
chr12	10523119	10523353	CpG: 18	234	18	138	15.4	59.0	0.91
chr12	10536452	10536701	CpG: 17	249	17	149	13.7	59.8	0.78
chr12	10547037	10547292	CpG: 22	255	22	167	17.3	65.5	0.80
chr12	10567198	10567434	CpG: 19	236	19	139	16.1	58.9	0.96
chr12	10595641	10596684	CpG: 128	1043	128	755	24.5	72.4	0.95
chr12	10658292	10658566	CpG: 25	274	25	173	18.2	63.1	0.93
chr12	10899487	10899716	CpG: 19	229	19	136	16.6	59.4	0.95
chr12	11039474	11039750	CpG: 21	276	21	170	15.2	61.6	0.81
chr12	11040379	11040977	CpG: 65	598	65	408	21.7	68.2	0.94
chr12	11369479	11370015	CpG: 56	536	56	371	20.9	69.2	0.87
chr12	11396859	11397201	CpG: 28	342	28	212	16.4	62.0	0.86
chr12	11416507	11416816	CpG: 28	309	28	224	18.1	72.5	0.69
chr12	11502965	11503203	CpG: 17	238	17	141	14.3	59.2	0.84
chr12	11517022	11517285	CpG: 21	263	21	156	16.0	59.3	0.92
chr12	11518189	11519319	CpG: 128	1130	128	751	22.7	66.5	1.03
chr12	11604986	11605226	CpG: 19	240	19	142	15.8	59.2	0.92
chr12	11711106	11711380	CpG: 24	274	24	172	17.5	62.8	0.90
chr12	11864588	11864868	CpG: 21	280	21	163	15.0	58.2	0.90
chr12	11875148	11875374	CpG: 19	226	19	136	16.8	60.2	0.96
chr12	11875855	11876105	CpG: 20	250	20	157	16.0	62.8	0.83
chr12	11979594	11979860	CpG: 20	266	20	164	15.0	61.7	0.81
chr12	12130201	12130458	CpG: 21	257	21	153	16.3	59.5	0.94
chr12	12135812	12136674	CpG: 102	862	102	594	23.7	68.9	1.00
chr12	12138039	12138331	CpG: 23	292	23	176	15.8	60.3	0.88
chr12	12173012	12173408	CpG: 30	396	30	222	15.2	56.1	0.96
chr12	12197826	12198062	CpG: 17	236	17	140	14.4	59.3	0.84
chr12	12219141	12219664	CpG: 61	523	61	383	23.3	73.2	0.87
chr12	12226107	12226624	CpG: 58	517	58	364	22.4	70.4	0.91
chr12	12326548	12326785	CpG: 20	237	20	148	16.9	62.4	0.89
chr12	12341829	12342034	CpG: 17	205	17	149	16.6	72.7	0.65
chr12	12401047	12401328	CpG: 24	281	24	177	17.1	63.0	0.88
chr12	12430870	12432227	CpG: 150	1357	150	943	22.1	69.5	0.92
chr12	12435082	12435506	CpG: 36	424	36	313	17.0	73.8	0.62
chr12	12480972	12481426	CpG: 40	454	40	306	17.6	67.4	0.78
chr12	12487344	12488059	CpG: 54	715	54	488	15.1	68.3	0.65
chr12	12501255	12501529	CpG: 23	274	23	169	16.8	61.7	0.89
chr12	12539099	12539330	CpG: 18	231	18	141	15.6	61.0	0.85
chr12	12569678	12569881	CpG: 19	203	19	118	18.7	58.1	1.11
chr12	12590367	12591851	CpG: 141	1484	141	981	19.0	66.1	0.87
chr12	12597233	12599605	CpG: 241	2372	241	1566	20.3	66.0	0.94
chr12	12660343	12661021	CpG: 71	678	71	479	20.9	70.6	0.84
chr12	12686767	12686993	CpG: 25	226	25	147	22.1	65.0	1.08
chr12	12738289	12738562	CpG: 25	273	25	171	18.3	62.6	0.95
chr12	12764710	12765335	CpG: 49	625	49	418	15.7	66.9	0.70
chr12	12873552	12875638	CpG: 188	2086	188	1402	18.0	67.2	0.80
chr12	12918527	12919117	CpG: 66	590	66	429	22.4	72.7	0.85
chr12	12975320	12975902	CpG: 69	582	69	433	23.7	74.4	0.86
chr12	13241017	13241239	CpG: 19	222	19	135	17.1	60.8	0.96
chr12	13267045	13267472	CpG: 33	427	33	258	15.5	60.4	0.85
chr12	13437377	13438562	CpG: 81	1185	81	723	13.7	61.0	0.74
chr12	13641400	13641638	CpG: 18	238	18	140	15.1	58.8	0.91
chr12	13855142	13855490	CpG: 42	348	42	247	24.1	71.0	0.98
chr12	13856106	13856722	CpG: 44	616	44	411	14.3	66.7	0.65
chr12	13869419	13869642	CpG: 17	223	17	136	15.2	61.0	0.84
chr12	13895302	13895576	CpG: 25	274	25	171	18.2	62.4	0.95
chr12	13939289	13939564	CpG: 19	275	19	168	13.8	61.1	0.75
chr12	14183652	14183888	CpG: 19	236	19	143	16.1	60.6	0.89
chr12	14197023	14197374	CpG: 32	351	32	264	18.2	75.2	0.65
chr12	14198116	14198400	CpG: 20	284	20	163	14.1	57.4	0.87
chr12	14243099	14243549	CpG: 46	450	46	280	20.4	62.2	1.08
chr12	14315273	14315547	CpG: 23	274	23	170	16.8	62.0	0.88
chr12	14444819	14445664	CpG: 80	845	80	571	18.9	67.6	0.83
chr12	14446104	14446376	CpG: 24	272	24	164	17.6	60.3	0.98
chr12	14592789	14593021	CpG: 17	232	17	138	14.7	59.5	0.84
chr12	14599149	14599423	CpG: 22	274	22	169	16.1	61.7	0.86
chr12	14647293	14648390	CpG: 87	1097	87	638	15.9	58.2	0.94
chr12	14649807	14650082	CpG: 22	275	22	168	16.0	61.1	0.87
chr12	14651706	14652438	CpG: 69	732	69	464	18.9	63.4	0.96
chr12	14680422	14680902	CpG: 38	480	38	290	15.8	60.4	0.88
chr12	15026202	15026435	CpG: 17	233	17	136	14.6	58.4	0.88
chr12	15089347	15089634	CpG: 25	287	25	180	17.4	62.7	0.90
chr12	15098323	15098851	CpG: 49	528	49	359	18.6	68.0	0.80
chr12	15150495	15150710	CpG: 16	215	16	129	14.9	60.0	0.85
chr12	15199651	15200234	CpG: 61	583	61	418	20.9	71.7	0.82
chr12	15220997	15221247	CpG: 20	250	20	155	16.0	62.0	0.84
chr12	15225746	15226048	CpG: 28	302	28	185	18.5	61.3	0.99
chr12	15297194	15297408	CpG: 18	214	18	127	16.8	59.3	0.98
chr12	15666015	15667037	CpG: 117	1022	117	700	22.9	68.5	0.98
chr12	15752782	15752995	CpG: 16	213	16	120	15.0	56.3	0.99
chr12	15759110	15760158	CpG: 79	1048	79	639	15.1	61.0	0.82
chr12	15788404	15788858	CpG: 54	454	54	329	23.8	72.5	0.91
chr12	15800298	15800572	CpG: 25	274	25	171	18.2	62.4	0.95
chr12	15803712	15803987	CpG: 24	275	24	173	17.5	62.9	0.90
chr12	15900813	15901049	CpG: 21	236	21	145	17.8	61.4	0.96
chr12	15906431	15906660	CpG: 19	229	19	140	16.6	61.1	0.93
chr12	15934677	15935060	CpG: 37	383	37	284	19.3	74.2	0.70
chr12	15962256	15962488	CpG: 18	232	18	139	15.5	59.9	0.89
chr12	16133916	16134190	CpG: 18	274	18	163	13.1	59.5	0.75
chr12	16432135	16432357	CpG: 20	222	20	138	18.0	62.2	0.99
chr12	16697844	16698081	CpG: 21	237	21	142	17.7	59.9	1.01
chr12	16746013	16746288	CpG: 22	275	22	170	16.0	61.8	0.85
chr12	16764363	16764630	CpG: 19	267	19	160	14.2	59.9	0.80
chr12	16885025	16885415	CpG: 35	390	35	287	17.9	73.6	0.66
chr12	17031134	17031364	CpG: 17	230	17	138	14.8	60.0	0.83
chr12	17116983	17117264	CpG: 24	281	24	173	17.1	61.6	0.92
chr12	17152878	17153153	CpG: 22	275	22	169	16.0	61.5	0.86
chr12	17255245	17255523	CpG: 25	278	25	176	18.0	63.3	0.90
chr12	17507744	17508022	CpG: 23	278	23	174	16.5	62.6	0.85
chr12	17650211	17650544	CpG: 23	333	23	194	13.8	58.3	0.81
chr12	17731907	17732216	CpG: 24	309	24	184	15.5	59.5	0.88
chr12	17849621	17849850	CpG: 17	229	17	143	14.8	62.4	0.78
chr12	17855555	17855867	CpG: 23	312	23	177	14.7	56.7	0.92
chr12	18117102	18117338	CpG: 18	236	18	146	15.3	61.9	0.82
chr12	18124236	18124475	CpG: 21	239	21	145	17.6	60.7	0.98
chr12	18199888	18200161	CpG: 24	273	24	172	17.6	63.0	0.89
chr12	18274838	18275074	CpG: 20	236	20	144	16.9	61.0	0.93
chr12	18375922	18376460	CpG: 46	538	46	391	17.1	72.7	0.65
chr12	18376802	18377049	CpG: 20	247	20	140	16.2	56.7	1.06
chr12	18438073	18438346	CpG: 21	273	21	166	15.4	60.8	0.84
chr12	18953996	18954232	CpG: 17	236	17	145	14.4	61.4	0.77
chr12	18955155	18955362	CpG: 16	207	16	124	15.5	59.9	0.88
chr12	18985271	18985539	CpG: 22	268	22	161	16.4	60.1	0.92
chr12	19006080	19007641	CpG: 170	1561	170	1132	21.8	72.5	0.83
chr12	19049690	19049971	CpG: 22	281	22	173	15.7	61.6	0.84
chr12	19183059	19183507	CpG: 39	448	39	278	17.4	62.1	0.90
chr12	19262741	19263100	CpG: 29	359	29	218	16.2	60.7	0.89
chr12	19316027	19317526	CpG: 164	1499	164	1070	21.9	71.4	0.87
chr12	19530072	19530303	CpG: 20	231	20	140	17.3	60.6	0.95
chr12	19676140	19676403	CpG: 21	263	21	157	16.0	59.7	0.90
chr12	19819515	19819736	CpG: 24	221	24	152	21.7	68.8	0.93
chr12	20194702	20194949	CpG: 18	247	18	149	14.6	60.3	0.82
chr12	20247088	20248596	CpG: 127	1508	127	979	16.8	64.9	0.82
chr12	20360294	20360531	CpG: 18	237	18	140	15.2	59.1	0.90
chr12	20394234	20394508	CpG: 24	274	24	171	17.5	62.4	0.91
chr12	20411226	20411450	CpG: 21	224	21	140	18.8	62.5	0.99
chr12	20429918	20431532	CpG: 109	1614	109	994	13.5	61.6	0.72
chr12	20460100	20460330	CpG: 20	230	20	138	17.4	60.0	0.99
chr12	20591357	20591631	CpG: 25	274	25	171	18.2	62.4	0.95
chr12	20634034	20634316	CpG: 22	282	22	174	15.6	61.7	0.84
chr12	20685999	20686487	CpG: 42	488	42	365	17.2	74.8	0.62
chr12	20896180	20896394	CpG: 16	214	16	125	15.0	58.4	0.88
chr12	21093270	21093698	CpG: 30	428	30	256	14.0	59.8	0.79
chr12	21263469	21263743	CpG: 21	274	21	159	15.3	58.0	0.92
chr12	21298040	21298283	CpG: 18	243	18	145	14.8	59.7	0.83
chr12	21316234	21316550	CpG: 33	316	33	203	20.9	64.2	1.01
chr12	21360726	21361008	CpG: 23	282	23	174	16.3	61.7	0.87
chr12	21380471	21381031	CpG: 47	560	47	338	16.8	60.4	0.94
chr12	21406441	21407015	CpG: 56	574	56	400	19.5	69.7	0.80
chr12	21436600	21436874	CpG: 19	274	19	167	13.9	60.9	0.76
chr12	21490195	21490477	CpG: 24	282	24	174	17.0	61.7	0.91
chr12	21536156	21536434	CpG: 22	278	22	177	15.8	63.7	0.78
chr12	21536826	21537063	CpG: 20	237	20	148	16.9	62.4	0.89
chr12	21540136	21540564	CpG: 39	428	39	319	18.2	74.5	0.66
chr12	21541091	21541342	CpG: 24	251	24	136	19.1	54.2	1.38
chr12	21552889	21553105	CpG: 22	216	22	159	20.4	73.6	0.76
chr12	21558847	21559124	CpG: 22	277	22	167	15.9	60.3	0.89
chr12	21653172	21653739	CpG: 44	567	44	384	15.5	67.7	0.69
chr12	21819751	21820179	CpG: 34	428	34	237	15.9	55.4	1.04
chr12	21820845	21821154	CpG: 27	309	27	211	17.5	68.3	0.75
chr12	21849566	21849840	CpG: 24	274	24	171	17.5	62.4	0.91
chr12	21924184	21924711	CpG: 54	527	54	387	20.5	73.4	0.79
chr12	21978322	21978603	CpG: 22	281	22	173	15.7	61.6	0.84
chr12	22211929	22213755	CpG: 164	1826	164	1180	18.0	64.6	0.87
chr12	22254815	22255244	CpG: 44	429	44	324	20.5	75.5	0.72
chr12	22268327	22268605	CpG: 19	278	19	169	13.7	60.8	0.75
chr12	22269889	22270125	CpG: 19	236	19	146	16.1	61.9	0.86
chr12	22288242	22288505	CpG: 20	263	20	158	15.2	60.1	0.85
chr12	22380352	22380631	CpG: 23	279	23	171	16.5	61.3	0.89
chr12	22415307	22416255	CpG: 90	948	90	626	19.0	66.0	0.88
chr12	22496519	22496984	CpG: 58	465	58	329	24.9	70.8	1.01
chr12	22543020	22543257	CpG: 17	237	17	140	14.3	59.1	0.86
chr12	22564537	22564920	CpG: 31	383	31	280	16.2	73.1	0.61
chr12	22584662	22584937	CpG: 24	275	24	172	17.5	62.5	0.90
chr12	22816430	22816708	CpG: 26	278	26	177	18.7	63.7	0.93
chr12	22947969	22948212	CpG: 18	243	18	143	14.8	58.8	0.86
chr12	22992874	22993110	CpG: 20	236	20	144	16.9	61.0	0.93
chr12	23011728	23012006	CpG: 23	278	23	173	16.5	62.2	0.86
chr12	23121516	23121883	CpG: 32	367	32	222	17.4	60.5	0.96
chr12	23157463	23157936	CpG: 48	473	48	352	20.3	74.4	0.73
chr12	23262186	23262460	CpG: 23	274	23	170	16.8	62.0	0.88
chr12	23514607	23514881	CpG: 23	274	23	170	16.8	62.0	0.88
chr12	23927636	23927910	CpG: 25	274	25	171	18.2	62.4	0.94
chr12	24080709	24080987	CpG: 24	278	24	173	17.3	62.2	0.90
chr12	24087174	24087458	CpG: 26	284	26	181	18.3	63.7	0.91
chr12	24160454	24160734	CpG: 25	280	25	175	17.9	62.5	0.92
chr12	24396401	24396621	CpG: 18	220	18	132	16.4	60.0	0.91
chr12	24418018	24418299	CpG: 24	281	24	174	17.1	61.9	0.91
chr12	24432839	24434176	CpG: 122	1337	122	886	18.2	66.3	0.83
chr12	24473369	24473602	CpG: 17	233	17	140	14.6	60.1	0.83
chr12	24475288	24475550	CpG: 19	262	19	159	14.5	60.7	0.79
chr12	24714648	24714879	CpG: 17	231	17	135	14.7	58.4	0.88
chr12	24772722	24773369	CpG: 70	647	70	447	21.6	69.1	0.92
chr12	24818749	24819215	CpG: 42	466	42	270	18.0	57.9	1.08
chr12	24991415	24991697	CpG: 24	282	24	172	17.0	61.0	0.93
chr12	25066348	25066708	CpG: 37	360	37	236	20.6	65.6	0.96
chr12	25121555	25122800	CpG: 149	1245	149	923	23.9	74.1	0.87
chr12	25163043	25163319	CpG: 21	276	21	169	15.2	61.2	0.82
chr12	25257753	25257965	CpG: 16	212	16	123	15.1	58.0	0.90
chr12	25258395	25259025	CpG: 68	630	68	414	21.6	65.7	1.01
chr12	25263971	25264177	CpG: 21	206	21	153	20.4	74.3	0.75
chr12	25362301	25362535	CpG: 19	234	19	141	16.2	60.3	0.89
chr12	25424920	25425141	CpG: 17	221	17	126	15.4	57.0	0.97
chr12	25500430	25500665	CpG: 21	235	21	143	17.9	60.9	0.98
chr12	25672130	25672407	CpG: 25	277	25	177	18.1	63.9	0.89
chr12	25824189	25824470	CpG: 23	281	23	173	16.4	61.6	0.88
chr12	25830822	25831954	CpG: 179	1132	179	887	31.6	78.4	1.03
chr12	25986667	25987137	CpG: 61	470	61	347	26.0	73.8	0.96
chr12	25994671	25999329	CpG: 340	4658	340	2753	14.6	59.1	0.84
chr12	26067854	26068724	CpG: 79	870	79	591	18.2	67.9	0.79
chr12	26346717	26346992	CpG: 24	275	24	172	17.5	62.5	0.90
chr12	26683386	26683811	CpG: 29	425	29	253	13.6	59.5	0.79
chr12	26704523	26705591	CpG: 122	1068	122	779	22.8	72.9	0.86
chr12	26719011	26719283	CpG: 21	272	21	159	15.4	58.5	0.93
chr12	26809992	26810933	CpG: 87	941	87	615	18.5	65.4	0.87
chr12	26863169	26863450	CpG: 23	281	23	175	16.4	62.3	0.86
chr12	26886065	26886533	CpG: 64	468	64	354	27.4	75.6	0.97
chr12	26893867	26894149	CpG: 23	282	23	169	16.3	59.9	0.92
chr12	26894429	26894930	CpG: 41	501	41	308	16.4	61.5	0.88
chr12	26934924	26935198	CpG: 25	274	25	172	18.2	62.8	0.93
chr12	27116013	27116677	CpG: 67	664	67	457	20.2	68.8	0.86
chr12	27204385	27205377	CpG: 131	992	131	748	26.4	75.4	0.93
chr12	27582436	27582884	CpG: 39	448	39	302	17.4	67.4	0.77
chr12	27651532	27652519	CpG: 124	987	124	747	25.1	75.7	0.88
chr12	27655317	27655623	CpG: 23	306	23	184	15.0	60.1	0.84
chr12	27745464	27746021	CpG: 48	557	48	398	17.2	71.5	0.68
chr12	27811313	27811587	CpG: 20	274	20	168	14.6	61.3	0.79
chr12	27841821	27842571	CpG: 105	750	105	573	28.0	76.4	0.98
chr12	27846689	27847374	CpG: 56	685	56	440	16.4	64.2	0.79
chr12	27993407	27993689	CpG: 25	282	25	179	17.7	63.5	0.89
chr12	28033239	28033480	CpG: 19	241	19	146	15.8	60.6	0.89
chr12	28062459	28063076	CpG: 70	617	70	430	22.7	69.7	0.96
chr12	28072922	28073977	CpG: 84	1055	84	750	15.9	71.1	0.63
chr12	28136478	28136751	CpG: 25	273	25	168	18.3	61.5	0.97
chr12	28632941	28633234	CpG: 25	293	25	177	17.1	60.4	0.94
chr12	28842644	28842919	CpG: 22	275	22	169	16.0	61.5	0.86
chr12	28999853	29000126	CpG: 25	273	25	169	18.3	61.9	0.96
chr12	29021574	29022553	CpG: 91	979	91	695	18.6	71.0	0.74
chr12	29059312	29059591	CpG: 20	279	20	170	14.3	60.9	0.78
chr12	29168317	29168609	CpG: 25	292	25	180	17.1	61.6	0.92
chr12	29253042	29253512	CpG: 30	470	30	276	12.8	58.7	0.74
chr12	29253686	29253904	CpG: 20	218	20	112	18.3	51.4	1.41
chr12	29258761	29259141	CpG: 33	380	33	281	17.4	73.9	0.64
chr12	29261810	29262430	CpG: 66	620	66	437	21.3	70.5	0.86
chr12	29536246	29536470	CpG: 19	224	19	135	17.0	60.3	0.94
chr12	29655292	29656730	CpG: 155	1438	155	1040	21.6	72.3	0.83
chr12	29674405	29674667	CpG: 23	262	23	164	17.6	62.6	0.91
chr12	29779352	29779618	CpG: 19	266	19	161	14.3	60.5	0.80
chr12	29979221	29979446	CpG: 19	225	19	133	16.9	59.1	1.01
chr12	30029107	30029310	CpG: 15	203	15	145	14.8	71.4	0.61
chr12	30041651	30042443	CpG: 66	792	66	532	16.7	67.2	0.74
chr12	30072751	30073433	CpG: 59	682	59	460	17.3	67.4	0.76
chr12	30569993	30570745	CpG: 68	752	68	500	18.1	66.5	0.82
chr12	30629062	30629948	CpG: 111	886	111	672	25.1	75.8	0.89
chr12	30661410	30661641	CpG: 19	231	19	139	16.5	60.2	0.92
chr12	30670235	30671445	CpG: 97	1210	97	831	16.0	68.7	0.69
chr12	30697066	30697973	CpG: 67	907	67	596	14.8	65.7	0.69
chr12	30722810	30723048	CpG: 20	238	20	144	16.8	60.5	0.94
chr12	30800929	30801564	CpG: 69	635	69	466	21.7	73.4	0.81
chr12	30945828	30946195	CpG: 40	367	40	273	21.8	74.4	0.79
chr12	30947903	30948746	CpG: 67	843	67	523	15.9	62.0	0.84
chr12	30952053	30952295	CpG: 19	242	19	149	15.7	61.6	0.86
chr12	31039735	31040045	CpG: 23	310	23	193	14.8	62.3	0.77
chr12	31052022	31052263	CpG: 21	241	21	147	17.4	61.0	0.95
chr12	31128774	31129135	CpG: 26	361	26	218	14.4	60.4	0.79
chr12	31200257	31203062	CpG: 273	2805	273	1798	19.5	64.1	0.95
chr12	31252745	31252978	CpG: 19	233	19	138	16.3	59.2	0.95
chr12	31466360	31467924	CpG: 212	1564	212	1162	27.1	74.3	0.98
chr12	31492901	31493104	CpG: 24	203	24	146	23.6	71.9	0.92
chr12	31497361	31497630	CpG: 28	269	28	172	20.8	63.9	1.03
chr12	31535942	31536288	CpG: 32	346	32	217	18.5	62.7	0.95
chr12	31605545	31606376	CpG: 72	831	72	528	17.3	63.5	0.87
chr12	31668746	31669170	CpG: 39	424	39	258	18.4	60.8	1.00
chr12	31670952	31671241	CpG: 22	289	22	171	15.2	59.2	0.89
chr12	31675210	31675453	CpG: 22	243	22	147	18.1	60.5	0.99
chr12	31680309	31680695	CpG: 31	386	31	279	16.1	72.3	0.62
chr12	31778357	31778589	CpG: 19	232	19	142	16.4	61.2	0.90
chr12	31799133	31799410	CpG: 23	277	23	170	16.6	61.4	0.89
chr12	31809746	31810012	CpG: 20	266	20	157	15.0	59.0	0.89
chr12	31835168	31835881	CpG: 91	713	91	517	25.5	72.5	0.97
chr12	31968544	31968781	CpG: 21	237	21	142	17.7	59.9	1.00
chr12	31982469	31983394	CpG: 111	925	111	657	24.0	71.0	0.95
chr12	32041441	32041716	CpG: 23	275	23	167	16.7	60.7	0.93
chr12	32154831	32155063	CpG: 18	232	18	140	15.5	60.3	0.86
chr12	32265900	32266143	CpG: 20	243	20	148	16.5	60.9	0.89
chr12	32267133	32267463	CpG: 40	330	40	241	24.2	73.0	0.91
chr12	32275330	32276343	CpG: 114	1013	114	741	22.5	73.1	0.85
chr12	32439266	32440146	CpG: 66	880	66	611	15.0	69.4	0.62
chr12	32449409	32449677	CpG: 19	268	19	152	14.2	56.7	0.89
chr12	32475462	32475698	CpG: 22	236	22	146	18.6	61.9	1.00
chr12	32534528	32534811	CpG: 24	283	24	167	17.0	59.0	0.98
chr12	32544105	32544372	CpG: 20	267	20	162	15.0	60.7	0.83
chr12	32555483	32556331	CpG: 80	848	80	586	18.9	69.1	0.80
chr12	32561286	32561520	CpG: 18	234	18	142	15.4	60.7	0.86
chr12	32631721	32632349	CpG: 56	628	56	387	17.8	61.6	0.94
chr12	32643836	32644066	CpG: 20	230	20	141	17.4	61.3	0.94
chr12	32772360	32773151	CpG: 96	791	96	604	24.3	76.4	0.84
chr12	32898973	32899500	CpG: 38	527	38	346	14.4	65.7	0.67
chr12	33043600	33044026	CpG: 33	426	33	255	15.5	59.9	0.87
chr12	33086911	33087187	CpG: 21	276	21	167	15.2	60.5	0.84
chr12	33217346	33217619	CpG: 23	273	23	173	16.8	63.4	0.85
chr12	33310045	33311332	CpG: 131	1287	131	875	20.4	68.0	0.88
chr12	33456608	33456837	CpG: 20	229	20	139	17.5	60.7	0.98
chr12	33531257	33531497	CpG: 19	240	19	146	15.8	60.8	0.87
chr12	33741315	33741741	CpG: 30	426	30	252	14.1	59.2	0.81
chr12	33899888	33900114	CpG: 25	226	25	138	22.1	61.1	1.23
chr12	33985484	33986446	CpG: 90	962	90	700	18.7	72.8	0.71
chr12	34015725	34015999	CpG: 23	274	23	170	16.8	62.0	0.88
chr12	34044310	34044695	CpG: 31	385	31	270	16.1	70.1	0.69
chr12	34089034	34089614	CpG: 45	580	45	391	15.5	67.4	0.69
chr12	34096320	34096997	CpG: 56	677	56	438	16.5	64.7	0.79
chr12	34167309	34167606	CpG: 22	297	22	192	14.8	64.6	0.72
chr12	34188289	34188500	CpG: 15	211	15	116	14.2	55.0	0.98
chr12	34229716	34230544	CpG: 53	828	53	540	12.8	65.2	0.61
chr12	34232057	34232303	CpG: 20	246	20	164	16.3	66.7	0.73
chr12	34234482	34235015	CpG: 37	533	37	330	13.9	61.9	0.73
chr12	34239091	34239528	CpG: 30	437	30	285	13.7	65.2	0.65
chr12	34240490	34241365	CpG: 56	875	56	557	12.8	63.7	0.63
chr12	34244586	34244844	CpG: 19	258	19	166	14.7	64.3	0.71
chr12	34246472	34246765	CpG: 20	293	20	183	13.7	62.5	0.70
chr12	34251598	34251853	CpG: 21	255	21	165	16.5	64.7	0.79
chr12	34269334	34269548	CpG: 16	214	16	137	15.0	64.0	0.73
chr12	37371048	37371575	CpG: 42	527	42	346	15.9	65.7	0.74
chr12	37495886	37496411	CpG: 38	525	38	342	14.5	65.1	0.69
chr12	37726844	37727125	CpG: 23	281	23	173	16.4	61.6	0.88
chr12	37825027	37825301	CpG: 23	274	23	170	16.8	62.0	0.88
chr12	38087895	38088482	CpG: 44	587	44	386	15.0	65.8	0.69
chr12	38102012	38102268	CpG: 21	256	21	167	16.4	65.2	0.77
chr12	38102783	38103485	CpG: 49	702	49	443	14.0	63.1	0.71
chr12	38105284	38105558	CpG: 20	274	20	185	14.6	67.5	0.68
chr12	38106089	38106717	CpG: 41	628	41	403	13.1	64.2	0.64
chr12	38106948	38107167	CpG: 20	219	20	144	18.3	65.8	0.85
chr12	38107537	38107796	CpG: 20	259	20	176	15.4	68.0	0.69
chr12	38108042	38108248	CpG: 15	206	15	134	14.6	65.0	0.70
chr12	38109293	38109503	CpG: 15	210	15	133	14.3	63.3	0.72
chr12	38110268	38110470	CpG: 14	202	14	131	13.9	64.9	0.66
chr12	38112799	38113546	CpG: 54	747	54	502	14.5	67.2	0.64
chr12	38266248	38266499	CpG: 23	251	23	150	18.3	59.8	1.06
chr12	38279954	38280825	CpG: 69	871	69	610	15.8	70.0	0.65
chr12	38533997	38534271	CpG: 24	274	24	171	17.5	62.4	0.91
chr12	38553241	38553515	CpG: 22	274	22	169	16.1	61.7	0.85
chr12	38705530	38705808	CpG: 25	278	25	173	18.0	62.2	0.93
chr12	38714120	38714394	CpG: 23	274	23	170	16.8	62.0	0.88
chr12	38749593	38749885	CpG: 20	292	20	174	13.7	59.6	0.77
chr12	38855211	38855592	CpG: 34	381	34	267	17.8	70.1	0.74
chr12	38856432	38856643	CpG: 22	211	22	145	20.9	68.7	0.89
chr12	38934291	38934521	CpG: 19	230	19	140	16.5	60.9	0.90
chr12	39094437	39095555	CpG: 114	1118	114	761	20.4	68.1	0.88
chr12	39365166	39365424	CpG: 25	258	25	160	19.4	62.0	1.04
chr12	39392295	39393583	CpG: 140	1288	140	933	21.7	72.4	0.83
chr12	39562981	39563255	CpG: 24	274	24	171	17.5	62.4	0.91
chr12	39646179	39646457	CpG: 24	278	24	174	17.3	62.6	0.89
chr12	39816369	39816646	CpG: 23	277	23	174	16.6	62.8	0.84
chr12	39912936	39913158	CpG: 15	222	15	129	13.5	58.1	0.81
chr12	39928346	39928590	CpG: 22	244	22	150	18.0	61.5	0.96
chr12	40055056	40056111	CpG: 135	1055	135	787	25.6	74.6	0.92
chr12	40176911	40177469	CpG: 68	558	68	424	24.4	76.0	0.86
chr12	40305261	40306008	CpG: 54	747	54	503	14.5	67.3	0.64
chr12	40580401	40580745	CpG: 33	344	33	247	19.2	71.8	0.74
chr12	40652413	40652993	CpG: 47	580	47	389	16.2	67.1	0.73
chr12	40870407	40870650	CpG: 18	243	18	143	14.8	58.8	0.88
chr12	40966306	40966581	CpG: 22	275	22	169	16.0	61.5	0.85
chr12	41102715	41102975	CpG: 20	260	20	161	15.4	61.9	0.81
chr12	41147555	41148375	CpG: 97	820	97	601	23.7	73.3	0.89
chr12	41203917	41204204	CpG: 23	287	23	176	16.0	61.3	0.87
chr12	41532122	41532332	CpG: 16	210	16	117	15.2	55.7	1.01
chr12	41630680	41630885	CpG: 16	205	16	117	15.6	57.1	0.96
chr12	41631302	41631583	CpG: 19	281	19	166	13.5	59.1	0.78
chr12	41688149	41688426	CpG: 25	277	25	174	18.1	62.8	0.92
chr12	41890489	41890876	CpG: 34	387	34	257	17.6	66.4	0.82
chr12	42102225	42103002	CpG: 122	777	122	595	31.4	76.6	1.08
chr12	42184794	42186792	CpG: 183	1998	183	1542	18.3	77.2	0.62
chr12	42195369	42196764	CpG: 172	1395	172	1030	24.7	73.8	0.91
chr12	42197676	42197954	CpG: 20	278	20	161	14.4	57.9	0.87
chr12	42217420	42217652	CpG: 20	232	20	141	17.2	60.8	0.95
chr12	42244087	42244379	CpG: 22	292	22	172	15.1	58.9	0.88
chr12	42244752	42245034	CpG: 26	282	26	190	18.4	67.4	0.82
chr12	42283894	42284252	CpG: 37	358	37	233	20.7	65.1	0.99
chr12	42299584	42299804	CpG: 16	220	16	131	14.5	59.5	0.82
chr12	42307961	42308777	CpG: 61	816	61	571	15.0	70.0	0.61
chr12	42358103	42358377	CpG: 23	274	23	170	16.8	62.0	0.88
chr12	42440672	42442205	CpG: 164	1533	164	1075	21.4	70.1	0.90
chr12	42490418	42490656	CpG: 20	238	20	146	16.8	61.3	0.91
chr12	42546822	42547879	CpG: 135	1057	135	759	25.5	71.8	0.99
chr12	42548084	42548377	CpG: 23	293	23	174	15.7	59.4	0.90
chr12	42602437	42602673	CpG: 21	236	21	145	17.8	61.4	0.96
chr12	42611175	42611456	CpG: 23	281	23	175	16.4	62.3	0.86
chr12	43183395	43183706	CpG: 26	311	26	222	16.7	71.4	0.66
chr12	43186813	43187159	CpG: 24	346	24	203	13.9	58.7	0.81
chr12	43219675	43219952	CpG: 23	277	23	172	16.6	62.1	0.88
chr12	43283219	43283500	CpG: 23	281	23	173	16.4	61.6	0.88
chr12	43317926	43318203	CpG: 25	277	25	172	18.1	62.1	0.94
chr12	43333071	43333349	CpG: 25	278	25	173	18.0	62.2	0.94
chr12	43368686	43368956	CpG: 23	270	23	165	17.0	61.1	0.92
chr12	43430528	43430820	CpG: 24	292	24	182	16.4	62.3	0.85
chr12	43451503	43451769	CpG: 20	266	20	163	15.0	61.3	0.81
chr12	43511431	43512997	CpG: 126	1566	126	1024	16.1	65.4	0.77
chr12	43523831	43524109	CpG: 21	278	21	175	15.1	62.9	0.77
chr12	43532466	43532695	CpG: 27	229	27	170	23.6	74.2	0.86
chr12	43576384	43576649	CpG: 25	265	25	166	18.9	62.6	0.98
chr12	43651984	43652258	CpG: 22	274	22	166	16.1	60.6	0.89
chr12	43704143	43704426	CpG: 23	283	23	174	16.3	61.5	0.87
chr12	43717401	43717817	CpG: 41	416	41	267	19.7	64.2	0.96
chr12	43764552	43765327	CpG: 89	775	89	554	23.0	71.5	0.91
chr12	43779028	43779241	CpG: 17	213	17	127	16.0	59.6	0.92
chr12	43794463	43795085	CpG: 98	622	98	481	31.5	77.3	1.05
chr12	43917578	43917815	CpG: 18	237	18	144	15.2	60.8	0.85
chr12	44072505	44072932	CpG: 31	427	31	255	14.5	59.7	0.82
chr12	44083914	44084121	CpG: 14	207	14	120	13.5	58.0	0.81
chr12	44103596	44103870	CpG: 21	274	21	168	15.3	61.3	0.83
chr12	44267372	44267608	CpG: 18	236	18	140	15.3	59.3	0.88
chr12	44479963	44480193	CpG: 19	230	19	140	16.5	60.9	0.91
chr12	44486526	44486761	CpG: 18	235	18	142	15.3	60.4	0.85
chr12	44546600	44546805	CpG: 14	205	14	122	13.7	59.5	0.81
chr12	44576097	44576376	CpG: 22	279	22	172	15.8	61.6	0.84
chr12	44694715	44694988	CpG: 23	273	23	168	16.8	61.5	0.90
chr12	44731929	44732155	CpG: 17	226	17	133	15.0	58.8	0.87
chr12	44777345	44777626	CpG: 23	281	23	174	16.4	61.9	0.87
chr12	44834648	44835653	CpG: 86	1005	86	676	17.1	67.3	0.76
chr12	44909722	44910015	CpG: 21	293	21	177	14.3	60.4	0.79
chr12	44929583	44929857	CpG: 22	274	22	169	16.1	61.7	0.85
chr12	45009028	45010212	CpG: 115	1184	115	815	19.4	68.8	0.84
chr12	45082133	45082352	CpG: 15	219	15	131	13.7	59.8	0.77
chr12	45174572	45175611	CpG: 106	1039	106	717	20.4	69.0	0.86
chr12	45329696	45329907	CpG: 17	211	17	123	16.1	58.3	0.95
chr12	45584658	45584932	CpG: 23	274	23	169	16.8	61.7	0.89
chr12	45601926	45602196	CpG: 19	270	19	161	14.1	59.6	0.80
chr12	45685571	45689300	CpG: 325	3729	325	2275	17.4	61.0	0.94
chr12	45755074	45755351	CpG: 19	277	19	164	13.7	59.2	0.79
chr12	45877713	45877933	CpG: 16	220	16	130	14.5	59.1	0.85
chr12	45949326	45951652	CpG: 193	2326	193	1444	16.6	62.1	0.87
chr12	45959351	45959946	CpG: 44	595	44	404	14.8	67.9	0.64
chr12	45977577	45977965	CpG: 31	388	31	280	16.0	72.2	0.61
chr12	45992396	45992677	CpG: 22	281	22	173	15.7	61.6	0.84
chr12	46194030	46194260	CpG: 19	230	19	139	16.5	60.4	0.92
chr12	46226831	46229185	CpG: 180	2354	180	1485	15.3	63.1	0.77
chr12	46330910	46332545	CpG: 163	1635	163	1059	19.9	64.8	0.96
chr12	46342507	46343632	CpG: 114	1125	114	781	20.3	69.4	0.88
chr12	46790354	46791106	CpG: 63	752	63	490	16.8	65.2	0.82
chr12	46793301	46793564	CpG: 20	263	20	162	15.2	61.6	0.81
chr12	46939055	46939327	CpG: 21	272	21	163	15.4	59.9	0.87
chr12	46945990	46946217	CpG: 20	227	20	141	17.6	62.1	0.95
chr12	46963800	46964074	CpG: 24	274	24	171	17.5	62.4	0.91
chr12	47040169	47041112	CpG: 98	943	98	671	20.8	71.2	0.82
chr12	47172569	47172807	CpG: 20	238	20	145	16.8	60.9	0.93
chr12	47196027	47196673	CpG: 44	646	44	396	13.6	61.3	0.73
chr12	47200431	47200791	CpG: 28	360	28	205	15.6	56.9	0.97
chr12	47266997	47267223	CpG: 18	226	18	164	15.9	72.6	0.61
chr12	47297776	47298050	CpG: 24	274	24	171	17.5	62.4	0.91
chr12	47366770	47367006	CpG: 17	236	17	139	14.4	58.9	0.85
chr12	47376924	47377192	CpG: 20	268	20	161	14.9	60.1	0.85
chr12	47666859	47667447	CpG: 69	588	69	423	23.5	71.9	0.95
chr12	47720087	47720679	CpG: 49	592	49	422	16.6	71.3	0.67
chr12	47720862	47721084	CpG: 18	222	18	149	16.2	67.1	0.72
chr12	47734317	47735188	CpG: 116	871	116	637	26.6	73.1	1.00
chr12	47774333	47774738	CpG: 31	405	31	274	15.3	67.7	0.69
chr12	47780721	47781800	CpG: 127	1079	127	817	23.5	75.7	0.82
chr12	47830635	47830839	CpG: 16	204	16	121	15.7	59.3	0.90
chr12	47834788	47835053	CpG: 23	265	23	168	17.4	63.4	0.88
chr12	47866266	47867147	CpG: 75	881	75	578	17.0	65.6	0.81
chr12	47925200	47925512	CpG: 43	312	43	222	27.6	71.2	1.09
chr12	47963317	47963882	CpG: 44	565	44	348	15.6	61.6	0.83
chr12	47965838	47966680	CpG: 83	842	83	610	19.7	72.4	0.75
chr12	47967117	47967321	CpG: 17	204	17	143	16.7	70.1	0.68
chr12	48067017	48067788	CpG: 65	771	65	499	16.9	64.7	0.81
chr12	48118388	48119082	CpG: 53	694	53	436	15.3	62.8	0.78
chr12	48134093	48134321	CpG: 16	228	16	130	14.0	57.0	0.87
chr12	48144934	48146147	CpG: 114	1213	114	841	18.8	69.3	0.78
chr12	48159552	48160360	CpG: 60	808	60	482	14.9	59.7	0.83
chr12	48182548	48182784	CpG: 18	236	18	138	15.3	58.5	0.91
chr12	48216903	48217184	CpG: 23	281	23	175	16.4	62.3	0.86
chr12	48278286	48278560	CpG: 24	274	24	170	17.5	62.0	0.92
chr12	48290874	48291427	CpG: 55	553	55	381	19.9	68.9	0.85
chr12	48311842	48312623	CpG: 82	781	82	576	21.0	73.8	0.78
chr12	48482656	48482863	CpG: 17	207	17	144	16.4	69.6	0.68
chr12	48490006	48490361	CpG: 34	355	34	239	19.2	67.3	0.86
chr12	48603449	48603650	CpG: 16	201	16	129	15.9	64.2	0.78
chr12	48643732	48644544	CpG: 66	812	66	510	16.3	62.8	0.83
chr12	48644629	48644865	CpG: 17	236	17	137	14.4	58.1	0.87
chr12	48678298	48679407	CpG: 89	1109	89	650	16.1	58.6	0.93
chr12	48744673	48745400	CpG: 61	727	61	499	16.8	68.6	0.71
chr12	48750667	48751573	CpG: 95	906	95	671	21.0	74.1	0.81
chr12	48776447	48777681	CpG: 104	1234	104	865	16.9	70.1	0.71
chr12	48780048	48781027	CpG: 98	979	98	711	20.0	72.6	0.78
chr12	48813384	48813660	CpG: 21	276	21	159	15.2	57.6	0.93
chr12	48814065	48814582	CpG: 44	517	44	340	17.0	65.8	0.80
chr12	48827819	48828035	CpG: 18	216	18	135	16.7	62.5	0.85
chr12	48877913	48878685	CpG: 61	772	61	532	15.8	68.9	0.67
chr12	48886897	48887887	CpG: 75	990	75	652	15.2	65.9	0.70
chr12	48893094	48893317	CpG: 17	223	17	134	15.2	60.1	0.85
chr12	48919256	48919876	CpG: 57	620	57	444	18.4	71.6	0.73
chr12	48932082	48932861	CpG: 77	779	77	541	19.8	69.4	0.82
chr12	48933768	48934060	CpG: 28	292	28	210	19.2	71.9	0.75
chr12	48940090	48943950	CpG: 322	3860	322	2524	16.7	65.4	0.78
chr12	48956787	48957057	CpG: 21	270	21	188	15.6	69.6	0.69
chr12	48959009	48961753	CpG: 198	2744	198	1855	14.4	67.6	0.63
chr12	48980688	48981145	CpG: 46	457	46	315	20.1	68.9	0.85
chr12	48988420	48988681	CpG: 21	261	21	156	16.1	59.8	0.90
chr12	49022027	49023152	CpG: 128	1125	128	814	22.8	72.4	0.87
chr12	49024061	49024327	CpG: 19	266	19	157	14.3	59.0	0.84
chr12	49031832	49032380	CpG: 52	548	52	359	19.0	65.5	0.89
chr12	49032910	49033188	CpG: 23	278	23	172	16.5	61.9	0.88
chr12	49051991	49053576	CpG: 132	1585	132	953	16.7	60.1	0.93
chr12	49054164	49054375	CpG: 21	211	21	141	19.9	66.8	0.89
chr12	49056361	49056625	CpG: 26	264	26	182	19.7	68.9	0.83
chr12	49072435	49073042	CpG: 53	607	53	394	17.5	64.9	0.84
chr12	49074543	49074779	CpG: 18	236	18	141	15.3	59.7	0.87
chr12	49081013	49081224	CpG: 15	211	15	128	14.2	60.7	0.79
chr12	49084700	49084936	CpG: 17	236	17	141	14.4	59.7	0.83
chr12	49092461	49093881	CpG: 139	1420	139	932	19.6	65.6	0.91
chr12	49143967	49144242	CpG: 23	275	23	169	16.7	61.5	0.89
chr12	49150497	49151282	CpG: 66	785	66	495	16.8	63.1	0.86
chr12	49196691	49196925	CpG: 33	234	33	177	28.2	75.6	1.01
chr12	49197064	49197299	CpG: 18	235	18	137	15.3	58.3	0.92
chr12	49210772	49211013	CpG: 18	241	18	141	14.9	58.5	0.89
chr12	49226654	49227583	CpG: 83	929	83	659	17.9	70.9	0.72
chr12	49228067	49228578	CpG: 39	511	39	282	15.3	55.2	1.01
chr12	49252369	49252598	CpG: 16	229	16	134	14.0	58.5	0.83
chr12	49257281	49259881	CpG: 215	2600	215	1739	16.5	66.9	0.74
chr12	49284953	49285425	CpG: 49	472	49	306	20.8	64.8	1.00
chr12	49294998	49295521	CpG: 47	523	47	351	18.0	67.1	0.82
chr12	49296100	49296371	CpG: 19	271	19	159	14.0	58.7	0.82
chr12	49298135	49299569	CpG: 134	1434	134	1020	18.7	71.1	0.74
chr12	49304130	49305286	CpG: 90	1156	90	773	15.6	66.9	0.70
chr12	49307087	49309436	CpG: 187	2349	187	1548	15.9	65.9	0.74
chr12	49328632	49329906	CpG: 156	1274	156	885	24.5	69.5	1.02
chr12	49351406	49351634	CpG: 19	228	19	146	16.7	64.0	0.81
chr12	49415099	49415337	CpG: 19	238	19	141	16.0	59.2	0.93
chr12	49476113	49476350	CpG: 19	237	19	140	16.0	59.1	0.94
chr12	49500038	49502100	CpG: 209	2062	209	1464	20.3	71.0	0.80
chr12	49506410	49506613	CpG: 22	203	22	133	21.7	65.5	1.01
chr12	49511259	49511908	CpG: 66	649	66	448	20.3	69.0	0.86
chr12	49530103	49530692	CpG: 47	589	47	344	16.0	58.4	0.94
chr12	49586199	49586842	CpG: 73	643	73	501	22.7	77.9	0.77
chr12	49669674	49670819	CpG: 132	1145	132	844	23.1	73.7	0.85
chr12	49692312	49692548	CpG: 20	236	20	144	16.9	61.0	0.93
chr12	49704268	49705282	CpG: 72	1014	72	622	14.2	61.3	0.77
chr12	49754826	49755056	CpG: 18	230	18	163	15.7	70.9	0.62
chr12	49757885	49758191	CpG: 22	306	22	205	14.4	67.0	0.64
chr12	49790789	49791840	CpG: 84	1051	84	724	16.0	68.9	0.67
chr12	49800321	49800599	CpG: 25	278	25	174	18.0	62.6	0.93
chr12	49805114	49805387	CpG: 23	273	23	168	16.8	61.5	0.89
chr12	49805867	49806279	CpG: 42	412	42	262	20.4	63.6	1.01
chr12	49809566	49809806	CpG: 20	240	20	148	16.7	61.7	0.90
chr12	49823376	49824439	CpG: 82	1063	82	760	15.4	71.5	0.60
chr12	49866811	49867219	CpG: 47	408	47	300	23.0	73.5	0.85
chr12	49918287	49918733	CpG: 44	446	44	322	19.7	72.2	0.76
chr12	49924047	49925371	CpG: 160	1324	160	985	24.2	74.4	0.87
chr12	49930573	49930858	CpG: 27	285	27	191	18.9	67.0	0.85
chr12	49988214	49988679	CpG: 41	465	41	303	17.6	65.2	0.89
chr12	49995833	49996199	CpG: 42	366	42	260	23.0	71.0	0.91
chr12	50020276	50021220	CpG: 112	944	112	698	23.7	73.9	0.87
chr12	50044144	50044720	CpG: 45	576	45	390	15.6	67.7	0.69
chr12	50048161	50048653	CpG: 60	492	60	367	24.4	74.6	0.89
chr12	50074437	50075534	CpG: 82	1097	82	686	14.9	62.5	0.77
chr12	50109655	50109879	CpG: 20	224	20	136	17.9	60.7	1.00
chr12	50128203	50128506	CpG: 25	303	25	172	16.5	56.8	1.04
chr12	50130034	50130694	CpG: 71	660	71	491	21.5	74.4	0.82
chr12	50178599	50178869	CpG: 21	270	21	163	15.6	60.4	0.87
chr12	50193735	50193972	CpG: 17	237	17	140	14.3	59.1	0.84
chr12	50243323	50243563	CpG: 18	240	18	142	15.0	59.2	0.89
chr12	50246580	50246864	CpG: 38	284	38	205	26.8	72.2	1.04
chr12	50355354	50355634	CpG: 20	280	20	169	14.3	60.4	0.80
chr12	50356073	50356364	CpG: 25	291	25	167	17.2	57.4	1.05
chr12	50363802	50364173	CpG: 31	371	31	234	16.7	63.1	0.88
chr12	50467293	50467571	CpG: 24	278	24	173	17.3	62.2	0.90
chr12	50467932	50468439	CpG: 63	507	63	373	24.9	73.6	0.95
chr12	50503715	50503934	CpG: 20	219	20	133	18.3	60.7	1.01
chr12	50541644	50541919	CpG: 19	275	19	165	13.8	60.0	0.77
chr12	50717238	50717601	CpG: 25	363	25	214	13.8	59.0	0.80
chr12	50726876	50728220	CpG: 142	1344	142	915	21.1	68.1	0.92
chr12	50805992	50806283	CpG: 27	291	27	206	18.6	70.8	0.74
chr12	50989198	50990553	CpG: 109	1355	109	879	16.1	64.9	0.77
chr12	51010698	51011287	CpG: 40	589	40	364	13.6	61.8	0.72
chr12	51045994	51046687	CpG: 81	693	81	513	23.4	74.0	0.87
chr12	51046967	51047499	CpG: 39	532	39	303	14.7	57.0	0.91
chr12	51114401	51114637	CpG: 18	236	18	141	15.3	59.7	0.88
chr12	51134349	51134565	CpG: 18	216	18	133	16.7	61.6	0.90
chr12	51135784	51136176	CpG: 38	392	38	245	19.4	62.5	1.02
chr12	51143876	51144105	CpG: 19	229	19	137	16.6	59.8	0.96
chr12	51180018	51181212	CpG: 108	1194	108	829	18.1	69.4	0.75
chr12	51194507	51194714	CpG: 17	207	17	124	16.4	59.9	0.93
chr12	51201601	51202274	CpG: 66	673	66	444	19.6	66.0	0.91
chr12	51202396	51202634	CpG: 17	238	17	139	14.3	58.4	0.87
chr12	51232511	51233518	CpG: 125	1007	125	743	24.8	73.8	0.91
chr12	51258137	51258426	CpG: 21	289	21	166	14.5	57.4	0.89
chr12	51286682	51287754	CpG: 73	1072	73	694	13.6	64.7	0.65
chr12	51310231	51310634	CpG: 30	403	30	238	14.9	59.1	0.86
chr12	51354276	51354846	CpG: 64	570	64	421	22.5	73.9	0.83
chr12	51355103	51355376	CpG: 20	273	20	161	14.7	59.0	0.86
chr12	51387478	51388184	CpG: 71	706	71	508	20.1	72.0	0.78
chr12	51531780	51532207	CpG: 30	427	30	253	14.1	59.3	0.80
chr12	51554252	51555062	CpG: 130	810	130	652	32.1	80.5	1.00
chr12	51683336	51683610	CpG: 23	274	23	169	16.8	61.7	0.89
chr12	51685147	51685416	CpG: 34	269	34	191	25.3	71.0	1.00
chr12	51777570	51778615	CpG: 135	1045	135	791	25.8	75.7	0.90
chr12	51783921	51785880	CpG: 239	1959	239	1469	24.4	75.0	0.87
chr12	51789164	51789442	CpG: 26	278	26	176	18.7	63.3	0.94
chr12	51810584	51813165	CpG: 211	2581	211	1863	16.4	72.2	0.63
chr12	51827722	51828028	CpG: 26	306	26	220	17.0	71.9	0.67
chr12	51832388	51833242	CpG: 81	854	81	609	19.0	71.3	0.75
chr12	51863932	51864419	CpG: 44	487	44	314	18.1	64.5	0.87
chr12	51870589	51871371	CpG: 80	782	80	584	20.5	74.7	0.73
chr12	51878827	51879130	CpG: 25	303	25	196	16.5	64.7	0.79
chr12	51914754	51915686	CpG: 121	932	121	692	26.0	74.2	0.96
chr12	51970254	51971483	CpG: 138	1229	138	922	22.5	75.0	0.82
chr12	51976669	51976947	CpG: 26	278	26	176	18.7	63.3	0.94
chr12	51978167	51978907	CpG: 91	740	91	553	24.6	74.7	0.88
chr12	51986573	51987617	CpG: 88	1044	88	752	16.9	72.0	0.65
chr12	51996537	51996985	CpG: 45	448	45	299	20.1	66.7	0.90
chr12	52000318	52001397	CpG: 123	1079	123	793	22.8	73.5	0.86
chr12	52014352	52015220	CpG: 87	868	87	611	20.0	70.4	0.81
chr12	52032286	52032565	CpG: 22	279	22	166	15.8	59.5	0.90
chr12	52033144	52033998	CpG: 77	854	77	561	18.0	65.7	0.84
chr12	52043146	52043974	CpG: 89	828	89	597	21.5	72.1	0.83
chr12	52097725	52098000	CpG: 24	275	24	170	17.5	61.8	0.92
chr12	52115744	52116218	CpG: 54	474	54	362	22.8	76.4	0.78
chr12	52196644	52197429	CpG: 79	785	79	558	20.1	71.1	0.80
chr12	52209055	52209276	CpG: 16	221	16	145	14.5	65.6	0.69
chr12	52213842	52214271	CpG: 43	429	43	306	20.0	71.3	0.80
chr12	52221878	52222603	CpG: 89	725	89	527	24.6	72.7	0.94
chr12	52255084	52255361	CpG: 34	277	34	201	24.5	72.6	0.95
chr12	52265866	52266143	CpG: 33	277	33	201	23.8	72.6	0.93
chr12	52272099	52272697	CpG: 63	598	63	425	21.1	71.1	0.84
chr12	52284941	52285192	CpG: 29	251	29	182	23.1	72.5	0.90
chr12	52319962	52320556	CpG: 52	594	52	417	17.5	70.2	0.71
chr12	52330961	52331226	CpG: 26	265	26	185	19.6	69.8	0.82
chr12	52565514	52566125	CpG: 55	611	55	423	18.0	69.2	0.75
chr12	52639853	52640100	CpG: 24	247	24	179	19.4	72.5	0.83
chr12	52678581	52679192	CpG: 65	611	65	446	21.3	73.0	0.80
chr12	52754383	52754850	CpG: 40	467	40	316	17.1	67.7	0.75
chr12	52838548	52838979	CpG: 45	431	45	322	20.9	74.7	0.75
chr12	52843919	52844186	CpG: 23	267	23	193	17.2	72.3	0.66
chr12	52856363	52856594	CpG: 17	231	17	141	14.7	61.0	0.80
chr12	52868146	52868621	CpG: 43	475	43	344	18.1	72.4	0.70
chr12	52913460	52913937	CpG: 54	477	54	351	22.6	73.6	0.84
chr12	52923021	52923298	CpG: 20	277	20	169	14.4	61.0	0.79
chr12	52929957	52930272	CpG: 26	315	26	222	16.5	70.5	0.67
chr12	52930538	52930812	CpG: 20	274	20	165	14.6	60.2	0.82
chr12	52967903	52968495	CpG: 48	592	48	347	16.2	58.6	0.95
chr12	52970451	52971613	CpG: 103	1162	103	726	17.7	62.5	0.91
chr12	53011179	53012300	CpG: 130	1121	130	845	23.2	75.4	0.82
chr12	53018604	53019002	CpG: 36	398	36	278	18.1	69.8	0.75
chr12	53043398	53044274	CpG: 75	876	75	588	17.1	67.1	0.77
chr12	53061992	53062546	CpG: 48	554	48	404	17.3	72.9	0.65
chr12	53145837	53146962	CpG: 122	1125	122	785	21.7	69.8	0.89
chr12	53163068	53163581	CpG: 48	513	48	360	18.7	70.2	0.76
chr12	53185531	53187633	CpG: 167	2102	167	1389	15.9	66.1	0.73
chr12	53197439	53197803	CpG: 37	364	37	266	20.3	73.1	0.76
chr12	53217525	53217877	CpG: 40	352	40	266	22.7	75.6	0.82
chr12	53232382	53232653	CpG: 22	271	22	163	16.2	60.1	0.90
chr12	53233748	53234249	CpG: 57	501	57	335	22.8	66.9	1.07
chr12	53261154	53261497	CpG: 29	343	29	216	16.9	63.0	0.87
chr12	53265368	53265955	CpG: 53	587	53	385	18.1	65.6	0.85
chr12	53270593	53270866	CpG: 23	273	23	169	16.8	61.9	0.89
chr12	53287066	53287449	CpG: 38	383	38	243	19.8	63.4	0.99
chr12	53290563	53291709	CpG: 116	1146	116	818	20.2	71.4	0.79
chr12	53310502	53310942	CpG: 54	440	54	329	24.5	74.8	0.88
chr12	53317284	53317569	CpG: 23	285	23	172	16.1	60.4	0.91
chr12	53320378	53320652	CpG: 22	274	22	169	16.1	61.7	0.86
chr12	53339161	53339422	CpG: 21	261	21	143	16.1	54.8	1.07
chr12	53346239	53346866	CpG: 70	627	70	484	22.3	77.2	0.76
chr12	53350076	53350312	CpG: 18	236	18	144	15.3	61.0	0.83
chr12	53358425	53358700	CpG: 24	275	24	171	17.5	62.2	0.91
chr12	53387982	53388309	CpG: 30	327	30	204	18.3	62.4	0.96
chr12	53404728	53405007	CpG: 25	279	25	175	17.9	62.7	0.92
chr12	53407554	53407827	CpG: 21	273	21	166	15.4	60.8	0.83
chr12	53408309	53408578	CpG: 21	269	21	160	15.6	59.5	0.89
chr12	53417921	53418859	CpG: 101	938	101	670	21.5	71.4	0.87
chr12	53458833	53459372	CpG: 48	539	48	384	17.8	71.2	0.71
chr12	53465416	53465831	CpG: 40	415	40	306	19.3	73.7	0.75
chr12	53466671	53467534	CpG: 78	863	78	557	18.1	64.5	0.87
chr12	53515080	53515295	CpG: 17	215	17	127	15.8	59.1	0.91
chr12	53543428	53543706	CpG: 21	278	21	165	15.1	59.4	0.88
chr12	53586341	53586615	CpG: 23	274	23	170	16.8	62.0	0.88
chr12	53592070	53592541	CpG: 39	471	39	302	16.6	64.1	0.81
chr12	53641973	53643615	CpG: 119	1642	119	979	14.5	59.6	0.82
chr12	53661238	53661566	CpG: 36	328	36	230	22.0	70.1	0.92
chr12	53704117	53704322	CpG: 18	205	18	127	17.6	62.0	0.92
chr12	53705528	53705804	CpG: 29	276	29	180	21.0	65.2	1.04
chr12	53716532	53717929	CpG: 117	1397	117	928	16.8	66.4	0.77
chr12	53733723	53734008	CpG: 23	285	23	176	16.1	61.8	0.86
chr12	53892958	53893378	CpG: 41	420	41	278	19.5	66.2	0.90
chr12	53901158	53901428	CpG: 22	270	22	157	16.3	58.1	0.97
chr12	53904432	53905469	CpG: 113	1037	113	746	21.8	71.9	0.85
chr12	53910481	53910888	CpG: 33	407	33	235	16.2	57.7	0.98
chr12	53915330	53915556	CpG: 22	226	22	153	19.5	67.7	0.89
chr12	53917271	53917624	CpG: 33	353	33	225	18.7	63.7	0.92
chr12	53918485	53918809	CpG: 29	324	29	216	17.9	66.7	0.83
chr12	53920401	53921084	CpG: 92	683	92	488	26.9	71.4	1.06
chr12	53926234	53927196	CpG: 94	962	94	659	19.5	68.5	0.83
chr12	53931367	53931615	CpG: 18	248	18	147	14.5	59.3	0.83
chr12	53932083	53932368	CpG: 25	285	25	179	17.5	62.8	0.94
chr12	53938523	53940811	CpG: 171	2288	171	1448	14.9	63.3	0.75
chr12	53950420	53951826	CpG: 112	1406	112	905	15.9	64.4	0.77
chr12	53959545	53960452	CpG: 77	907	77	601	17.0	66.3	0.81
chr12	53960833	53961240	CpG: 31	407	31	266	15.2	65.4	0.71
chr12	53965112	53966386	CpG: 117	1274	117	799	18.4	62.7	0.93
chr12	53971150	53971392	CpG: 26	242	26	160	21.5	66.1	1.02
chr12	53971644	53972233	CpG: 47	589	47	354	16.0	60.1	0.90
chr12	53974413	53975090	CpG: 68	677	68	458	20.1	67.7	0.88
chr12	53980209	53980496	CpG: 24	287	24	179	16.7	62.4	0.86
chr12	53983498	53983920	CpG: 32	422	32	294	15.2	69.7	0.63
chr12	53984779	53985135	CpG: 30	356	30	230	16.9	64.6	0.81
chr12	53995208	53995493	CpG: 31	285	31	172	21.8	60.4	1.20
chr12	53996391	53996954	CpG: 49	563	49	377	17.4	67.0	0.78
chr12	53998806	54000490	CpG: 129	1684	129	1063	15.3	63.1	0.77
chr12	54012429	54013330	CpG: 78	901	78	580	17.3	64.4	0.84
chr12	54017657	54017894	CpG: 23	237	23	126	19.4	53.2	1.38
chr12	54019525	54019872	CpG: 30	347	30	228	17.3	65.7	0.86
chr12	54026036	54026245	CpG: 24	209	24	149	23.0	71.3	0.92
chr12	54032569	54032859	CpG: 25	290	25	177	17.2	61.0	0.94
chr12	54045095	54045352	CpG: 25	257	25	178	19.5	69.3	0.81
chr12	54047294	54047598	CpG: 27	304	27	191	17.8	62.8	0.99
chr12	54048102	54048378	CpG: 31	276	31	202	22.5	73.2	0.86
chr12	54055978	54056273	CpG: 36	295	36	214	24.4	72.5	0.95
chr12	54071906	54072937	CpG: 84	1031	84	653	16.3	63.3	0.82
chr12	54091542	54092231	CpG: 50	689	50	456	14.5	66.2	0.66
chr12	54138806	54139265	CpG: 55	459	55	309	24.0	67.3	1.08
chr12	54153855	54154088	CpG: 20	233	20	142	17.2	60.9	0.93
chr12	54184385	54184828	CpG: 41	443	41	288	18.5	65.0	0.89
chr12	54186055	54186541	CpG: 32	486	32	267	13.2	54.9	0.89
chr12	54217093	54217445	CpG: 28	352	28	202	15.9	57.4	0.99
chr12	54246115	54246343	CpG: 18	228	18	136	15.8	59.6	0.92
chr12	54246607	54247781	CpG: 77	1174	77	620	13.1	52.8	0.95
chr12	54292457	54293023	CpG: 38	566	38	310	13.4	54.8	0.91
chr12	54335850	54336081	CpG: 18	231	18	146	15.6	63.2	0.89
chr12	54336858	54337303	CpG: 38	445	38	312	17.1	70.1	0.69
chr12	54345485	54345855	CpG: 46	370	46	299	24.9	80.8	0.83
chr12	54357701	54358039	CpG: 34	338	34	256	20.1	75.7	0.73
chr12	54384783	54385004	CpG: 16	221	16	154	14.5	69.7	0.62
chr12	54385504	54385993	CpG: 41	489	41	352	16.8	72.0	0.65
chr12	54426325	54426599	CpG: 24	274	24	171	17.5	62.4	0.91
chr12	54449293	54449567	CpG: 26	274	26	173	19.0	63.1	0.96
chr12	54454628	54455710	CpG: 92	1082	92	780	17.0	72.1	0.65
chr12	54515891	54516343	CpG: 39	452	39	318	17.3	70.4	0.72
chr12	54554698	54555357	CpG: 75	659	75	492	22.8	74.7	0.82
chr12	54755244	54755603	CpG: 26	359	26	209	14.5	58.2	0.86
chr12	54888539	54888824	CpG: 24	285	24	179	16.8	62.8	0.87
chr12	54920166	54920443	CpG: 19	277	19	164	13.7	59.2	0.80
chr12	55053660	55053902	CpG: 18	242	18	144	14.9	59.5	0.84
chr12	55068532	55068891	CpG: 26	359	26	211	14.5	58.8	0.84
chr12	55209475	55209710	CpG: 19	235	19	143	16.2	60.9	0.89
chr12	55233341	55233614	CpG: 21	273	21	171	15.4	62.6	0.79
chr12	55381415	55381698	CpG: 36	283	36	232	25.4	82.0	0.76
chr12	55612789	55613138	CpG: 33	349	33	237	18.9	67.9	0.87
chr12	55614905	55615651	CpG: 56	746	56	511	15.0	68.5	0.64
chr12	55622034	55622378	CpG: 28	344	28	205	16.3	59.6	0.92
chr12	55633648	55633922	CpG: 22	274	22	167	16.1	60.9	0.88
chr12	55668830	55669103	CpG: 21	273	21	168	15.4	61.5	0.85
chr12	55674063	55674809	CpG: 66	746	66	526	17.7	70.5	0.73
chr12	55680869	55681148	CpG: 23	279	23	170	16.5	60.9	0.90
chr12	55682650	55683150	CpG: 38	500	38	322	15.2	64.4	0.74
chr12	55694867	55696036	CpG: 111	1169	111	848	19.0	72.5	0.73
chr12	55708102	55708334	CpG: 16	232	16	139	13.8	59.9	0.80
chr12	55709624	55710635	CpG: 113	1011	113	743	22.4	73.5	0.83
chr12	55784185	55784413	CpG: 17	228	17	136	14.9	59.6	0.86
chr12	55795786	55796460	CpG: 54	674	54	409	16.0	60.7	0.87
chr12	55796648	55797174	CpG: 36	526	36	338	13.7	64.3	0.70
chr12	55821475	55821750	CpG: 20	275	20	166	14.5	60.4	0.81
chr12	55831257	55831493	CpG: 21	236	21	145	17.8	61.4	0.96
chr12	55845425	55845650	CpG: 17	225	17	132	15.1	58.7	0.90
chr12	55894017	55894906	CpG: 64	889	64	557	14.4	62.7	0.74
chr12	55898864	55899501	CpG: 60	637	60	435	18.8	68.3	0.81
chr12	55902796	55903068	CpG: 24	272	24	181	17.6	66.5	0.82
chr12	55933746	55934188	CpG: 34	442	34	281	15.4	63.6	0.77
chr12	55940915	55941451	CpG: 36	536	36	354	13.4	66.0	0.65
chr12	55967247	55967580	CpG: 29	333	29	248	17.4	74.5	0.63
chr12	55967862	55968143	CpG: 22	281	22	162	15.7	57.7	0.95
chr12	55974369	55975099	CpG: 56	730	56	513	15.3	70.3	0.63
chr12	55989890	55990168	CpG: 24	278	24	173	17.3	62.2	0.90
chr12	56008854	56009687	CpG: 58	833	58	464	13.9	55.7	0.91
chr12	56014575	56014854	CpG: 20	279	20	167	14.3	59.9	0.81
chr12	56035328	56035598	CpG: 21	270	21	164	15.6	60.7	0.86
chr12	56042739	56044070	CpG: 107	1331	107	968	16.1	72.7	0.61
chr12	56046458	56048059	CpG: 116	1601	116	1053	14.5	65.8	0.67
chr12	56071688	56072867	CpG: 98	1179	98	770	16.6	65.3	0.78
chr12	56083466	56083702	CpG: 21	236	21	138	17.8	58.5	1.06
chr12	56085675	56086223	CpG: 50	548	50	358	18.2	65.3	0.86
chr12	56096054	56096268	CpG: 22	214	22	142	20.6	66.4	0.96
chr12	56096757	56097099	CpG: 31	342	31	231	18.1	67.5	0.80
chr12	56120013	56120232	CpG: 24	219	24	152	21.9	69.4	0.94
chr12	56124860	56125227	CpG: 26	367	26	223	14.2	60.8	0.84
chr12	56125744	56125968	CpG: 16	224	16	142	14.3	63.4	0.73
chr12	56156527	56158156	CpG: 147	1629	147	1103	18.0	67.7	0.79
chr12	56189359	56189603	CpG: 23	244	23	167	18.9	68.4	0.81
chr12	56190711	56190920	CpG: 17	209	17	138	16.3	66.0	0.79
chr12	56191830	56192209	CpG: 38	379	38	267	20.1	70.4	0.82
chr12	56225538	56226373	CpG: 89	835	89	617	21.3	73.9	0.78
chr12	56227257	56227582	CpG: 27	325	27	202	16.6	62.2	0.86
chr12	56234302	56234991	CpG: 68	689	68	473	19.7	68.7	0.84
chr12	56267536	56268201	CpG: 62	665	62	463	18.6	69.6	0.78
chr12	56276930	56277365	CpG: 29	435	29	249	13.3	57.2	0.83
chr12	56283319	56283971	CpG: 57	652	57	427	17.5	65.5	0.83
chr12	56298026	56298300	CpG: 24	274	24	171	17.5	62.4	0.91
chr12	56301523	56301858	CpG: 31	335	31	205	18.5	61.2	1.00
chr12	56327764	56328226	CpG: 37	462	37	290	16.0	62.8	0.82
chr12	56376085	56376321	CpG: 18	236	18	143	15.3	60.6	0.85
chr12	56416773	56417182	CpG: 47	409	47	286	23.0	69.9	0.94
chr12	56436092	56436355	CpG: 29	263	29	165	22.1	62.7	1.12
chr12	56455287	56456588	CpG: 94	1301	94	866	14.5	66.6	0.67
chr12	56462147	56462412	CpG: 23	265	23	198	17.4	74.7	0.62
chr12	56478099	56478386	CpG: 23	287	23	175	16.0	61.0	0.88
chr12	56593637	56593866	CpG: 20	229	20	138	17.5	60.3	0.97
chr12	56597509	56598446	CpG: 75	937	75	656	16.0	70.0	0.66
chr12	56602606	56603153	CpG: 48	547	48	377	17.6	68.9	0.81
chr12	56613249	56614025	CpG: 56	776	56	457	14.4	58.9	0.83
chr12	56614929	56615161	CpG: 17	232	17	136	14.7	58.6	0.87
chr12	56619407	56620403	CpG: 72	996	72	659	14.5	66.2	0.66
chr12	56651682	56651955	CpG: 23	273	23	169	16.8	61.9	0.88
chr12	56653433	56653655	CpG: 16	222	16	131	14.4	59.0	0.85
chr12	56655509	56656664	CpG: 112	1155	112	763	19.4	66.1	0.89
chr12	56693125	56693522	CpG: 36	397	36	244	18.1	61.5	0.98
chr12	56720003	56720493	CpG: 49	490	49	312	20.0	63.7	0.99
chr12	56720680	56720937	CpG: 19	257	19	145	14.8	56.4	0.96
chr12	56746668	56746905	CpG: 20	237	20	139	16.9	58.6	0.99
chr12	56763710	56763921	CpG: 21	211	21	154	19.9	73.0	0.77
chr12	56973953	56974557	CpG: 88	604	88	481	29.1	79.6	0.92
chr12	57046363	57046708	CpG: 29	345	29	227	16.8	65.8	0.84
chr12	57054886	57057205	CpG: 188	2319	188	1579	16.2	68.1	0.70
chr12	57095576	57096211	CpG: 51	635	51	434	16.1	68.3	0.70
chr12	57143775	57143993	CpG: 18	218	18	138	16.5	63.3	0.83
chr12	57153371	57153676	CpG: 26	305	26	198	17.0	64.9	0.81
chr12	57171439	57171780	CpG: 29	341	29	229	17.0	67.2	0.76
chr12	57184441	57185624	CpG: 143	1183	143	881	24.2	74.5	0.87
chr12	57188434	57188674	CpG: 26	240	26	171	21.7	71.2	0.89
chr12	57192977	57193857	CpG: 79	880	79	599	18.0	68.1	0.78
chr12	57197875	57198358	CpG: 35	483	35	286	14.5	59.2	0.83
chr12	57204561	57204924	CpG: 28	363	28	240	15.4	66.1	0.71
chr12	57206387	57209033	CpG: 187	2646	187	1696	14.1	64.1	0.69
chr12	57209713	57210027	CpG: 23	314	23	198	14.6	63.1	0.75
chr12	57211011	57212127	CpG: 75	1116	75	702	13.4	62.9	0.69
chr12	57325060	57325319	CpG: 22	259	22	157	17.0	60.6	0.94
chr12	57354517	57354879	CpG: 30	362	30	266	16.6	73.5	0.61
chr12	57398648	57399482	CpG: 99	834	99	617	23.7	74.0	0.87
chr12	57428221	57428479	CpG: 25	258	25	185	19.4	71.7	0.76
chr12	57443581	57444687	CpG: 100	1106	100	762	18.1	68.9	0.76
chr12	57454805	57455135	CpG: 28	330	28	201	17.0	60.9	0.92
chr12	57456259	57456544	CpG: 28	285	28	190	19.6	66.7	0.93
chr12	57475681	57476761	CpG: 85	1080	85	770	15.7	71.3	0.62
chr12	57488252	57488479	CpG: 19	227	19	148	16.7	65.2	0.80
chr12	57488830	57489265	CpG: 45	435	45	307	20.7	70.6	0.84
chr12	57490767	57491486	CpG: 79	719	79	547	22.0	76.1	0.78
chr12	57515019	57515437	CpG: 47	418	47	302	22.5	72.2	0.96
chr12	57518118	57518382	CpG: 32	264	32	200	24.2	75.8	0.85
chr12	57559230	57559756	CpG: 56	526	56	367	21.3	69.8	0.88
chr12	57573053	57573320	CpG: 33	267	33	206	24.7	77.2	0.89
chr12	57578316	57578685	CpG: 27	369	27	245	14.6	66.4	0.67
chr12	57579418	57580225	CpG: 71	807	71	601	17.6	74.5	0.63
chr12	57587607	57588088	CpG: 40	481	40	324	16.6	67.4	0.74
chr12	57589144	57590133	CpG: 81	989	81	656	16.4	66.3	0.76
chr12	57595730	57596473	CpG: 67	743	67	513	18.0	69.0	0.76
chr12	57600097	57601492	CpG: 134	1395	134	982	19.2	70.4	0.78
chr12	57643041	57643342	CpG: 24	301	24	195	15.9	64.8	0.76
chr12	57662119	57662617	CpG: 34	498	34	270	13.7	54.2	0.95
chr12	57694480	57696122	CpG: 159	1642	159	1131	19.4	68.9	0.82
chr12	57704399	57704932	CpG: 42	533	42	348	15.8	65.3	0.76
chr12	57705441	57707305	CpG: 171	1864	171	1363	18.3	73.1	0.70
chr12	57720420	57720927	CpG: 45	507	45	339	17.8	66.9	0.80
chr12	57723301	57724349	CpG: 134	1048	134	825	25.6	78.7	0.83
chr12	57733421	57734566	CpG: 91	1145	91	759	15.9	66.3	0.72
chr12	57740129	57740528	CpG: 30	399	30	252	15.0	63.2	0.78
chr12	57740818	57741307	CpG: 49	489	49	333	20.0	68.1	0.87
chr12	57752008	57752280	CpG: 20	272	20	152	14.7	55.9	0.94
chr12	57796506	57796747	CpG: 18	241	18	141	14.9	58.5	0.88
chr12	57813425	57816059	CpG: 223	2634	223	1775	16.9	67.4	0.75
chr12	57833491	57834080	CpG: 62	589	62	424	21.1	72.0	0.81
chr12	57836181	57836466	CpG: 24	285	24	176	16.8	61.8	0.89
chr12	57864815	57865139	CpG: 38	324	38	250	23.5	77.2	0.79
chr12	57904302	57904583	CpG: 22	281	22	162	15.7	57.7	0.98
chr12	57909716	57910155	CpG: 46	439	46	319	21.0	72.7	0.81
chr12	57933639	57933912	CpG: 25	273	25	169	18.3	61.9	0.96
chr12	58033105	58033379	CpG: 24	274	24	171	17.5	62.4	0.91
chr12	58100583	58100919	CpG: 25	336	25	197	14.9	58.6	0.87
chr12	58105159	58105432	CpG: 21	273	21	171	15.4	62.6	0.79
chr12	58196414	58196695	CpG: 24	281	24	175	17.1	62.3	0.90
chr12	58536321	58536588	CpG: 19	267	19	164	14.2	61.4	0.76
chr12	58617865	58618139	CpG: 19	274	19	166	13.9	60.6	0.77
chr12	58643117	58643343	CpG: 17	226	17	133	15.0	58.8	0.89
chr12	58644773	58645047	CpG: 24	274	24	171	17.5	62.4	0.91
chr12	58900054	58900947	CpG: 110	893	110	621	24.6	69.5	1.03
chr12	58952112	58952386	CpG: 19	274	19	165	13.9	60.2	0.77
chr12	58974328	58974613	CpG: 25	285	25	178	17.5	62.5	0.91
chr12	59003355	59003630	CpG: 24	275	24	170	17.5	61.8	0.92
chr12	59079022	59079297	CpG: 21	275	21	168	15.3	61.1	0.82
chr12	59175169	59175443	CpG: 24	274	24	170	17.5	62.0	0.92
chr12	59572394	59573251	CpG: 80	857	80	574	18.7	67.0	0.83
chr12	59778792	59779065	CpG: 23	273	23	170	16.8	62.3	0.88
chr12	59864867	59865142	CpG: 24	275	24	169	17.5	61.5	0.94
chr12	59944594	59944829	CpG: 18	235	18	143	15.3	60.9	0.84
chr12	60242035	60242612	CpG: 66	577	66	431	22.9	74.7	0.82
chr12	60256523	60256807	CpG: 24	284	24	177	16.9	62.3	0.89
chr12	60295085	60295359	CpG: 24	274	24	175	17.5	63.9	0.87
chr12	60937178	60937461	CpG: 23	283	23	174	16.3	61.5	0.87
chr12	60938124	60938359	CpG: 22	235	22	145	18.7	61.7	1.00
chr12	61168096	61168329	CpG: 17	233	17	137	14.6	58.8	0.86
chr12	61288566	61288844	CpG: 24	278	24	173	17.3	62.2	0.90
chr12	61342874	61343109	CpG: 16	235	16	139	13.6	59.1	0.80
chr12	61423311	61423585	CpG: 24	274	24	171	17.5	62.4	0.91
chr12	61431472	61431746	CpG: 19	274	19	166	13.9	60.6	0.77
chr12	61596181	61596455	CpG: 24	274	24	171	17.5	62.4	0.91
chr12	62014481	62014754	CpG: 25	273	25	169	18.3	61.9	0.96
chr12	62059640	62059903	CpG: 20	263	20	163	15.2	62.0	0.80
chr12	62169714	62171214	CpG: 119	1500	119	938	15.9	62.5	0.82
chr12	62238898	62239710	CpG: 74	812	74	526	18.2	64.8	0.88
chr12	62439246	62439454	CpG: 17	208	17	116	16.3	55.8	1.10
chr12	62445402	62445874	CpG: 50	472	50	332	21.2	70.3	0.87
chr12	62471161	62471446	CpG: 25	285	25	178	17.5	62.5	0.91
chr12	62581197	62582710	CpG: 171	1513	171	1029	22.6	68.0	0.99
chr12	62602328	62602567	CpG: 18	239	18	141	15.1	59.0	0.88
chr12	62610546	62611171	CpG: 52	625	52	405	16.6	64.8	0.80
chr12	62618416	62618690	CpG: 23	274	23	173	16.8	63.1	0.85
chr12	62780648	62780900	CpG: 23	252	23	180	18.3	71.4	0.72
chr12	62783469	62783743	CpG: 21	274	21	169	15.3	61.7	0.82
chr12	62817414	62817688	CpG: 25	274	25	172	18.2	62.8	0.94
chr12	62911486	62911723	CpG: 19	237	19	139	16.0	58.6	0.96
chr12	62913155	62914147	CpG: 107	992	107	719	21.6	72.5	0.83
chr12	62916900	62917150	CpG: 18	250	18	151	14.4	60.4	0.79
chr12	62918476	62918712	CpG: 16	236	16	140	13.6	59.3	0.79
chr12	62948807	62949057	CpG: 21	250	21	148	16.8	59.2	0.98
chr12	63128506	63129837	CpG: 122	1331	122	862	18.3	64.8	0.87
chr12	63503708	63503917	CpG: 17	209	17	132	16.3	63.2	0.83
chr12	63646504	63647751	CpG: 96	1247	96	789	15.4	63.3	0.78
chr12	63665266	63665614	CpG: 31	348	31	268	17.8	77.0	0.60
chr12	63758376	63759166	CpG: 80	790	80	547	20.3	69.2	0.85
chr12	63800428	63800919	CpG: 45	491	45	318	18.3	64.8	0.89
chr12	63822333	63823331	CpG: 126	998	126	747	25.3	74.8	0.91
chr12	63960640	63960874	CpG: 17	234	17	138	14.5	59.0	0.85
chr12	64200854	64201416	CpG: 54	562	54	365	19.2	64.9	0.91
chr12	64271740	64272167	CpG: 33	427	33	257	15.5	60.2	0.86
chr12	64293458	64293685	CpG: 18	227	18	132	15.9	58.1	0.96
chr12	64298728	64298976	CpG: 18	248	18	151	14.5	60.9	0.81
chr12	64358458	64358756	CpG: 23	298	23	179	15.4	60.1	0.86
chr12	64368863	64369517	CpG: 72	654	72	457	22.0	69.9	0.90
chr12	64382782	64383793	CpG: 120	1011	120	727	23.7	71.9	0.93
chr12	64384892	64385101	CpG: 16	209	16	126	15.3	60.3	0.85
chr12	64430446	64431161	CpG: 90	715	90	514	25.2	71.9	0.98
chr12	64433362	64433599	CpG: 20	237	20	144	16.9	60.8	0.94
chr12	64494957	64495235	CpG: 25	278	25	174	18.0	62.6	0.93
chr12	64521373	64522504	CpG: 105	1131	105	877	18.6	77.5	0.63
chr12	64578573	64578809	CpG: 19	236	19	143	16.1	60.6	0.90
chr12	64583516	64583740	CpG: 20	224	20	138	17.9	61.6	0.97
chr12	64587193	64587407	CpG: 15	214	15	130	14.0	60.7	0.79
chr12	64588826	64589932	CpG: 132	1106	132	834	23.9	75.4	0.84
chr12	64617118	64617354	CpG: 20	236	20	145	16.9	61.4	0.92
chr12	64737916	64738536	CpG: 63	620	63	422	20.3	68.1	0.91
chr12	64759279	64760218	CpG: 125	939	125	716	26.6	76.3	0.92
chr12	64803484	64804382	CpG: 93	898	93	653	20.7	72.7	0.78
chr12	65100132	65101319	CpG: 98	1187	98	785	16.5	66.1	0.76
chr12	65146935	65147194	CpG: 20	259	20	159	15.4	61.4	0.86
chr12	65148337	65149538	CpG: 125	1201	125	820	20.8	68.3	0.90
chr12	65257587	65258494	CpG: 101	907	101	677	22.3	74.6	0.80
chr12	65353929	65354161	CpG: 19	232	19	133	16.4	57.3	1.02
chr12	65355161	65355391	CpG: 18	230	18	141	15.7	61.3	0.85
chr12	65534715	65534939	CpG: 22	224	22	132	19.6	58.9	1.13
chr12	65555292	65555570	CpG: 23	278	23	172	16.5	61.9	0.87
chr12	65563933	65564158	CpG: 19	225	19	137	16.9	60.9	0.92
chr12	65708485	65709025	CpG: 56	540	56	369	20.7	68.3	0.90
chr12	65720819	65722099	CpG: 136	1280	136	919	21.2	71.8	0.83
chr12	65724944	65725158	CpG: 18	214	18	121	16.8	56.5	1.09
chr12	65774060	65774312	CpG: 17	252	17	155	13.5	61.5	0.73
chr12	65794052	65794291	CpG: 18	239	18	145	15.1	60.7	0.83
chr12	65803240	65805902	CpG: 242	2662	242	1802	18.2	67.7	0.80
chr12	66110190	66110518	CpG: 30	328	30	200	18.3	61.0	0.99
chr12	66140265	66140622	CpG: 30	357	30	250	16.8	70.0	0.69
chr12	66148929	66149994	CpG: 81	1065	81	636	15.2	59.7	0.85
chr12	66168407	66169057	CpG: 78	650	78	478	24.0	73.5	0.89
chr12	66200078	66200352	CpG: 24	274	24	171	17.5	62.4	0.91
chr12	66212765	66213044	CpG: 22	279	22	170	15.8	60.9	0.86
chr12	66214757	66215162	CpG: 66	405	66	318	32.6	78.5	1.07
chr12	66281665	66282266	CpG: 42	601	42	375	14.0	62.4	0.72
chr12	66389445	66389719	CpG: 23	274	23	169	16.8	61.7	0.89
chr12	66423674	66423955	CpG: 22	281	22	173	15.7	61.6	0.84
chr12	66429488	66429728	CpG: 18	240	18	141	15.0	58.8	0.88
chr12	66463362	66463636	CpG: 23	274	23	169	16.8	61.7	0.89
chr12	67048150	67049371	CpG: 146	1221	146	915	23.9	74.9	0.86
chr12	67235574	67235843	CpG: 20	269	20	168	14.9	62.5	0.77
chr12	67248648	67249660	CpG: 100	1012	100	697	19.8	68.9	0.84
chr12	67627905	67629615	CpG: 217	1710	217	1303	25.4	76.2	0.89
chr12	67658961	67659200	CpG: 18	239	18	144	15.1	60.3	0.85
chr12	67698736	67699105	CpG: 36	369	36	274	19.5	74.3	0.71
chr12	67810573	67810797	CpG: 19	224	19	138	17.0	61.6	0.92
chr12	67983137	67983374	CpG: 16	237	16	137	13.5	57.8	0.84
chr12	68159829	68160065	CpG: 19	236	19	144	16.1	61.0	0.88
chr12	68311618	68312246	CpG: 54	628	54	424	17.2	67.5	0.76
chr12	68353008	68353293	CpG: 20	285	20	170	14.0	59.6	0.80
chr12	68376169	68376381	CpG: 16	212	16	129	15.1	60.8	0.83
chr12	68547905	68548180	CpG: 22	275	22	169	16.0	61.5	0.86
chr12	68550044	68550318	CpG: 19	274	19	164	13.9	59.9	0.78
chr12	68588523	68589003	CpG: 31	480	31	280	12.9	58.3	0.76
chr12	68589977	68591134	CpG: 150	1157	150	838	25.9	72.4	0.99
chr12	68666347	68666923	CpG: 39	576	39	333	13.5	57.8	0.82
chr12	68725592	68725983	CpG: 47	391	47	277	24.0	70.8	0.99
chr12	68787425	68788466	CpG: 115	1041	115	722	22.1	69.4	0.93
chr12	68827055	68827333	CpG: 22	278	22	171	15.8	61.5	0.85
chr12	68912482	68913328	CpG: 99	846	99	625	23.4	73.9	0.86
chr12	69218575	69219398	CpG: 129	823	129	628	31.3	76.3	1.08
chr12	69337504	69337739	CpG: 17	235	17	139	14.5	59.1	0.85
chr12	69338601	69339244	CpG: 66	643	66	417	20.5	64.9	0.98
chr12	69342002	69342243	CpG: 19	241	19	148	15.8	61.4	0.86
chr12	69353816	69354748	CpG: 69	932	69	639	14.8	68.6	0.63
chr12	69415512	69415743	CpG: 17	231	17	139	14.7	60.2	0.83
chr12	69423789	69424024	CpG: 20	235	20	146	17.0	62.1	0.90
chr12	69448136	69448424	CpG: 25	288	25	180	17.4	62.5	0.90
chr12	69449154	69449633	CpG: 53	479	53	344	22.1	71.8	0.86
chr12	69464162	69464394	CpG: 19	232	19	138	16.4	59.5	0.95
chr12	69564200	69564859	CpG: 58	659	58	450	17.6	68.3	0.76
chr12	69707700	69707976	CpG: 24	276	24	171	17.4	62.0	0.92
chr12	69717694	69718913	CpG: 159	1219	159	904	26.1	74.2	0.95
chr12	69738685	69739386	CpG: 62	701	62	507	17.7	72.3	0.68
chr12	69758128	69758555	CpG: 32	427	32	254	15.0	59.5	0.85
chr12	69786176	69787074	CpG: 72	898	72	641	16.0	71.4	0.63
chr12	69832283	69833346	CpG: 79	1063	79	731	14.9	68.8	0.63
chr12	69856201	69856432	CpG: 18	231	18	141	15.6	61.0	0.84
chr12	69918091	69918307	CpG: 20	216	20	130	18.5	60.2	1.02
chr12	69924987	69925257	CpG: 22	270	22	167	16.3	61.9	0.86
chr12	69944017	69944290	CpG: 22	273	22	166	16.1	60.8	0.88
chr12	69974709	69974984	CpG: 20	275	20	165	14.5	60.0	0.82
chr12	69992405	69992731	CpG: 23	326	23	192	14.1	58.9	0.82
chr12	70021457	70021723	CpG: 22	266	22	161	16.5	60.5	0.91
chr12	70077486	70077722	CpG: 20	236	20	146	16.9	61.9	0.91
chr12	70212272	70212516	CpG: 17	244	17	143	13.9	58.6	0.83
chr12	70222230	70223362	CpG: 116	1132	116	767	20.5	67.8	0.90
chr12	70241686	70241962	CpG: 19	276	19	163	13.8	59.1	0.80
chr12	70345127	70346742	CpG: 171	1615	171	1126	21.2	69.7	0.87
chr12	70361636	70361898	CpG: 24	262	24	164	18.3	62.6	0.95
chr12	70589255	70589688	CpG: 55	433	55	327	25.4	75.5	0.89
chr12	70661468	70661746	CpG: 26	278	26	177	18.7	63.7	0.93
chr12	70864072	70864308	CpG: 19	236	19	136	16.1	57.6	0.98
chr12	70964692	70964966	CpG: 24	274	24	171	17.5	62.4	0.91
chr12	71097715	71098026	CpG: 25	311	25	190	16.1	61.1	0.87
chr12	71146116	71146707	CpG: 51	591	51	430	17.3	72.8	0.65
chr12	71354463	71354822	CpG: 38	359	38	265	21.2	73.8	0.78
chr12	71417157	71418354	CpG: 104	1197	104	800	17.4	66.8	0.78
chr12	71492075	71492289	CpG: 18	214	18	130	16.8	60.7	0.92
chr12	71563932	71564206	CpG: 23	274	23	169	16.8	61.7	0.89
chr12	71640497	71641516	CpG: 90	1019	90	639	17.7	62.7	0.92
chr12	71663511	71663983	CpG: 55	472	55	339	23.3	71.8	0.91
chr12	71732179	71733042	CpG: 84	863	84	597	19.5	69.2	0.82
chr12	71739810	71740040	CpG: 20	230	20	141	17.4	61.3	0.94
chr12	71816725	71817333	CpG: 44	608	44	345	14.5	56.7	0.90
chr12	71902214	71902488	CpG: 24	274	24	171	17.5	62.4	0.91
chr12	71944879	71945113	CpG: 19	234	19	144	16.2	61.5	0.87
chr12	72107057	72107294	CpG: 19	237	19	141	16.0	59.5	0.93
chr12	72160974	72161362	CpG: 31	388	31	283	16.0	72.9	0.60
chr12	72179159	72179379	CpG: 17	220	17	128	15.5	58.2	0.92
chr12	72247665	72249707	CpG: 187	2042	187	1356	18.3	66.4	0.83
chr12	72357159	72357438	CpG: 24	279	24	174	17.2	62.4	0.89
chr12	72496024	72496267	CpG: 21	243	21	144	17.3	59.3	0.98
chr12	72615914	72616139	CpG: 16	225	16	136	14.2	60.4	0.78
chr12	72777814	72778050	CpG: 23	236	23	145	19.5	61.4	1.05
chr12	73177506	73177731	CpG: 17	225	17	130	15.1	57.8	0.91
chr12	73267377	73267601	CpG: 20	224	20	134	17.9	59.8	1.00
chr12	73316497	73316789	CpG: 22	292	22	169	15.1	57.9	0.91
chr12	73484155	73484429	CpG: 24	274	24	171	17.5	62.4	0.91
chr12	73973158	73973438	CpG: 26	280	26	176	18.6	62.9	0.95
chr12	74148292	74148718	CpG: 30	426	30	276	14.1	64.8	0.67
chr12	74219174	74219415	CpG: 19	241	19	143	15.8	59.3	0.91
chr12	74271406	74271680	CpG: 25	274	25	169	18.2	61.7	0.97
chr12	74322179	74322453	CpG: 24	274	24	171	17.5	62.4	0.91
chr12	74376800	74377192	CpG: 34	392	34	287	17.3	73.2	0.65
chr12	74482992	74483300	CpG: 24	308	24	186	15.6	60.4	0.86
chr12	74510562	74510839	CpG: 23	277	23	170	16.6	61.4	0.89
chr12	74511570	74511957	CpG: 38	387	38	260	19.6	67.2	0.88
chr12	74561872	74562583	CpG: 53	711	53	484	14.9	68.1	0.65
chr12	74849627	74849903	CpG: 23	276	23	165	16.7	59.8	0.94
chr12	75050964	75051217	CpG: 21	253	21	148	16.6	58.5	0.99
chr12	75113321	75113571	CpG: 18	250	18	145	14.4	58.0	0.88
chr12	75166205	75166485	CpG: 23	280	23	173	16.4	61.8	0.87
chr12	75181942	75182613	CpG: 78	671	78	473	23.2	70.5	0.94
chr12	75183852	75184205	CpG: 34	353	34	235	19.3	66.6	0.87
chr12	75274874	75275114	CpG: 19	240	19	144	15.8	60.0	0.90
chr12	75280130	75280333	CpG: 19	203	19	144	18.7	70.9	0.75
chr12	75304639	75305016	CpG: 34	377	34	251	18.0	66.6	0.83
chr12	75306175	75306449	CpG: 23	274	23	169	16.8	61.7	0.89
chr12	75316056	75316330	CpG: 27	274	27	169	19.7	61.7	1.04
chr12	75365603	75366045	CpG: 34	442	34	275	15.4	62.2	0.80
chr12	75460269	75460499	CpG: 19	230	19	140	16.5	60.9	0.90
chr12	75486126	75486425	CpG: 26	299	26	158	17.4	52.8	1.27
chr12	75512031	75512308	CpG: 23	277	23	170	16.6	61.4	0.89
chr12	75774223	75774455	CpG: 21	232	21	140	18.1	60.3	1.01
chr12	75880279	75880556	CpG: 24	277	24	171	17.3	61.7	0.92
chr12	75918014	75918256	CpG: 20	242	20	147	16.5	60.7	0.91
chr12	76005323	76007613	CpG: 192	2290	192	1505	16.8	65.7	0.78
chr12	76058978	76060392	CpG: 140	1414	140	969	19.8	68.5	0.87
chr12	76199444	76199725	CpG: 23	281	23	176	16.4	62.6	0.84
chr12	76290808	76291048	CpG: 18	240	18	146	15.0	60.8	0.83
chr12	76297691	76298030	CpG: 25	339	25	202	14.7	59.6	0.83
chr12	76326050	76326427	CpG: 31	377	31	237	16.4	62.9	0.83
chr12	76536867	76537990	CpG: 104	1123	104	759	18.5	67.6	0.82
chr12	76655143	76655383	CpG: 19	240	19	142	15.8	59.2	0.95
chr12	76737770	76738006	CpG: 17	236	17	144	14.4	61.0	0.80
chr12	76738208	76738419	CpG: 15	211	15	126	14.2	59.7	0.81
chr12	76741198	76741412	CpG: 16	214	16	124	15.0	57.9	0.91
chr12	76741647	76742562	CpG: 95	915	95	648	20.8	70.8	0.84
chr12	76836155	76836390	CpG: 17	235	17	136	14.5	57.9	0.89
chr12	76856667	76857306	CpG: 73	639	73	470	22.8	73.6	0.85
chr12	76867158	76867388	CpG: 20	230	20	143	17.4	62.2	0.91
chr12	76880369	76880578	CpG: 18	209	18	127	17.2	60.8	0.95
chr12	76932762	76933047	CpG: 26	285	26	179	18.2	62.8	0.94
chr12	77043019	77044014	CpG: 103	995	103	696	20.7	69.9	0.85
chr12	77091221	77091496	CpG: 22	275	22	169	16.0	61.5	0.85
chr12	77156945	77157214	CpG: 22	269	22	161	16.4	59.9	0.93
chr12	77221840	77222113	CpG: 20	273	20	169	14.7	61.9	0.77
chr12	77302722	77303709	CpG: 94	987	94	639	19.0	64.7	0.91
chr12	77492838	77493113	CpG: 24	275	24	172	17.5	62.5	0.90
chr12	77632042	77632267	CpG: 19	225	19	133	16.9	59.1	0.97
chr12	77716772	77717043	CpG: 20	271	20	162	14.8	59.8	0.84
chr12	77978933	77979170	CpG: 22	237	22	147	18.6	62.0	0.99
chr12	78056754	78057028	CpG: 24	274	24	171	17.5	62.4	0.91
chr12	78069854	78070128	CpG: 23	274	23	170	16.8	62.0	0.88
chr12	78782745	78783177	CpG: 45	432	45	260	20.8	60.2	1.20
chr12	78839735	78839974	CpG: 17	239	17	144	14.2	60.3	0.80
chr12	79023820	79024045	CpG: 22	225	22	134	19.6	59.6	1.10
chr12	79100754	79101028	CpG: 25	274	25	172	18.2	62.8	0.94
chr12	79124309	79124583	CpG: 22	274	22	169	16.1	61.7	0.85
chr12	79236160	79236448	CpG: 22	288	22	172	15.3	59.7	0.87
chr12	79292529	79292809	CpG: 25	280	25	175	17.9	62.5	0.93
chr12	79328904	79329178	CpG: 22	274	22	168	16.1	61.3	0.86
chr12	79349113	79349388	CpG: 19	275	19	163	13.8	59.3	0.79
chr12	79636170	79636407	CpG: 20	237	20	143	16.9	60.3	0.95
chr12	79668299	79670030	CpG: 210	1731	210	1276	24.3	73.7	0.89
chr12	79689452	79690028	CpG: 47	576	47	423	16.3	73.4	0.61
chr12	79694831	79695105	CpG: 23	274	23	173	16.8	63.1	0.86
chr12	79913201	79914177	CpG: 87	976	87	661	17.8	67.7	0.78
chr12	79972026	79972385	CpG: 35	359	35	266	19.5	74.1	0.71
chr12	79981210	79981466	CpG: 18	256	18	152	14.1	59.4	0.83
chr12	80070161	80070436	CpG: 18	275	18	159	13.1	57.8	0.79
chr12	80169115	80169351	CpG: 18	236	18	141	15.3	59.7	0.88
chr12	80228352	80228668	CpG: 27	316	27	195	17.1	61.7	0.90
chr12	80376480	80376722	CpG: 22	242	22	146	18.2	60.3	1.02
chr12	80456214	80456607	CpG: 29	393	29	232	14.8	59.0	0.85
chr12	80537778	80538052	CpG: 20	274	20	164	14.6	59.9	0.82
chr12	80557140	80557352	CpG: 15	212	15	129	14.2	60.8	0.76
chr12	80621343	80621617	CpG: 25	274	25	172	18.2	62.8	0.93
chr12	80686962	80687644	CpG: 50	682	50	406	14.7	59.5	0.83
chr12	80695656	80696057	CpG: 33	401	33	260	16.5	64.8	0.78
chr12	80915672	80916786	CpG: 104	1114	104	764	18.7	68.6	0.80
chr12	81016561	81016832	CpG: 23	271	23	163	17.0	60.1	0.95
chr12	81029341	81029616	CpG: 25	275	25	173	18.2	62.9	0.94
chr12	81056756	81057306	CpG: 43	550	43	359	15.6	65.3	0.73
chr12	81247137	81247414	CpG: 25	277	25	174	18.1	62.8	0.92
chr12	81541510	81541776	CpG: 23	266	23	166	17.3	62.4	0.90
chr12	81598868	81599101	CpG: 18	233	18	141	15.5	60.5	0.87
chr12	81615269	81615543	CpG: 23	274	23	171	16.8	62.4	0.87
chr12	81617686	81617960	CpG: 24	274	24	171	17.5	62.4	0.91
chr12	81737603	81737957	CpG: 34	354	34	234	19.2	66.1	0.88
chr12	81925866	81926142	CpG: 21	276	21	168	15.2	60.9	0.83
chr12	82094356	82094619	CpG: 24	263	24	163	18.3	62.0	0.96
chr12	82112892	82113166	CpG: 23	274	23	171	16.8	62.4	0.87
chr12	82198650	82198885	CpG: 16	235	16	138	13.6	58.7	0.81
chr12	82337685	82338427	CpG: 59	742	59	472	15.9	63.6	0.79
chr12	82583000	82583278	CpG: 25	278	25	174	18.0	62.6	0.93
chr12	82666418	82667396	CpG: 78	978	78	640	16.0	65.4	0.76
chr12	82683087	82683310	CpG: 16	223	16	133	14.3	59.6	0.84
chr12	82695909	82696182	CpG: 23	273	23	167	16.8	61.2	0.91
chr12	82708334	82708565	CpG: 18	231	18	167	15.6	72.3	0.60
chr12	82758076	82758354	CpG: 23	278	23	172	16.5	61.9	0.87
chr12	82861573	82861809	CpG: 20	236	20	144	16.9	61.0	0.93
chr12	82882955	82883227	CpG: 23	272	23	169	16.9	62.1	0.90
chr12	82926830	82927049	CpG: 18	219	18	135	16.4	61.6	0.87
chr12	83610572	83610803	CpG: 20	231	20	141	17.3	61.0	0.97
chr12	83627340	83627615	CpG: 22	275	22	169	16.0	61.5	0.86
chr12	83923641	83923915	CpG: 23	274	23	170	16.8	62.0	0.88
chr12	83966206	83966480	CpG: 23	274	23	169	16.8	61.7	0.89
chr12	84051070	84051344	CpG: 25	274	25	172	18.2	62.8	0.93
chr12	84103005	84103216	CpG: 16	211	16	126	15.2	59.7	0.87
chr12	84138694	84138979	CpG: 23	285	23	177	16.1	62.1	0.85
chr12	84276551	84276826	CpG: 21	275	21	166	15.3	60.4	0.85
chr12	84398000	84398279	CpG: 20	279	20	170	14.3	60.9	0.79
chr12	84523034	84523269	CpG: 16	235	16	136	13.6	57.9	0.83
chr12	84532529	84532755	CpG: 19	226	19	131	16.8	58.0	1.01
chr12	84534192	84534477	CpG: 24	285	24	178	16.8	62.5	0.88
chr12	84548280	84548518	CpG: 18	238	18	142	15.1	59.7	0.87
chr12	84589829	84590065	CpG: 17	236	17	138	14.4	58.5	0.86
chr12	84716168	84716445	CpG: 24	277	24	169	17.3	61.0	0.94
chr12	84741315	84741545	CpG: 19	230	19	140	16.5	60.9	0.90
chr12	84890825	84891047	CpG: 17	222	17	138	15.3	62.2	0.79
chr12	84891288	84891501	CpG: 16	213	16	118	15.0	55.4	1.00
chr12	84891907	84892454	CpG: 52	547	52	371	19.0	67.8	0.85
chr12	84927127	84927365	CpG: 19	238	19	145	16.0	60.9	0.88
chr12	84959634	84959862	CpG: 22	228	22	143	19.3	62.7	1.02
chr12	85096337	85096617	CpG: 20	280	20	173	14.3	61.8	0.75
chr12	85211024	85211257	CpG: 20	233	20	142	17.2	60.9	0.94
chr12	85260446	85261268	CpG: 57	822	57	488	13.9	59.4	0.79
chr12	85298429	85298672	CpG: 21	243	21	148	17.3	60.9	0.93
chr12	85317091	85317331	CpG: 17	240	17	144	14.2	60.0	0.82
chr12	85666843	85667124	CpG: 22	281	22	173	15.7	61.6	0.84
chr12	85759021	85759300	CpG: 25	279	25	175	17.9	62.7	0.92
chr12	85799324	85799597	CpG: 20	273	20	162	14.7	59.3	0.85
chr12	85967996	85968271	CpG: 23	275	23	171	16.7	62.2	0.87
chr12	86110559	86110833	CpG: 25	274	25	171	18.2	62.4	0.95
chr12	86193582	86193860	CpG: 24	278	24	169	17.3	60.8	0.95
chr12	86256779	86257055	CpG: 22	276	22	159	15.9	57.6	0.97
chr12	86277329	86277710	CpG: 32	381	32	275	16.8	72.2	0.65
chr12	86288704	86288941	CpG: 20	237	20	142	16.9	59.9	0.96
chr12	86296365	86296605	CpG: 19	240	19	142	15.8	59.2	0.94
chr12	86498741	86498984	CpG: 20	243	20	144	16.5	59.3	0.96
chr12	86820703	86820980	CpG: 24	277	24	174	17.3	62.8	0.89
chr12	86860911	86861185	CpG: 23	274	23	171	16.8	62.4	0.87
chr12	86903616	86903852	CpG: 19	236	19	143	16.1	60.6	0.90
chr12	87190711	87190995	CpG: 25	284	25	179	17.6	63.0	0.90
chr12	87311557	87311815	CpG: 25	258	25	191	19.4	74.0	0.71
chr12	87489857	87490131	CpG: 24	274	24	174	17.5	63.5	0.88
chr12	87620004	87620278	CpG: 24	274	24	171	17.5	62.4	0.91
chr12	87925965	87926239	CpG: 24	274	24	171	17.5	62.4	0.91
chr12	87987853	87988085	CpG: 17	232	17	137	14.7	59.1	0.86
chr12	88017206	88017707	CpG: 52	501	52	329	20.8	65.7	0.98
chr12	88098565	88098801	CpG: 21	236	21	144	17.8	61.0	0.98
chr12	88123900	88124313	CpG: 34	413	34	257	16.5	62.2	0.86
chr12	88361828	88362059	CpG: 20	231	20	140	17.3	60.6	0.96
chr12	88416898	88417134	CpG: 19	236	19	143	16.1	60.6	0.89
chr12	88561617	88562823	CpG: 104	1206	104	773	17.2	64.1	0.84
chr12	88836762	88837003	CpG: 19	241	19	149	15.8	61.8	0.85
chr12	88869862	88870128	CpG: 23	266	23	166	17.3	62.4	0.90
chr12	89112298	89112531	CpG: 17	233	17	139	14.6	59.7	0.84
chr12	89333335	89336311	CpG: 259	2976	259	1845	17.4	62.0	0.91
chr12	89420115	89420389	CpG: 22	274	22	168	16.1	61.3	0.87
chr12	89485104	89485888	CpG: 59	784	59	540	15.1	68.9	0.64
chr12	89507091	89507983	CpG: 85	892	85	621	19.1	69.6	0.79
chr12	89635145	89635427	CpG: 23	282	23	173	16.3	61.3	0.88
chr12	89689536	89692165	CpG: 297	2629	297	1882	22.6	71.6	0.88
chr12	89702382	89702656	CpG: 24	274	24	171	17.5	62.4	0.91
chr12	89794127	89794370	CpG: 19	243	19	145	15.6	59.7	0.88
chr12	89801664	89801939	CpG: 22	275	22	170	16.0	61.8	0.85
chr12	89934202	89934481	CpG: 24	279	24	173	17.2	62.0	0.90
chr12	90028142	90028394	CpG: 19	252	19	149	15.1	59.1	0.87
chr12	90388424	90389196	CpG: 59	772	59	528	15.3	68.4	0.65
chr12	90514163	90514472	CpG: 26	309	26	184	16.8	59.5	0.95
chr12	90618088	90618369	CpG: 22	281	22	173	15.7	61.6	0.84
chr12	90714526	90714811	CpG: 25	285	25	178	17.5	62.5	0.91
chr12	90743996	90744226	CpG: 18	230	18	138	15.7	60.0	0.89
chr12	90801370	90801627	CpG: 27	257	27	196	21.0	76.3	0.73
chr12	90819296	90819566	CpG: 22	270	22	165	16.3	61.1	0.88
chr12	90931535	90932473	CpG: 68	938	68	606	14.5	64.6	0.69
chr12	91147261	91147498	CpG: 18	237	18	141	15.2	59.5	0.88
chr12	91547298	91547572	CpG: 23	274	23	169	16.8	61.7	0.89
chr12	91611225	91611822	CpG: 49	597	49	433	16.4	72.5	0.62
chr12	91900597	91900802	CpG: 16	205	16	116	15.6	56.6	1.00
chr12	91901440	91901775	CpG: 31	335	31	245	18.5	73.1	0.69
chr12	91976725	91976998	CpG: 21	273	21	170	15.4	62.3	0.80
chr12	92049231	92049509	CpG: 25	278	25	174	18.0	62.6	0.93
chr12	92122497	92124120	CpG: 151	1623	151	1068	18.6	65.8	0.86
chr12	92128406	92128673	CpG: 19	267	19	161	14.2	60.3	0.81
chr12	92270687	92270965	CpG: 25	278	25	173	18.0	62.2	0.94
chr12	92291620	92291930	CpG: 25	310	25	188	16.1	60.6	0.88
chr12	92300144	92300378	CpG: 21	234	21	144	17.9	61.5	0.97
chr12	92383246	92383454	CpG: 15	208	15	119	14.4	57.2	0.90
chr12	92383970	92384374	CpG: 32	404	32	292	15.8	72.3	0.61
chr12	92809402	92809685	CpG: 23	283	23	174	16.3	61.5	0.87
chr12	92832751	92832994	CpG: 20	243	20	143	16.5	58.8	0.97
chr12	92896655	92897082	CpG: 30	427	30	253	14.1	59.3	0.80
chr12	92909462	92910618	CpG: 141	1156	141	853	24.4	73.8	0.90
chr12	93063063	93063358	CpG: 24	295	24	176	16.3	59.7	0.93
chr12	93318274	93318538	CpG: 20	264	20	157	15.2	59.5	0.87
chr12	93358663	93359487	CpG: 107	824	107	619	26.0	75.1	0.92
chr12	93422144	93423375	CpG: 159	1231	159	904	25.8	73.4	0.96
chr12	93448396	93448731	CpG: 32	335	32	213	19.1	63.6	0.95
chr12	93551640	93555072	CpG: 327	3432	327	2317	19.1	67.5	0.84
chr12	93659012	93659374	CpG: 27	362	27	224	14.9	61.9	0.78
chr12	93706399	93706635	CpG: 18	236	18	140	15.3	59.3	0.88
chr12	93751630	93751868	CpG: 21	238	21	144	17.6	60.5	1.00
chr12	94082632	94083715	CpG: 72	1083	72	658	13.3	60.8	0.72
chr12	94121102	94121325	CpG: 19	223	19	153	17.0	68.6	0.72
chr12	94129106	94131379	CpG: 268	2273	268	1657	23.6	72.9	0.89
chr12	94168031	94168249	CpG: 21	218	21	139	19.3	63.8	0.95
chr12	94324346	94324635	CpG: 24	289	24	178	16.6	61.6	0.89
chr12	94440370	94441341	CpG: 92	971	92	656	18.9	67.6	0.84
chr12	94630601	94631547	CpG: 134	946	134	730	28.3	77.2	0.95
chr12	94723040	94723321	CpG: 24	281	24	174	17.1	61.9	0.91
chr12	94853738	94854691	CpG: 119	953	119	741	25.0	77.8	0.83
chr12	94931002	94931280	CpG: 24	278	24	174	17.3	62.6	0.89
chr12	94984312	94984541	CpG: 24	229	24	153	21.0	66.8	0.95
chr12	95052513	95052916	CpG: 27	403	27	220	13.4	54.6	0.90
chr12	95053579	95054393	CpG: 102	814	102	573	25.1	70.4	1.01
chr12	95197853	95199016	CpG: 118	1163	118	763	20.3	65.6	0.94
chr12	95216011	95217088	CpG: 91	1077	91	785	16.9	72.9	0.64
chr12	95248981	95249262	CpG: 22	281	22	173	15.7	61.6	0.83
chr12	95320600	95320870	CpG: 23	270	23	170	17.0	63.0	0.87
chr12	95338225	95338461	CpG: 22	236	22	145	18.6	61.4	1.01
chr12	95360672	95360906	CpG: 23	234	23	172	19.7	73.5	0.73
chr12	95391579	95391860	CpG: 23	281	23	176	16.4	62.6	0.85
chr12	95454834	95455269	CpG: 39	435	39	286	17.9	65.7	0.83
chr12	95500547	95500776	CpG: 19	229	19	137	16.6	59.8	0.97
chr12	95529171	95530252	CpG: 139	1081	139	780	25.7	72.2	1.01
chr12	95590978	95591216	CpG: 18	238	18	141	15.1	59.2	0.88
chr12	95629764	95629998	CpG: 23	234	23	146	19.7	62.4	1.04
chr12	95750177	95750441	CpG: 21	264	21	161	15.9	61.0	0.86
chr12	95769253	95770580	CpG: 135	1327	135	965	20.3	72.7	0.78
chr12	95796016	95796286	CpG: 19	270	19	163	14.1	60.4	0.79
chr12	95834663	95834889	CpG: 18	226	18	119	15.9	52.7	1.17
chr12	95835198	95835673	CpG: 40	475	40	296	16.8	62.3	0.87
chr12	95919037	95920203	CpG: 89	1166	89	772	15.3	66.2	0.71
chr12	95930711	95930914	CpG: 18	203	18	131	17.7	64.5	0.86
chr12	95943138	95943526	CpG: 32	388	32	279	16.5	71.9	0.64
chr12	95943763	95943992	CpG: 20	229	20	139	17.5	60.7	0.96
chr12	95969624	95969894	CpG: 23	270	23	177	17.0	65.6	0.83
chr12	96009233	96009728	CpG: 41	495	41	320	16.6	64.6	0.84
chr12	96011712	96011987	CpG: 20	275	20	166	14.5	60.4	0.81
chr12	96060909	96061183	CpG: 24	274	24	170	17.5	62.0	0.92
chr12	96082980	96083323	CpG: 36	343	36	257	21.0	74.9	0.75
chr12	96126779	96127057	CpG: 26	278	26	176	18.7	63.3	0.94
chr12	96168192	96169498	CpG: 133	1306	133	927	20.4	71.0	0.82
chr12	96221194	96221564	CpG: 30	370	30	233	16.2	63.0	0.82
chr12	96290177	96290604	CpG: 31	427	31	255	14.5	59.7	0.82
chr12	96373613	96374952	CpG: 187	1339	187	1004	27.9	75.0	1.00
chr12	96463669	96464120	CpG: 45	451	45	290	20.0	64.3	0.97
chr12	96565712	96565989	CpG: 23	277	23	168	16.6	60.6	0.91
chr12	96628314	96628588	CpG: 23	274	23	170	16.8	62.0	0.88
chr12	96703483	96703707	CpG: 17	224	17	136	15.2	60.7	0.83
chr12	96848420	96848686	CpG: 25	266	25	170	18.8	63.9	0.94
chr12	96876706	96876980	CpG: 23	274	23	170	16.8	62.0	0.88
chr12	96880779	96881264	CpG: 64	485	64	366	26.4	75.5	0.93
chr12	97047697	97047975	CpG: 24	278	24	178	17.3	64.0	0.86
chr12	97201052	97201322	CpG: 24	270	24	169	17.8	62.6	0.92
chr12	97660435	97660652	CpG: 15	217	15	124	13.8	57.1	0.85
chr12	97697126	97697368	CpG: 20	242	20	145	16.5	59.9	0.92
chr12	97893792	97894066	CpG: 24	274	24	170	17.5	62.0	0.92
chr12	98223255	98223536	CpG: 23	281	23	174	16.4	61.9	0.87
chr12	98430152	98430464	CpG: 37	312	37	232	23.7	74.4	0.88
chr12	98477092	98477583	CpG: 40	491	40	288	16.3	58.7	0.97
chr12	98488550	98489759	CpG: 142	1209	142	828	23.5	68.5	1.00
chr12	98527138	98527415	CpG: 21	277	21	166	15.2	59.9	0.85
chr12	98529396	98529626	CpG: 18	230	18	135	15.7	58.7	0.92
chr12	98566382	98567392	CpG: 93	1010	93	666	18.4	65.9	0.85
chr12	98617422	98618645	CpG: 122	1223	122	860	20.0	70.3	0.81
chr12	98655017	98655291	CpG: 20	274	20	164	14.6	59.9	0.82
chr12	98718561	98718973	CpG: 44	412	44	259	21.4	62.9	1.08
chr12	98827878	98828159	CpG: 23	281	23	172	16.4	61.2	0.89
chr12	98857537	98857818	CpG: 23	281	23	173	16.4	61.6	0.88
chr12	98867461	98868613	CpG: 152	1152	152	870	26.4	75.5	0.93
chr12	99025471	99025753	CpG: 24	282	24	174	17.0	61.7	0.91
chr12	99031784	99032058	CpG: 24	274	24	171	17.5	62.4	0.91
chr12	99546268	99546554	CpG: 24	286	24	178	16.8	62.2	0.88
chr12	99682602	99682877	CpG: 24	275	24	173	17.5	62.9	0.89
chr12	99889526	99889803	CpG: 23	277	23	172	16.6	62.1	0.87
chr12	99924064	99924375	CpG: 21	311	21	188	13.5	60.5	0.74
chr12	99945686	99946350	CpG: 93	664	93	511	28.0	77.0	0.98
chr12	99960106	99960380	CpG: 24	274	24	171	17.5	62.4	0.91
chr12	100103373	100104275	CpG: 101	902	101	649	22.4	72.0	0.87
chr12	100160715	100161499	CpG: 84	784	84	549	21.4	70.0	0.89
chr12	100161948	100162261	CpG: 24	313	24	164	15.3	52.4	1.12
chr12	100228196	100229094	CpG: 83	898	83	606	18.5	67.5	0.81
chr12	100231267	100231513	CpG: 19	246	19	150	15.4	61.0	0.84
chr12	100283521	100283796	CpG: 24	275	24	172	17.5	62.5	0.90
chr12	100391746	100392084	CpG: 31	338	31	251	18.3	74.3	0.67
chr12	100400180	100400465	CpG: 21	285	21	175	14.7	61.4	0.80
chr12	100418395	100418629	CpG: 18	234	18	141	15.4	60.3	0.88
chr12	100495340	100495618	CpG: 23	278	23	173	16.5	62.2	0.87
chr12	100520808	100521066	CpG: 21	258	21	185	16.3	71.7	0.64
chr12	100522542	100522776	CpG: 17	234	17	140	14.5	59.8	0.83
chr12	100534917	100535469	CpG: 55	552	55	381	19.9	69.0	0.84
chr12	100677477	100679236	CpG: 161	1759	161	1164	18.3	66.2	0.84
chr12	100856159	100856381	CpG: 18	222	18	136	16.2	61.3	0.88
chr12	101018320	101018606	CpG: 27	286	27	180	18.9	62.9	0.96
chr12	101107907	101108217	CpG: 24	310	24	185	15.5	59.7	0.88
chr12	101171314	101171860	CpG: 62	546	62	383	22.7	70.1	0.92
chr12	101241261	101241503	CpG: 19	242	19	145	15.7	59.9	0.89
chr12	101241795	101242161	CpG: 30	366	30	237	16.4	64.8	0.80
chr12	101335067	101335341	CpG: 24	274	24	172	17.5	62.8	0.90
chr12	101368387	101369493	CpG: 84	1106	84	662	15.2	59.9	0.85
chr12	101393428	101393695	CpG: 19	267	19	157	14.2	58.8	0.84
chr12	101439194	101439437	CpG: 18	243	18	144	14.8	59.3	0.87
chr12	101595080	101595320	CpG: 24	240	24	151	20.0	62.9	1.03
chr12	101603675	101603883	CpG: 23	208	23	134	22.1	64.4	1.07
chr12	101658492	101659814	CpG: 145	1322	145	961	21.9	72.7	0.83
chr12	101700202	101700864	CpG: 56	662	56	426	16.9	64.4	0.82
chr12	101783364	101783637	CpG: 23	273	23	172	16.8	63.0	0.86
chr12	101791574	101792270	CpG: 90	696	90	500	25.9	71.8	1.00
chr12	101838181	101839228	CpG: 118	1047	118	748	22.5	71.4	0.89
chr12	101843359	101843597	CpG: 18	238	18	142	15.1	59.7	0.87
chr12	101951448	101951718	CpG: 23	270	23	165	17.0	61.1	0.92
chr12	102022775	102023338	CpG: 41	563	41	354	14.6	62.9	0.74
chr12	102050306	102050868	CpG: 42	562	42	381	14.9	67.8	0.65
chr12	102081022	102081430	CpG: 43	408	43	276	21.1	67.6	0.92
chr12	102178931	102179166	CpG: 20	235	20	145	17.0	61.7	0.91
chr12	102274533	102274749	CpG: 20	216	20	130	18.5	60.2	1.02
chr12	102413201	102413479	CpG: 25	278	25	173	18.0	62.2	0.94
chr12	102785471	102786039	CpG: 38	568	38	343	13.4	60.4	0.73
chr12	102793956	102794199	CpG: 18	243	18	144	14.8	59.3	0.85
chr12	102860398	102860676	CpG: 24	278	24	174	17.3	62.6	0.89
chr12	102878085	102878298	CpG: 16	213	16	151	15.0	70.9	0.61
chr12	102911444	102911686	CpG: 18	242	18	150	14.9	62.0	0.78
chr12	102917135	102919741	CpG: 208	2606	208	1639	16.0	62.9	0.81
chr12	102926324	102926705	CpG: 31	381	31	253	16.3	66.4	0.74
chr12	103001894	103002155	CpG: 21	261	21	159	16.1	60.9	0.88
chr12	103263119	103263447	CpG: 29	328	29	216	17.7	65.9	0.82
chr12	103395345	103395642	CpG: 22	297	22	177	14.8	59.6	0.84
chr12	103456176	103456871	CpG: 80	695	80	521	23.0	75.0	0.82
chr12	103618017	103618298	CpG: 24	281	24	175	17.1	62.3	0.90
chr12	103663627	103663909	CpG: 25	282	25	176	17.7	62.4	0.92
chr12	103802266	103803320	CpG: 112	1054	112	754	21.3	71.5	0.83
chr12	103890939	103892733	CpG: 128	1794	128	1082	14.3	60.3	0.78
chr12	103918440	103919006	CpG: 51	566	51	372	18.0	65.7	0.84
chr12	103927327	103927888	CpG: 53	561	53	375	18.9	66.8	0.85
chr12	104025681	104027002	CpG: 120	1321	120	901	18.2	68.2	0.78
chr12	104099094	104100459	CpG: 178	1365	178	1031	26.1	75.5	0.93
chr12	104177312	104178087	CpG: 80	775	80	519	20.6	67.0	0.92
chr12	104207521	104207804	CpG: 22	283	22	174	15.5	61.5	0.84
chr12	104226989	104227515	CpG: 44	526	44	324	16.7	61.6	0.88
chr12	104228394	104228667	CpG: 20	273	20	164	14.7	60.1	0.82
chr12	104248657	104249016	CpG: 29	359	29	215	16.2	59.9	0.92
chr12	104250521	104250913	CpG: 35	392	35	231	17.9	58.9	1.04
chr12	104264269	104264503	CpG: 20	234	20	142	17.1	60.7	0.94
chr12	104265288	104265924	CpG: 68	636	68	421	21.4	66.2	1.00
chr12	104285066	104285440	CpG: 39	374	39	308	20.9	82.4	0.62
chr12	104415766	104416003	CpG: 17	237	17	140	14.3	59.1	0.85
chr12	104418122	104420264	CpG: 186	2142	186	1412	17.4	65.9	0.80
chr12	104718593	104718828	CpG: 18	235	18	151	15.3	64.3	0.74
chr12	104815894	104816137	CpG: 20	243	20	150	16.5	61.7	0.89
chr12	104866194	104866442	CpG: 17	248	17	140	13.7	56.5	0.88
chr12	104919408	104920115	CpG: 97	707	97	558	27.4	78.9	0.88
chr12	104947802	104948271	CpG: 48	469	48	340	20.5	72.5	0.78
chr12	105006119	105006393	CpG: 25	274	25	172	18.2	62.8	0.94
chr12	105046081	105046509	CpG: 49	428	49	327	22.9	76.4	0.79
chr12	105064894	105065172	CpG: 26	278	26	176	18.7	63.3	0.95
chr12	105069374	105070008	CpG: 76	634	76	472	24.0	74.4	0.88
chr12	105092912	105093193	CpG: 23	281	23	173	16.4	61.6	0.88
chr12	105171794	105172019	CpG: 18	225	18	132	16.0	58.7	0.94
chr12	105197535	105198137	CpG: 77	602	77	464	25.6	77.1	0.86
chr12	105292309	105293089	CpG: 100	780	100	601	25.6	77.1	0.87
chr12	105323925	105324198	CpG: 23	273	23	170	16.8	62.3	0.88
chr12	105589889	105590316	CpG: 32	427	32	257	15.0	60.2	0.83
chr12	105791762	105791998	CpG: 20	236	20	146	16.9	61.9	0.90
chr12	106029648	106029867	CpG: 16	219	16	137	14.6	62.6	0.76
chr12	106101090	106102680	CpG: 187	1590	187	1197	23.5	75.3	0.83
chr12	106202635	106202855	CpG: 19	220	19	146	17.3	66.4	0.79
chr12	106204345	106204616	CpG: 24	271	24	168	17.7	62.0	0.93
chr12	106210094	106211585	CpG: 195	1491	195	1153	26.2	77.3	0.90
chr12	106223782	106224055	CpG: 23	273	23	170	16.8	62.3	0.88
chr12	106265433	106266721	CpG: 117	1288	117	895	18.2	69.5	0.76
chr12	106320951	106321500	CpG: 57	549	57	364	20.8	66.3	0.95
chr12	106440758	106441187	CpG: 29	429	29	258	13.5	60.1	0.75
chr12	106460524	106460811	CpG: 26	287	26	178	18.1	62.0	0.95
chr12	106508261	106508536	CpG: 23	275	23	169	16.7	61.5	0.89
chr12	106544291	106550966	CpG: 429	6675	429	4025	12.9	60.3	0.71
chr12	106664090	106664364	CpG: 23	274	23	170	16.8	62.0	0.88
chr12	106737630	106738615	CpG: 85	985	85	638	17.3	64.8	0.83
chr12	106906959	106907233	CpG: 23	274	23	170	16.8	62.0	0.88
chr12	106919009	106919946	CpG: 116	937	116	693	24.8	74.0	0.91
chr12	106950414	106950932	CpG: 46	518	46	352	17.8	68.0	0.78
chr12	106953024	106953257	CpG: 17	233	17	134	14.6	57.5	0.89
chr12	107056467	107057666	CpG: 130	1199	130	817	21.7	68.1	0.94
chr12	107118409	107118671	CpG: 26	262	26	165	19.8	63.0	1.01
chr12	107281436	107283936	CpG: 235	2500	235	1695	18.8	67.8	0.82
chr12	107284608	107285022	CpG: 34	414	34	241	16.4	58.2	1.00
chr12	107376609	107376883	CpG: 20	274	20	166	14.6	60.6	0.80
chr12	107396620	107396906	CpG: 24	286	24	175	16.8	61.2	0.91
chr12	107415893	107416128	CpG: 16	235	16	140	13.6	59.6	0.78
chr12	107544662	107545125	CpG: 51	463	51	345	22.0	74.5	0.80
chr12	107609183	107609389	CpG: 14	206	14	114	13.6	55.3	0.89
chr12	107649158	107649609	CpG: 38	451	38	294	16.9	65.2	0.80
chr12	107724108	107724851	CpG: 98	743	98	566	26.4	76.2	0.93
chr12	107738700	107739284	CpG: 76	584	76	428	26.0	73.3	0.97
chr12	107792898	107793179	CpG: 23	281	23	173	16.4	61.6	0.88
chr12	107807775	107810030	CpG: 158	2255	158	1484	14.0	65.8	0.65
chr12	107828326	107828609	CpG: 32	283	32	201	22.6	71.0	0.90
chr12	107867771	107868088	CpG: 44	317	44	239	27.8	75.4	0.98
chr12	107868446	107868720	CpG: 22	274	22	169	16.1	61.7	0.86
chr12	108097365	108098280	CpG: 91	915	91	652	19.9	71.3	0.79
chr12	108483522	108483740	CpG: 16	218	16	119	14.7	54.6	0.99
chr12	108484287	108484806	CpG: 57	519	57	357	22.0	68.8	0.94
chr12	108528122	108528356	CpG: 18	234	18	141	15.4	60.3	0.87
chr12	108530086	108530614	CpG: 44	528	44	333	16.7	63.1	0.87
chr12	108531779	108532351	CpG: 66	572	66	397	23.1	69.4	0.96
chr12	108556324	108556548	CpG: 20	224	20	148	17.9	66.1	0.82
chr12	108566433	108566636	CpG: 15	203	15	136	14.8	67.0	0.67
chr12	108630143	108631002	CpG: 64	859	64	595	14.9	69.3	0.62
chr12	108705072	108706812	CpG: 151	1740	151	1232	17.4	70.8	0.77
chr12	108743267	108743581	CpG: 30	314	30	232	19.1	73.9	0.71
chr12	108831881	108832952	CpG: 135	1071	135	791	25.2	73.9	0.92
chr12	108971896	108972206	CpG: 26	310	26	189	16.8	61.0	0.91
chr12	109027246	109027681	CpG: 48	435	48	302	22.1	69.4	0.93
chr12	109068114	109068366	CpG: 26	252	26	155	20.6	61.5	1.10
chr12	109072271	109073438	CpG: 105	1167	105	813	18.0	69.7	0.74
chr12	109086143	109086418	CpG: 21	275	21	193	15.3	70.2	0.62
chr12	109129545	109129863	CpG: 40	318	40	242	25.2	76.1	0.89
chr12	109266748	109267002	CpG: 19	254	19	173	15.0	68.1	0.66
chr12	109283982	109285541	CpG: 162	1559	162	1085	20.8	69.6	0.86
chr12	109452235	109452742	CpG: 44	507	44	333	17.4	65.7	0.81
chr12	109548088	109548840	CpG: 72	752	72	504	19.1	67.0	0.85
chr12	109687695	109687910	CpG: 21	215	21	147	19.5	68.4	0.84
chr12	109688975	109690406	CpG: 193	1431	193	1098	27.0	76.7	0.92
chr12	109693915	109694170	CpG: 30	255	30	170	23.5	66.7	1.07
chr12	109808607	109809241	CpG: 73	634	73	470	23.0	74.1	0.84
chr12	109820921	109821142	CpG: 18	221	18	138	16.3	62.4	0.84
chr12	109855898	109856665	CpG: 96	767	96	568	25.0	74.1	0.92
chr12	109875868	109876479	CpG: 63	611	63	393	20.6	64.3	1.01
chr12	109952053	109952267	CpG: 16	214	16	130	15.0	60.7	0.82
chr12	109971626	109972089	CpG: 53	463	53	347	22.9	74.9	0.82
chr12	109975021	109975831	CpG: 87	810	87	544	21.5	67.2	0.95
chr12	109990532	109990765	CpG: 18	233	18	139	15.5	59.7	0.89
chr12	110023975	110024466	CpG: 42	491	42	310	17.1	63.1	0.89
chr12	110099808	110100655	CpG: 87	847	87	572	20.5	67.5	0.90
chr12	110258229	110259899	CpG: 201	1670	201	1229	24.1	73.6	0.90
chr12	110379319	110379610	CpG: 21	291	21	173	14.4	59.5	0.84
chr12	110380015	110380250	CpG: 17	235	17	136	14.5	57.9	0.87
chr12	110380429	110381407	CpG: 81	978	81	612	16.6	62.6	0.86
chr12	110395732	110396009	CpG: 24	277	24	173	17.3	62.5	0.90
chr12	110409283	110409523	CpG: 20	240	20	149	16.7	62.1	0.90
chr12	110427752	110428136	CpG: 39	384	39	264	20.3	68.8	0.88
chr12	110445768	110447072	CpG: 116	1304	116	842	17.8	64.6	0.85
chr12	110478597	110478862	CpG: 19	265	19	163	14.3	61.5	0.77
chr12	110479348	110480065	CpG: 59	717	59	464	16.5	64.7	0.79
chr12	110483907	110484177	CpG: 20	270	20	163	14.8	60.4	0.82
chr12	110560001	110561079	CpG: 140	1078	140	786	26.0	72.9	0.98
chr12	110591579	110592036	CpG: 47	457	47	323	20.6	70.7	0.85
chr12	110666416	110667235	CpG: 78	819	78	594	19.0	72.5	0.74
chr12	110719910	110720932	CpG: 103	1022	103	711	20.2	69.6	0.83
chr12	110795207	110795434	CpG: 16	227	16	137	14.1	60.4	0.80
chr12	110824725	110824994	CpG: 32	269	32	192	23.8	71.4	0.93
chr12	111012442	111014928	CpG: 260	2486	260	1698	20.9	68.3	0.90
chr12	111016335	111016624	CpG: 21	289	21	168	14.5	58.1	0.86
chr12	111290025	111290239	CpG: 18	214	18	147	16.8	68.7	0.74
chr12	111299602	111300369	CpG: 86	767	86	565	22.4	73.7	0.84
chr12	111343207	111343936	CpG: 58	729	58	517	15.9	70.9	0.64
chr12	111349251	111349752	CpG: 66	501	66	375	26.3	74.9	0.94
chr12	111377623	111377839	CpG: 20	216	20	154	18.5	71.3	0.73
chr12	111385692	111387146	CpG: 150	1454	150	1054	20.6	72.5	0.79
chr12	111398650	111399504	CpG: 100	854	100	649	23.4	76.0	0.82
chr12	111487368	111488162	CpG: 61	794	61	553	15.4	69.6	0.63
chr12	111516280	111516554	CpG: 22	274	22	169	16.1	61.7	0.85
chr12	111554256	111554495	CpG: 17	239	17	144	14.2	60.3	0.80
chr12	111574732	111576675	CpG: 229	1943	229	1451	23.6	74.7	0.85
chr12	111662363	111663176	CpG: 82	813	82	539	20.2	66.3	0.92
chr12	111663316	111663633	CpG: 22	317	22	183	13.9	57.7	0.84
chr12	111743607	111744088	CpG: 62	481	62	365	25.8	75.9	0.90
chr12	111818799	111819821	CpG: 114	1022	114	735	22.3	71.9	0.87
chr12	111990006	111990957	CpG: 94	951	94	642	19.8	67.5	0.87
chr12	112085247	112085806	CpG: 66	559	66	398	23.6	71.2	0.94
chr12	112086133	112086409	CpG: 19	276	19	167	13.8	60.5	0.76
chr12	112102286	112103215	CpG: 83	929	83	616	17.9	66.3	0.82
chr12	112154345	112154582	CpG: 17	237	17	140	14.3	59.1	0.84
chr12	112161284	112162203	CpG: 64	919	64	601	13.9	65.4	0.66
chr12	112245804	112246077	CpG: 24	273	24	168	17.6	61.5	0.94
chr12	112259016	112259248	CpG: 16	232	16	137	13.8	59.1	0.81
chr12	112349189	112349425	CpG: 18	236	18	138	15.3	58.5	0.90
chr12	112358133	112358344	CpG: 17	211	17	137	16.1	64.9	0.78
chr12	112358560	112359583	CpG: 128	1023	128	769	25.0	75.2	0.89
chr12	112364530	112364759	CpG: 21	229	21	144	18.3	62.9	0.95
chr12	112380107	112380385	CpG: 24	278	24	174	17.3	62.6	0.89
chr12	112386051	112386296	CpG: 20	245	20	155	16.3	63.3	0.82
chr12	112395100	112396341	CpG: 129	1241	129	841	20.8	67.8	0.90
chr12	112552119	112552627	CpG: 52	508	52	369	20.5	72.6	0.81
chr12	112557335	112557600	CpG: 24	265	24	163	18.1	61.5	0.97
chr12	112598114	112598465	CpG: 29	351	29	211	16.5	60.1	0.92
chr12	112667692	112667950	CpG: 21	258	21	158	16.3	61.2	0.88
chr12	112686688	112686951	CpG: 19	263	19	157	14.4	59.7	0.83
chr12	112915029	112915337	CpG: 36	308	36	219	23.4	71.1	0.93
chr12	113033237	113034382	CpG: 124	1145	124	866	21.7	75.6	0.76
chr12	113054010	113054816	CpG: 107	806	107	595	26.6	73.8	1.00
chr12	113069739	113070318	CpG: 46	579	46	419	15.9	72.4	0.61
chr12	113080519	113080923	CpG: 35	404	35	282	17.3	69.8	0.72
chr12	113088719	113089026	CpG: 26	307	26	215	16.9	70.0	0.70
chr12	113111815	113112596	CpG: 64	781	64	547	16.4	70.0	0.67
chr12	113129628	113131459	CpG: 130	1831	130	1121	14.2	61.2	0.76
chr12	113161600	113162771	CpG: 115	1171	115	814	19.6	69.5	0.81
chr12	113197856	113198475	CpG: 64	619	64	427	20.7	69.0	0.92
chr12	113221947	113222183	CpG: 21	236	21	143	17.8	60.6	0.99
chr12	113311272	113311839	CpG: 61	567	61	376	21.5	66.3	0.99
chr12	113335035	113335665	CpG: 67	630	67	467	21.3	74.1	0.77
chr12	113438952	113444644	CpG: 414	5692	414	3626	14.5	63.7	0.72
chr12	113447089	113448883	CpG: 137	1794	137	1154	15.3	64.3	0.74
chr12	113451817	113452859	CpG: 91	1042	91	668	17.5	64.1	0.85
chr12	113454635	113454919	CpG: 28	284	28	203	19.7	71.5	0.78
chr12	113455596	113456309	CpG: 61	713	61	402	17.1	56.4	1.09
chr12	113567448	113567882	CpG: 46	434	46	293	21.2	67.5	0.93
chr12	113583734	113583999	CpG: 23	265	23	164	17.4	61.9	0.92
chr12	113613877	113614174	CpG: 41	297	41	207	27.6	69.7	1.17
chr12	113753032	113753313	CpG: 23	281	23	173	16.4	61.6	0.88
chr12	113942058	113942433	CpG: 34	375	34	234	18.1	62.4	0.93
chr12	114366232	114366506	CpG: 24	274	24	171	17.5	62.4	0.91
chr12	114372708	114373144	CpG: 53	436	53	301	24.3	69.0	1.03
chr12	114377246	114377823	CpG: 46	577	46	348	15.9	60.3	0.88
chr12	114379786	114380662	CpG: 63	876	63	519	14.4	59.2	0.84
chr12	114381955	114382543	CpG: 54	588	54	393	18.4	66.8	0.82
chr12	114384794	114386583	CpG: 119	1789	119	1027	13.3	57.4	0.81
chr12	114390890	114391293	CpG: 39	403	39	281	19.4	69.7	0.80
chr12	114417076	114418088	CpG: 75	1012	75	544	14.8	53.8	1.03
chr12	114420582	114420870	CpG: 36	288	36	193	25.0	67.0	1.13
chr12	114424036	114424349	CpG: 34	313	34	219	21.7	70.0	0.90
chr12	114425285	114425510	CpG: 27	225	27	161	24.0	71.6	0.94
chr12	114461551	114462208	CpG: 48	657	48	453	14.6	68.9	0.62
chr12	114641969	114643264	CpG: 94	1295	94	809	14.5	62.5	0.75
chr12	114644131	114644831	CpG: 52	700	52	439	14.9	62.7	0.76
chr12	114648786	114649344	CpG: 52	558	52	374	18.6	67.0	0.85
chr12	114651296	114651909	CpG: 70	613	70	448	22.8	73.1	0.86
chr12	114660042	114662216	CpG: 167	2174	167	1307	15.4	60.1	0.85
chr12	114664000	114664423	CpG: 35	423	35	255	16.5	60.3	0.91
chr12	114669268	114669629	CpG: 37	361	37	250	20.5	69.3	0.86
chr12	114675176	114675603	CpG: 40	427	40	273	18.7	63.9	0.93
chr12	114677027	114677728	CpG: 47	701	47	396	13.4	56.5	0.87
chr12	114712619	114714213	CpG: 106	1594	106	920	13.3	57.7	0.80
chr12	114852712	114852948	CpG: 19	236	19	141	16.1	59.7	0.92
chr12	115263521	115263840	CpG: 24	319	24	191	15.0	59.9	0.84
chr12	115430932	115431537	CpG: 82	605	82	462	27.1	76.4	0.93
chr12	115897916	115898353	CpG: 50	437	50	316	22.9	72.3	0.88
chr12	116056925	116057160	CpG: 22	235	22	145	18.7	61.7	0.99
chr12	116221568	116221799	CpG: 18	231	18	142	15.6	61.5	0.85
chr12	116257375	116259247	CpG: 248	1872	248	1376	26.5	73.5	0.99
chr12	116395379	116395615	CpG: 19	236	19	144	16.1	61.0	0.89
chr12	116489591	116490003	CpG: 46	412	46	295	22.3	71.6	0.88
chr12	116641766	116642259	CpG: 43	493	43	360	17.4	73.0	0.66
chr12	116642846	116643051	CpG: 16	205	16	115	15.6	56.1	1.00
chr12	116692413	116692689	CpG: 19	276	19	168	13.8	60.9	0.75
chr12	116718963	116719777	CpG: 79	814	79	532	19.4	65.4	0.91
chr12	116731157	116731379	CpG: 22	222	22	169	19.8	76.1	0.69
chr12	116800417	116800888	CpG: 60	471	60	344	25.5	73.0	0.96
chr12	116830294	116830549	CpG: 23	255	23	170	18.0	66.7	0.81
chr12	116859652	116860968	CpG: 100	1316	100	849	15.2	64.5	0.74
chr12	116861971	116862784	CpG: 107	813	107	607	26.3	74.7	0.94
chr12	116863083	116863316	CpG: 19	233	19	140	16.3	60.1	0.91
chr12	116891914	116892476	CpG: 77	562	77	431	27.4	76.7	0.94
chr12	116893548	116893835	CpG: 21	287	21	174	14.6	60.6	0.81
chr12	117008884	117009118	CpG: 17	234	17	143	14.5	61.1	0.78
chr12	117020062	117020358	CpG: 23	296	23	194	15.5	65.5	0.72
chr12	117027557	117027879	CpG: 27	322	27	210	16.8	65.2	0.79
chr12	117079533	117080664	CpG: 139	1131	139	832	24.6	73.6	0.91
chr12	117136621	117136914	CpG: 28	293	28	194	19.1	66.2	0.87
chr12	117170872	117171725	CpG: 105	853	105	623	24.6	73.0	0.92
chr12	117205397	117205639	CpG: 17	242	17	145	14.0	59.9	0.80
chr12	117240893	117241138	CpG: 18	245	18	148	14.7	60.4	0.82
chr12	117286226	117286468	CpG: 17	242	17	142	14.0	58.7	0.85
chr12	117341324	117342696	CpG: 143	1372	143	969	20.8	70.6	0.84
chr12	117363320	117363746	CpG: 33	426	33	256	15.5	60.1	0.86
chr12	117582524	117582804	CpG: 22	280	22	174	15.7	62.1	0.82
chr12	117726280	117726554	CpG: 21	274	21	168	15.3	61.3	0.82
chr12	117748221	117748587	CpG: 41	366	41	258	22.4	70.5	0.93
chr12	117754397	117754683	CpG: 21	286	21	167	14.7	58.4	0.88
chr12	117881216	117881491	CpG: 21	275	21	164	15.3	59.6	0.87
chr12	117956052	117956839	CpG: 88	787	88	564	22.4	71.7	0.90
chr12	117971064	117971342	CpG: 24	278	24	175	17.3	62.9	0.88
chr12	118003880	118004485	CpG: 56	605	56	405	18.5	66.9	0.83
chr12	118048026	118048968	CpG: 106	942	106	683	22.5	72.5	0.87
chr12	118090508	118091584	CpG: 104	1076	104	768	19.3	71.4	0.76
chr12	118106083	118106358	CpG: 20	275	20	166	14.5	60.4	0.81
chr12	118114043	118114330	CpG: 24	287	24	174	16.7	60.6	0.94
chr12	118118504	118118741	CpG: 18	237	18	140	15.2	59.1	0.89
chr12	118122444	118122711	CpG: 21	267	21	152	15.7	56.9	0.98
chr12	118123176	118124177	CpG: 89	1001	89	691	17.8	69.0	0.75
chr12	118210343	118210700	CpG: 25	357	25	213	14.0	59.7	0.80
chr12	118231853	118232092	CpG: 19	239	19	143	15.9	59.8	0.90
chr12	118312069	118312307	CpG: 18	238	18	142	15.1	59.7	0.87
chr12	118326848	118327096	CpG: 17	248	17	147	13.7	59.3	0.78
chr12	118355485	118355812	CpG: 24	327	24	187	14.7	57.2	0.90
chr12	118358754	118360485	CpG: 135	1731	135	1196	15.6	69.1	0.70
chr12	118363478	118364303	CpG: 99	825	99	595	24.0	72.1	0.94
chr12	118419739	118419980	CpG: 22	241	22	149	18.3	61.8	0.97
chr12	118584451	118584839	CpG: 41	388	41	291	21.1	75.0	0.75
chr12	118602212	118602434	CpG: 18	222	18	132	16.2	59.5	0.96
chr12	118761762	118762045	CpG: 29	283	29	176	20.5	62.2	1.07
chr12	118811998	118812284	CpG: 23	286	23	174	16.1	60.8	0.88
chr12	118968286	118968529	CpG: 19	243	19	156	15.6	64.2	0.77
chr12	118968799	118969504	CpG: 57	705	57	466	16.2	66.1	0.74
chr12	119141484	119141804	CpG: 29	320	29	210	18.1	65.6	0.86
chr12	119144021	119144269	CpG: 26	248	26	182	21.0	73.4	0.78
chr12	119279741	119280015	CpG: 20	274	20	167	14.6	60.9	0.80
chr12	119321973	119322214	CpG: 19	241	19	161	15.8	66.8	0.73
chr12	119347518	119348421	CpG: 74	903	74	650	16.4	72.0	0.63
chr12	119385641	119385854	CpG: 19	213	19	153	17.8	71.8	0.70
chr12	119387529	119387770	CpG: 18	241	18	145	14.9	60.2	0.85
chr12	119581117	119582930	CpG: 124	1813	124	1160	13.7	64.0	0.70
chr12	119654979	119655709	CpG: 78	730	78	502	21.4	68.8	0.90
chr12	119656254	119656711	CpG: 33	457	33	271	14.4	59.3	0.82
chr12	119677453	119677771	CpG: 31	318	31	226	19.5	71.1	0.78
chr12	119791486	119791798	CpG: 26	312	26	205	16.7	65.7	0.77
chr12	119864370	119864692	CpG: 33	322	33	228	20.5	70.8	0.82
chr12	119905694	119907127	CpG: 120	1433	120	1037	16.7	72.4	0.64
chr12	119975875	119977403	CpG: 210	1528	210	1186	27.5	77.6	0.92
chr12	120045054	120045297	CpG: 20	243	20	149	16.5	61.3	0.91
chr12	120074128	120074527	CpG: 39	399	39	275	19.5	68.9	0.83
chr12	120083909	120084374	CpG: 33	465	33	295	14.2	63.4	0.73
chr12	120085997	120086308	CpG: 22	311	22	183	14.1	58.8	0.85
chr12	120090921	120091145	CpG: 17	224	17	140	15.2	62.5	0.78
chr12	120103428	120104595	CpG: 151	1167	151	867	25.9	74.3	0.94
chr12	120181581	120182143	CpG: 66	562	66	422	23.5	75.1	0.84
chr12	120187950	120189067	CpG: 89	1117	89	667	15.9	59.7	0.90
chr12	120199590	120199904	CpG: 25	314	25	200	15.9	63.7	0.80
chr12	120201082	120201314	CpG: 17	232	17	150	14.7	64.7	0.71
chr12	120231536	120231774	CpG: 19	238	19	144	16.0	60.5	0.89
chr12	120252337	120253111	CpG: 100	774	100	601	25.8	77.6	0.86
chr12	120256419	120256689	CpG: 19	270	19	161	14.1	59.6	0.80
chr12	120262139	120262405	CpG: 21	266	21	163	15.8	61.3	0.86
chr12	120279031	120279769	CpG: 50	738	50	409	13.6	55.4	0.90
chr12	120286141	120286410	CpG: 21	269	21	159	15.6	59.1	0.91
chr12	120292923	120293155	CpG: 17	232	17	136	14.7	58.6	0.88
chr12	120297945	120298174	CpG: 18	229	18	139	15.7	60.7	0.86
chr12	120304728	120305054	CpG: 26	326	26	190	16.0	58.3	0.95
chr12	120338915	120339132	CpG: 18	217	18	128	16.6	59.0	0.97
chr12	120348746	120349286	CpG: 52	540	52	391	19.3	72.4	0.74
chr12	120355162	120356733	CpG: 204	1571	204	1213	26.0	77.2	0.87
chr12	120384914	120385255	CpG: 33	341	33	235	19.4	68.9	0.82
chr12	120417907	120418224	CpG: 22	317	22	173	13.9	54.6	0.93
chr12	120425594	120426485	CpG: 69	891	69	542	15.5	60.8	0.84
chr12	120434757	120435413	CpG: 70	656	70	433	21.3	66.0	0.98
chr12	120444229	120444496	CpG: 20	267	20	164	15.0	61.4	0.81
chr12	120458057	120459273	CpG: 143	1216	143	865	23.5	71.1	0.94
chr12	120485018	120486082	CpG: 84	1064	84	676	15.8	63.5	0.79
chr12	120491309	120491530	CpG: 17	221	17	132	15.4	59.7	0.89
chr12	120518167	120518417	CpG: 27	250	27	161	21.6	64.4	1.05
chr12	120522908	120523180	CpG: 21	272	21	168	15.4	61.8	0.82
chr12	120523544	120524232	CpG: 83	688	83	496	24.1	72.1	0.95
chr12	120570058	120570699	CpG: 52	641	52	400	16.2	62.4	0.83
chr12	120573524	120574042	CpG: 60	518	60	371	23.2	71.6	0.90
chr12	120629513	120630835	CpG: 182	1322	182	1025	27.5	77.5	0.92
chr12	120675395	120676832	CpG: 138	1437	138	994	19.2	69.2	0.80
chr12	120699506	120700198	CpG: 90	692	90	532	26.0	76.9	0.88
chr12	120714795	120715248	CpG: 56	453	56	340	24.7	75.1	0.88
chr12	120721342	120722253	CpG: 70	911	70	633	15.4	69.5	0.64
chr12	120728435	120728661	CpG: 25	226	25	160	22.1	70.8	0.88
chr12	120743384	120743657	CpG: 22	273	22	165	16.1	60.4	0.89
chr12	120892699	120893721	CpG: 138	1022	138	794	27.0	77.7	0.90
chr12	120940000	120940352	CpG: 28	352	28	257	15.9	73.0	0.60
chr12	120949982	120950244	CpG: 20	262	20	161	15.3	61.5	0.82
chr12	120968368	120968700	CpG: 25	332	25	232	15.1	69.9	0.64
chr12	121005944	121006148	CpG: 20	204	20	126	19.6	61.8	1.05
chr12	121054370	121054651	CpG: 24	281	24	174	17.1	61.9	0.91
chr12	121084166	121084565	CpG: 32	399	32	292	16.0	73.2	0.60
chr12	121086446	121086798	CpG: 25	352	25	216	14.2	61.4	0.85
chr12	121200658	121201422	CpG: 91	764	91	551	23.8	72.1	0.92
chr12	121233530	121233800	CpG: 22	270	22	166	16.3	61.5	0.87
chr12	121265437	121265753	CpG: 27	316	27	223	17.1	70.6	0.69
chr12	121287635	121288759	CpG: 144	1124	144	861	25.6	76.6	0.87
chr12	121294000	121294269	CpG: 21	269	21	170	15.6	63.2	0.79
chr12	121341803	121342082	CpG: 23	279	23	173	16.5	62.0	0.87
chr12	121342924	121343165	CpG: 18	241	18	139	14.9	57.7	0.92
chr12	121343574	121343878	CpG: 30	304	30	192	19.7	63.2	1.01
chr12	121353662	121353928	CpG: 22	266	22	166	16.5	62.4	0.86
chr12	121365689	121366007	CpG: 30	318	30	231	18.9	72.6	0.72
chr12	121389526	121389799	CpG: 22	273	22	167	16.1	61.2	0.87
chr12	121391009	121392025	CpG: 103	1016	103	688	20.3	67.7	0.89
chr12	121427672	121427908	CpG: 20	236	20	142	16.9	60.2	0.96
chr12	121433680	121434345	CpG: 57	665	57	470	17.1	70.7	0.69
chr12	121435818	121436043	CpG: 16	225	16	145	14.2	64.4	0.69
chr12	121437546	121437823	CpG: 21	277	21	169	15.2	61.0	0.82
chr12	121443850	121444137	CpG: 24	287	24	202	16.7	70.4	0.68
chr12	121444385	121444771	CpG: 43	386	43	275	22.3	71.2	0.88
chr12	121457927	121459578	CpG: 235	1651	235	1288	28.5	78.0	0.94
chr12	121530291	121531403	CpG: 137	1112	137	852	24.6	76.6	0.84
chr12	121571432	121573848	CpG: 182	2416	182	1563	15.1	64.7	0.72
chr12	121588416	121588724	CpG: 25	308	25	183	16.2	59.4	0.93
chr12	121619466	121620426	CpG: 123	960	123	729	25.6	75.9	0.89
chr12	121627454	121627789	CpG: 30	335	30	225	17.9	67.2	0.79
chr12	121633623	121633882	CpG: 20	259	20	156	15.4	60.2	0.88
chr12	121639413	121639649	CpG: 18	236	18	140	15.3	59.3	0.91
chr12	121651491	121651709	CpG: 18	218	18	135	16.5	61.9	0.89
chr12	121658515	121658767	CpG: 23	252	23	162	18.3	64.3	0.88
chr12	121664812	121665022	CpG: 17	210	17	123	16.2	58.6	0.95
chr12	121680153	121680530	CpG: 34	377	34	236	18.0	62.6	0.92
chr12	121705875	121706418	CpG: 69	543	69	414	25.4	76.2	0.88
chr12	121789668	121791124	CpG: 135	1456	135	1041	18.5	71.5	0.73
chr12	121793870	121794074	CpG: 21	204	21	149	20.6	73.0	0.77
chr12	121796335	121802149	CpG: 443	5814	443	3645	15.2	62.7	0.78
chr12	121806537	121807180	CpG: 50	643	50	434	15.6	67.5	0.70
chr12	121808599	121808920	CpG: 34	321	34	242	21.2	75.4	0.75
chr12	121813661	121814248	CpG: 44	587	44	396	15.0	67.5	0.66
chr12	121824129	121824709	CpG: 44	580	44	377	15.2	65.0	0.72
chr12	121835187	121835395	CpG: 17	208	17	128	16.3	61.5	0.88
chr12	121836069	121836307	CpG: 23	238	23	168	19.3	70.6	0.78
chr12	121884780	121885437	CpG: 66	657	66	428	20.1	65.1	0.95
chr12	121914707	121915245	CpG: 46	538	46	378	17.1	70.3	0.70
chr12	121916760	121916994	CpG: 17	234	17	140	14.5	59.8	0.84
chr12	121974404	121974640	CpG: 18	236	18	139	15.3	58.9	0.90
chr12	121989402	121990214	CpG: 64	812	64	568	15.8	70.0	0.64
chr12	122017194	122019267	CpG: 269	2073	269	1513	26.0	73.0	0.97
chr12	122074100	122075115	CpG: 134	1015	134	742	26.4	73.1	1.00
chr12	122118365	122118629	CpG: 19	264	19	155	14.4	58.7	0.84
chr12	122119955	122120245	CpG: 23	290	23	227	15.9	78.3	0.86
chr12	122178163	122178468	CpG: 21	305	21	173	13.8	56.7	0.88
chr12	122178852	122179279	CpG: 57	427	57	330	26.7	77.3	0.94
chr12	122188888	122189163	CpG: 23	275	23	170	16.7	61.8	0.89
chr12	122199041	122200383	CpG: 166	1342	166	994	24.7	74.1	0.90
chr12	122221293	122222610	CpG: 138	1317	138	917	21.0	69.6	0.87
chr12	122262011	122262563	CpG: 55	552	55	342	19.9	62.0	1.04
chr12	122263798	122264071	CpG: 19	273	19	165	13.9	60.4	0.77
chr12	122264215	122264479	CpG: 20	264	20	161	15.2	61.0	0.83
chr12	122284630	122284901	CpG: 21	271	21	164	15.5	60.5	0.85
chr12	122352549	122353667	CpG: 88	1118	88	796	15.7	71.2	0.62
chr12	122417652	122418676	CpG: 145	1024	145	807	28.3	78.8	0.92
chr12	122435654	122435928	CpG: 24	274	24	171	17.5	62.4	0.91
chr12	122463250	122463556	CpG: 23	306	23	183	15.0	59.8	0.86
chr12	122464532	122464811	CpG: 20	279	20	168	14.3	60.2	0.80
chr12	122496257	122496906	CpG: 70	649	70	428	21.6	65.9	0.99
chr12	122520890	122521177	CpG: 22	287	22	173	15.3	60.3	0.85
chr12	122522185	122522689	CpG: 44	504	44	285	17.5	56.5	1.10
chr12	122574573	122574847	CpG: 24	274	24	171	17.5	62.4	0.91
chr12	122587514	122587904	CpG: 35	390	35	284	17.9	72.8	0.68
chr12	122647654	122647912	CpG: 21	258	21	159	16.3	61.6	0.88
chr12	122665619	122665893	CpG: 24	274	24	171	17.5	62.4	0.91
chr12	122672250	122672512	CpG: 28	262	28	199	21.4	76.0	0.74
chr12	122744438	122744674	CpG: 17	236	17	143	14.4	60.6	0.80
chr12	122745737	122745971	CpG: 17	234	17	140	14.5	59.8	0.82
chr12	122747850	122748520	CpG: 68	670	68	445	20.3	66.4	0.92
chr12	122769757	122770652	CpG: 90	895	90	566	20.1	63.2	1.01
chr12	122782095	122782331	CpG: 18	236	18	142	15.3	60.2	0.85
chr12	122830642	122831935	CpG: 157	1293	157	941	24.3	72.8	0.94
chr12	122862337	122862614	CpG: 25	277	25	193	18.1	69.7	0.83
chr12	122880927	122881205	CpG: 26	278	26	176	18.7	63.3	0.94
chr12	122891016	122891577	CpG: 71	561	71	397	25.3	70.8	1.03
chr12	122904663	122904944	CpG: 24	281	24	177	17.1	63.0	0.88
chr12	122956189	122956543	CpG: 27	354	27	245	15.3	69.2	0.64
chr12	122962846	122963185	CpG: 36	339	36	255	21.2	75.2	0.77
chr12	122969779	122970091	CpG: 26	312	26	187	16.7	59.9	0.94
chr12	122971129	122972061	CpG: 82	932	82	590	17.6	63.3	0.88
chr12	122976798	122977950	CpG: 133	1152	133	838	23.1	72.7	0.89
chr12	122982531	122983080	CpG: 52	549	52	392	18.9	71.4	0.74
chr12	122993868	122994095	CpG: 20	227	20	154	17.6	67.8	0.79
chr12	123124174	123124399	CpG: 17	225	17	135	15.1	60.0	0.85
chr12	123146828	123148178	CpG: 193	1350	193	1046	28.6	77.5	0.96
chr12	123171761	123171996	CpG: 17	235	17	137	14.5	58.3	0.87
chr12	123229373	123230394	CpG: 94	1021	94	659	18.4	64.5	0.88
chr12	123266031	123266355	CpG: 27	324	27	232	16.7	71.6	0.67
chr12	123267228	123268629	CpG: 217	1401	217	1136	31.0	81.1	0.95
chr12	123270979	123271210	CpG: 18	231	18	138	15.6	59.7	0.88
chr12	123272032	123272359	CpG: 23	327	23	190	14.1	58.1	0.84
chr12	123277256	123277464	CpG: 16	208	16	116	15.4	55.8	1.02
chr12	123342966	123343183	CpG: 17	217	17	129	15.7	59.4	0.90
chr12	123360574	123361879	CpG: 139	1305	139	927	21.3	71.0	0.85
chr12	123363127	123363379	CpG: 19	252	19	145	15.1	57.5	0.92
chr12	123368245	123368880	CpG: 50	635	50	427	15.7	67.2	0.70
chr12	123379504	123381348	CpG: 132	1844	132	1132	14.3	61.4	0.76
chr12	123385082	123386621	CpG: 215	1539	215	1208	27.9	78.5	0.91
chr12	123410801	123411059	CpG: 26	258	26	195	20.2	75.6	0.71
chr12	123432610	123433490	CpG: 69	880	69	589	15.7	66.9	0.71
chr12	123433978	123434215	CpG: 19	237	19	143	16.0	60.3	0.90
chr12	123456386	123456745	CpG: 25	359	25	200	13.9	55.7	0.90
chr12	123456991	123457353	CpG: 31	362	31	240	17.1	66.3	0.83
chr12	123457533	123457995	CpG: 32	462	32	281	13.9	60.8	0.75
chr12	123531899	123533300	CpG: 188	1401	188	1080	26.8	77.1	0.90
chr12	123557207	123557472	CpG: 20	265	20	162	15.1	61.1	0.81
chr12	123564085	123564324	CpG: 17	239	17	140	14.2	58.6	0.84
chr12	123582592	123584014	CpG: 114	1422	114	877	16.0	61.7	0.84
chr12	123600099	123600335	CpG: 20	236	20	144	16.9	61.0	0.94
chr12	123600534	123601332	CpG: 78	798	78	564	19.5	70.7	0.78
chr12	123617896	123618127	CpG: 18	231	18	138	15.6	59.7	0.90
chr12	123631531	123631767	CpG: 21	236	21	144	17.8	61.0	0.98
chr12	123632414	123632796	CpG: 43	382	43	267	22.5	69.9	0.93
chr12	123669899	123670492	CpG: 48	593	48	384	16.2	64.8	0.77
chr12	123710773	123711826	CpG: 121	1053	121	747	23.0	70.9	0.92
chr12	123760767	123761631	CpG: 105	864	105	631	24.3	73.0	0.91
chr12	123786548	123787005	CpG: 34	457	34	290	14.9	63.5	0.74
chr12	123938471	123939053	CpG: 45	582	45	383	15.5	65.8	0.73
chr12	123973542	123975697	CpG: 258	2155	258	1646	23.9	76.4	0.83
chr12	124039234	124039544	CpG: 26	310	26	188	16.8	60.6	0.92
chr12	124054189	124054463	CpG: 21	274	21	167	15.3	60.9	0.83
chr12	124074865	124075139	CpG: 24	274	24	172	17.5	62.8	0.90
chr12	124085878	124086159	CpG: 21	281	21	168	14.9	59.8	0.85
chr12	124102404	124102606	CpG: 16	202	16	124	15.8	61.4	0.85
chr12	124103432	124104602	CpG: 95	1170	95	844	16.2	72.1	0.63
chr12	124297117	124297994	CpG: 109	877	109	692	24.9	78.9	0.81
chr12	124306373	124306964	CpG: 40	591	40	380	13.5	64.3	0.66
chr12	124316598	124317026	CpG: 33	428	33	305	15.4	71.3	0.61
chr12	124326834	124327038	CpG: 15	204	15	120	14.7	58.8	0.85
chr12	124336248	124336556	CpG: 30	308	30	196	19.5	63.6	1.28
chr12	124339047	124339621	CpG: 52	574	52	363	18.1	63.2	0.95
chr12	124347052	124347389	CpG: 39	337	39	238	23.1	70.6	0.94
chr12	124349032	124349329	CpG: 28	297	28	216	18.9	72.7	0.71
chr12	124374609	124374854	CpG: 23	245	23	174	18.8	71.0	0.79
chr12	124375841	124376397	CpG: 43	556	43	399	15.5	71.8	0.62
chr12	124391165	124391928	CpG: 67	763	67	550	17.6	72.1	0.68
chr12	124418979	124419893	CpG: 66	914	66	599	14.4	65.5	0.68
chr12	124429292	124429519	CpG: 18	227	18	146	15.9	64.3	0.79
chr12	124450660	124450949	CpG: 28	289	28	193	19.4	66.8	0.88
chr12	124462032	124462378	CpG: 29	346	29	234	16.8	67.6	0.75
chr12	124471499	124471733	CpG: 21	234	21	165	17.9	70.5	0.73
chr12	124484675	124484950	CpG: 28	275	28	164	20.4	59.6	1.32
chr12	124522823	124523250	CpG: 34	427	34	301	15.9	70.5	0.66
chr12	124523697	124523918	CpG: 21	221	21	166	19.0	75.1	0.69
chr12	124524034	124524299	CpG: 20	265	20	173	15.1	65.3	0.75
chr12	124544393	124544613	CpG: 17	220	17	158	15.5	71.8	0.62
chr12	124548786	124549136	CpG: 29	350	29	245	16.6	70.0	0.68
chr12	124559878	124560103	CpG: 18	225	18	156	16.0	69.3	0.67
chr12	124571544	124573127	CpG: 182	1583	182	1173	23.0	74.1	0.84
chr12	124588539	124588813	CpG: 21	274	21	167	15.3	60.9	0.84
chr12	124681961	124682291	CpG: 33	330	33	201	20.0	60.9	1.41
chr12	124730088	124730357	CpG: 20	269	20	165	14.9	61.3	0.81
chr12	124744258	124744488	CpG: 18	230	18	140	15.7	60.9	0.86
chr12	124798696	124798970	CpG: 21	274	21	168	15.3	61.3	0.82
chr12	124820213	124820644	CpG: 29	431	29	281	13.5	65.2	0.63
chr12	124844945	124845489	CpG: 41	544	41	351	15.1	64.5	0.93
chr12	124868375	124869279	CpG: 100	904	100	676	22.1	74.8	0.79
chr12	124919220	124920561	CpG: 127	1341	127	874	18.9	65.2	0.91
chr12	124933548	124933822	CpG: 26	274	26	178	19.0	65.0	0.91
chr12	124961842	124962043	CpG: 16	201	16	134	15.9	66.7	0.72
chr12	124994063	124994474	CpG: 35	411	35	279	17.0	67.9	0.75
chr12	124997253	124997554	CpG: 26	301	26	188	17.3	62.5	0.89
chr12	124998715	124999628	CpG: 132	913	132	714	28.9	78.2	0.95
chr12	125032728	125033194	CpG: 38	466	38	296	16.3	63.5	0.81
chr12	125057361	125057828	CpG: 44	467	44	316	18.8	67.7	0.87
chr12	125072975	125073614	CpG: 73	639	73	478	22.8	74.8	0.82
chr12	125093129	125093441	CpG: 27	312	27	166	17.3	53.2	1.28
chr12	125101798	125102038	CpG: 18	240	18	151	15.0	62.9	0.77
chr12	125122743	125123062	CpG: 30	319	30	230	18.8	72.1	0.72
chr12	125193553	125195548	CpG: 212	1995	212	1472	21.3	73.8	0.80
chr12	125289776	125290012	CpG: 19	236	19	143	16.1	60.6	0.91
chr12	125339207	125339469	CpG: 29	262	29	195	22.1	74.4	0.81
chr12	125519686	125519922	CpG: 17	236	17	140	14.4	59.3	0.86
chr12	125541659	125541929	CpG: 24	270	24	182	17.8	67.4	0.79
chr12	125568603	125568879	CpG: 20	276	20	166	14.5	60.1	0.82
chr12	125692317	125692535	CpG: 23	218	23	158	21.1	72.5	0.81
chr12	125812559	125812834	CpG: 20	275	20	168	14.5	61.1	0.78
chr12	125870177	125870809	CpG: 63	632	63	450	19.9	71.2	0.79
chr12	125992160	125992447	CpG: 20	287	20	190	13.9	66.2	0.64
chr12	125993508	125993742	CpG: 21	234	21	149	17.9	63.7	0.91
chr12	126199806	126200440	CpG: 56	634	56	437	17.7	68.9	0.76
chr12	126313365	126313824	CpG: 34	459	34	274	14.8	59.7	0.84
chr12	126733826	126734699	CpG: 83	873	83	584	19.0	66.9	0.86
chr12	126735327	126735577	CpG: 26	250	26	164	20.8	65.6	0.98
chr12	126868235	126868490	CpG: 20	255	20	156	15.7	61.2	0.85
chr12	126882051	126882332	CpG: 23	281	23	176	16.4	62.6	0.85
chr12	126935018	126935296	CpG: 29	278	29	180	20.9	64.7	1.01
chr12	127110669	127110898	CpG: 19	229	19	136	16.6	59.4	0.95
chr12	127156403	127157091	CpG: 78	688	78	485	22.7	70.5	0.91
chr12	127190716	127191203	CpG: 75	487	75	358	30.8	73.5	1.14
chr12	127305666	127305905	CpG: 32	239	32	186	26.8	77.8	0.90
chr12	127480333	127481299	CpG: 94	966	94	708	19.5	73.3	0.75
chr12	127702702	127702976	CpG: 23	274	23	174	16.8	63.5	0.85
chr12	127789328	127789647	CpG: 23	319	23	176	14.4	55.2	0.95
chr12	127991854	127992128	CpG: 20	274	20	163	14.6	59.5	0.84
chr12	128011823	128012261	CpG: 46	438	46	327	21.0	74.7	0.75
chr12	128250977	128251250	CpG: 19	273	19	164	13.9	60.1	0.79
chr12	128253816	128254097	CpG: 23	281	23	174	16.4	61.9	0.87
chr12	128296392	128298502	CpG: 213	2110	213	1496	20.2	70.9	0.81
chr12	128396005	128396211	CpG: 17	206	17	130	16.5	63.1	0.83
chr12	128445219	128445471	CpG: 19	252	19	164	15.1	65.1	0.72
chr12	128694713	128694973	CpG: 23	260	23	167	17.7	64.2	0.99
chr12	128735983	128736235	CpG: 21	252	21	161	16.7	63.9	0.82
chr12	128827707	128827937	CpG: 17	230	17	141	14.8	61.3	0.79
chr12	128844338	128844574	CpG: 18	236	18	137	15.3	58.1	0.93
chr12	128855358	128856316	CpG: 123	958	123	707	25.7	73.8	0.95
chr12	128876476	128878574	CpG: 171	2098	171	1416	16.3	67.5	0.72
chr12	128884981	128885982	CpG: 130	1001	130	756	26.0	75.5	0.91
chr12	128912600	128912878	CpG: 23	278	23	171	16.5	61.5	0.89
chr12	128940300	128940582	CpG: 24	282	24	177	17.0	62.8	0.87
chr12	128976684	128976924	CpG: 25	240	25	169	20.8	70.4	0.84
chr12	129034958	129035237	CpG: 24	279	24	175	17.2	62.7	0.88
chr12	129067136	129067410	CpG: 24	274	24	170	17.5	62.0	0.92
chr12	129275347	129275617	CpG: 22	270	22	169	16.3	62.6	0.85
chr12	129334406	129335566	CpG: 68	1160	68	731	11.7	63.0	0.68
chr12	129342919	129343149	CpG: 20	230	20	141	17.4	61.3	0.94
chr12	129353563	129353841	CpG: 19	278	19	167	13.7	60.1	0.78
chr12	129388181	129388549	CpG: 31	368	31	213	16.8	57.9	1.01
chr12	129533690	129533955	CpG: 19	265	19	157	14.3	59.2	0.83
chr12	129545182	129545441	CpG: 20	259	20	157	15.4	60.6	0.85
chr12	129545519	129545795	CpG: 19	276	19	170	13.8	61.6	0.73
chr12	129732153	129732464	CpG: 23	311	23	211	14.8	67.8	0.66
chr12	129889595	129895369	CpG: 382	5774	382	3632	13.2	62.9	0.77
chr12	129939298	129940828	CpG: 169	1530	169	1111	22.1	72.6	0.84
chr12	130006669	130006952	CpG: 24	283	24	174	17.0	61.5	0.90
chr12	130078801	130079003	CpG: 26	202	26	151	25.7	74.8	0.93
chr12	130175723	130176073	CpG: 26	350	26	215	14.9	61.4	0.83
chr12	130197925	130201586	CpG: 363	3661	363	2508	19.8	68.5	0.85
chr12	130293780	130294169	CpG: 34	389	34	284	17.5	73.0	0.66
chr12	130374304	130377146	CpG: 261	2842	261	2080	18.4	73.2	0.77
chr12	130429153	130429414	CpG: 19	261	19	131	14.6	50.2	1.16
chr12	130461514	130461928	CpG: 37	414	37	297	17.9	71.7	0.70
chr12	130488442	130488693	CpG: 20	251	20	145	15.9	57.8	0.96
chr12	130506363	130506566	CpG: 16	203	16	105	15.8	51.7	1.18
chr12	130642028	130642265	CpG: 19	237	19	145	16.0	61.2	0.88
chr12	130647960	130648234	CpG: 24	274	24	171	17.5	62.4	0.91
chr12	130678737	130678995	CpG: 23	258	23	166	17.8	64.3	0.87
chr12	130687070	130687333	CpG: 20	263	20	166	15.2	63.1	0.79
chr12	130725066	130725446	CpG: 32	380	32	256	16.8	67.4	0.76
chr12	130741895	130742146	CpG: 18	251	18	170	14.3	67.7	0.65
chr12	130754411	130754628	CpG: 17	217	17	137	15.7	63.1	0.80
chr12	130857706	130858458	CpG: 61	752	61	471	16.2	62.6	0.83
chr12	130877772	130878581	CpG: 94	809	94	634	23.2	78.4	0.77
chr12	130890191	130890423	CpG: 19	232	19	142	16.4	61.2	0.88
chr12	130891182	130891563	CpG: 32	381	32	246	16.8	64.6	0.81
chr12	130910386	130911781	CpG: 188	1395	188	1035	27.0	74.2	0.98
chr12	130926526	130927006	CpG: 45	480	45	292	18.8	60.8	1.27
chr12	130943809	130944371	CpG: 51	562	51	424	18.1	75.4	0.64
chr12	130954553	130954790	CpG: 20	237	20	145	16.9	61.2	0.93
chr12	130972498	130972842	CpG: 24	344	24	217	14.0	63.1	0.70
chr12	130978771	130979045	CpG: 23	274	23	170	16.8	62.0	0.88
chr12	131002405	131002637	CpG: 17	232	17	137	14.7	59.1	0.85
chr12	131043488	131043767	CpG: 21	279	21	185	15.1	66.3	0.71
chr12	131068113	131068318	CpG: 17	205	17	115	16.6	56.1	1.05
chr12	131072208	131072565	CpG: 30	357	30	192	16.8	53.8	1.19
chr12	131073425	131073747	CpG: 21	322	21	208	13.0	64.6	0.70
chr12	131084238	131084828	CpG: 58	590	58	392	19.7	66.4	0.89
chr12	131110116	131110535	CpG: 28	419	28	263	13.4	62.8	0.70
chr12	131127790	131128234	CpG: 30	444	30	288	13.5	64.9	0.64
chr12	131160962	131161171	CpG: 15	209	15	136	14.4	65.1	0.68
chr12	131162157	131162403	CpG: 18	246	18	158	14.6	64.2	0.72
chr12	131170567	131170793	CpG: 20	226	20	168	17.7	74.3	0.65
chr12	131178554	131178900	CpG: 24	346	24	223	13.9	64.5	0.67
chr12	131203138	131203730	CpG: 56	592	56	430	18.9	72.6	0.72
chr12	131204549	131204963	CpG: 36	414	36	270	17.4	65.2	0.82
chr12	131263425	131263691	CpG: 22	266	22	170	16.5	63.9	0.82
chr12	131267740	131268131	CpG: 31	391	31	284	15.9	72.6	0.60
chr12	131280532	131280806	CpG: 24	274	24	170	17.5	62.0	0.92
chr12	131295861	131296142	CpG: 26	281	26	178	18.5	63.3	0.94
chr12	131323256	131323485	CpG: 21	229	21	139	18.3	60.7	1.00
chr12	131340287	131341484	CpG: 116	1197	116	824	19.4	68.8	0.83
chr12	131392510	131392741	CpG: 19	231	19	137	16.5	59.3	0.97
chr12	131475024	131476376	CpG: 120	1352	120	990	17.8	73.2	0.85
chr12	131501055	131501297	CpG: 20	242	20	156	16.5	64.5	0.80
chr12	131536179	131536554	CpG: 32	375	32	245	17.1	65.3	0.80
chr12	131603868	131604131	CpG: 20	263	20	161	15.2	61.2	0.86
chr12	131631038	131631359	CpG: 22	321	22	190	13.7	59.2	0.89
chr12	131660997	131661271	CpG: 25	274	25	172	18.2	62.8	0.94
chr12	131704878	131706075	CpG: 116	1197	116	824	19.4	68.8	0.83
chr12	131730178	131730506	CpG: 23	328	23	173	14.0	52.7	1.01
chr12	131754525	131755945	CpG: 121	1420	121	922	17.0	64.9	0.81
chr12	131778815	131779027	CpG: 18	212	18	138	17.0	65.1	0.82
chr12	131803582	131803821	CpG: 20	239	20	143	16.7	59.8	0.96
chr12	131823138	131823433	CpG: 31	295	31	195	21.0	66.1	1.13
chr12	131836146	131836358	CpG: 15	212	15	112	14.2	52.8	1.05
chr12	131844006	131844237	CpG: 16	231	16	160	13.9	69.3	0.60
chr12	131845502	131845748	CpG: 20	246	20	146	16.3	59.3	0.95
chr12	131852862	131853296	CpG: 40	434	40	303	18.4	69.8	0.76
chr12	131871917	131875227	CpG: 310	3310	310	2400	18.7	72.5	0.71
chr12	131882727	131882948	CpG: 21	221	21	165	19.0	74.7	0.88
chr12	131884400	131884853	CpG: 42	453	42	307	18.5	67.8	0.81
chr12	131888621	131889533	CpG: 61	912	61	598	13.4	65.6	0.63
chr12	131892687	131893133	CpG: 31	446	31	257	13.9	57.6	0.84
chr12	131893822	131894246	CpG: 32	424	32	287	15.1	67.7	0.66
chr12	131931189	131931465	CpG: 20	276	20	168	14.5	60.9	0.79
chr12	131939053	131940228	CpG: 135	1175	135	893	23.0	76.0	0.83
chr12	131940805	131941118	CpG: 28	313	28	229	17.9	73.2	0.67
chr12	131952616	131954721	CpG: 192	2105	192	1522	18.2	72.3	0.70
chr12	131961709	131964801	CpG: 237	3092	237	2294	15.3	74.2	0.90
chr12	131974333	131975170	CpG: 60	837	60	559	14.3	66.8	0.66
chr12	131976422	131978300	CpG: 189	1878	189	1301	20.1	69.3	0.85
chr12	131993033	131993244	CpG: 18	211	18	133	17.1	63.0	0.86
chr12	131997656	131998898	CpG: 170	1242	170	905	27.4	72.9	1.03
chr12	132020235	132020506	CpG: 21	271	21	167	15.5	61.6	0.83
chr12	132078574	132078816	CpG: 19	242	19	160	15.7	66.1	0.72
chr12	132081504	132081715	CpG: 17	211	17	123	16.1	58.3	0.96
chr12	132084616	132085238	CpG: 41	622	41	355	13.2	57.1	0.81
chr12	132132104	132132334	CpG: 21	230	21	140	18.3	60.9	0.99
chr12	132132847	132134010	CpG: 127	1163	127	832	21.8	71.5	0.90
chr12	132141608	132141878	CpG: 21	270	21	166	15.6	61.5	0.83
chr12	132156849	132157123	CpG: 22	274	22	170	16.1	62.0	0.85
chr12	132166122	132166880	CpG: 58	758	58	508	15.3	67.0	0.68
chr12	132168263	132168542	CpG: 25	279	25	197	17.9	70.6	0.73
chr12	132184087	132185958	CpG: 151	1871	151	1390	16.1	74.3	0.70
chr12	132192864	132201052	CpG: 576	8188	576	5298	14.1	64.7	0.68
chr12	132201788	132202054	CpG: 20	266	20	188	15.0	70.7	0.60
chr12	132205283	132205772	CpG: 44	489	44	318	18.0	65.0	0.85
chr12	132219487	132219700	CpG: 15	213	15	144	14.1	67.6	0.63
chr12	132229716	132230142	CpG: 32	426	32	260	15.0	61.0	0.82
chr12	132238650	132238911	CpG: 22	261	22	181	16.9	69.3	0.70
chr12	132240480	132242005	CpG: 143	1525	143	1026	18.8	67.3	0.83
chr12	132249296	132249619	CpG: 27	323	27	216	16.7	66.9	0.76
chr12	132254863	132255146	CpG: 27	283	27	204	19.1	72.1	0.74
chr12	132256632	132256949	CpG: 29	317	29	222	18.3	70.0	0.77
chr12	132257091	132257323	CpG: 18	232	18	155	15.5	66.8	0.70
chr12	132263416	132264159	CpG: 54	743	54	489	14.5	65.8	0.74
chr12	132265957	132266287	CpG: 24	330	24	204	14.5	61.8	0.76
chr12	132277460	132277743	CpG: 25	283	25	190	17.7	67.1	0.79
chr12	132281404	132284432	CpG: 179	3028	179	1899	11.8	62.7	0.61
chr12	132296662	132297943	CpG: 87	1281	87	934	13.6	72.9	0.82
chr12	132299031	132299259	CpG: 19	228	19	157	16.7	68.9	0.71
chr12	132300748	132301169	CpG: 40	421	40	295	19.0	70.1	0.86
chr12	132303245	132303509	CpG: 19	264	19	173	14.4	65.5	0.75
chr12	132303931	132304281	CpG: 36	350	36	220	20.6	62.9	1.04
chr12	132310532	132310986	CpG: 48	454	48	325	21.1	71.6	0.89
chr12	132313967	132314236	CpG: 26	269	26	186	19.3	69.1	0.81
chr12	132319094	132319340	CpG: 26	246	26	151	21.1	61.4	1.21
chr12	132321876	132322912	CpG: 74	1036	74	672	14.3	64.9	0.70
chr12	132324196	132324511	CpG: 25	315	25	211	15.9	67.0	0.71
chr12	132324650	132325346	CpG: 48	696	48	467	13.8	67.1	0.61
chr12	132330499	132330746	CpG: 19	247	19	163	15.4	66.0	0.71
chr12	132331726	132331938	CpG: 16	212	16	143	15.1	67.5	0.66
chr12	132336023	132336381	CpG: 24	358	24	237	13.4	66.2	0.62
chr12	132337236	132337522	CpG: 23	286	23	174	16.1	60.8	1.07
chr12	132338544	132338764	CpG: 16	220	16	141	14.5	64.1	0.71
chr12	132339141	132339511	CpG: 37	370	37	265	20.0	71.6	0.79
chr12	132340198	132340825	CpG: 43	627	43	378	13.7	60.3	0.77
chr12	132341789	132342059	CpG: 27	270	27	190	20.0	70.4	0.85
chr12	132348284	132348527	CpG: 20	243	20	162	16.5	66.7	0.74
chr12	132355892	132356819	CpG: 64	927	64	670	13.8	72.3	0.66
chr12	132359954	132360156	CpG: 18	202	18	144	17.8	71.3	0.70
chr12	132370863	132371133	CpG: 21	270	21	182	15.6	67.4	0.69
chr12	132374788	132375653	CpG: 72	865	72	530	16.6	61.3	0.89
chr12	132380013	132381140	CpG: 134	1127	134	884	23.8	78.4	0.77
chr12	132385017	132385366	CpG: 27	349	27	221	15.5	63.3	0.77
chr12	132388839	132389048	CpG: 23	209	23	144	22.0	68.9	1.04
chr12	132391351	132391737	CpG: 31	386	31	254	16.1	65.8	0.75
chr12	132396647	132397007	CpG: 27	360	27	251	15.0	69.7	0.70
chr12	132404577	132404811	CpG: 16	234	16	166	13.7	70.9	0.60
chr12	132409969	132410465	CpG: 49	496	49	333	19.8	67.1	0.88
chr12	132412113	132412482	CpG: 25	369	25	246	13.6	66.7	0.63
chr12	132412639	132413547	CpG: 87	908	87	635	19.2	69.9	0.93
chr12	132413951	132414159	CpG: 20	208	20	118	19.2	56.7	1.20
chr12	132418376	132418593	CpG: 17	217	17	145	15.7	66.8	0.78
chr12	132429715	132430333	CpG: 44	618	44	391	14.2	63.3	0.71
chr12	132439946	132440211	CpG: 21	265	21	160	15.8	60.4	0.87
chr12	132442141	132443332	CpG: 85	1191	85	858	14.3	72.0	0.68
chr12	132446923	132447169	CpG: 20	246	20	162	16.3	65.9	0.77
chr12	132450599	132450885	CpG: 24	286	24	201	16.8	70.3	0.69
chr12	132451110	132451379	CpG: 20	269	20	183	14.9	68.0	0.67
chr12	132457472	132458659	CpG: 94	1187	94	813	15.8	68.5	0.69
chr12	132474034	132474283	CpG: 21	249	21	187	16.9	75.1	0.64
chr12	132481023	132481350	CpG: 25	327	25	206	15.3	63.0	0.78
chr12	132483756	132483985	CpG: 23	229	23	145	20.1	63.3	1.01
chr12	132484698	132484961	CpG: 19	263	19	182	14.4	69.2	0.60
chr12	132489399	132489666	CpG: 27	267	27	197	20.2	73.8	0.74
chr12	132493036	132493321	CpG: 20	285	20	175	14.0	61.4	0.76
chr12	132493832	132494042	CpG: 19	210	19	132	18.1	62.9	0.93
chr12	132496625	132497070	CpG: 36	445	36	275	16.2	61.8	0.89
chr12	132507629	132508188	CpG: 40	559	40	374	14.3	66.9	0.66
chr12	132519511	132519746	CpG: 17	235	17	137	14.5	58.3	0.87
chr12	132523380	132526447	CpG: 240	3067	240	2153	15.7	70.2	0.67
chr12	132530248	132530584	CpG: 29	336	29	213	17.3	63.4	0.91
chr12	132533278	132533663	CpG: 28	385	28	208	14.5	54.0	1.04
chr12	132539250	132541213	CpG: 284	1963	284	1541	28.9	78.5	0.94
chr12	132546875	132547110	CpG: 23	235	23	162	19.6	68.9	0.82
chr12	132575648	132576084	CpG: 37	436	37	308	17.0	70.6	0.68
chr12	132599174	132599526	CpG: 33	352	33	245	18.8	69.6	0.77
chr12	132600127	132600553	CpG: 30	426	30	294	14.1	69.0	0.64
chr12	132602745	132603138	CpG: 29	393	29	267	14.8	67.9	0.64
chr12	132605442	132605740	CpG: 41	298	41	225	27.5	75.5	0.98
chr12	132608874	132609501	CpG: 41	627	41	407	13.1	64.9	0.62
chr12	132609702	132611061	CpG: 171	1359	171	1014	25.2	74.6	0.90
chr12	132614469	132614874	CpG: 33	405	33	247	16.3	61.0	0.89
chr12	132615300	132615627	CpG: 25	327	25	177	15.3	54.1	1.06
chr12	132619933	132621678	CpG: 143	1745	143	1255	16.4	71.9	0.64
chr12	132622123	132622438	CpG: 26	315	26	223	16.5	70.8	0.66
chr12	132632143	132633995	CpG: 199	1852	199	1365	21.5	73.7	0.80
chr12	132635254	132635521	CpG: 20	267	20	192	15.0	71.9	0.62
chr12	132641264	132641590	CpG: 24	326	24	212	14.7	65.0	0.71
chr12	132642116	132642860	CpG: 49	744	49	486	13.2	65.3	0.63
chr12	132647993	132648962	CpG: 162	969	162	789	33.4	81.4	1.52
chr12	132649103	132649505	CpG: 26	402	26	244	12.9	60.7	0.71
chr12	132652306	132652521	CpG: 20	215	20	134	18.6	62.3	0.96
chr12	132653550	132654015	CpG: 48	465	48	327	20.6	70.3	0.84
chr12	132660371	132660737	CpG: 25	366	25	231	13.7	63.1	0.69
chr12	132668502	132670190	CpG: 172	1688	172	1281	20.4	75.9	0.71
chr12	132720717	132720960	CpG: 16	243	16	141	13.2	58.0	0.80
chr12	132723559	132723823	CpG: 18	264	18	177	13.6	67.0	0.61
chr12	132736162	132739197	CpG: 329	3035	329	2164	21.7	71.3	0.86
chr12	132758966	132760429	CpG: 169	1463	169	1017	23.1	69.5	0.96
chr12	132766370	132767161	CpG: 65	791	65	515	16.4	65.1	0.78
chr12	132768870	132769142	CpG: 19	272	19	174	14.0	64.0	0.71
chr12	132776477	132777103	CpG: 52	626	52	423	16.6	67.6	0.73
chr12	132781735	132783692	CpG: 127	1957	127	1106	13.0	56.5	0.82
chr12	132785917	132786210	CpG: 22	293	22	178	15.0	60.8	0.82
chr12	132809503	132810324	CpG: 65	821	65	582	15.8	70.9	0.64
chr12	132812272	132813556	CpG: 181	1284	181	1004	28.2	78.2	0.92
chr12	132815352	132815586	CpG: 19	234	19	145	16.2	62.0	0.85
chr12	132824139	132824474	CpG: 26	335	26	227	15.5	67.8	0.68
chr12	132829908	132830167	CpG: 19	259	19	159	14.7	61.4	0.79
chr12	132831447	132831727	CpG: 20	280	20	178	14.3	63.6	0.90
chr12	132838240	132838459	CpG: 16	219	16	137	14.6	62.6	0.77
chr12	132839216	132839482	CpG: 25	266	25	215	18.8	80.8	0.64
chr12	132840633	132840964	CpG: 25	331	25	215	15.1	65.0	0.72
chr12	132843949	132844844	CpG: 78	895	78	631	17.4	70.5	0.74
chr12	132852900	132853258	CpG: 29	358	29	229	16.2	64.0	0.79
chr12	132872388	132872613	CpG: 19	225	19	134	16.9	59.6	0.96
chr12	132878911	132880365	CpG: 138	1454	138	976	19.0	67.1	0.85
chr12	132886580	132887356	CpG: 65	776	65	544	16.8	70.1	0.71
chr12	132888440	132888649	CpG: 21	209	21	146	20.1	69.9	0.82
chr12	132904139	132904793	CpG: 49	654	49	444	15.0	67.9	0.65
chr12	132918971	132919222	CpG: 19	251	19	147	15.1	58.6	0.90
chr12	132937930	132939110	CpG: 135	1180	135	817	22.9	69.2	0.96
chr12	132958592	132959894	CpG: 123	1302	123	796	18.9	61.1	1.01
chr12	132989537	132989924	CpG: 31	387	31	282	16.0	72.9	0.61
chr12	132992337	132992620	CpG: 25	283	25	184	17.7	65.0	0.86
chr12	133013236	133013765	CpG: 66	529	66	394	25.0	74.5	0.97
chr12	133014344	133014603	CpG: 22	259	22	159	17.0	61.4	0.91
chr12	133028990	133029234	CpG: 19	244	19	147	15.6	60.2	0.88
chr12	133043459	133044202	CpG: 73	743	73	500	19.7	67.3	0.87
chr12	133094179	133095260	CpG: 126	1081	126	721	23.3	66.7	1.07
chr12	133137426	133138535	CpG: 97	1109	97	695	17.5	62.7	0.92
chr12	133187258	133188324	CpG: 117	1066	117	710	22.0	66.6	0.99
chr12	133236694	133236974	CpG: 20	280	20	173	14.3	61.8	0.75
chr12	133238672	133238914	CpG: 24	242	24	151	19.8	62.4	1.02
chr12	133292940	133293826	CpG: 97	886	97	669	21.9	75.5	0.77
chr13	4973224	4973511	CpG: 25	287	25	194	17.4	67.6	0.82
chr13	4995155	4995697	CpG: 42	542	42	362	15.5	66.8	0.71
chr13	5228492	5228979	CpG: 38	487	38	329	15.6	67.6	0.70
chr13	5323480	5323759	CpG: 25	279	25	174	17.9	62.4	0.93
chr13	5430669	5430961	CpG: 24	292	24	176	16.4	60.3	0.91
chr13	5442708	5443009	CpG: 21	301	21	182	14.0	60.5	0.77
chr13	5449950	5450281	CpG: 26	331	26	214	15.7	64.7	0.75
chr13	5700253	5700470	CpG: 22	217	22	158	20.3	72.8	0.77
chr13	5765235	5766019	CpG: 52	784	52	484	13.3	61.7	0.70
chr13	5770653	5770908	CpG: 19	255	19	132	14.9	51.8	1.12
chr13	5773068	9348047	CpG: 258797	3574979	258797	2069913	14.5	57.9	0.87
chr13	9400151	9400482	CpG: 22	331	22	212	13.3	64.0	0.65
chr13	9401782	9402092	CpG: 20	310	20	197	12.9	63.5	0.64
chr13	9404498	9405042	CpG: 43	544	43	358	15.8	65.8	0.73
chr13	9409307	9409600	CpG: 28	293	28	212	19.1	72.4	0.73
chr13	9459523	9459730	CpG: 19	207	19	141	18.4	68.1	0.79
chr13	9460027	9460271	CpG: 19	244	19	168	15.6	68.9	0.69
chr13	9462552	9462923	CpG: 30	371	30	248	16.2	66.8	0.72
chr13	9472849	9473255	CpG: 32	406	32	288	15.8	70.9	0.63
chr13	9477076	9477733	CpG: 55	657	55	436	16.7	66.4	0.80
chr13	9516032	9516388	CpG: 28	356	28	247	15.7	69.4	0.69
chr13	9630244	9631158	CpG: 71	914	71	609	15.5	66.6	0.70
chr13	9635739	9637127	CpG: 104	1388	104	941	15.0	67.8	0.65
chr13	9644045	9645947	CpG: 129	1902	129	1278	13.6	67.2	0.60
chr13	9651744	9653159	CpG: 93	1415	93	932	13.1	65.9	0.61
chr13	9658959	9660890	CpG: 135	1931	135	1284	14.0	66.5	0.63
chr13	9663465	9664503	CpG: 76	1038	76	699	14.6	67.3	0.65
chr13	9671285	9671545	CpG: 20	260	20	175	15.4	67.3	0.72
chr13	9678505	9680922	CpG: 159	2417	159	1598	13.2	66.1	0.61
chr13	9689071	9690466	CpG: 101	1395	101	942	14.5	67.5	0.64
chr13	9695796	9696598	CpG: 63	802	63	569	15.7	70.9	0.62
chr13	9700657	9701800	CpG: 83	1143	83	764	14.5	66.8	0.65
chr13	9715702	9715965	CpG: 18	263	18	178	13.7	67.7	0.65
chr13	9716333	9717011	CpG: 54	678	54	472	15.9	69.6	0.66
chr13	9717493	9717722	CpG: 19	229	19	152	16.6	66.4	0.76
chr13	9723210	9723434	CpG: 20	224	20	153	17.9	68.3	0.80
chr13	9729406	9730884	CpG: 106	1478	106	1004	14.3	67.9	0.62
chr13	9737007	9737695	CpG: 51	688	51	476	14.8	69.2	0.62
chr13	9740825	9742935	CpG: 145	2110	145	1407	13.7	66.7	0.62
chr13	9746121	9747300	CpG: 95	1179	95	810	16.1	68.7	0.68
chr13	9747886	9748181	CpG: 26	295	26	195	17.6	66.1	0.87
chr13	9756984	9758790	CpG: 121	1806	121	1199	13.4	66.4	0.61
chr13	9767117	9769078	CpG: 135	1961	135	1296	13.8	66.1	0.63
chr13	9778090	9780025	CpG: 136	1935	136	1316	14.1	68.0	0.61
chr13	9786795	9788540	CpG: 119	1745	119	1169	13.6	67.0	0.61
chr13	9902621	9903773	CpG: 124	1152	124	829	21.5	72.0	0.83
chr13	10120928	10121258	CpG: 31	330	31	232	18.8	70.3	0.78
chr13	10411913	10412307	CpG: 29	394	29	276	14.7	70.1	0.62
chr13	10447526	10447822	CpG: 29	296	29	218	19.6	73.6	0.72
chr13	10452173	10452467	CpG: 26	294	26	201	17.7	68.4	0.76
chr13	10551337	10551858	CpG: 47	521	47	350	18.0	67.2	0.81
chr13	10847691	10848147	CpG: 40	456	40	313	17.5	68.6	0.79
chr13	10948880	10950071	CpG: 132	1191	132	847	22.2	71.1	0.88
chr13	10987593	10989311	CpG: 198	1718	198	1106	23.1	64.4	1.18
chr13	11020586	11021899	CpG: 134	1313	134	869	20.4	66.2	0.94
chr13	11048399	11049149	CpG: 83	750	83	515	22.1	68.7	1.00
chr13	11562020	11562916	CpG: 68	896	68	574	15.2	64.1	0.74
chr13	11616005	11616258	CpG: 19	253	19	175	15.0	69.2	0.63
chr13	11618464	11619144	CpG: 56	680	56	469	16.5	69.0	0.71
chr13	11620373	11621354	CpG: 80	981	80	663	16.3	67.6	0.72
chr13	11700175	11700530	CpG: 23	355	23	219	13.0	61.7	0.69
chr13	11702458	11702771	CpG: 26	313	26	213	16.6	68.1	0.77
chr13	11707911	11708136	CpG: 21	225	21	148	18.7	65.8	0.90
chr13	11720135	11720374	CpG: 17	239	17	145	14.2	60.7	0.81
chr13	11729801	11735641	CpG: 407	5840	407	3691	13.9	63.2	0.70
chr13	11970493	11970716	CpG: 17	223	17	136	15.2	61.0	0.83
chr13	12071617	12072379	CpG: 58	762	58	529	15.2	69.4	0.63
chr13	12084996	12085425	CpG: 32	429	32	281	14.9	65.5	0.70
chr13	12106685	12107051	CpG: 26	366	26	266	14.2	72.7	0.84
chr13	12196781	12197846	CpG: 154	1065	154	742	28.9	69.7	1.48
chr13	12200900	12201184	CpG: 23	284	23	172	16.2	60.6	0.89
chr13	12259030	12259351	CpG: 23	321	23	213	14.3	66.4	0.70
chr13	12302477	12303001	CpG: 43	524	43	337	16.4	64.3	0.79
chr13	12303883	12436954	CpG: 7669	133071	7669	80641	11.5	60.6	0.63
chr13	12437839	12438361	CpG: 43	522	43	334	16.5	64.0	0.81
chr13	12597228	12597501	CpG: 21	273	21	166	15.4	60.8	0.84
chr13	12609965	12610247	CpG: 26	282	26	178	18.4	63.1	0.94
chr13	12644179	12644458	CpG: 26	279	26	173	18.6	62.0	0.98
chr13	12718436	12720428	CpG: 160	1992	160	1295	16.1	65.0	0.76
chr13	12720616	12720842	CpG: 18	226	18	135	15.9	59.7	0.90
chr13	12721240	12721530	CpG: 27	290	27	201	18.6	69.3	0.78
chr13	12724103	12724643	CpG: 37	540	37	344	13.7	63.7	0.68
chr13	12776589	12776855	CpG: 20	266	20	163	15.0	61.3	0.81
chr13	12791132	12791357	CpG: 18	225	18	136	16.0	60.4	0.90
chr13	12800429	12801863	CpG: 121	1434	121	1012	16.9	70.6	0.68
chr13	12807896	12808141	CpG: 19	245	19	176	15.5	71.8	0.62
chr13	12836439	12837286	CpG: 77	847	77	589	18.2	69.5	0.75
chr13	12838442	12839096	CpG: 47	654	47	430	14.4	65.7	0.70
chr13	12841548	12841796	CpG: 21	248	21	176	16.9	71.0	0.67
chr13	12894640	12895536	CpG: 75	896	75	580	16.7	64.7	0.80
chr13	13008720	13008993	CpG: 23	273	23	168	16.8	61.5	0.91
chr13	13274705	13274979	CpG: 23	274	23	169	16.8	61.7	0.89
chr13	13433609	13433964	CpG: 44	355	44	236	24.8	66.5	1.17
chr13	13444398	13444606	CpG: 21	208	21	142	20.2	68.3	0.96
chr13	13538790	13540276	CpG: 173	1486	173	1080	23.3	72.7	0.88
chr13	13608784	13609075	CpG: 19	291	19	168	13.1	57.7	0.78
chr13	13612746	13613130	CpG: 56	384	56	311	29.2	81.0	0.92
chr13	13673473	13678479	CpG: 615	5006	615	3354	24.6	67.0	1.10
chr13	13844511	13844986	CpG: 41	475	41	321	17.3	67.6	0.81
chr13	17606778	17607013	CpG: 21	235	21	141	17.9	60.0	1.01
chr13	17623875	17624859	CpG: 69	984	69	660	14.0	67.1	0.63
chr13	17629262	17629536	CpG: 23	274	23	169	16.8	61.7	0.89
chr13	17784577	17784874	CpG: 28	297	28	214	18.9	72.1	0.73
chr13	17796471	17796745	CpG: 25	274	25	171	18.2	62.4	0.95
chr13	17814942	17815308	CpG: 25	366	25	236	13.7	64.5	0.66
chr13	17816171	17817260	CpG: 75	1089	75	705	13.8	64.7	0.66
chr13	17817418	17817621	CpG: 15	203	15	131	14.8	64.5	0.72
chr13	17825251	17826127	CpG: 103	876	103	655	23.5	74.8	0.84
chr13	17879033	17879681	CpG: 71	648	71	463	21.9	71.5	0.86
chr13	17887380	17888029	CpG: 59	649	59	458	18.2	70.6	0.73
chr13	17894380	17894647	CpG: 21	267	21	173	15.7	64.8	0.77
chr13	17939441	17939675	CpG: 23	234	23	165	19.7	70.5	0.81
chr13	17941168	17941408	CpG: 18	240	18	150	15.0	62.5	0.77
chr13	18030965	18031356	CpG: 29	391	29	271	14.8	69.3	0.62
chr13	18031870	18032071	CpG: 16	201	16	146	15.9	72.6	0.60
chr13	18069492	18070413	CpG: 79	921	79	628	17.2	68.2	0.78
chr13	18138252	18138778	CpG: 42	526	42	358	16.0	68.1	0.70
chr13	18304414	18304723	CpG: 26	309	26	185	16.8	59.9	0.95
chr13	18372691	18372914	CpG: 18	223	18	139	16.1	62.3	0.88
chr13	18540420	18541096	CpG: 60	676	60	447	17.8	66.1	0.82
chr13	18552524	18552983	CpG: 33	459	33	266	14.4	58.0	0.87
chr13	18561069	18561619	CpG: 38	550	38	311	13.8	56.5	0.89
chr13	18578402	18578635	CpG: 29	233	29	187	24.9	80.3	0.78
chr13	18590550	18590788	CpG: 19	238	19	148	16.0	62.2	0.84
chr13	18692976	18693287	CpG: 24	311	24	189	15.4	60.8	0.85
chr13	18756180	18756399	CpG: 17	219	17	148	15.5	67.6	0.69
chr13	18757313	18758157	CpG: 65	844	65	556	15.4	65.9	0.72
chr13	18760769	18761583	CpG: 64	814	64	508	15.7	62.4	0.81
chr13	18797896	18798696	CpG: 102	800	102	595	25.5	74.4	0.93
chr13	18829398	18830117	CpG: 66	719	66	479	18.4	66.6	0.83
chr13	18889943	18890173	CpG: 16	230	16	136	13.9	59.1	0.82
chr13	18978265	18979352	CpG: 116	1087	116	690	21.3	63.5	1.06
chr13	19014504	19014780	CpG: 23	276	23	185	16.7	67.0	0.74
chr13	19024016	19024221	CpG: 14	205	14	122	13.7	59.5	0.79
chr13	19058848	19061161	CpG: 215	2313	215	1603	18.6	69.3	0.78
chr13	19073206	19073424	CpG: 16	218	16	129	14.7	59.2	0.86
chr13	19080475	19080978	CpG: 37	503	37	267	14.7	53.1	1.04
chr13	19153821	19155987	CpG: 231	2166	231	1573	21.3	72.6	0.82
chr13	19314847	19315499	CpG: 50	652	50	462	15.3	70.9	0.62
chr13	19324115	19325420	CpG: 115	1305	115	904	17.6	69.3	0.73
chr13	19325657	19325872	CpG: 16	215	16	126	14.9	58.6	0.89
chr13	19333225	19333558	CpG: 31	333	31	217	18.6	65.2	0.88
chr13	19338432	19339667	CpG: 107	1235	107	846	17.3	68.5	0.74
chr13	19357170	19358450	CpG: 160	1280	160	922	25.0	72.0	0.97
chr13	19373545	19374236	CpG: 67	691	67	495	19.4	71.6	0.76
chr13	19388499	19390200	CpG: 169	1701	169	1143	19.9	67.2	0.88
chr13	19428343	19429195	CpG: 96	852	96	636	22.5	74.6	0.81
chr13	19485599	19485888	CpG: 27	289	27	216	18.7	74.7	0.67
chr13	19494560	19495256	CpG: 60	696	60	480	17.2	69.0	0.73
chr13	19534536	19534813	CpG: 24	277	24	171	17.3	61.7	0.92
chr13	19584916	19585467	CpG: 57	551	57	415	20.7	75.3	0.76
chr13	19587733	19588200	CpG: 38	467	38	303	16.3	64.9	0.77
chr13	19607967	19609222	CpG: 100	1255	100	832	15.9	66.3	0.73
chr13	19628734	19629298	CpG: 56	564	56	383	19.9	67.9	0.86
chr13	19653721	19653999	CpG: 22	278	22	168	15.8	60.4	0.88
chr13	19670075	19670349	CpG: 21	274	21	169	15.3	61.7	0.82
chr13	19718376	19719514	CpG: 120	1138	120	772	21.1	67.8	0.92
chr13	19759975	19760743	CpG: 75	768	75	545	19.5	71.0	0.83
chr13	19761903	19762176	CpG: 20	273	20	163	14.7	59.7	0.83
chr13	19896242	19897706	CpG: 197	1464	197	1140	26.9	77.9	0.91
chr13	19914615	19915442	CpG: 80	827	80	568	19.3	68.7	0.82
chr13	19916853	19917085	CpG: 19	232	19	143	16.4	61.6	0.87
chr13	19966448	19967471	CpG: 82	1023	82	633	16.0	61.9	0.85
chr13	19969591	19969875	CpG: 22	284	22	172	15.5	60.6	0.86
chr13	20095766	20096391	CpG: 81	625	81	461	25.9	73.8	0.96
chr13	20107272	20107499	CpG: 20	227	20	139	17.6	61.2	0.98
chr13	20139306	20139546	CpG: 28	240	28	168	23.3	70.0	0.96
chr13	20181107	20182412	CpG: 128	1305	128	927	19.6	71.0	0.79
chr13	20191789	20192452	CpG: 58	663	58	447	17.5	67.4	0.77
chr13	20253468	20254856	CpG: 196	1388	196	1067	28.2	76.9	0.96
chr13	20268659	20269355	CpG: 58	696	58	510	16.7	73.3	0.68
chr13	20297359	20297591	CpG: 26	232	26	164	22.4	70.7	0.90
chr13	20333173	20334046	CpG: 75	873	75	517	17.2	59.2	0.98
chr13	20349845	20350133	CpG: 25	288	25	180	17.4	62.5	0.90
chr13	20368290	20368651	CpG: 30	361	30	216	16.6	59.8	0.94
chr13	20369228	20370273	CpG: 123	1045	123	716	23.5	68.5	1.01
chr13	20379369	20380377	CpG: 83	1008	83	734	16.5	72.8	0.62
chr13	20385674	20385910	CpG: 18	236	18	139	15.3	58.9	0.90
chr13	20452697	20453392	CpG: 53	695	53	476	15.3	68.5	0.67
chr13	20454325	20454544	CpG: 17	219	17	149	15.5	68.0	0.68
chr13	20491118	20491604	CpG: 59	486	59	340	24.3	70.0	1.00
chr13	20512071	20512551	CpG: 49	480	49	316	20.4	65.8	0.96
chr13	20513030	20513551	CpG: 34	521	34	327	13.1	62.8	0.66
chr13	20520525	20520737	CpG: 28	212	28	157	26.4	74.1	0.97
chr13	20571484	20571908	CpG: 29	424	29	270	13.7	63.7	0.75
chr13	20574184	20574405	CpG: 16	221	16	136	14.5	61.5	0.77
chr13	20653065	20653933	CpG: 112	868	112	649	25.8	74.8	0.92
chr13	20674881	20675161	CpG: 23	280	23	172	16.4	61.4	0.89
chr13	20678195	20678461	CpG: 23	266	23	170	17.3	63.9	0.85
chr13	20727712	20727948	CpG: 17	236	17	144	14.4	61.0	0.79
chr13	20795249	20795454	CpG: 15	205	15	117	14.6	57.1	0.90
chr13	20796567	20796837	CpG: 24	270	24	168	17.8	62.2	0.93
chr13	20797990	20798639	CpG: 70	649	70	458	21.6	70.6	0.87
chr13	20848068	20848336	CpG: 18	268	18	160	13.4	59.7	0.77
chr13	20863464	20865563	CpG: 181	2099	181	1337	17.2	63.7	0.85
chr13	20868004	20869956	CpG: 189	1952	189	1347	19.4	69.0	0.83
chr13	20960756	20961063	CpG: 22	307	22	176	14.3	57.3	0.90
chr13	21040777	21041048	CpG: 19	271	19	158	14.0	58.3	0.84
chr13	21044617	21044858	CpG: 17	241	17	142	14.1	58.9	0.83
chr13	21146586	21146867	CpG: 22	281	22	172	15.7	61.2	0.85
chr13	21170241	21170452	CpG: 16	211	16	129	15.2	61.1	0.82
chr13	21540949	21541189	CpG: 19	240	19	146	15.8	60.8	0.88
chr13	21678696	21678970	CpG: 24	274	24	170	17.5	62.0	0.92
chr13	21731431	21731709	CpG: 22	278	22	172	15.8	61.9	0.84
chr13	21757450	21757686	CpG: 22	236	22	147	18.6	62.3	0.99
chr13	21868942	21869169	CpG: 19	227	19	137	16.7	60.4	0.93
chr13	21894511	21894850	CpG: 41	339	41	231	24.2	68.1	1.12
chr13	21908097	21908367	CpG: 23	270	23	168	17.0	62.2	0.88
chr13	21911386	21911661	CpG: 22	275	22	168	16.0	61.1	0.87
chr13	21941874	21942136	CpG: 20	262	20	159	15.3	60.7	0.84
chr13	21960767	21961001	CpG: 17	234	17	141	14.5	60.3	0.82
chr13	21968279	21968554	CpG: 21	275	21	164	15.3	59.6	0.87
chr13	21969020	21969232	CpG: 18	212	18	145	17.0	68.4	0.73
chr13	22036118	22036533	CpG: 43	415	43	298	20.7	71.8	0.83
chr13	22046604	22046813	CpG: 21	209	21	145	20.1	69.4	0.86
chr13	22057033	22057532	CpG: 42	499	42	369	16.8	73.9	0.62
chr13	22096493	22096699	CpG: 17	206	17	141	16.5	68.4	0.71
chr13	22114367	22114625	CpG: 23	258	23	156	17.8	60.5	1.03
chr13	22116397	22116825	CpG: 49	428	49	306	22.9	71.5	0.91
chr13	22127019	22128170	CpG: 102	1151	102	826	17.7	71.8	0.73
chr13	22139693	22139913	CpG: 18	220	18	155	16.4	70.5	0.66
chr13	22224818	22225090	CpG: 21	272	21	162	15.4	59.6	0.88
chr13	22258632	22258885	CpG: 22	253	22	154	17.4	60.9	0.97
chr13	22271429	22271665	CpG: 17	236	17	141	14.4	59.7	0.83
chr13	22295404	22295678	CpG: 25	274	25	172	18.2	62.8	0.94
chr13	22348780	22349047	CpG: 21	267	21	181	15.7	67.8	0.69
chr13	22363019	22363250	CpG: 18	231	18	136	15.6	58.9	0.92
chr13	22366463	22367471	CpG: 92	1008	92	703	18.3	69.7	0.83
chr13	22369129	22369369	CpG: 17	240	17	143	14.2	59.6	0.82
chr13	22398666	22398896	CpG: 21	230	21	140	18.3	60.9	1.00
chr13	22455321	22455591	CpG: 21	270	21	168	15.6	62.2	0.82
chr13	22483347	22483573	CpG: 17	226	17	127	15.0	56.2	0.97
chr13	22581797	22582603	CpG: 116	806	116	621	28.8	77.0	1.00
chr13	22618795	22619052	CpG: 19	257	19	156	14.8	60.7	0.81
chr13	22673130	22673703	CpG: 59	573	59	391	20.6	68.2	0.89
chr13	22701684	22701961	CpG: 25	277	25	178	18.1	64.3	0.88
chr13	22753519	22753803	CpG: 25	284	25	196	17.6	69.0	0.80
chr13	22785249	22786491	CpG: 130	1242	130	895	20.9	72.1	0.81
chr13	22787675	22787937	CpG: 20	262	20	160	15.3	61.1	0.85
chr13	22901157	22901393	CpG: 19	236	19	144	16.1	61.0	0.89
chr13	22901809	22902477	CpG: 56	668	56	457	16.8	68.4	0.72
chr13	23095415	23095973	CpG: 58	558	58	389	20.8	69.7	0.86
chr13	23109779	23110406	CpG: 62	627	62	454	19.8	72.4	0.77
chr13	23115161	23115437	CpG: 23	276	23	170	16.7	61.6	0.89
chr13	23152626	23153157	CpG: 42	531	42	340	15.8	64.0	0.86
chr13	23179381	23179768	CpG: 35	387	35	287	18.1	74.2	0.66
chr13	23186424	23187284	CpG: 65	860	65	541	15.1	62.9	0.77
chr13	23226011	23226285	CpG: 22	274	22	169	16.1	61.7	0.86
chr13	23259645	23259857	CpG: 21	212	21	180	19.8	84.9	0.70
chr13	23289553	23289834	CpG: 24	281	24	175	17.1	62.3	0.90
chr13	23343872	23344147	CpG: 23	275	23	170	16.7	61.8	0.89
chr13	23364383	23364620	CpG: 20	237	20	143	16.9	60.3	0.94
chr13	23367657	23368424	CpG: 77	767	77	544	20.1	70.9	0.82
chr13	23498886	23499158	CpG: 23	272	23	168	16.9	61.8	0.91
chr13	23515054	23515907	CpG: 73	853	73	598	17.1	70.1	0.70
chr13	23534818	23535638	CpG: 70	820	70	518	17.1	63.2	0.86
chr13	23545750	23546184	CpG: 42	434	42	299	19.4	68.9	0.82
chr13	23547510	23548062	CpG: 43	552	43	393	15.6	71.2	0.63
chr13	23687378	23687595	CpG: 16	217	16	122	14.7	56.2	0.95
chr13	23690666	23690947	CpG: 22	281	22	173	15.7	61.6	0.84
chr13	23714311	23714768	CpG: 47	457	47	335	20.6	73.3	0.77
chr13	23717744	23718018	CpG: 23	274	23	171	16.8	62.4	0.88
chr13	23719853	23720398	CpG: 61	545	61	389	22.4	71.4	0.89
chr13	23736250	23736528	CpG: 24	278	24	172	17.3	61.9	0.91
chr13	23749529	23750354	CpG: 73	825	73	554	17.7	67.2	0.79
chr13	23845375	23845636	CpG: 22	261	22	162	16.9	62.1	0.88
chr13	23846293	23846536	CpG: 18	243	18	169	14.8	69.5	0.63
chr13	23869316	23869592	CpG: 21	276	21	169	15.2	61.2	0.83
chr13	23888290	23888990	CpG: 82	700	82	522	23.4	74.6	0.85
chr13	23894520	23894796	CpG: 22	276	22	169	15.9	61.2	0.86
chr13	23904482	23904769	CpG: 24	287	24	175	16.7	61.0	0.92
chr13	23926662	23926953	CpG: 29	291	29	207	19.9	71.1	0.79
chr13	23953380	23955967	CpG: 216	2587	216	1728	16.7	66.8	0.75
chr13	23972929	23973169	CpG: 19	240	19	144	15.8	60.0	0.90
chr13	24076024	24076298	CpG: 24	274	24	171	17.5	62.4	0.91
chr13	24103175	24103486	CpG: 28	311	28	219	18.0	70.4	0.73
chr13	24125198	24125442	CpG: 17	244	17	144	13.9	59.0	0.81
chr13	24130680	24131391	CpG: 78	711	78	479	21.9	67.4	0.98
chr13	24132117	24132358	CpG: 18	241	18	139	14.9	57.7	0.92
chr13	24140227	24140455	CpG: 23	228	23	146	20.2	64.0	1.01
chr13	24178507	24179831	CpG: 113	1324	113	968	17.1	73.1	0.64
chr13	24197782	24198025	CpG: 20	243	20	143	16.5	58.8	0.96
chr13	24204825	24205066	CpG: 18	241	18	150	14.9	62.2	0.79
chr13	24212816	24213060	CpG: 18	244	18	139	14.8	57.0	0.92
chr13	24225200	24225469	CpG: 19	269	19	169	14.1	62.8	0.72
chr13	24226655	24227718	CpG: 100	1063	100	756	18.8	71.1	0.75
chr13	24255556	24256173	CpG: 51	617	51	393	16.5	63.7	0.82
chr13	24277396	24278189	CpG: 54	793	54	468	13.6	59.0	0.78
chr13	24279825	24280098	CpG: 24	273	24	173	17.6	63.4	0.89
chr13	24304687	24305177	CpG: 48	490	48	325	19.6	66.3	0.92
chr13	24379534	24381663	CpG: 205	2129	205	1401	19.3	65.8	0.90
chr13	24496780	24497340	CpG: 59	560	59	392	21.1	70.0	0.86
chr13	24510549	24511755	CpG: 97	1206	97	749	16.1	62.1	0.84
chr13	24575478	24575886	CpG: 33	408	33	260	16.2	63.7	0.80
chr13	24581491	24582660	CpG: 142	1169	142	836	24.3	71.5	0.95
chr13	24596404	24596629	CpG: 18	225	18	138	16.0	61.3	0.87
chr13	24609066	24609348	CpG: 23	282	23	173	16.3	61.3	0.88
chr13	24677440	24677668	CpG: 18	228	18	141	15.8	61.8	0.84
chr13	24678420	24679213	CpG: 85	793	85	571	21.4	72.0	0.83
chr13	24689931	24690512	CpG: 50	581	50	433	17.2	74.5	0.62
chr13	24714337	24714622	CpG: 25	285	25	179	17.5	62.8	0.90
chr13	25192543	25192816	CpG: 22	273	22	162	16.1	59.3	0.93
chr13	25226021	25226625	CpG: 49	604	49	403	16.2	66.7	0.75
chr13	25264481	25266013	CpG: 189	1532	189	1123	24.7	73.3	0.93
chr13	25317742	25318004	CpG: 23	262	23	163	17.6	62.2	0.92
chr13	25400152	25401073	CpG: 93	921	93	590	20.2	64.1	0.98
chr13	25435450	25436353	CpG: 77	903	77	570	17.1	63.1	0.86
chr13	25467574	25468741	CpG: 110	1167	110	808	18.9	69.2	0.79
chr13	25476970	25477209	CpG: 19	239	19	146	15.9	61.1	0.88
chr13	25737991	25738227	CpG: 16	236	16	140	13.6	59.3	0.80
chr13	25771343	25772452	CpG: 159	1109	159	858	28.7	77.4	0.96
chr13	25937239	25938211	CpG: 77	972	77	687	15.8	70.7	0.63
chr13	25974046	25975025	CpG: 119	979	119	710	24.3	72.5	0.93
chr13	26046379	26046665	CpG: 25	286	25	180	17.5	62.9	0.90
chr13	26207051	26207289	CpG: 17	238	17	141	14.3	59.2	0.84
chr13	26308856	26309131	CpG: 21	275	21	169	15.3	61.5	0.81
chr13	26391683	26393056	CpG: 196	1373	196	1085	28.6	79.0	0.93
chr13	26471929	26472627	CpG: 64	698	64	421	18.3	60.3	1.01
chr13	26489288	26489562	CpG: 24	274	24	170	17.5	62.0	0.92
chr13	26491244	26492111	CpG: 103	867	103	627	23.8	72.3	0.91
chr13	26528169	26528449	CpG: 25	280	25	177	17.9	63.2	0.90
chr13	26561479	26561747	CpG: 20	268	20	163	14.9	60.8	0.83
chr13	26645200	26645792	CpG: 78	592	78	438	26.4	74.0	0.96
chr13	26670800	26671913	CpG: 105	1113	105	684	18.9	61.5	1.00
chr13	26804263	26804466	CpG: 23	203	23	114	22.7	56.2	1.46
chr13	26841160	26843226	CpG: 202	2066	202	1446	19.6	70.0	0.80
chr13	26967177	26967449	CpG: 20	272	20	163	14.7	59.9	0.83
chr13	27010717	27011243	CpG: 49	526	49	378	18.6	71.9	0.72
chr13	27012519	27012759	CpG: 19	240	19	152	15.8	63.3	0.81
chr13	27013523	27015479	CpG: 164	1956	164	1303	16.8	66.6	0.76
chr13	27018483	27018742	CpG: 19	259	19	166	14.7	64.1	0.72
chr13	27093650	27093924	CpG: 21	274	21	168	15.3	61.3	0.82
chr13	27127794	27128032	CpG: 17	238	17	142	14.3	59.7	0.82
chr13	27138479	27139509	CpG: 70	1030	70	585	13.6	56.8	0.85
chr13	27140993	27143091	CpG: 164	2098	164	1395	15.6	66.5	0.71
chr13	27145218	27146038	CpG: 81	820	81	570	19.8	69.5	0.82
chr13	27148851	27150366	CpG: 104	1515	104	939	13.7	62.0	0.71
chr13	27175001	27176242	CpG: 134	1241	134	860	21.6	69.3	0.90
chr13	27181190	27181429	CpG: 19	239	19	141	15.9	59.0	0.92
chr13	27181687	27182815	CpG: 96	1128	96	742	17.0	65.8	0.79
chr13	27187607	27190795	CpG: 237	3188	237	2063	14.9	64.7	0.71
chr13	27191775	27192140	CpG: 42	365	42	247	23.0	67.7	1.01
chr13	27197087	27197494	CpG: 42	407	42	282	20.6	69.3	0.86
chr13	27198762	27200221	CpG: 150	1459	150	966	20.6	66.2	0.94
chr13	27201675	27202313	CpG: 54	638	54	423	16.9	66.3	0.77
chr13	27295291	27295571	CpG: 20	280	20	171	14.3	61.1	0.77
chr13	27313794	27314068	CpG: 25	274	25	173	18.2	63.1	0.93
chr13	27322641	27323584	CpG: 118	943	118	697	25.0	73.9	0.93
chr13	27346968	27347259	CpG: 20	291	20	162	13.7	55.7	0.90
chr13	27360592	27361869	CpG: 138	1277	138	911	21.6	71.3	0.85
chr13	27377422	27377665	CpG: 19	243	19	142	15.6	58.4	0.94
chr13	27715874	27718063	CpG: 206	2189	206	1513	18.8	69.1	0.80
chr13	27753348	27753760	CpG: 36	412	36	256	17.5	62.1	0.92
chr13	27754407	27755338	CpG: 115	931	115	677	24.7	72.7	0.94
chr13	27760267	27760514	CpG: 21	247	21	152	17.0	61.5	0.91
chr13	27882161	27882664	CpG: 53	503	53	345	21.1	68.6	0.90
chr13	27941814	27942473	CpG: 80	659	80	463	24.3	70.3	0.98
chr13	28001890	28002308	CpG: 32	418	32	275	15.3	65.8	0.72
chr13	28042773	28044013	CpG: 158	1240	158	931	25.5	75.1	0.92
chr13	28188072	28188348	CpG: 24	276	24	171	17.4	62.0	0.92
chr13	28372149	28372423	CpG: 23	274	23	172	16.8	62.8	0.86
chr13	28468338	28468612	CpG: 23	274	23	170	16.8	62.0	0.88
chr13	28563107	28563522	CpG: 32	415	32	267	15.4	64.3	0.75
chr13	28703142	28703358	CpG: 16	216	16	144	14.8	66.7	0.72
chr13	28726031	28726276	CpG: 23	245	23	163	18.8	66.5	0.90
chr13	28737327	28737541	CpG: 17	214	17	144	15.9	67.3	0.70
chr13	28817371	28818711	CpG: 176	1340	176	1020	26.3	76.1	0.91
chr13	28869888	28870305	CpG: 33	417	33	253	15.8	60.7	0.86
chr13	28886419	28886700	CpG: 20	281	20	170	14.2	60.5	0.79
chr13	28959409	28959634	CpG: 17	225	17	137	15.1	60.9	0.83
chr13	29072427	29073447	CpG: 111	1020	111	698	21.8	68.4	0.94
chr13	29288225	29288501	CpG: 20	276	20	166	14.5	60.1	0.81
chr13	29321850	29322125	CpG: 22	275	22	167	16.0	60.7	0.88
chr13	29337250	29337733	CpG: 68	483	68	370	28.2	76.6	0.96
chr13	29473329	29473561	CpG: 17	232	17	138	14.7	59.5	0.84
chr13	29491679	29492824	CpG: 91	1145	91	829	15.9	72.4	0.61
chr13	29500174	29500410	CpG: 20	236	20	143	16.9	60.6	0.95
chr13	29529235	29530280	CpG: 105	1045	105	724	20.1	69.3	0.84
chr13	29553089	29553367	CpG: 26	278	26	175	18.7	62.9	0.95
chr13	29609550	29609834	CpG: 22	284	22	172	15.5	60.6	0.86
chr13	29630504	29631044	CpG: 52	540	52	363	19.3	67.2	0.86
chr13	29643923	29644927	CpG: 89	1004	89	721	17.7	71.8	0.75
chr13	29668131	29668408	CpG: 25	277	25	185	18.1	66.8	0.82
chr13	29686653	29688496	CpG: 246	1843	246	1342	26.7	72.8	1.01
chr13	29717892	29718119	CpG: 17	227	17	134	15.0	59.0	0.87
chr13	29839431	29840109	CpG: 71	678	71	459	20.9	67.7	0.92
chr13	29884450	29884680	CpG: 16	230	16	137	13.9	59.6	0.80
chr13	29895964	29896517	CpG: 67	553	67	388	24.2	70.2	0.99
chr13	29896986	29897241	CpG: 19	255	19	155	14.9	60.8	0.82
chr13	30025128	30025476	CpG: 27	348	27	228	15.5	65.5	0.72
chr13	30036111	30036385	CpG: 24	274	24	171	17.5	62.4	0.91
chr13	30128060	30128893	CpG: 93	833	93	608	22.3	73.0	0.84
chr13	30384016	30385577	CpG: 125	1561	125	994	16.0	63.7	0.79
chr13	30417629	30417859	CpG: 18	230	18	139	15.7	60.4	0.87
chr13	30422797	30423912	CpG: 168	1115	168	882	30.1	79.1	0.96
chr13	30525335	30525762	CpG: 31	427	31	255	14.5	59.7	0.82
chr13	30575779	30576066	CpG: 20	287	20	189	13.9	65.9	0.64
chr13	30827903	30828133	CpG: 17	230	17	137	14.8	59.6	0.85
chr13	30832025	30832226	CpG: 17	201	17	140	16.9	69.7	0.71
chr13	30864173	30864403	CpG: 17	230	17	138	14.8	60.0	0.83
chr13	30908897	30909171	CpG: 22	274	22	169	16.1	61.7	0.86
chr13	31069756	31070400	CpG: 87	644	87	501	27.0	77.8	0.91
chr13	31175871	31176362	CpG: 33	491	33	316	13.4	64.4	0.65
chr13	31216587	31217420	CpG: 67	833	67	583	16.1	70.0	0.66
chr13	31248052	31248635	CpG: 52	583	52	398	17.8	68.3	0.77
chr13	31349148	31349382	CpG: 21	234	21	143	17.9	61.1	0.98
chr13	31490488	31490761	CpG: 21	273	21	171	15.4	62.6	0.79
chr13	31528532	31528770	CpG: 23	238	23	171	19.3	71.8	0.75
chr13	31532641	31533008	CpG: 43	367	43	251	23.4	68.4	1.02
chr13	31558865	31559105	CpG: 20	240	20	147	16.7	61.2	0.90
chr13	31644356	31645263	CpG: 103	907	103	667	22.7	73.5	0.84
chr13	31803480	31805029	CpG: 193	1549	193	1078	24.9	69.6	1.04
chr13	32183785	32184021	CpG: 19	236	19	142	16.1	60.2	0.92
chr13	32233104	32234604	CpG: 176	1500	176	1094	23.5	72.9	0.89
chr13	32542816	32543081	CpG: 21	265	21	165	15.8	62.3	0.83
chr13	32566884	32567735	CpG: 89	851	89	598	20.9	70.3	0.85
chr13	32581941	32582173	CpG: 17	232	17	142	14.7	61.2	0.81
chr13	32759777	32760360	CpG: 66	583	66	390	22.6	66.9	1.03
chr13	32867595	32867835	CpG: 22	240	22	148	18.3	61.7	0.99
chr13	32899289	32899869	CpG: 44	580	44	411	15.2	70.9	0.61
chr13	32978808	32979044	CpG: 18	236	18	139	15.3	58.9	0.90
chr13	32992072	32992346	CpG: 23	274	23	170	16.8	62.0	0.88
chr13	33035472	33035838	CpG: 38	366	38	242	20.8	66.1	0.96
chr13	33036432	33036668	CpG: 18	236	18	143	15.3	60.6	0.84
chr13	33430366	33430641	CpG: 20	275	20	165	14.5	60.0	0.82
chr13	33580804	33581070	CpG: 22	266	22	166	16.5	62.4	0.86
chr13	33704038	33704465	CpG: 31	427	31	256	14.5	60.0	0.81
chr13	33908092	33908322	CpG: 17	230	17	140	14.8	60.9	0.82
chr13	33925608	33925859	CpG: 19	251	19	148	15.1	59.0	0.90
chr13	34160573	34161629	CpG: 119	1056	119	762	22.5	72.2	0.87
chr13	34689073	34689710	CpG: 55	637	55	404	17.3	63.4	0.86
chr13	34690160	34690372	CpG: 18	212	18	108	17.0	50.9	1.31
chr13	34693799	34694388	CpG: 44	589	44	350	14.9	59.4	0.85
chr13	34696764	34697330	CpG: 46	566	46	373	16.3	65.9	0.75
chr13	34757980	34758209	CpG: 18	229	18	141	15.7	61.6	0.86
chr13	35082724	35082998	CpG: 24	274	24	171	17.5	62.4	0.91
chr13	35186180	35186839	CpG: 52	659	52	448	15.8	68.0	0.68
chr13	35196083	35196371	CpG: 24	288	24	175	16.7	60.8	0.91
chr13	35233400	35233740	CpG: 25	340	25	199	14.7	58.5	0.86
chr13	35312053	35312302	CpG: 23	249	23	156	18.5	62.7	0.96
chr13	35350409	35351076	CpG: 84	667	84	516	25.2	77.4	0.85
chr13	35374300	35374622	CpG: 29	322	29	222	18.0	68.9	0.76
chr13	35433796	35434420	CpG: 49	624	49	433	15.7	69.4	0.65
chr13	35494423	35494658	CpG: 19	235	19	142	16.2	60.4	0.91
chr13	35517037	35517429	CpG: 33	392	33	255	16.8	65.1	0.80
chr13	35565099	35566367	CpG: 128	1268	128	808	20.2	63.7	1.00
chr13	35650923	35652052	CpG: 128	1129	128	823	22.7	72.9	0.86
chr13	35893329	35893842	CpG: 61	513	61	369	23.8	71.9	0.92
chr13	36038658	36039537	CpG: 88	879	88	605	20.0	68.8	0.85
chr13	36129115	36129393	CpG: 20	278	20	168	14.4	60.4	0.80
chr13	36138773	36139816	CpG: 135	1043	135	804	25.9	77.1	0.90
chr13	36218332	36220562	CpG: 152	2230	152	1226	13.6	55.0	0.90
chr13	36278459	36279030	CpG: 61	571	61	394	21.4	69.0	0.90
chr13	36786333	36786607	CpG: 24	274	24	171	17.5	62.4	0.91
chr13	36838948	36839184	CpG: 20	236	20	144	16.9	61.0	0.93
chr13	36895885	36896120	CpG: 17	235	17	137	14.5	58.3	0.87
chr13	37089023	37089569	CpG: 44	546	44	350	16.1	64.1	0.79
chr13	37215794	37216075	CpG: 23	281	23	174	16.4	61.9	0.87
chr13	37251999	37252265	CpG: 26	266	26	170	19.5	63.9	0.97
chr13	37569474	37569930	CpG: 32	456	32	270	14.0	59.2	0.80
chr13	37615742	37616021	CpG: 25	279	25	175	17.9	62.7	0.92
chr13	37692137	37692526	CpG: 33	389	33	276	17.0	71.0	0.68
chr13	37903811	37904874	CpG: 99	1063	99	723	18.6	68.0	0.81
chr13	38132499	38132738	CpG: 19	239	19	142	15.9	59.4	0.91
chr13	38257194	38257622	CpG: 49	428	49	309	22.9	72.2	0.88
chr13	38257923	38258436	CpG: 34	513	34	308	13.3	60.0	0.74
chr13	38259543	38259788	CpG: 21	245	21	145	17.1	59.2	1.00
chr13	38270216	38270483	CpG: 21	267	21	161	15.7	60.3	0.87
chr13	38357991	38358272	CpG: 23	281	23	174	16.4	61.9	0.87
chr13	38618891	38619165	CpG: 23	274	23	170	16.8	62.0	0.88
chr13	38672741	38673015	CpG: 24	274	24	170	17.5	62.0	0.92
chr13	38741767	38742010	CpG: 20	243	20	149	16.5	61.3	0.89
chr13	38821181	38821908	CpG: 78	727	78	530	21.5	72.9	0.81
chr13	38874013	38874451	CpG: 50	438	50	313	22.8	71.5	0.90
chr13	39304932	39305209	CpG: 25	277	25	171	18.1	61.7	0.96
chr13	39390762	39391089	CpG: 30	327	30	225	18.3	68.8	0.78
chr13	39536358	39536633	CpG: 23	275	23	167	16.7	60.7	0.92
chr13	39575542	39575808	CpG: 23	266	23	165	17.3	62.0	0.90
chr13	39754376	39754635	CpG: 21	259	21	167	16.2	64.5	0.81
chr13	39882970	39886592	CpG: 394	3622	394	2506	21.8	69.2	0.91
chr13	39907088	39907362	CpG: 23	274	23	171	16.8	62.4	0.87
chr13	39915978	39916252	CpG: 24	274	24	171	17.5	62.4	0.91
chr13	39917946	39918210	CpG: 24	264	24	167	18.2	63.3	0.93
chr13	39954040	39954280	CpG: 21	240	21	143	17.5	59.6	0.99
chr13	39989885	39990393	CpG: 48	508	48	326	18.9	64.2	0.92
chr13	40008265	40009149	CpG: 103	884	103	649	23.3	73.4	0.88
chr13	40140611	40141680	CpG: 79	1069	79	586	14.8	54.8	0.98
chr13	40146127	40146391	CpG: 21	264	21	166	15.9	62.9	0.82
chr13	40279193	40281132	CpG: 173	1939	173	1251	17.8	64.5	0.86
chr13	40351190	40352108	CpG: 77	918	77	564	16.8	61.4	0.89
chr13	40412822	40413757	CpG: 79	935	79	595	16.9	63.6	0.84
chr13	40502753	40502977	CpG: 20	224	20	140	17.9	62.5	0.95
chr13	40525233	40525488	CpG: 22	255	22	152	17.3	59.6	0.99
chr13	40530258	40531203	CpG: 101	945	101	642	21.4	67.9	0.95
chr13	40542507	40542788	CpG: 21	281	21	170	14.9	60.5	0.83
chr13	40559812	40560079	CpG: 19	267	19	159	14.2	59.6	0.81
chr13	40645153	40645485	CpG: 24	332	24	222	14.5	66.9	0.65
chr13	40647155	40647741	CpG: 51	586	51	383	17.4	65.4	0.82
chr13	40657925	40658214	CpG: 21	289	21	178	14.5	61.6	0.78
chr13	40675918	40677816	CpG: 195	1898	195	1319	20.5	69.5	0.85
chr13	40790659	40791371	CpG: 52	712	52	494	14.6	69.4	0.61
chr13	40792799	40793044	CpG: 18	245	18	159	14.7	64.9	0.70
chr13	40800146	40800425	CpG: 24	279	24	175	17.2	62.7	0.88
chr13	40876629	40876910	CpG: 23	281	23	173	16.4	61.6	0.88
chr13	41060630	41060895	CpG: 19	265	19	162	14.3	61.1	0.78
chr13	41100804	41101957	CpG: 89	1153	89	817	15.4	70.9	0.61
chr13	41117822	41118210	CpG: 39	388	39	287	20.1	74.0	0.74
chr13	41178901	41179160	CpG: 21	259	21	161	16.2	62.2	0.86
chr13	41179916	41180581	CpG: 79	665	79	487	23.8	73.2	0.89
chr13	41216671	41216962	CpG: 26	291	26	181	17.9	62.2	0.94
chr13	41259585	41261057	CpG: 191	1472	191	1094	26.0	74.3	0.95
chr13	41267152	41268925	CpG: 165	1773	165	1206	18.6	68.0	0.82
chr13	41400578	41400849	CpG: 23	271	23	167	17.0	61.6	0.91
chr13	41464351	41464625	CpG: 23	274	23	171	16.8	62.4	0.88
chr13	41491465	41492419	CpG: 100	954	100	659	21.0	69.1	0.90
chr13	41660691	41660964	CpG: 25	273	25	169	18.3	61.9	0.96
chr13	41696160	41696484	CpG: 43	324	43	259	26.5	79.9	0.83
chr13	41779698	41780037	CpG: 28	339	28	246	16.5	72.6	0.63
chr13	41794055	41795060	CpG: 83	1005	83	672	16.5	66.9	0.74
chr13	41868621	41868895	CpG: 24	274	24	171	17.5	62.4	0.91
chr13	41895815	41896100	CpG: 23	285	23	176	16.1	61.8	0.86
chr13	42004565	42004823	CpG: 18	258	18	142	14.0	55.0	0.95
chr13	42110401	42110638	CpG: 16	237	16	141	13.5	59.5	0.79
chr13	42151296	42151577	CpG: 24	281	24	175	17.1	62.3	0.90
chr13	42192804	42193079	CpG: 19	275	19	167	13.8	60.7	0.76
chr13	42210354	42210788	CpG: 38	434	38	283	17.5	65.2	0.82
chr13	42241786	42242138	CpG: 35	352	35	216	19.9	61.4	1.06
chr13	42242786	42243061	CpG: 21	275	21	168	15.3	61.1	0.83
chr13	42252786	42253056	CpG: 19	270	19	164	14.1	60.7	0.77
chr13	42466359	42466637	CpG: 24	278	24	174	17.3	62.6	0.89
chr13	42799969	42800205	CpG: 20	236	20	144	16.9	61.0	0.93
chr13	43004674	43006512	CpG: 200	1838	200	1320	21.8	71.8	0.86
chr13	43012957	43013238	CpG: 24	281	24	176	17.1	62.6	0.89
chr13	43025123	43025398	CpG: 24	275	24	170	17.5	61.8	0.92
chr13	43055438	43055729	CpG: 24	291	24	182	16.5	62.5	0.86
chr13	43097932	43099074	CpG: 131	1142	131	822	22.9	72.0	0.89
chr13	43121237	43121473	CpG: 20	236	20	141	16.9	59.7	0.98
chr13	43129533	43129765	CpG: 18	232	18	140	15.5	60.3	0.86
chr13	43187251	43187676	CpG: 54	425	54	312	25.4	73.4	0.94
chr13	43188565	43188801	CpG: 17	236	17	144	14.4	61.0	0.77
chr13	43188985	43189361	CpG: 33	376	33	249	17.6	66.2	0.80
chr13	43194754	43194997	CpG: 21	243	21	146	17.3	60.1	0.96
chr13	43361563	43362147	CpG: 68	584	68	402	23.3	68.8	0.99
chr13	43592994	43594066	CpG: 113	1072	113	761	21.1	71.0	0.84
chr13	43633162	43633728	CpG: 52	566	52	415	18.4	73.3	0.68
chr13	43634663	43634881	CpG: 20	218	20	121	18.3	55.5	1.22
chr13	43656662	43657019	CpG: 27	357	27	233	15.1	65.3	0.72
chr13	43731957	43732187	CpG: 18	230	18	137	15.7	59.6	0.90
chr13	43795621	43797939	CpG: 260	2318	260	1639	22.4	70.7	0.91
chr13	43801036	43801276	CpG: 18	240	18	146	15.0	60.8	0.83
chr13	43810282	43810564	CpG: 21	282	21	172	14.9	61.0	0.80
chr13	43853711	43853965	CpG: 19	254	19	152	15.0	59.8	0.85
chr13	43902123	43903079	CpG: 77	956	77	669	16.1	70.0	0.66
chr13	43926884	43927108	CpG: 17	224	17	133	15.2	59.4	0.88
chr13	43945066	43945339	CpG: 22	273	22	169	16.1	61.9	0.85
chr13	44072221	44072495	CpG: 24	274	24	171	17.5	62.4	0.91
chr13	44093146	44093379	CpG: 17	233	17	139	14.6	59.7	0.83
chr13	44137959	44138200	CpG: 24	241	24	141	19.9	58.5	1.17
chr13	44169286	44169560	CpG: 24	274	24	171	17.5	62.4	0.91
chr13	44209235	44209949	CpG: 63	714	63	463	17.6	64.8	0.85
chr13	44266943	44267216	CpG: 23	273	23	165	16.8	60.4	0.94
chr13	44282410	44282646	CpG: 16	236	16	134	13.6	56.8	0.87
chr13	44340439	44340883	CpG: 41	444	41	266	18.5	59.9	1.04
chr13	44466087	44466364	CpG: 20	277	20	167	14.4	60.3	0.80
chr13	44531673	44532022	CpG: 37	349	37	251	21.2	71.9	0.82
chr13	44534589	44534819	CpG: 20	230	20	141	17.4	61.3	0.94
chr13	44560729	44561768	CpG: 119	1039	119	728	22.9	70.1	0.93
chr13	44579465	44579734	CpG: 20	269	20	162	14.9	60.2	0.84
chr13	44591172	44591500	CpG: 28	328	28	193	17.1	58.8	0.99
chr13	44610247	44610558	CpG: 37	311	37	224	23.8	72.0	0.92
chr13	44636977	44637594	CpG: 62	617	62	423	20.1	68.6	0.86
chr13	44685272	44686000	CpG: 66	728	66	495	18.1	68.0	0.79
chr13	44866388	44866782	CpG: 29	394	29	237	14.7	60.2	0.82
chr13	44934450	44935382	CpG: 63	932	63	624	13.5	67.0	0.60
chr13	44965428	44965658	CpG: 19	230	19	143	16.5	62.2	0.86
chr13	45112133	45112358	CpG: 19	225	19	139	16.9	61.8	0.90
chr13	45196711	45197094	CpG: 30	383	30	200	15.7	52.2	1.67
chr13	45250835	45251113	CpG: 26	278	26	176	18.7	63.3	0.94
chr13	45269676	45269919	CpG: 20	243	20	147	16.5	60.5	0.93
chr13	45273709	45274274	CpG: 51	565	51	352	18.1	62.3	0.93
chr13	45383487	45384133	CpG: 52	646	52	442	16.1	68.4	0.69
chr13	45398376	45398611	CpG: 17	235	17	138	14.5	58.7	0.86
chr13	45414297	45414567	CpG: 20	270	20	160	14.8	59.3	0.86
chr13	45432730	45432967	CpG: 33	237	33	185	27.8	78.1	0.94
chr13	45607553	45608539	CpG: 93	986	93	644	18.9	65.3	0.90
chr13	45658970	45659308	CpG: 35	338	35	230	20.7	68.0	0.90
chr13	45676599	45676868	CpG: 21	269	21	166	15.6	61.7	0.83
chr13	45698860	45699071	CpG: 16	211	16	124	15.2	58.8	0.89
chr13	45774033	45775769	CpG: 169	1736	169	1193	19.5	68.7	0.83
chr13	45872681	45872884	CpG: 15	203	15	117	14.8	57.6	0.90
chr13	45873389	45873625	CpG: 19	236	19	142	16.1	60.2	0.90
chr13	46017849	46018570	CpG: 67	721	67	462	18.6	64.1	0.91
chr13	46336610	46336883	CpG: 25	273	25	175	18.3	64.1	0.90
chr13	46467478	46467744	CpG: 22	266	22	164	16.5	61.7	0.88
chr13	46595575	46595848	CpG: 22	273	22	172	16.1	63.0	0.82
chr13	46719853	46720128	CpG: 24	275	24	171	17.5	62.2	0.91
chr13	47002275	47002529	CpG: 21	254	21	151	16.5	59.4	0.95
chr13	47105520	47105754	CpG: 17	234	17	139	14.5	59.4	0.84
chr13	47221348	47221841	CpG: 52	493	52	347	21.1	70.4	0.85
chr13	47257903	47258525	CpG: 76	622	76	413	24.4	66.4	1.11
chr13	47260075	47260311	CpG: 21	236	21	145	17.8	61.4	0.96
chr13	47315069	47315616	CpG: 53	547	53	363	19.4	66.4	0.90
chr13	47393314	47393601	CpG: 24	287	24	175	16.7	61.0	0.91
chr13	47396217	47396491	CpG: 23	274	23	170	16.8	62.0	0.88
chr13	47396941	47397175	CpG: 18	234	18	148	15.4	63.2	0.79
chr13	47450271	47450518	CpG: 20	247	20	146	16.2	59.1	0.94
chr13	47453180	47454146	CpG: 107	966	107	686	22.2	71.0	0.88
chr13	47523657	47524699	CpG: 118	1042	118	726	22.6	69.7	0.93
chr13	47537100	47537730	CpG: 45	630	45	407	14.3	64.6	0.69
chr13	47538816	47540038	CpG: 85	1222	85	772	13.9	63.2	0.70
chr13	47540589	47541506	CpG: 59	917	59	524	12.9	57.1	0.79
chr13	47685827	47686209	CpG: 28	382	28	223	14.7	58.4	0.86
chr13	47752560	47753612	CpG: 97	1052	97	704	18.4	66.9	0.83
chr13	48019225	48019501	CpG: 24	276	24	170	17.4	61.6	0.93
chr13	48180988	48181254	CpG: 22	266	22	164	16.5	61.7	0.88
chr13	48196975	48198195	CpG: 144	1220	144	866	23.6	71.0	0.94
chr13	48379477	48379711	CpG: 22	234	22	142	18.8	60.7	1.02
chr13	48437004	48437287	CpG: 25	283	25	176	17.7	62.2	0.92
chr13	48441294	48442711	CpG: 188	1417	188	1041	26.5	73.5	0.98
chr13	48469093	48469871	CpG: 53	778	53	453	13.6	58.2	0.80
chr13	48534400	48534641	CpG: 16	241	16	139	13.3	57.7	0.82
chr13	48662617	48663234	CpG: 57	617	57	407	18.5	66.0	0.86
chr13	48713778	48714017	CpG: 18	239	18	144	15.1	60.3	0.86
chr13	48714525	48715218	CpG: 66	693	66	489	19.0	70.6	0.77
chr13	48737398	48737664	CpG: 21	266	21	165	15.8	62.0	0.83
chr13	48783649	48784325	CpG: 48	676	48	444	14.2	65.7	0.66
chr13	48803752	48804478	CpG: 81	726	81	529	22.3	72.9	0.84
chr13	48897190	48897612	CpG: 40	422	40	306	19.0	72.5	0.72
chr13	48909999	48910631	CpG: 63	632	63	456	19.9	72.2	0.77
chr13	48911064	48911297	CpG: 22	233	22	140	18.9	60.1	1.06
chr13	48980252	48981166	CpG: 72	914	72	640	15.8	70.0	0.64
chr13	49010802	49012046	CpG: 158	1244	158	916	25.4	73.6	0.94
chr13	49065379	49065619	CpG: 18	240	18	137	15.0	57.1	0.94
chr13	49066979	49067181	CpG: 27	202	27	139	26.7	68.8	1.14
chr13	49105517	49105750	CpG: 18	233	18	139	15.5	59.7	0.89
chr13	49156438	49157692	CpG: 109	1254	109	836	17.4	66.7	0.78
chr13	49163557	49163797	CpG: 19	240	19	135	15.8	56.2	1.04
chr13	49216863	49218174	CpG: 117	1311	117	909	17.8	69.3	0.78
chr13	49287987	49288223	CpG: 19	236	19	144	16.1	61.0	0.89
chr13	49301726	49302853	CpG: 101	1127	101	706	17.9	62.6	0.93
chr13	49303884	49304152	CpG: 20	268	20	163	14.9	60.8	0.81
chr13	49339754	49340031	CpG: 24	277	24	177	17.3	63.9	0.86
chr13	49344430	49348732	CpG: 382	4302	382	2792	17.8	64.9	0.84
chr13	49350131	49351471	CpG: 100	1340	100	846	14.9	63.1	0.76
chr13	49354025	49354459	CpG: 44	434	44	294	20.3	67.7	0.90
chr13	49406456	49406766	CpG: 24	310	24	188	15.5	60.6	0.85
chr13	49617204	49617589	CpG: 33	385	33	284	17.1	73.8	0.63
chr13	49874807	49875085	CpG: 25	278	25	176	18.0	63.3	0.91
chr13	49982123	49982404	CpG: 24	281	24	176	17.1	62.6	0.88
chr13	50058186	50058964	CpG: 79	778	79	547	20.3	70.3	0.82
chr13	50116068	50116342	CpG: 24	274	24	170	17.5	62.0	0.92
chr13	50124563	50125407	CpG: 107	844	107	612	25.4	72.5	0.96
chr13	50192802	50193083	CpG: 24	281	24	174	17.1	61.9	0.91
chr13	50197033	50197332	CpG: 22	299	22	172	14.7	57.5	0.90
chr13	50295467	50295895	CpG: 31	428	31	256	14.5	59.8	0.82
chr13	50436960	50437731	CpG: 117	771	117	597	30.4	77.4	1.01
chr13	50466532	50466879	CpG: 34	347	34	240	19.6	69.2	0.83
chr13	50666475	50668730	CpG: 235	2255	235	1606	20.8	71.2	0.83
chr13	50703844	50704125	CpG: 23	281	23	175	16.4	62.3	0.86
chr13	50798852	50800031	CpG: 120	1179	120	804	20.4	68.2	0.88
chr13	50856476	50856755	CpG: 25	279	25	175	17.9	62.7	0.92
chr13	50931329	50931604	CpG: 24	275	24	171	17.5	62.2	0.91
chr13	51018381	51019133	CpG: 96	752	96	553	25.5	73.5	0.95
chr13	51225994	51227247	CpG: 118	1253	118	850	18.8	67.8	0.82
chr13	51252460	51252734	CpG: 23	274	23	170	16.8	62.0	0.88
chr13	51294255	51295166	CpG: 76	911	76	645	16.7	70.8	0.67
chr13	51343470	51344157	CpG: 68	687	68	469	19.8	68.3	0.85
chr13	51374038	51374557	CpG: 68	519	68	378	26.2	72.8	0.99
chr13	51408985	51410949	CpG: 132	1964	132	1123	13.4	57.2	0.82
chr13	51456538	51456813	CpG: 21	275	21	167	15.3	60.7	0.84
chr13	51490044	51490470	CpG: 33	426	33	257	15.5	60.3	0.85
chr13	51548795	51549197	CpG: 29	402	29	265	14.4	65.9	0.67
chr13	51565626	51566215	CpG: 40	589	40	333	13.6	56.5	0.85
chr13	51584298	51584574	CpG: 23	276	23	168	16.7	60.9	0.91
chr13	51584731	51585009	CpG: 20	278	20	168	14.4	60.4	0.79
chr13	51620685	51621272	CpG: 65	587	65	428	22.1	72.9	0.83
chr13	51622077	51622290	CpG: 16	213	16	117	15.0	54.9	1.02
chr13	51641441	51641671	CpG: 20	230	20	137	17.4	59.6	0.99
chr13	51642147	51642407	CpG: 20	260	20	159	15.4	61.2	0.83
chr13	51664843	51665626	CpG: 107	783	107	581	27.3	74.2	0.99
chr13	51669882	51670816	CpG: 88	934	88	595	18.8	63.7	0.93
chr13	51704372	51704774	CpG: 29	402	29	265	14.4	65.9	0.67
chr13	51779966	51780241	CpG: 21	275	21	168	15.3	61.1	0.83
chr13	51815365	51816011	CpG: 69	646	69	467	21.4	72.3	0.82
chr13	51832742	51833209	CpG: 37	467	37	288	15.8	61.7	0.83
chr13	51867683	51868365	CpG: 60	682	60	421	17.6	61.7	0.93
chr13	51954183	51955370	CpG: 106	1187	106	801	17.9	67.5	0.80
chr13	52030650	52031033	CpG: 31	383	31	281	16.2	73.4	0.60
chr13	52033256	52033776	CpG: 37	520	37	359	14.2	69.0	0.60
chr13	52061207	52064182	CpG: 357	2975	357	2106	24.0	70.8	0.96
chr13	52066251	52067305	CpG: 88	1054	88	649	16.7	61.6	0.89
chr13	52222129	52222409	CpG: 23	280	23	170	16.4	60.7	0.90
chr13	52415748	52417838	CpG: 232	2090	232	1467	22.2	70.2	0.90
chr13	52667960	52668349	CpG: 29	389	29	274	14.9	70.4	0.60
chr13	53165523	53165797	CpG: 25	274	25	172	18.2	62.8	0.93
chr13	53492564	53492845	CpG: 24	281	24	175	17.1	62.3	0.89
chr13	53532149	53532354	CpG: 16	205	16	138	15.6	67.3	0.71
chr13	53675687	53675961	CpG: 23	274	23	170	16.8	62.0	0.88
chr13	53694515	53694788	CpG: 22	273	22	172	16.1	63.0	0.82
chr13	53788322	53788754	CpG: 32	432	32	258	14.8	59.7	0.84
chr13	53953310	53953513	CpG: 16	203	16	144	15.8	70.9	0.64
chr13	54015797	54016142	CpG: 30	345	30	247	17.4	71.6	0.68
chr13	54026083	54026361	CpG: 23	278	23	172	16.5	61.9	0.87
chr13	54279678	54279953	CpG: 23	275	23	169	16.7	61.5	0.89
chr13	54467039	54467312	CpG: 20	273	20	167	14.7	61.2	0.80
chr13	54539942	54540174	CpG: 16	232	16	134	13.8	57.8	0.84
chr13	55149486	55149721	CpG: 17	235	17	132	14.5	56.2	0.93
chr13	55194568	55194834	CpG: 21	266	21	164	15.8	61.7	0.84
chr13	55598371	55598666	CpG: 24	295	24	180	16.3	61.0	0.88
chr13	55890462	55890736	CpG: 23	274	23	170	16.8	62.0	0.88
chr13	55952316	55952660	CpG: 36	344	36	256	20.9	74.4	0.76
chr13	56302239	56302461	CpG: 18	222	18	132	16.2	59.5	0.94
chr13	56350996	56351233	CpG: 19	237	19	142	16.0	59.9	0.93
chr13	56356846	56357148	CpG: 21	302	21	187	13.9	61.9	0.73
chr13	56357707	56358040	CpG: 25	333	25	217	15.0	65.2	0.71
chr13	56359283	56359484	CpG: 18	201	18	144	17.9	71.6	0.70
chr13	56364277	56364610	CpG: 25	333	25	216	15.0	64.9	0.72
chr13	56365853	56366054	CpG: 18	201	18	144	17.9	71.6	0.70
chr13	56370843	56371176	CpG: 25	333	25	216	15.0	64.9	0.72
chr13	56372419	56372620	CpG: 18	201	18	144	17.9	71.6	0.70
chr13	56377414	56377747	CpG: 25	333	25	216	15.0	64.9	0.72
chr13	56378990	56379191	CpG: 18	201	18	144	17.9	71.6	0.70
chr13	56383985	56384318	CpG: 25	333	25	216	15.0	64.9	0.72
chr13	56422459	56422733	CpG: 25	274	25	172	18.2	62.8	0.94
chr13	56503374	56503859	CpG: 49	485	49	354	20.2	73.0	0.76
chr13	56545378	56545659	CpG: 27	281	27	177	19.2	63.0	0.98
chr13	56609765	56610041	CpG: 19	276	19	169	13.8	61.2	0.74
chr13	56845750	56846486	CpG: 64	736	64	437	17.4	59.4	0.99
chr13	56848689	56851093	CpG: 222	2404	222	1512	18.5	62.9	0.94
chr13	56868283	56868569	CpG: 24	286	24	179	16.8	62.6	0.87
chr13	57333262	57333496	CpG: 20	234	20	145	17.1	62.0	0.91
chr13	57468341	57468581	CpG: 17	240	17	141	14.2	58.8	0.85
chr13	57534708	57535241	CpG: 47	533	47	392	17.6	73.5	0.65
chr13	57604168	57604389	CpG: 17	221	17	127	15.4	57.5	0.96
chr13	57689480	57689765	CpG: 25	285	25	180	17.5	63.2	0.90
chr13	57843470	57843700	CpG: 20	230	20	141	17.4	61.3	0.94
chr13	57864505	57864764	CpG: 20	259	20	154	15.4	59.5	0.87
chr13	57897064	57897356	CpG: 24	292	24	179	16.4	61.3	0.88
chr13	58022661	58022936	CpG: 23	275	23	169	16.7	61.5	0.89
chr13	58042203	58042480	CpG: 23	277	23	170	16.6	61.4	0.89
chr13	58043490	58043824	CpG: 29	334	29	239	17.4	71.6	0.70
chr13	58056635	58056857	CpG: 19	222	19	136	17.1	61.3	0.92
chr13	58078710	58079109	CpG: 36	399	36	290	18.0	72.7	0.68
chr13	58303448	58303722	CpG: 23	274	23	170	16.8	62.0	0.88
chr13	58388717	58388957	CpG: 22	240	22	150	18.3	62.5	0.96
chr13	58454305	58454552	CpG: 19	247	19	148	15.4	59.9	0.88
chr13	58916722	58916945	CpG: 18	223	18	133	16.1	59.6	0.92
chr13	58933591	58933865	CpG: 24	274	24	172	17.5	62.8	0.90
chr13	58976970	58977206	CpG: 18	236	18	142	15.3	60.2	0.87
chr13	59022211	59022491	CpG: 23	280	23	172	16.4	61.4	0.89
chr13	59311986	59312221	CpG: 17	235	17	140	14.5	59.6	0.83
chr13	59339090	59339364	CpG: 23	274	23	169	16.8	61.7	0.89
chr13	59356286	59356565	CpG: 21	279	21	169	15.1	60.6	0.83
chr13	59383169	59383790	CpG: 51	621	51	413	16.4	66.5	0.74
chr13	59409960	59410233	CpG: 22	273	22	169	16.1	61.9	0.86
chr13	59541376	59541654	CpG: 25	278	25	175	18.0	62.9	0.92
chr13	59545505	59545720	CpG: 19	215	19	130	17.7	60.5	0.98
chr13	59613778	59614362	CpG: 41	584	41	339	14.0	58.0	0.83
chr13	59615961	59617603	CpG: 154	1642	154	1108	18.8	67.5	0.83
chr13	59624062	59624298	CpG: 21	236	21	145	17.8	61.4	0.96
chr13	59784745	59785023	CpG: 24	278	24	174	17.3	62.6	0.89
chr13	59794051	59794328	CpG: 22	277	22	170	15.9	61.4	0.86
chr13	59956708	59956981	CpG: 24	273	24	168	17.6	61.5	0.94
chr13	60013394	60013631	CpG: 21	237	21	145	17.7	61.2	0.97
chr13	60207450	60207734	CpG: 23	284	23	174	16.2	61.3	0.88
chr13	60237438	60237708	CpG: 21	270	21	166	15.6	61.5	0.83
chr13	60246313	60246544	CpG: 20	231	20	141	17.3	61.0	0.94
chr13	60559517	60559873	CpG: 37	356	37	259	20.8	72.8	0.79
chr13	60681512	60681786	CpG: 24	274	24	172	17.5	62.8	0.90
chr13	60852861	60853135	CpG: 22	274	22	170	16.1	62.0	0.84
chr13	61005134	61005400	CpG: 22	266	22	161	16.5	60.5	0.91
chr13	61235036	61235331	CpG: 26	295	26	180	17.6	61.0	0.96
chr13	61367569	61367843	CpG: 22	274	22	169	16.1	61.7	0.85
chr13	61414493	61414743	CpG: 19	250	19	153	15.2	61.2	0.84
chr13	61668966	61669363	CpG: 36	397	36	293	18.1	73.8	0.67
chr13	61755638	61755920	CpG: 24	282	24	176	17.0	62.4	0.88
chr13	61818425	61818657	CpG: 16	232	16	135	13.8	58.2	0.83
chr13	62330514	62330760	CpG: 21	246	21	150	17.1	61.0	0.93
chr13	62494307	62494561	CpG: 21	254	21	156	16.5	61.4	0.89
chr13	62527047	62527610	CpG: 47	563	47	403	16.7	71.6	0.65
chr13	62600372	62600595	CpG: 17	223	17	129	15.2	57.8	0.92
chr13	62756399	62756685	CpG: 24	286	24	176	16.8	61.5	0.90
chr13	62792715	62792951	CpG: 21	236	21	146	17.8	61.9	0.95
chr13	62971955	62972165	CpG: 18	210	18	129	17.1	61.4	0.92
chr13	63033164	63033502	CpG: 36	338	36	230	21.3	68.0	0.92
chr13	63050826	63051061	CpG: 20	235	20	144	17.0	61.3	0.92
chr13	63065979	63066224	CpG: 21	245	21	172	17.1	70.2	0.70
chr13	63096150	63096424	CpG: 23	274	23	171	16.8	62.4	0.87
chr13	63299320	63299714	CpG: 38	394	38	288	19.3	73.1	0.72
chr13	63401321	63401597	CpG: 23	276	23	170	16.7	61.6	0.89
chr13	63520468	63520742	CpG: 20	274	20	171	14.6	62.4	0.76
chr13	63576675	63576952	CpG: 22	277	22	165	15.9	59.6	0.90
chr13	63648526	63648763	CpG: 18	237	18	147	15.2	62.0	0.81
chr13	63917399	63917643	CpG: 19	244	19	148	15.6	60.7	0.86
chr13	64081691	64081972	CpG: 24	281	24	172	17.1	61.2	0.92
chr13	64253472	64253681	CpG: 16	209	16	145	15.3	69.4	0.65
chr13	64284616	64284876	CpG: 20	260	20	155	15.4	59.6	0.87
chr13	64314972	64315248	CpG: 20	276	20	164	14.5	59.4	0.83
chr13	64368492	64368917	CpG: 39	425	39	313	18.4	73.6	0.68
chr13	64756786	64757018	CpG: 18	232	18	141	15.5	60.8	0.86
chr13	64787153	64787393	CpG: 23	240	23	151	19.2	62.9	0.99
chr13	65227944	65228284	CpG: 30	340	30	249	17.6	73.2	0.66
chr13	65304739	65305003	CpG: 22	264	22	162	16.7	61.4	0.90
chr13	65348885	65349144	CpG: 25	259	25	162	19.3	62.5	0.99
chr13	65414022	65414258	CpG: 18	236	18	140	15.3	59.3	0.89
chr13	65600539	65600771	CpG: 18	232	18	141	15.5	60.8	0.86
chr13	65842910	65843126	CpG: 19	216	19	123	17.6	56.9	1.12
chr13	65928014	65928288	CpG: 25	274	25	170	18.2	62.0	0.96
chr13	65957424	65957851	CpG: 30	427	30	257	14.1	60.2	0.78
chr13	66045329	66045602	CpG: 25	273	25	169	18.3	61.9	0.96
chr13	66068639	66068917	CpG: 21	278	21	171	15.1	61.5	0.80
chr13	66154753	66155031	CpG: 26	278	26	176	18.7	63.3	0.94
chr13	66225961	66226192	CpG: 17	231	17	139	14.7	60.2	0.82
chr13	66450427	66451379	CpG: 93	952	93	640	19.5	67.2	0.87
chr13	66460211	66460431	CpG: 17	220	17	131	15.5	59.5	0.88
chr13	66717794	66718072	CpG: 24	278	24	175	17.3	62.9	0.88
chr13	66839105	66839379	CpG: 25	274	25	173	18.2	63.1	0.93
chr13	66906832	66907057	CpG: 20	225	20	137	17.8	60.9	0.96
chr13	67019989	67020277	CpG: 24	288	24	179	16.7	62.2	0.88
chr13	67135480	67135778	CpG: 26	298	26	198	17.4	66.4	0.82
chr13	67203124	67203339	CpG: 16	215	16	128	14.9	59.5	0.86
chr13	67258475	67258711	CpG: 18	236	18	142	15.3	60.2	0.87
chr13	67330057	67330461	CpG: 36	404	36	300	17.8	74.3	0.65
chr13	67393142	67393533	CpG: 39	391	39	289	19.9	73.9	0.73
chr13	67610223	67610451	CpG: 17	228	17	133	14.9	58.3	0.90
chr13	67746202	67746465	CpG: 20	263	20	182	15.2	69.2	0.66
chr13	67863209	67863438	CpG: 16	229	16	135	14.0	59.0	0.83
chr13	67925443	67925699	CpG: 21	256	21	156	16.4	60.9	0.90
chr13	68031186	68031417	CpG: 17	231	17	135	14.7	58.4	0.87
chr13	68206800	68207200	CpG: 34	400	34	282	17.0	70.5	0.70
chr13	68233722	68233965	CpG: 19	243	19	146	15.6	60.1	0.89
chr13	68559343	68559609	CpG: 21	266	21	165	15.8	62.0	0.84
chr13	68704422	68704724	CpG: 23	302	23	178	15.2	58.9	0.88
chr13	69106859	69107140	CpG: 25	281	25	176	17.8	62.6	0.92
chr13	69289982	69290212	CpG: 20	230	20	142	17.4	61.7	0.93
chr13	69329471	69329958	CpG: 42	487	42	323	17.2	66.3	0.82
chr13	69389631	69389858	CpG: 16	227	16	130	14.1	57.3	0.90
chr13	69733740	69734018	CpG: 25	278	25	174	18.0	62.6	0.93
chr13	69736228	69736613	CpG: 34	385	34	280	17.7	72.7	0.67
chr13	69851844	69852053	CpG: 18	209	18	131	17.2	62.7	0.89
chr13	69861705	69861986	CpG: 20	281	20	168	14.2	59.8	0.82
chr13	69986618	69986856	CpG: 21	238	21	145	17.6	60.9	0.97
chr13	70111775	70112048	CpG: 22	273	22	169	16.1	61.9	0.86
chr13	70134077	70134314	CpG: 22	237	22	148	18.6	62.4	0.98
chr13	70178656	70178890	CpG: 19	234	19	141	16.2	60.3	0.91
chr13	70399561	70399850	CpG: 24	289	24	164	16.6	56.7	1.06
chr13	70463326	70463592	CpG: 20	266	20	163	15.0	61.3	0.81
chr13	70499247	70499471	CpG: 21	224	21	139	18.8	62.1	1.01
chr13	70753664	70753888	CpG: 17	224	17	134	15.2	59.8	0.87
chr13	70900205	70900478	CpG: 26	273	26	168	19.0	61.5	1.01
chr13	70990852	70991074	CpG: 16	222	16	134	14.4	60.4	0.81
chr13	71040679	71040953	CpG: 24	274	24	171	17.5	62.4	0.91
chr13	71071228	71071479	CpG: 18	251	18	151	14.3	60.2	0.80
chr13	71089874	71091537	CpG: 163	1663	163	1152	19.6	69.3	0.82
chr13	71092233	71092515	CpG: 20	282	20	156	14.2	55.3	0.98
chr13	71375897	71376154	CpG: 22	257	22	148	17.1	57.6	1.06
chr13	71495192	71495437	CpG: 17	245	17	139	13.9	56.7	0.89
chr13	71547046	71547320	CpG: 22	274	22	169	16.1	61.7	0.86
chr13	71753868	71754141	CpG: 21	273	21	169	15.4	61.9	0.81
chr13	71816613	71816858	CpG: 20	245	20	149	16.3	60.8	0.91
chr13	71827271	71827553	CpG: 21	282	21	166	14.9	58.9	0.86
chr13	71831700	71831925	CpG: 18	225	18	133	16.0	59.1	0.92
chr13	71863645	71863916	CpG: 19	271	19	163	14.0	60.1	0.79
chr13	71948617	71949541	CpG: 100	924	100	623	21.6	67.4	0.96
chr13	72003048	72003702	CpG: 65	654	65	412	19.9	63.0	1.00
chr13	72026649	72026866	CpG: 15	217	15	124	13.8	57.1	0.86
chr13	72234569	72234835	CpG: 22	266	22	166	16.5	62.4	0.86
chr13	72280236	72281746	CpG: 163	1510	163	1019	21.6	67.5	0.95
chr13	72337066	72337336	CpG: 25	270	25	170	18.5	63.0	0.94
chr13	72345750	72346025	CpG: 24	275	24	172	17.5	62.5	0.90
chr13	72368695	72368971	CpG: 21	276	21	169	15.2	61.2	0.82
chr13	72537673	72537940	CpG: 18	267	18	161	13.5	60.3	0.75
chr13	72639623	72639897	CpG: 21	274	21	167	15.3	60.9	0.85
chr13	72862275	72862478	CpG: 19	203	19	121	18.7	59.6	1.05
chr13	73228996	73229231	CpG: 20	235	20	144	17.0	61.3	0.93
chr13	73317051	73317324	CpG: 22	273	22	172	16.1	63.0	0.82
chr13	73355788	73357698	CpG: 208	1910	208	1392	21.8	72.9	0.82
chr13	73443035	73443261	CpG: 18	226	18	137	15.9	60.6	0.88
chr13	73463559	73463896	CpG: 27	337	27	199	16.0	59.1	0.92
chr13	73648360	73648670	CpG: 23	310	23	186	14.8	60.0	0.83
chr13	73767394	73767656	CpG: 25	262	25	164	19.1	62.6	0.98
chr13	73848560	73848838	CpG: 24	278	24	174	17.3	62.6	0.89
chr13	73940251	73940503	CpG: 22	252	22	186	17.5	73.8	0.64
chr13	73979338	73979611	CpG: 21	273	21	169	15.4	61.9	0.82
chr13	74492135	74492365	CpG: 21	230	21	164	18.3	71.3	0.72
chr13	74585695	74586053	CpG: 29	358	29	236	16.2	65.9	0.75
chr13	74634274	74634560	CpG: 26	286	26	181	18.2	63.3	0.92
chr13	74704350	74706294	CpG: 203	1944	203	1359	20.9	69.9	0.86
chr13	74761189	74761560	CpG: 31	371	31	246	16.7	66.3	0.76
chr13	74772983	74773793	CpG: 69	810	69	500	17.0	61.7	0.91
chr13	74858073	74858308	CpG: 17	235	17	138	14.5	58.7	0.87
chr13	74859021	74860694	CpG: 175	1673	175	1193	20.9	71.3	0.83
chr13	74961104	74961370	CpG: 23	266	23	167	17.3	62.8	0.89
chr13	75107717	75107956	CpG: 17	239	17	141	14.2	59.0	0.84
chr13	75289001	75289275	CpG: 23	274	23	169	16.8	61.7	0.89
chr13	75413755	75414268	CpG: 45	513	45	372	17.5	72.5	0.67
chr13	75518516	75519043	CpG: 40	527	40	349	15.2	66.2	0.69
chr13	75606238	75606471	CpG: 18	233	18	140	15.5	60.1	0.87
chr13	75842097	75842524	CpG: 31	427	31	254	14.5	59.5	0.82
chr13	76100386	76100623	CpG: 18	237	18	141	15.2	59.5	0.88
chr13	76108858	76110635	CpG: 214	1777	214	1262	24.1	71.0	0.96
chr13	76172691	76172922	CpG: 18	231	18	135	15.6	58.4	0.94
chr13	76203760	76204032	CpG: 27	272	27	197	19.9	72.4	0.77
chr13	76215563	76216104	CpG: 68	541	68	395	25.1	73.0	0.97
chr13	76250072	76250930	CpG: 112	858	112	654	26.1	76.2	0.91
chr13	76392763	76393001	CpG: 22	238	22	149	18.5	62.6	0.96
chr13	76473780	76474054	CpG: 25	274	25	171	18.2	62.4	0.95
chr13	76550217	76551040	CpG: 91	823	91	594	22.1	72.2	0.86
chr13	76553110	76553584	CpG: 35	474	35	284	14.8	59.9	0.82
chr13	76589582	76589867	CpG: 25	285	25	179	17.5	62.8	0.90
chr13	76674699	76674923	CpG: 18	224	18	134	16.1	59.8	0.92
chr13	76699464	76699956	CpG: 42	492	42	354	17.1	72.0	0.66
chr13	76732360	76732590	CpG: 20	230	20	141	17.4	61.3	0.94
chr13	76767979	76768215	CpG: 20	236	20	146	16.9	61.9	0.91
chr13	76857985	76858258	CpG: 23	273	23	170	16.8	62.3	0.89
chr13	76884967	76885465	CpG: 34	498	34	331	13.7	66.5	0.63
chr13	76915115	76915352	CpG: 19	237	19	147	16.0	62.0	0.86
chr13	76922193	76923447	CpG: 151	1254	151	957	24.1	76.3	0.83
chr13	77003272	77003516	CpG: 20	244	20	152	16.4	62.3	0.88
chr13	77143217	77144174	CpG: 70	957	70	579	14.6	60.5	0.80
chr13	77235498	77235772	CpG: 24	274	24	171	17.5	62.4	0.91
chr13	77245275	77245556	CpG: 24	281	24	175	17.1	62.3	0.90
chr13	77742770	77743051	CpG: 24	281	24	175	17.1	62.3	0.90
chr13	77801486	77801760	CpG: 24	274	24	170	17.5	62.0	0.92
chr13	77821702	77822819	CpG: 95	1117	95	687	17.0	61.5	0.90
chr13	77827198	77829576	CpG: 290	2378	290	1648	24.4	69.3	1.02
chr13	77832926	77833213	CpG: 20	287	20	179	13.9	62.4	0.73
chr13	77833543	77833821	CpG: 23	278	23	191	16.5	68.7	0.70
chr13	77834458	77835479	CpG: 75	1021	75	595	14.7	58.3	0.87
chr13	77859522	77859759	CpG: 19	237	19	144	16.0	60.8	0.90
chr13	77884421	77885016	CpG: 63	595	63	381	21.2	64.0	1.05
chr13	77925300	77925578	CpG: 24	278	24	173	17.3	62.2	0.91
chr13	78078053	78078330	CpG: 23	277	23	172	16.6	62.1	0.87
chr13	78260575	78260851	CpG: 21	276	21	168	15.2	60.9	0.84
chr13	78315240	78315514	CpG: 25	274	25	172	18.2	62.8	0.94
chr13	78329267	78329550	CpG: 21	283	21	171	14.8	60.4	0.81
chr13	78347113	78347329	CpG: 17	216	17	122	15.7	56.5	1.02
chr13	78373171	78373407	CpG: 20	236	20	145	16.9	61.4	0.92
chr13	78633849	78634657	CpG: 79	808	79	517	19.6	64.0	0.96
chr13	78646872	78647143	CpG: 23	271	23	164	17.0	60.5	0.94
chr13	78708857	78709504	CpG: 75	647	75	445	23.2	68.8	0.98
chr13	78827745	78828134	CpG: 33	389	33	277	17.0	71.2	0.67
chr13	78852590	78852871	CpG: 24	281	24	175	17.1	62.3	0.90
chr13	79050956	79051167	CpG: 16	211	16	125	15.2	59.2	0.86
chr13	79192735	79193005	CpG: 24	270	24	171	17.8	63.3	0.89
chr13	79303789	79304063	CpG: 21	274	21	168	15.3	61.3	0.83
chr13	79332309	79332583	CpG: 24	274	24	175	17.5	63.9	0.88
chr13	79380072	79380288	CpG: 21	216	21	130	19.4	60.2	1.07
chr13	79506907	79507206	CpG: 23	299	23	214	15.4	71.6	0.61
chr13	79562150	79562425	CpG: 24	275	24	172	17.5	62.5	0.91
chr13	79567084	79567388	CpG: 22	304	22	200	14.5	65.8	0.73
chr13	79567940	79569595	CpG: 159	1655	159	1087	19.2	65.7	0.89
chr13	79570889	79571148	CpG: 34	259	34	186	26.3	71.8	1.02
chr13	79583619	79583998	CpG: 32	379	32	280	16.9	73.9	0.62
chr13	79584540	79584787	CpG: 20	247	20	139	16.2	56.3	1.06
chr13	79605863	79606102	CpG: 18	239	18	142	15.1	59.4	0.87
chr13	79719485	79719875	CpG: 32	390	32	285	16.4	73.1	0.62
chr13	79884390	79884788	CpG: 31	398	31	272	15.6	68.3	0.67
chr13	80178914	80179205	CpG: 27	291	27	179	18.6	61.5	0.99
chr13	80210145	80210367	CpG: 17	222	17	133	15.3	59.9	0.87
chr13	80332410	80332660	CpG: 21	250	21	186	16.8	74.4	0.61
chr13	80466146	80466429	CpG: 23	283	23	175	16.3	61.8	0.87
chr13	80571009	80571435	CpG: 34	426	34	310	16.0	72.8	0.61
chr13	80681667	80681952	CpG: 26	285	26	180	18.2	63.2	0.93
chr13	80767641	80767871	CpG: 19	230	19	139	16.5	60.4	0.92
chr13	81080426	81080699	CpG: 19	273	19	169	13.9	61.9	0.73
chr13	81272281	81272555	CpG: 24	274	24	171	17.5	62.4	0.91
chr13	81278558	81278801	CpG: 19	243	19	146	15.6	60.1	0.87
chr13	81372104	81372378	CpG: 22	274	22	168	16.1	61.3	0.86
chr13	81490891	81491466	CpG: 55	575	55	417	19.1	72.5	0.73
chr13	81581430	81581666	CpG: 19	236	19	144	16.1	61.0	0.88
chr13	81794801	81795079	CpG: 23	278	23	173	16.5	62.2	0.86
chr13	81864600	81864840	CpG: 18	240	18	141	15.0	58.8	0.89
chr13	81899921	81900156	CpG: 18	235	18	142	15.3	60.4	0.85
chr13	82406169	82406450	CpG: 23	281	23	174	16.4	61.9	0.87
chr13	82568711	82568981	CpG: 21	270	21	165	15.6	61.1	0.85
chr13	82708974	82709212	CpG: 19	238	19	139	16.0	58.4	0.94
chr13	82749687	82749898	CpG: 19	211	19	154	18.0	73.0	0.68
chr13	83099022	83099299	CpG: 21	277	21	173	15.2	62.5	0.78
chr13	83105057	83105324	CpG: 22	267	22	165	16.5	61.8	0.88
chr13	83112324	83112557	CpG: 18	233	18	138	15.5	59.2	0.88
chr13	83137725	83138003	CpG: 24	278	24	174	17.3	62.6	0.89
chr13	83216733	83217005	CpG: 21	272	21	168	15.4	61.8	0.83
chr13	83319236	83319741	CpG: 52	505	52	374	20.6	74.1	0.75
chr13	83324347	83324621	CpG: 22	274	22	169	16.1	61.7	0.85
chr13	83346274	83346547	CpG: 19	273	19	168	13.9	61.5	0.75
chr13	83398044	83398318	CpG: 24	274	24	170	17.5	62.0	0.92
chr13	83561077	83561313	CpG: 18	236	18	140	15.3	59.3	0.88
chr13	83596997	83597257	CpG: 18	260	18	152	13.8	58.5	0.82
chr13	83612818	83613092	CpG: 20	274	20	165	14.6	60.2	0.82
chr13	84137583	84137824	CpG: 20	241	20	148	16.6	61.4	0.90
chr13	84244572	84244847	CpG: 22	275	22	166	16.0	60.4	0.89
chr13	84368169	84368392	CpG: 17	223	17	130	15.2	58.3	0.90
chr13	84449575	84450128	CpG: 53	553	53	411	19.2	74.3	0.70
chr13	84460343	84460579	CpG: 20	236	20	144	16.9	61.0	0.93
chr13	84571524	84571765	CpG: 18	241	18	142	14.9	58.9	0.87
chr13	84586348	84587019	CpG: 54	671	54	465	16.1	69.3	0.67
chr13	84608636	84608889	CpG: 26	253	26	197	20.6	77.9	0.69
chr13	84674019	84674299	CpG: 23	280	23	170	16.4	60.7	0.90
chr13	84722127	84722332	CpG: 18	205	18	120	17.6	58.5	1.04
chr13	84831995	84832270	CpG: 24	275	24	170	17.5	61.8	0.92
chr13	85265177	85265419	CpG: 19	242	19	146	15.7	60.3	0.89
chr13	85276774	85277001	CpG: 20	227	20	140	17.6	61.7	0.94
chr13	85798269	85798547	CpG: 26	278	26	176	18.7	63.3	0.94
chr13	85995324	85995839	CpG: 53	515	53	383	20.6	74.4	0.75
chr13	85997076	85997328	CpG: 18	252	18	151	14.3	59.9	0.81
chr13	86143434	86143670	CpG: 20	236	20	144	16.9	61.0	0.93
chr13	86153834	86154138	CpG: 27	304	27	192	17.8	63.2	0.90
chr13	86158480	86158741	CpG: 19	261	19	159	14.6	60.9	0.79
chr13	86226852	86227133	CpG: 24	281	24	175	17.1	62.3	0.90
chr13	86290305	86290583	CpG: 20	278	20	166	14.4	59.7	0.82
chr13	86579508	86579782	CpG: 24	274	24	171	17.5	62.4	0.91
chr13	86618317	86618532	CpG: 17	215	17	130	15.8	60.5	0.90
chr13	86688283	86688557	CpG: 23	274	23	169	16.8	61.7	0.89
chr13	86765057	86765731	CpG: 52	674	52	463	15.4	68.7	0.66
chr13	86874918	86876320	CpG: 138	1402	138	972	19.7	69.3	0.82
chr13	86877949	86878268	CpG: 23	319	23	164	14.4	51.4	1.13
chr13	86880742	86881549	CpG: 71	807	71	519	17.6	64.3	0.86
chr13	87039595	87039869	CpG: 23	274	23	170	16.8	62.0	0.88
chr13	87428118	87428653	CpG: 39	535	39	299	14.6	55.9	0.94
chr13	87495432	87495818	CpG: 33	386	33	279	17.1	72.3	0.66
chr13	87548871	87549466	CpG: 65	595	65	457	21.8	76.8	0.80
chr13	87553139	87553374	CpG: 19	235	19	141	16.2	60.0	0.91
chr13	87624376	87624606	CpG: 20	230	20	141	17.4	61.3	0.94
chr13	87804617	87804891	CpG: 24	274	24	171	17.5	62.4	0.91
chr13	87877834	87878114	CpG: 21	280	21	172	15.0	61.4	0.81
chr13	88291906	88292260	CpG: 25	354	25	205	14.1	57.9	0.85
chr13	88359159	88359397	CpG: 17	238	17	141	14.3	59.2	0.83
chr13	88567252	88567615	CpG: 41	363	41	269	22.6	74.1	0.82
chr13	88713446	88713727	CpG: 25	281	25	176	17.8	62.6	0.92
chr13	89087807	89088158	CpG: 39	351	39	266	22.2	75.8	0.78
chr13	89102287	89102562	CpG: 22	275	22	172	16.0	62.5	0.83
chr13	89226066	89226294	CpG: 17	228	17	132	14.9	57.9	0.91
chr13	89412338	89412614	CpG: 24	276	24	171	17.4	62.0	0.92
chr13	89465472	89465746	CpG: 21	274	21	168	15.3	61.3	0.82
chr13	89497889	89498172	CpG: 24	283	24	174	17.0	61.5	0.91
chr13	89531690	89531926	CpG: 17	236	17	141	14.4	59.7	0.83
chr13	89551365	89551754	CpG: 34	389	34	286	17.5	73.5	0.65
chr13	89697595	89697938	CpG: 29	343	29	248	16.9	72.3	0.65
chr13	89698610	89698856	CpG: 20	246	20	141	16.3	57.3	1.01
chr13	89895347	89895606	CpG: 20	259	20	157	15.4	60.6	0.86
chr13	89951389	89951670	CpG: 23	281	23	171	16.4	60.9	0.90
chr13	90208177	90208458	CpG: 24	281	24	175	17.1	62.3	0.90
chr13	90377566	90378036	CpG: 49	470	49	329	20.9	70.0	0.85
chr13	90459140	90459370	CpG: 17	230	17	134	14.8	58.3	0.89
chr13	90496942	90497156	CpG: 17	214	17	129	15.9	60.3	0.88
chr13	90549861	90551763	CpG: 281	1902	281	1474	29.5	77.5	1.00
chr13	90600953	90601986	CpG: 99	1033	99	715	19.2	69.2	0.81
chr13	90712003	90712286	CpG: 23	283	23	174	16.3	61.5	0.87
chr13	90811862	90812135	CpG: 24	273	24	168	17.6	61.5	0.94
chr13	91064487	91064717	CpG: 20	230	20	140	17.4	60.9	0.95
chr13	91184410	91184688	CpG: 22	278	22	171	15.8	61.5	0.85
chr13	91211183	91211461	CpG: 21	278	21	170	15.1	61.2	0.82
chr13	91409345	91409632	CpG: 21	287	21	177	14.6	61.7	0.78
chr13	91499818	91500076	CpG: 21	258	21	186	16.3	72.1	0.63
chr13	91556188	91556469	CpG: 21	281	21	172	14.9	61.2	0.81
chr13	91585921	91586159	CpG: 18	238	18	139	15.1	58.4	0.91
chr13	91601398	91601628	CpG: 21	230	21	142	18.3	61.7	0.97
chr13	91652069	91652290	CpG: 18	221	18	133	16.3	60.2	0.91
chr13	91697555	91697825	CpG: 21	270	21	165	15.6	61.1	0.84
chr13	91751513	91751762	CpG: 18	249	18	143	14.5	57.4	0.89
chr13	91799136	91799376	CpG: 20	240	20	148	16.7	61.7	0.90
chr13	91862630	91862904	CpG: 24	274	24	171	17.5	62.4	0.91
chr13	91894915	91895217	CpG: 24	302	24	179	15.9	59.3	0.91
chr13	92379814	92380047	CpG: 19	233	19	140	16.3	60.1	0.92
chr13	92430948	92432580	CpG: 139	1632	139	1084	17.0	66.4	0.77
chr13	92479738	92479999	CpG: 21	261	21	161	16.1	61.7	0.85
chr13	92699947	92700178	CpG: 17	231	17	136	14.7	58.9	0.85
chr13	93301000	93301205	CpG: 17	205	17	122	16.6	59.5	0.96
chr13	93520186	93520460	CpG: 23	274	23	170	16.8	62.0	0.88
chr13	93576070	93576381	CpG: 27	311	27	194	17.4	62.4	0.90
chr13	93613076	93613321	CpG: 18	245	18	142	14.7	58.0	0.88
chr13	93752811	93753544	CpG: 64	733	64	447	17.5	61.0	0.94
chr13	93799541	93799925	CpG: 39	384	39	249	20.3	64.8	0.97
chr13	93802412	93802697	CpG: 23	285	23	178	16.1	62.5	0.84
chr13	93805072	93805827	CpG: 65	755	65	515	17.2	68.2	0.74
chr13	93905446	93906441	CpG: 73	995	73	593	14.7	59.6	0.83
chr13	93908847	93909141	CpG: 25	294	25	180	17.0	61.2	0.91
chr13	93910892	93911125	CpG: 31	233	31	167	26.6	71.7	1.04
chr13	93914403	93917302	CpG: 315	2899	315	2018	21.7	69.6	0.90
chr13	94094059	94094300	CpG: 18	241	18	144	14.9	59.8	0.87
chr13	94171137	94172231	CpG: 106	1094	106	772	19.4	70.6	0.78
chr13	94206455	94206864	CpG: 46	409	46	313	22.5	76.5	0.78
chr13	94393832	94394094	CpG: 25	262	25	165	19.1	63.0	0.97
chr13	94505584	94506535	CpG: 126	951	126	708	26.5	74.4	0.96
chr13	94638346	94638575	CpG: 17	229	17	135	14.8	59.0	0.87
chr13	94756975	94757780	CpG: 75	805	75	573	18.6	71.2	0.74
chr13	94845897	94846894	CpG: 89	997	89	689	17.9	69.1	0.75
chr13	94848434	94849350	CpG: 91	916	91	652	19.9	71.2	0.78
chr13	94850239	94850513	CpG: 20	274	20	162	14.6	59.1	0.85
chr13	94881175	94882253	CpG: 117	1078	117	762	21.7	70.7	0.87
chr13	94944948	94945376	CpG: 32	428	32	257	15.0	60.0	0.84
chr13	95050320	95050874	CpG: 38	554	38	364	13.7	65.7	0.64
chr13	95132716	95133614	CpG: 64	898	64	615	14.3	68.5	0.61
chr13	95135941	95136406	CpG: 40	465	40	346	17.2	74.4	0.62
chr13	95257182	95258277	CpG: 102	1095	102	706	18.6	64.5	0.90
chr13	95294126	95296150	CpG: 226	2024	226	1465	22.3	72.4	0.86
chr13	95356589	95356814	CpG: 16	225	16	137	14.2	60.9	0.78
chr13	95446086	95446293	CpG: 16	207	16	124	15.5	59.9	0.88
chr13	95829973	95830210	CpG: 17	237	17	137	14.3	57.8	0.90
chr13	95941435	95941716	CpG: 23	281	23	174	16.4	61.9	0.87
chr13	96198237	96198580	CpG: 36	343	36	257	21.0	74.9	0.77
chr13	96235566	96235802	CpG: 19	236	19	143	16.1	60.6	0.90
chr13	96455895	96456180	CpG: 26	285	26	180	18.2	63.2	0.93
chr13	96553017	96553432	CpG: 34	415	34	268	16.4	64.6	0.79
chr13	96580477	96580755	CpG: 24	278	24	174	17.3	62.6	0.90
chr13	96623264	96623538	CpG: 24	274	24	171	17.5	62.4	0.91
chr13	96639277	96641176	CpG: 200	1899	200	1288	21.1	67.8	0.92
chr13	96706560	96706834	CpG: 21	274	21	168	15.3	61.3	0.82
chr13	96789622	96789864	CpG: 22	242	22	149	18.2	61.6	0.98
chr13	96879406	96879800	CpG: 31	394	31	236	15.7	59.9	0.88
chr13	96936995	96937196	CpG: 16	201	16	113	15.9	56.2	1.01
chr13	97182649	97183980	CpG: 164	1331	164	1012	24.6	76.0	0.86
chr13	97190844	97191118	CpG: 24	274	24	171	17.5	62.4	0.91
chr13	97208886	97209154	CpG: 21	268	21	162	15.7	60.4	0.88
chr13	97236464	97236700	CpG: 19	236	19	144	16.1	61.0	0.89
chr13	97249391	97249669	CpG: 25	278	25	176	18.0	63.3	0.91
chr13	97270782	97271063	CpG: 23	281	23	174	16.4	61.9	0.87
chr13	97272028	97272302	CpG: 22	274	22	169	16.1	61.7	0.85
chr13	97289452	97289730	CpG: 24	278	24	173	17.3	62.2	0.91
chr13	97349217	97351060	CpG: 248	1843	248	1412	26.9	76.6	0.92
chr13	97358177	97358450	CpG: 24	273	24	170	17.6	62.3	0.92
chr13	97383678	97384680	CpG: 78	1002	78	637	15.6	63.6	0.77
chr13	97405061	97405298	CpG: 17	237	17	137	14.3	57.8	0.88
chr13	97416698	97416928	CpG: 16	230	16	135	13.9	58.7	0.82
chr13	97473003	97473273	CpG: 22	270	22	166	16.3	61.5	0.87
chr13	97516866	97517143	CpG: 23	277	23	171	16.6	61.7	0.88
chr13	97602984	97603298	CpG: 30	314	30	201	19.1	64.0	0.93
chr13	97683489	97683794	CpG: 22	305	22	194	14.4	63.6	0.72
chr13	97702737	97702985	CpG: 19	248	19	141	15.3	56.9	0.95
chr13	97784763	97786273	CpG: 207	1510	207	1210	27.4	80.1	0.85
chr13	97962157	97962800	CpG: 83	643	83	493	25.8	76.7	0.89
chr13	98152197	98152429	CpG: 16	232	16	135	13.8	58.2	0.83
chr13	98295770	98297664	CpG: 245	1894	245	1419	25.9	74.9	0.92
chr13	98322601	98322880	CpG: 25	279	25	175	17.9	62.7	0.92
chr13	98330288	98330525	CpG: 22	237	22	146	18.6	61.6	1.01
chr13	98348166	98348402	CpG: 19	236	19	146	16.1	61.9	0.86
chr13	98387446	98387712	CpG: 23	266	23	167	17.3	62.8	0.89
chr13	98410287	98411453	CpG: 115	1166	115	823	19.7	70.6	0.79
chr13	98411947	98412215	CpG: 21	268	21	164	15.7	61.2	0.85
chr13	98452469	98453250	CpG: 70	781	70	603	17.9	77.2	0.60
chr13	98457479	98457753	CpG: 25	274	25	172	18.2	62.8	0.94
chr13	98594947	98595214	CpG: 18	267	18	174	13.5	65.2	0.68
chr13	98640977	98641251	CpG: 24	274	24	172	17.5	62.8	0.90
chr13	98655533	98655768	CpG: 17	235	17	142	14.5	60.4	0.81
chr13	98666452	98666705	CpG: 18	253	18	150	14.2	59.3	0.82
chr13	98709328	98709656	CpG: 34	328	34	228	20.7	69.5	0.86
chr13	98710534	98710812	CpG: 24	278	24	170	17.3	61.2	0.93
chr13	98712004	98712777	CpG: 64	773	64	482	16.6	62.4	0.85
chr13	98817333	98817814	CpG: 65	481	65	368	27.0	76.5	0.96
chr13	98868829	98869071	CpG: 24	242	24	165	19.8	68.2	0.85
chr13	98920850	98921113	CpG: 18	263	18	161	13.7	61.2	0.74
chr13	98954901	98955171	CpG: 20	270	20	159	14.8	58.9	0.86
chr13	98981302	98981513	CpG: 16	211	16	126	15.2	59.7	0.86
chr13	99105788	99106047	CpG: 18	259	18	138	13.9	53.3	1.00
chr13	99106249	99107526	CpG: 143	1277	143	862	22.4	67.5	0.98
chr13	99166789	99168353	CpG: 126	1564	126	988	16.1	63.2	0.81
chr13	99170521	99170937	CpG: 39	416	39	273	18.8	65.6	0.87
chr13	99178901	99183005	CpG: 426	4104	426	2836	20.8	69.1	0.87
chr13	99190408	99196599	CpG: 571	6191	571	4030	18.4	65.1	0.87
chr13	99199991	99200845	CpG: 61	854	61	529	14.3	61.9	0.75
chr13	99201431	99201767	CpG: 26	336	26	220	15.5	65.5	0.75
chr13	99207975	99209043	CpG: 99	1068	99	739	18.5	69.2	0.78
chr13	99222961	99223242	CpG: 24	281	24	175	17.1	62.3	0.90
chr13	99235999	99236277	CpG: 25	278	25	174	18.0	62.6	0.93
chr13	99254993	99255263	CpG: 20	270	20	161	14.8	59.6	0.85
chr13	99302193	99303042	CpG: 82	849	82	593	19.3	69.8	0.79
chr13	99735636	99735898	CpG: 25	262	25	166	19.1	63.4	0.96
chr13	99747425	99747877	CpG: 51	452	51	322	22.6	71.2	0.89
chr13	99803718	99804255	CpG: 73	537	73	423	27.2	78.8	0.89
chr13	99805131	99805404	CpG: 19	273	19	166	13.9	60.8	0.76
chr13	99889280	99890491	CpG: 171	1211	171	947	28.2	78.2	0.92
chr13	99913437	99913653	CpG: 17	216	17	128	15.7	59.3	0.90
chr13	100190696	100191273	CpG: 48	577	48	417	16.6	72.3	0.64
chr13	100191815	100192061	CpG: 17	246	17	140	13.8	56.9	0.87
chr13	100350003	100350278	CpG: 20	275	20	167	14.5	60.7	0.80
chr13	100469699	100469965	CpG: 23	266	23	166	17.3	62.4	0.90
chr13	100494622	100494897	CpG: 24	275	24	171	17.5	62.2	0.91
chr13	100630943	100632085	CpG: 119	1142	119	822	20.8	72.0	0.81
chr13	100635156	100635382	CpG: 17	226	17	135	15.0	59.7	0.88
chr13	100641662	100641891	CpG: 22	229	22	139	19.2	60.7	1.06
chr13	100668980	100669303	CpG: 39	323	39	238	24.1	73.7	0.90
chr13	100887460	100887734	CpG: 23	274	23	172	16.8	62.8	0.86
chr13	100925088	100925369	CpG: 23	281	23	174	16.4	61.9	0.87
chr13	100953077	100953359	CpG: 23	282	23	174	16.3	61.7	0.87
chr13	101037253	101037518	CpG: 20	265	20	167	15.1	63.0	0.77
chr13	101132327	101133457	CpG: 132	1130	132	843	23.4	74.6	0.85
chr13	101223012	101223293	CpG: 23	281	23	173	16.4	61.6	0.88
chr13	101284733	101284976	CpG: 22	243	22	177	18.1	72.8	0.69
chr13	101298928	101299168	CpG: 21	240	21	145	17.5	60.4	0.98
chr13	101568549	101568815	CpG: 23	266	23	166	17.3	62.4	0.91
chr13	101610340	101610886	CpG: 60	546	60	385	22.0	70.5	0.89
chr13	101616021	101616604	CpG: 51	583	51	417	17.5	71.5	0.71
chr13	101808069	101808485	CpG: 31	416	31	257	14.9	61.8	0.80
chr13	101812469	101813648	CpG: 108	1179	108	821	18.3	69.6	0.76
chr13	101990987	101992576	CpG: 163	1589	163	1058	20.5	66.6	0.94
chr13	102016703	102019042	CpG: 226	2339	226	1562	19.3	66.8	0.87
chr13	102027992	102028202	CpG: 18	210	18	132	17.1	62.9	0.89
chr13	102063946	102064609	CpG: 56	663	56	413	16.9	62.3	0.88
chr13	102575587	102575861	CpG: 24	274	24	171	17.5	62.4	0.91
chr13	102638889	102639163	CpG: 24	274	24	171	17.5	62.4	0.91
chr13	102675321	102675551	CpG: 18	230	18	138	15.7	60.0	0.89
chr13	102675716	102675930	CpG: 15	214	15	126	14.0	58.9	0.83
chr13	102679936	102680211	CpG: 22	275	22	169	16.0	61.5	0.85
chr13	102681991	102682265	CpG: 25	274	25	172	18.2	62.8	0.93
chr13	102795137	102795403	CpG: 19	266	19	159	14.3	59.8	0.82
chr13	103088127	103088357	CpG: 20	230	20	142	17.4	61.7	0.92
chr13	103124079	103124361	CpG: 22	282	22	174	15.6	61.7	0.84
chr13	103169370	103169651	CpG: 24	281	24	175	17.1	62.3	0.90
chr13	103316319	103316581	CpG: 21	262	21	158	16.0	60.3	0.90
chr13	103480312	103480593	CpG: 24	281	24	175	17.1	62.3	0.89
chr13	103526251	103526513	CpG: 21	262	21	150	16.0	57.3	1.01
chr13	103540037	103540272	CpG: 20	235	20	142	17.0	60.4	0.96
chr13	103576584	103576823	CpG: 18	239	18	141	15.1	59.0	0.89
chr13	103688012	103688290	CpG: 23	278	23	175	16.5	62.9	0.84
chr13	104151467	104151703	CpG: 20	236	20	144	16.9	61.0	0.93
chr13	104176217	104176491	CpG: 21	274	21	169	15.3	61.7	0.82
chr13	104742426	104742702	CpG: 24	276	24	171	17.4	62.0	0.92
chr13	104902400	104902623	CpG: 20	223	20	140	17.9	62.8	0.93
chr13	105013804	105014034	CpG: 19	230	19	140	16.5	60.9	0.90
chr13	105064430	105064704	CpG: 22	274	22	170	16.1	62.0	0.84
chr13	105273231	105273505	CpG: 24	274	24	173	17.5	63.1	0.89
chr13	105286212	105286448	CpG: 23	236	23	146	19.5	61.9	1.04
chr13	105311154	105311365	CpG: 18	211	18	128	17.1	60.7	0.95
chr13	105433926	105434353	CpG: 30	427	30	256	14.1	60.0	0.79
chr13	105595961	105596193	CpG: 19	232	19	140	16.4	60.3	0.92
chr13	105642458	105642695	CpG: 17	237	17	139	14.3	58.6	0.86
chr13	105713470	105713849	CpG: 30	379	30	227	15.8	59.9	0.89
chr13	105753572	105753796	CpG: 32	224	32	173	28.6	77.2	0.96
chr13	105754530	105757086	CpG: 328	2556	328	1825	25.7	71.4	1.01
chr13	105758718	105758954	CpG: 17	236	17	135	14.4	57.2	0.89
chr13	105787628	105788732	CpG: 134	1104	134	739	24.3	66.9	1.14
chr13	105957754	105957991	CpG: 18	237	18	142	15.2	59.9	0.87
chr13	106010143	106010530	CpG: 27	387	27	228	14.0	58.9	0.81
chr13	106143600	106144684	CpG: 100	1084	100	726	18.5	67.0	0.85
chr13	106161345	106161569	CpG: 20	224	20	133	17.9	59.4	1.01
chr13	106242916	106243134	CpG: 20	218	20	138	18.3	63.3	0.94
chr13	106259444	106259710	CpG: 20	266	20	161	15.0	60.5	0.84
chr13	106288807	106289081	CpG: 23	274	23	170	16.8	62.0	0.88
chr13	106401209	106401483	CpG: 26	274	26	172	19.0	62.8	0.97
chr13	106932938	106933212	CpG: 24	274	24	169	17.5	61.7	0.94
chr13	107008189	107009313	CpG: 94	1124	94	812	16.7	72.2	0.64
chr13	107044605	107044879	CpG: 25	274	25	171	18.2	62.4	0.95
chr13	107092030	107094759	CpG: 229	2729	229	1796	16.8	65.8	0.78
chr13	107139630	107139904	CpG: 22	274	22	167	16.1	60.9	0.88
chr13	107433051	107433273	CpG: 20	222	20	135	18.0	60.8	0.98
chr13	107440861	107441118	CpG: 19	257	19	180	14.8	70.0	0.80
chr13	107444345	107445171	CpG: 90	826	90	590	21.8	71.4	0.87
chr13	107462943	107463177	CpG: 18	234	18	138	15.4	59.0	0.90
chr13	107487804	107488046	CpG: 19	242	19	142	15.7	58.7	0.94
chr13	107511053	107511326	CpG: 20	273	20	165	14.7	60.4	0.82
chr13	107658865	107659140	CpG: 24	275	24	171	17.5	62.2	0.91
chr13	107723311	107724532	CpG: 137	1221	137	864	22.4	70.8	0.90
chr13	107743894	107744204	CpG: 26	310	26	189	16.8	61.0	0.90
chr13	108025938	108026226	CpG: 25	288	25	182	17.4	63.2	0.88
chr13	108096666	108096946	CpG: 24	280	24	169	17.1	60.4	0.95
chr13	108113120	108113386	CpG: 20	266	20	160	15.0	60.2	0.84
chr13	108354717	108355000	CpG: 22	283	22	191	15.5	67.5	0.68
chr13	108367523	108368832	CpG: 142	1309	142	946	21.7	72.3	0.84
chr13	108570113	108570387	CpG: 24	274	24	171	17.5	62.4	0.91
chr13	108722421	108722655	CpG: 18	234	18	136	15.4	58.1	0.92
chr13	108777465	108777750	CpG: 22	285	22	171	15.4	60.0	0.86
chr13	108961180	108961706	CpG: 50	526	50	393	19.0	74.7	0.68
chr13	108962196	108962511	CpG: 28	315	28	228	17.8	72.4	0.76
chr13	109001344	109001629	CpG: 25	285	25	179	17.5	62.8	0.90
chr13	109010762	109016476	CpG: 715	5714	715	4240	25.0	74.2	0.91
chr13	109030838	109031114	CpG: 22	276	22	171	15.9	62.0	0.84
chr13	109098260	109098547	CpG: 23	287	23	183	16.0	63.8	0.80
chr13	109367002	109367480	CpG: 55	478	55	336	23.0	70.3	0.93
chr13	109476780	109477066	CpG: 24	286	24	191	16.8	66.8	0.76
chr13	109495440	109495841	CpG: 27	401	27	245	13.5	61.1	0.72
chr13	109536008	109537707	CpG: 190	1699	190	1216	22.4	71.6	0.87
chr13	109538041	109538260	CpG: 19	219	19	136	17.4	62.1	0.90
chr13	109654580	109654854	CpG: 23	274	23	170	16.8	62.0	0.88
chr13	109668698	109668921	CpG: 15	223	15	147	13.5	65.9	0.62
chr13	109682625	109682882	CpG: 24	257	24	163	18.7	63.4	0.95
chr13	109687221	109687775	CpG: 59	554	59	408	21.3	73.6	0.79
chr13	109742375	109742638	CpG: 23	263	23	169	17.5	64.3	0.86
chr13	109791847	109792736	CpG: 101	889	101	637	22.7	71.7	0.90
chr13	109811134	109811408	CpG: 25	274	25	172	18.2	62.8	0.94
chr13	109817993	109818278	CpG: 25	285	25	178	17.5	62.5	0.91
chr13	109836860	109837804	CpG: 70	944	70	659	14.8	69.8	0.61
chr13	109846058	109847056	CpG: 118	998	118	712	23.6	71.3	0.95
chr13	109855686	109855925	CpG: 20	239	20	149	16.7	62.3	0.86
chr13	109863465	109863854	CpG: 32	389	32	282	16.5	72.5	0.63
chr13	109868762	109869066	CpG: 22	304	22	197	14.5	64.8	0.71
chr13	109872768	109872993	CpG: 21	225	21	155	18.7	68.9	0.79
chr13	109879410	109879687	CpG: 25	277	25	179	18.1	64.6	0.88
chr13	109935951	109936765	CpG: 89	814	89	590	21.9	72.5	0.84
chr13	109942573	109946387	CpG: 374	3814	374	2571	19.6	67.4	0.88
chr13	109949367	109950027	CpG: 67	660	67	431	20.3	65.3	0.95
chr13	110042269	110044278	CpG: 163	2009	163	1322	16.2	65.8	0.78
chr13	110051354	110051743	CpG: 33	389	33	280	17.0	72.0	0.66
chr13	110104694	110104932	CpG: 28	238	28	187	23.5	78.6	0.95
chr13	110144022	110145886	CpG: 220	1864	220	1361	23.6	73.0	0.89
chr13	110220366	110220587	CpG: 21	221	21	141	19.0	63.8	0.93
chr13	110248456	110248705	CpG: 20	249	20	175	16.1	70.3	0.65
chr13	110250252	110250589	CpG: 26	337	26	215	15.4	63.8	0.76
chr13	110282304	110282521	CpG: 18	217	18	130	16.6	59.9	0.92
chr13	110296628	110297555	CpG: 74	927	74	583	16.0	62.9	0.81
chr13	110313747	110314136	CpG: 38	389	38	289	19.5	74.3	0.71
chr13	110323032	110323236	CpG: 16	204	16	130	15.7	63.7	0.78
chr13	110344399	110346026	CpG: 208	1627	208	1168	25.6	71.8	0.99
chr13	110377653	110377931	CpG: 22	278	22	172	15.8	61.9	0.84
chr13	110383225	110384118	CpG: 110	893	110	658	24.6	73.7	0.94
chr13	110436662	110436885	CpG: 18	223	18	136	16.1	61.0	0.88
chr13	110484257	110484822	CpG: 51	565	51	346	18.1	61.2	1.02
chr13	110512669	110512940	CpG: 22	271	22	187	16.2	69.0	0.78
chr13	110555689	110556278	CpG: 43	589	43	413	14.6	70.1	0.74
chr13	110633158	110633375	CpG: 15	217	15	143	13.8	65.9	0.64
chr13	110642311	110642764	CpG: 42	453	42	296	18.5	65.3	0.90
chr13	110751710	110751919	CpG: 16	209	16	127	15.3	60.8	0.84
chr13	110779848	110780529	CpG: 55	681	55	434	16.2	63.7	0.80
chr13	110791699	110791934	CpG: 20	235	20	161	17.0	68.5	0.73
chr13	110819244	110819465	CpG: 24	221	24	141	21.7	63.8	1.15
chr13	110856856	110857088	CpG: 18	232	18	140	15.5	60.3	0.87
chr13	110890325	110890696	CpG: 25	371	25	247	13.5	66.6	0.64
chr13	110902393	110902698	CpG: 29	305	29	211	19.0	69.2	0.80
chr13	110975755	110975979	CpG: 19	224	19	147	17.0	65.6	0.80
chr13	111036439	111036787	CpG: 28	348	28	232	16.1	66.7	0.73
chr13	111047359	111047579	CpG: 16	220	16	148	14.5	67.3	0.65
chr13	111051738	111052441	CpG: 57	703	57	436	16.2	62.0	0.84
chr13	111061318	111061589	CpG: 25	271	25	184	18.5	67.9	0.80
chr13	111076049	111076279	CpG: 22	230	22	142	19.1	61.7	1.02
chr13	111087587	111088201	CpG: 43	614	43	376	14.0	61.2	0.75
chr13	111136683	111137355	CpG: 53	672	53	417	15.8	62.1	0.84
chr13	111142748	111142957	CpG: 15	209	15	147	14.4	70.3	0.63
chr13	111164950	111165225	CpG: 22	275	22	184	16.0	66.9	0.72
chr13	111199940	111200715	CpG: 55	775	55	473	14.2	61.0	0.76
chr13	111208121	111208371	CpG: 21	250	21	160	16.8	64.0	0.83
chr13	111216710	111216924	CpG: 16	214	16	126	15.0	58.9	0.87
chr13	111219850	111220078	CpG: 27	228	27	173	23.7	75.9	0.85
chr13	111258530	111259463	CpG: 116	933	116	629	24.9	67.4	1.12
chr13	111280359	111280792	CpG: 42	433	42	324	19.4	74.8	0.79
chr13	111296978	111301839	CpG: 366	4861	366	2936	15.1	60.4	0.83
chr13	111304533	111306672	CpG: 161	2139	161	1324	15.1	61.9	0.79
chr13	111309738	111317592	CpG: 660	7854	660	4783	16.8	60.9	0.91
chr13	111329776	111330001	CpG: 18	225	18	136	16.0	60.4	0.89
chr13	111347239	111349746	CpG: 214	2507	214	1642	17.1	65.5	0.80
chr13	111350120	111350368	CpG: 23	248	23	160	18.5	64.5	0.90
chr13	111407303	111408636	CpG: 132	1333	132	910	19.8	68.3	0.90
chr13	111413193	111413425	CpG: 20	232	20	138	17.2	59.5	0.99
chr13	111438306	111438952	CpG: 53	646	53	404	16.4	62.5	0.84
chr13	111465504	111465893	CpG: 33	389	33	280	17.0	72.0	0.66
chr13	111484896	111485177	CpG: 22	281	22	158	15.7	56.2	1.00
chr13	111571646	111571932	CpG: 19	286	19	185	13.3	64.7	0.65
chr13	111576810	111577577	CpG: 76	767	76	522	19.8	68.1	0.86
chr13	111585654	111585928	CpG: 25	274	25	171	18.2	62.4	0.95
chr13	111589973	111590570	CpG: 59	597	59	431	19.8	72.2	0.76
chr13	111699127	111699334	CpG: 14	207	14	130	13.5	62.8	0.73
chr13	111714413	111714648	CpG: 17	235	17	163	14.5	69.4	0.60
chr13	111732917	111733144	CpG: 21	227	21	143	18.5	63.0	0.93
chr13	111795062	111795268	CpG: 25	206	25	117	24.3	56.8	1.57
chr13	111807798	111808072	CpG: 23	274	23	170	16.8	62.0	0.88
chr13	111825945	111826185	CpG: 20	240	20	147	16.7	61.2	0.91
chr13	111835076	111836338	CpG: 131	1262	131	854	20.8	67.7	0.92
chr13	111854112	111854313	CpG: 22	201	22	149	21.9	74.1	0.82
chr13	111893076	111893501	CpG: 57	425	57	293	26.8	68.9	1.51
chr13	111896817	111897051	CpG: 20	234	20	140	17.1	59.8	0.96
chr13	111926638	111926956	CpG: 30	318	30	211	18.9	66.4	0.86
chr13	111937574	111938909	CpG: 170	1335	170	1037	25.5	77.7	0.85
chr13	111939220	111939454	CpG: 20	234	20	143	17.1	61.1	0.94
chr13	111944199	111945232	CpG: 70	1033	70	687	13.6	66.5	0.61
chr13	111949579	111949816	CpG: 20	237	20	143	16.9	60.3	0.98
chr13	111950414	111950842	CpG: 29	428	29	268	13.6	62.6	0.69
chr13	111977352	111977761	CpG: 33	409	33	252	16.1	61.6	0.85
chr13	111995090	111995544	CpG: 34	454	34	273	15.0	60.1	0.83
chr13	112004084	112004292	CpG: 18	208	18	133	17.3	63.9	0.85
chr13	112004853	112005211	CpG: 34	358	34	222	19.0	62.0	1.01
chr13	112014919	112015151	CpG: 19	232	19	136	16.4	58.6	0.95
chr13	112019666	112019873	CpG: 20	207	20	144	19.3	69.6	0.81
chr13	112023891	112024107	CpG: 17	216	17	140	15.7	64.8	0.77
chr13	112024845	112025120	CpG: 20	275	20	195	14.5	70.9	0.60
chr13	112034975	112035815	CpG: 61	840	61	453	14.5	53.9	1.00
chr13	112058844	112059066	CpG: 19	222	19	139	17.1	62.6	0.89
chr13	112067088	112067333	CpG: 30	245	30	161	24.5	65.7	1.30
chr13	112068745	112069017	CpG: 25	272	25	171	18.4	62.9	0.94
chr13	112081529	112082041	CpG: 38	512	38	296	14.8	57.8	0.89
chr13	112087183	112087533	CpG: 25	350	25	218	14.3	62.3	0.74
chr13	112090082	112090500	CpG: 32	418	32	283	15.3	67.7	0.67
chr13	112092058	112092423	CpG: 30	365	30	232	16.4	63.6	0.82
chr13	112093582	112093797	CpG: 17	215	17	125	15.8	58.1	0.95
chr13	112132477	112133175	CpG: 52	698	52	459	14.9	65.8	0.72
chr13	112136011	112136219	CpG: 19	208	19	142	18.3	68.3	0.79
chr13	112144084	112144848	CpG: 87	764	87	604	22.8	79.1	0.73
chr13	112148102	112148494	CpG: 29	392	29	245	14.8	62.5	0.76
chr13	112169290	112169560	CpG: 21	270	21	165	15.6	61.1	0.84
chr13	112193534	112194284	CpG: 84	750	84	559	22.4	74.5	0.82
chr13	112218675	112219598	CpG: 107	923	107	681	23.2	73.8	0.85
chr13	112230708	112230930	CpG: 18	222	18	149	16.2	67.1	0.73
chr13	112236533	112236754	CpG: 18	221	18	145	16.3	65.6	0.77
chr13	112245139	112246397	CpG: 85	1258	85	803	13.5	63.8	0.67
chr13	112252912	112253175	CpG: 30	263	30	193	22.8	73.4	0.88
chr13	112259996	112260334	CpG: 31	338	31	236	18.3	69.8	0.76
chr13	112262783	112264126	CpG: 93	1343	93	860	13.8	64.0	0.90
chr13	112273534	112273873	CpG: 26	339	26	215	15.3	63.4	0.76
chr13	112274380	112274589	CpG: 15	209	15	143	14.4	68.4	0.64
chr13	112281089	112281555	CpG: 46	466	46	326	19.7	70.0	0.82
chr13	112283983	112284984	CpG: 68	1001	68	665	13.6	66.4	0.62
chr13	112299004	112299485	CpG: 43	481	43	311	17.9	64.7	0.95
chr13	112302153	112302973	CpG: 59	820	59	567	14.4	69.1	0.65
chr13	112312014	112312390	CpG: 28	376	28	227	14.9	60.4	0.83
chr13	112318804	112319491	CpG: 43	687	43	449	12.5	65.4	0.62
chr13	112326124	112326338	CpG: 16	214	16	143	15.0	66.8	0.67
chr13	112327975	112328405	CpG: 31	430	31	290	14.4	67.4	0.64
chr13	112339694	112339977	CpG: 23	283	23	178	16.3	62.9	0.83
chr13	112342188	112342671	CpG: 36	483	36	305	14.9	63.1	0.76
chr13	112347512	112348591	CpG: 108	1079	108	792	20.0	73.4	0.74
chr13	112352041	112352686	CpG: 42	645	42	376	13.0	58.3	0.77
chr13	112358740	112362882	CpG: 384	4142	384	3003	18.5	72.5	0.75
chr13	112369202	112369436	CpG: 21	234	21	160	17.9	68.4	0.77
chr13	112370075	112370360	CpG: 28	285	28	195	19.6	68.4	0.85
chr13	112381230	112382046	CpG: 73	816	73	537	17.9	65.8	0.83
chr13	112388332	112388606	CpG: 23	274	23	170	16.8	62.0	0.88
chr13	112395160	112395416	CpG: 21	256	21	170	16.4	66.4	0.77
chr13	112400562	112400824	CpG: 25	262	25	171	19.1	65.3	0.90
chr13	112404728	112406190	CpG: 130	1462	130	1023	17.8	70.0	0.78
chr13	112460394	112462549	CpG: 274	2155	274	1610	25.4	74.7	0.91
chr13	112468033	112468235	CpG: 16	202	16	126	15.8	62.4	0.93
chr13	112515243	112516834	CpG: 112	1591	112	901	14.1	56.6	0.88
chr13	112550052	112551343	CpG: 146	1291	146	887	22.6	68.7	0.97
chr13	112575046	112575380	CpG: 26	334	26	206	15.6	61.7	0.82
chr13	112585753	112586004	CpG: 23	251	23	154	18.3	61.4	1.18
chr13	112617292	112619723	CpG: 207	2431	207	1709	17.0	70.3	0.70
chr13	112623723	112624168	CpG: 37	445	37	289	16.6	64.9	0.79
chr13	112627913	112628142	CpG: 18	229	18	140	15.7	61.1	0.85
chr13	112649988	112650461	CpG: 57	473	57	365	24.1	77.2	0.81
chr13	112651778	112652200	CpG: 28	422	28	243	13.3	57.6	0.80
chr13	112657878	112658355	CpG: 33	477	33	292	13.8	61.2	0.74
chr13	112665580	112665977	CpG: 29	397	29	233	14.6	58.7	0.86
chr13	112666186	112666539	CpG: 28	353	28	232	15.9	65.7	0.73
chr13	112668330	112668563	CpG: 17	233	17	139	14.6	59.7	0.84
chr13	112668697	112669582	CpG: 92	885	92	616	20.8	69.6	0.96
chr13	112669900	112670190	CpG: 22	290	22	203	15.2	70.0	0.62
chr13	112687616	112687982	CpG: 33	366	33	224	18.0	61.2	0.96
chr13	112689320	112689722	CpG: 28	402	28	267	13.9	66.4	0.63
chr13	112700577	112700844	CpG: 26	267	26	164	19.5	61.4	1.06
chr13	112748983	112750153	CpG: 154	1170	154	906	26.3	77.4	0.90
chr13	112750493	112750700	CpG: 17	207	17	142	16.4	68.6	0.70
chr13	112769746	112769990	CpG: 18	244	18	155	14.8	63.5	0.74
chr13	112784548	112784936	CpG: 41	388	41	210	21.1	54.1	1.45
chr13	112790237	112790590	CpG: 33	353	33	229	18.7	64.9	0.89
chr13	112791631	112792051	CpG: 32	420	32	279	15.2	66.4	0.69
chr13	112800291	112801301	CpG: 84	1010	84	520	16.6	51.5	1.26
chr13	112802900	112803134	CpG: 17	234	17	157	14.5	67.1	0.65
chr13	112807178	112807444	CpG: 25	266	25	173	18.8	65.0	0.90
chr13	112818959	112819458	CpG: 50	499	50	350	20.0	70.1	0.94
chr13	112825044	112825387	CpG: 27	343	27	228	15.7	66.5	0.71
chr13	112843355	112844683	CpG: 194	1328	194	1060	29.2	79.8	0.92
chr13	112864960	112865334	CpG: 30	374	30	249	16.0	66.6	0.93
chr13	112884682	112885103	CpG: 33	421	33	251	15.7	59.6	0.92
chr13	112892283	112892566	CpG: 20	283	20	152	14.1	53.7	1.03
chr13	112894776	112895014	CpG: 18	238	18	153	15.1	64.3	0.73
chr13	112897303	112897638	CpG: 35	335	35	169	20.9	50.4	1.64
chr13	112907064	112907272	CpG: 21	208	21	133	20.2	63.9	1.03
chr13	112913798	112914098	CpG: 22	300	22	183	14.7	61.0	0.79
chr13	112930562	112931198	CpG: 48	636	48	415	15.1	65.3	0.72
chr13	112934604	112935791	CpG: 104	1187	104	838	17.5	70.6	0.73
chr13	112939101	112939679	CpG: 42	578	42	409	14.5	70.8	0.71
chr13	112942768	112943327	CpG: 45	559	45	298	16.1	53.3	1.42
chr13	112944532	112944883	CpG: 26	351	26	226	14.8	64.4	0.71
chr13	112961071	112961833	CpG: 82	762	82	506	21.5	66.4	1.01
chr13	112965425	112965645	CpG: 17	220	17	120	15.5	54.5	1.05
chr13	112967835	112968496	CpG: 73	661	73	490	22.1	74.1	0.83
chr13	112968702	112968957	CpG: 17	255	17	148	13.3	58.0	0.79
chr13	113004079	113004441	CpG: 28	362	28	224	15.5	61.9	0.84
chr13	113006120	113006387	CpG: 24	267	24	179	18.0	67.0	0.80
chr13	113012689	113013173	CpG: 43	484	43	329	17.8	68.0	0.77
chr13	113015414	113015805	CpG: 28	391	28	261	14.3	66.8	0.66
chr13	113021107	113021319	CpG: 16	212	16	140	15.1	66.0	0.74
chr13	113026776	113027475	CpG: 60	699	60	492	17.2	70.4	0.70
chr13	113029184	113029920	CpG: 58	736	58	461	15.8	62.6	0.80
chr13	113031873	113032300	CpG: 32	427	32	284	15.0	66.5	0.68
chr13	113032799	113033092	CpG: 24	293	24	200	16.4	68.3	0.75
chr13	113035056	113035513	CpG: 44	457	44	346	19.3	75.7	0.77
chr13	113036749	113036978	CpG: 21	229	21	142	18.3	62.0	0.98
chr13	113038937	113039147	CpG: 15	210	15	155	14.3	73.8	0.61
chr13	113040279	113040892	CpG: 46	613	46	414	15.0	67.5	0.66
chr13	113042973	113043457	CpG: 35	484	35	322	14.5	66.5	0.66
chr13	113043927	113044206	CpG: 23	279	23	178	16.5	63.8	0.81
chr13	113052583	113052821	CpG: 19	238	19	147	16.0	61.8	0.84
chr13	113053641	113053883	CpG: 19	242	19	170	15.7	70.2	0.65
chr13	113073115	113074514	CpG: 183	1399	183	1039	26.2	74.3	0.95
chr13	113075354	113075569	CpG: 16	215	16	132	14.9	61.4	0.80
chr13	113086679	113088109	CpG: 91	1430	91	942	12.7	65.9	0.84
chr13	113094248	113094469	CpG: 18	221	18	145	16.3	65.6	0.77
chr13	113094753	113095936	CpG: 95	1183	95	799	16.1	67.5	0.72
chr13	113124448	113124958	CpG: 38	510	38	288	14.9	56.5	1.07
chr13	113156961	113157175	CpG: 18	214	18	116	16.8	54.2	1.15
chr13	113166258	113167119	CpG: 69	861	69	543	16.0	63.1	1.03
chr13	113184411	113184648	CpG: 18	237	18	150	15.2	63.3	0.77
chr13	113185391	113185666	CpG: 25	275	25	184	18.2	66.9	0.81
chr13	113192433	113192684	CpG: 19	251	19	158	15.1	62.9	0.78
chr13	113205166	113205371	CpG: 15	205	15	130	14.6	63.4	0.73
chr13	113205487	113205714	CpG: 21	227	21	137	18.5	60.4	1.14
chr13	113207803	113208823	CpG: 86	1020	86	718	16.9	70.4	0.69
chr13	113219561	113219845	CpG: 21	284	21	185	14.8	65.1	0.70
chr13	113221738	113222094	CpG: 30	356	30	238	16.9	66.9	0.76
chr13	113222912	113223158	CpG: 22	246	22	169	17.9	68.7	0.76
chr13	113223720	113223929	CpG: 16	209	16	130	15.3	62.2	0.80
chr13	113224557	113224779	CpG: 20	222	20	154	18.0	69.4	0.75
chr13	113227183	113227434	CpG: 20	251	20	170	15.9	67.7	0.71
chr13	113238586	113238842	CpG: 18	256	18	171	14.1	66.8	0.88
chr13	113244213	113244449	CpG: 24	236	24	163	20.3	69.1	0.85
chr13	113246246	113247097	CpG: 83	851	83	528	19.5	62.0	1.05
chr13	113249845	113251989	CpG: 215	2144	215	1704	20.1	79.5	0.89
chr13	113255388	113255637	CpG: 21	249	21	155	16.9	62.2	0.91
chr13	113255832	113256347	CpG: 44	515	44	358	17.1	69.5	0.71
chr13	113263233	113263511	CpG: 20	278	20	171	14.4	61.5	0.77
chr13	113267336	113267674	CpG: 26	338	26	224	15.4	66.3	0.78
chr13	113269861	113270225	CpG: 42	364	42	236	23.1	64.8	1.15
chr13	113278273	113278972	CpG: 83	699	83	456	23.7	65.2	1.12
chr13	113281110	113281610	CpG: 42	500	42	258	16.8	51.6	1.27
chr13	113283436	113283990	CpG: 87	554	87	401	31.4	72.4	1.20
chr13	113284218	113284535	CpG: 26	317	26	205	16.4	64.7	0.79
chr13	113291410	113293752	CpG: 206	2342	206	1431	17.6	61.1	0.95
chr13	113293957	113294192	CpG: 17	235	17	163	14.5	69.4	0.60
chr13	113310888	113311865	CpG: 87	977	87	700	17.8	71.6	0.82
chr13	113317183	113317403	CpG: 18	220	18	146	16.4	66.4	0.74
chr13	113318484	113318875	CpG: 30	391	30	237	15.3	60.6	0.84
chr13	113320835	113322140	CpG: 104	1305	104	792	15.9	60.7	0.94
chr13	113339574	113341086	CpG: 178	1512	178	1087	23.5	71.9	0.91
chr13	113346595	113347155	CpG: 41	560	41	354	14.6	63.2	1.18
chr13	113355267	113355907	CpG: 43	640	43	441	13.4	68.9	0.65
chr13	113356986	113357203	CpG: 16	217	16	149	14.7	68.7	0.70
chr13	113369415	113369780	CpG: 41	365	41	234	22.5	64.1	1.11
chr13	113406815	113409023	CpG: 357	2208	357	1641	32.3	74.3	1.18
chr13	113443732	113444458	CpG: 76	726	76	532	20.9	73.3	0.80
chr13	113490260	113491619	CpG: 147	1359	147	919	21.6	67.6	0.95
chr13	113521580	113521800	CpG: 16	220	16	129	14.5	58.6	0.86
chr13	113523247	113523948	CpG: 107	701	107	541	30.5	77.2	1.03
chr13	113561884	113562946	CpG: 160	1062	160	789	30.1	74.3	1.10
chr14	664079	664419	CpG: 30	340	30	240	17.6	70.6	0.75
chr14	826337	827075	CpG: 54	738	54	480	14.6	65.0	0.70
chr14	829556	829787	CpG: 19	231	19	139	16.5	60.2	0.92
chr14	832543	833722	CpG: 96	1179	96	801	16.3	67.9	0.71
chr14	838283	839448	CpG: 81	1165	81	784	13.9	67.3	0.61
chr14	845964	847301	CpG: 91	1337	91	889	13.6	66.5	0.62
chr14	853456	853662	CpG: 17	206	17	140	16.5	68.0	0.73
chr14	853817	855387	CpG: 112	1570	112	1044	14.3	66.5	0.65
chr14	861211	863137	CpG: 137	1926	137	1292	14.2	67.1	0.63
chr14	902588	902802	CpG: 19	214	19	151	17.8	70.6	0.75
chr14	904139	905136	CpG: 67	997	67	634	13.4	63.6	0.68
chr14	909518	909785	CpG: 21	267	21	176	15.7	65.9	0.77
chr14	910391	911224	CpG: 75	833	75	593	18.0	71.2	0.71
chr14	923056	924064	CpG: 79	1008	79	678	15.7	67.3	0.69
chr14	933408	933618	CpG: 16	210	16	141	15.2	67.1	0.73
chr14	934250	935023	CpG: 54	773	54	527	14.0	68.2	0.61
chr14	942810	944612	CpG: 123	1802	123	1215	13.7	67.4	0.60
chr14	950515	951899	CpG: 100	1384	100	937	14.5	67.7	0.63
chr14	952664	953061	CpG: 30	397	30	251	15.1	63.2	0.76
chr14	954606	954850	CpG: 26	244	26	180	21.3	73.8	0.79
chr14	963189	963460	CpG: 22	271	22	166	16.2	61.3	0.87
chr14	1313094	1313381	CpG: 25	287	25	195	17.4	67.9	0.81
chr14	1325485	1327735	CpG: 150	2250	150	1505	13.3	66.9	0.60
chr14	1332542	1332759	CpG: 15	217	15	150	13.8	69.1	0.66
chr14	1335026	1335561	CpG: 41	535	41	359	15.3	67.1	0.69
chr14	1529275	1529762	CpG: 38	487	38	330	15.6	67.8	0.69
chr14	1623933	1624212	CpG: 25	279	25	174	17.9	62.4	0.93
chr14	1659125	1659512	CpG: 36	387	36	261	18.6	67.4	0.82
chr14	1762073	1762285	CpG: 18	212	18	124	17.0	58.5	0.99
chr14	1774114	1774415	CpG: 23	301	23	184	15.3	61.1	0.83
chr14	1858051	1858491	CpG: 30	440	30	289	13.6	65.7	0.63
chr14	2094223	2095007	CpG: 51	784	51	484	13.0	61.7	0.68
chr14	2099643	2099898	CpG: 19	255	19	132	14.9	51.8	1.12
chr14	2102274	2817857	CpG: 52872	715583	52872	416469	14.8	58.2	0.88
chr14	2834553	2834827	CpG: 25	274	25	173	18.2	63.1	0.92
chr14	2871423	2871755	CpG: 23	332	23	213	13.9	64.2	0.67
chr14	2873053	2873363	CpG: 20	310	20	196	12.9	63.2	0.65
chr14	2875960	2876279	CpG: 26	319	26	210	16.3	65.8	0.75
chr14	2880593	2880851	CpG: 26	258	26	189	20.2	73.3	0.75
chr14	2934004	2934235	CpG: 19	231	19	156	16.5	67.5	0.72
chr14	2948391	2949107	CpG: 59	716	59	478	16.5	66.8	0.77
chr14	2990751	2991107	CpG: 27	356	27	246	15.2	69.1	0.66
chr14	3104880	3105844	CpG: 74	964	74	641	15.4	66.5	0.69
chr14	3110425	3111813	CpG: 104	1388	104	944	15.0	68.0	0.65
chr14	3118732	3120634	CpG: 130	1902	130	1276	13.7	67.1	0.61
chr14	3126673	3127314	CpG: 49	641	49	450	15.3	70.2	0.62
chr14	3127641	3127846	CpG: 16	205	16	132	15.6	64.4	0.75
chr14	3133681	3135574	CpG: 132	1893	132	1259	13.9	66.5	0.63
chr14	3138149	3139187	CpG: 76	1038	76	700	14.6	67.4	0.64
chr14	3145970	3146230	CpG: 20	260	20	175	15.4	67.3	0.72
chr14	3153190	3155607	CpG: 159	2417	159	1595	13.2	66.0	0.61
chr14	3163757	3165152	CpG: 101	1395	101	937	14.5	67.2	0.64
chr14	3170482	3171737	CpG: 90	1255	90	860	14.3	68.5	0.61
chr14	3175343	3176486	CpG: 84	1143	84	765	14.7	66.9	0.66
chr14	3182709	3185327	CpG: 174	2618	174	1741	13.3	66.5	0.60
chr14	3190733	3190996	CpG: 18	263	18	179	13.7	68.1	0.64
chr14	3191364	3192042	CpG: 53	678	53	471	15.6	69.5	0.65
chr14	3192524	3192753	CpG: 20	229	20	153	17.5	66.8	0.79
chr14	3198241	3198465	CpG: 20	224	20	153	17.9	68.3	0.80
chr14	3204437	3205915	CpG: 106	1478	106	1005	14.3	68.0	0.62
chr14	3212038	3212726	CpG: 50	688	50	475	14.5	69.0	0.61
chr14	3215856	3217966	CpG: 144	2110	144	1407	13.6	66.7	0.61
chr14	3221152	3222331	CpG: 95	1179	95	812	16.1	68.9	0.68
chr14	3222917	3223212	CpG: 27	295	27	197	18.3	66.8	0.88
chr14	3228353	3228597	CpG: 17	244	17	146	13.9	59.8	0.78
chr14	3242149	3244110	CpG: 133	1961	133	1298	13.6	66.2	0.62
chr14	3253121	3255056	CpG: 135	1935	135	1312	14.0	67.8	0.61
chr14	3262061	3263571	CpG: 106	1510	106	1022	14.0	67.7	0.61
chr14	3271043	3271395	CpG: 27	352	27	236	15.3	67.0	0.75
chr14	3382884	3384036	CpG: 125	1152	125	831	21.7	72.1	0.83
chr14	3908336	3908542	CpG: 17	206	17	147	16.5	71.4	0.69
chr14	4016448	4016744	CpG: 31	296	31	215	20.9	72.6	0.79
chr14	4021014	4021430	CpG: 37	416	37	284	17.8	68.3	0.76
chr14	4085377	4085783	CpG: 33	406	33	297	16.3	73.2	0.61
chr14	4086225	4086578	CpG: 27	353	27	245	15.3	69.4	0.67
chr14	4092588	4093730	CpG: 90	1142	90	777	15.8	68.0	0.68
chr14	4094131	4094398	CpG: 21	267	21	182	15.7	68.2	0.75
chr14	4100057	4101150	CpG: 76	1093	76	729	13.9	66.7	0.63
chr14	4105707	4107501	CpG: 123	1794	123	1200	13.7	66.9	0.62
chr14	4123531	4125322	CpG: 121	1791	121	1186	13.5	66.2	0.62
chr14	4131759	4132011	CpG: 20	252	20	168	15.9	66.7	0.74
chr14	4134328	4135728	CpG: 98	1400	98	944	14.0	67.4	0.62
chr14	4144967	4146160	CpG: 89	1193	89	806	14.9	67.6	0.65
chr14	4148651	4149804	CpG: 80	1153	80	778	13.9	67.5	0.61
chr14	4150396	4150652	CpG: 22	256	22	164	17.2	64.1	0.86
chr14	4154777	4156116	CpG: 94	1339	94	889	14.0	66.4	0.64
chr14	4162043	4163120	CpG: 73	1077	73	710	13.6	65.9	0.62
chr14	4163743	4164004	CpG: 23	261	23	174	17.6	66.7	0.83
chr14	4173288	4174086	CpG: 56	798	56	525	14.0	65.8	0.65
chr14	4185361	4186209	CpG: 61	848	61	565	14.4	66.6	0.65
chr14	4192560	4193410	CpG: 67	850	67	594	15.8	69.9	0.65
chr14	4198148	4199247	CpG: 74	1099	74	730	13.5	66.4	0.61
chr14	4204009	4204790	CpG: 55	781	55	513	14.1	65.7	0.66
chr14	4217555	4217915	CpG: 31	360	31	237	17.2	65.8	0.79
chr14	4218453	4218754	CpG: 23	301	23	200	15.3	66.4	0.69
chr14	4220556	4220853	CpG: 24	297	24	197	16.2	66.3	0.78
chr14	4221499	4222556	CpG: 73	1057	73	703	13.8	66.5	0.63
chr14	4227175	4227457	CpG: 24	282	24	190	17.0	67.4	0.81
chr14	4227859	4229541	CpG: 116	1682	116	1139	13.8	67.7	0.61
chr14	4237311	4238491	CpG: 88	1180	88	789	14.9	66.9	0.67
chr14	4256623	4257500	CpG: 66	877	66	580	15.1	66.1	0.69
chr14	4258161	4258507	CpG: 30	346	30	239	17.3	69.1	0.77
chr14	4274834	4276389	CpG: 110	1555	110	1064	14.1	68.4	0.61
chr14	4280933	4281172	CpG: 17	239	17	155	14.2	64.9	0.68
chr14	4291922	4294135	CpG: 149	2213	149	1480	13.5	66.9	0.60
chr14	4365137	4365610	CpG: 44	473	44	334	18.6	70.6	0.75
chr14	4374392	4374625	CpG: 21	233	21	152	18.0	65.2	0.85
chr14	4377572	4378041	CpG: 46	469	46	323	19.6	68.9	0.83
chr14	4578216	4578490	CpG: 21	274	21	167	15.3	60.9	0.83
chr14	4586491	4586729	CpG: 22	238	22	170	18.5	71.4	0.76
chr14	4936109	4937231	CpG: 112	1122	112	802	20.0	71.5	0.78
chr14	4995900	4997351	CpG: 104	1451	104	975	14.3	67.2	0.64
chr14	5021898	5022139	CpG: 18	241	18	148	14.9	61.4	0.79
chr14	5022589	5023769	CpG: 84	1180	84	802	14.2	68.0	0.62
chr14	5030447	5030665	CpG: 17	218	17	137	15.6	62.8	0.79
chr14	5031162	5032331	CpG: 80	1169	80	786	13.7	67.2	0.61
chr14	5036058	5036273	CpG: 18	215	18	147	16.7	68.4	0.76
chr14	5041168	5041471	CpG: 24	303	24	199	15.8	65.7	0.78
chr14	5042138	5043220	CpG: 77	1082	77	725	14.2	67.0	0.63
chr14	5052164	5052761	CpG: 41	597	41	390	13.7	65.3	0.64
chr14	5058314	5060677	CpG: 167	2363	167	1581	14.1	66.9	0.64
chr14	5064822	5065093	CpG: 19	271	19	173	14.0	63.8	0.69
chr14	5065501	5066226	CpG: 50	725	50	467	13.8	64.4	0.66
chr14	5079578	5080886	CpG: 94	1308	94	883	14.4	67.5	0.63
chr14	5087254	5088256	CpG: 68	1002	68	645	13.6	64.4	0.67
chr14	5100575	5102098	CpG: 106	1523	106	1025	13.9	67.3	0.62
chr14	5130643	5131766	CpG: 86	1123	86	759	15.3	67.6	0.67
chr14	5142513	5142852	CpG: 30	339	30	224	17.7	66.1	0.81
chr14	5146420	5146680	CpG: 21	260	21	170	16.2	65.4	0.78
chr14	5147179	5148345	CpG: 80	1166	80	784	13.7	67.2	0.61
chr14	5154028	5154809	CpG: 65	781	65	543	16.6	69.5	0.69
chr14	5164980	5165775	CpG: 57	795	57	523	14.3	65.8	0.66
chr14	5173622	5174185	CpG: 39	563	39	357	13.9	63.4	0.69
chr14	5184908	5187286	CpG: 154	2378	154	1555	13.0	65.4	0.61
chr14	5197933	5199455	CpG: 103	1522	103	1012	13.5	66.5	0.61
chr14	5217652	5218837	CpG: 90	1185	90	813	15.2	68.6	0.65
chr14	5219397	5219664	CpG: 21	267	21	177	15.7	66.3	0.76
chr14	5222786	5223918	CpG: 87	1132	87	771	15.4	68.1	0.66
chr14	5224230	5224482	CpG: 18	252	18	158	14.3	62.7	0.73
chr14	5235285	5236433	CpG: 84	1148	84	779	14.6	67.9	0.63
chr14	5249684	5250619	CpG: 67	935	67	610	14.3	65.2	0.68
chr14	5256531	5257870	CpG: 95	1339	95	893	14.2	66.7	0.64
chr14	5271848	5272903	CpG: 73	1055	73	701	13.8	66.4	0.63
chr14	5299724	5300868	CpG: 84	1144	84	769	14.7	67.2	0.65
chr14	5305747	5306895	CpG: 84	1148	84	781	14.6	68.0	0.63
chr14	5317699	5317951	CpG: 18	252	18	158	14.3	62.7	0.73
chr14	5318263	5319395	CpG: 87	1132	87	771	15.4	68.1	0.66
chr14	5322517	5322784	CpG: 21	267	21	177	15.7	66.3	0.76
chr14	5323344	5324529	CpG: 90	1185	90	813	15.2	68.6	0.65
chr14	5336714	5336936	CpG: 19	222	19	148	17.1	66.7	0.81
chr14	5337437	5338996	CpG: 108	1559	108	1046	13.9	67.1	0.62
chr14	5350459	5350858	CpG: 30	399	30	258	15.0	64.7	0.72
chr14	5359948	5360158	CpG: 18	210	18	138	17.1	65.7	0.85
chr14	5362373	5362617	CpG: 19	244	19	148	15.6	60.7	0.85
chr14	5371213	5372365	CpG: 87	1152	87	776	15.1	67.4	0.67
chr14	5372615	5372959	CpG: 24	344	24	215	14.0	62.5	0.72
chr14	5381615	5382358	CpG: 57	743	57	491	15.3	66.1	0.70
chr14	5388648	5388911	CpG: 25	263	25	187	19.0	71.1	0.75
chr14	5389451	5389771	CpG: 23	320	23	224	14.4	70.0	0.65
chr14	5406426	5406672	CpG: 19	246	19	164	15.4	66.7	0.73
chr14	5411561	5411934	CpG: 29	373	29	241	15.5	64.6	0.75
chr14	5415824	5417019	CpG: 85	1195	85	805	14.2	67.4	0.63
chr14	5595526	5595821	CpG: 29	295	29	219	19.7	74.2	0.71
chr14	5670918	5671300	CpG: 28	382	28	266	14.7	69.6	0.63
chr14	5820619	5820915	CpG: 31	296	31	218	20.9	73.6	0.77
chr14	5825311	5825743	CpG: 40	432	40	296	18.5	68.5	0.79
chr14	5881693	5881943	CpG: 20	250	20	170	16.0	68.0	0.70
chr14	5997313	5997586	CpG: 31	273	31	188	22.7	68.9	1.05
chr14	6008018	6008373	CpG: 46	355	46	238	25.9	67.0	1.20
chr14	6426196	6426477	CpG: 24	281	24	173	17.1	61.6	0.92
chr14	6504573	6505469	CpG: 73	896	73	576	16.3	64.3	0.79
chr14	6562671	6563324	CpG: 46	653	46	428	14.1	65.5	0.69
chr14	6564482	6565387	CpG: 71	905	71	614	15.7	67.8	0.68
chr14	6593689	6593934	CpG: 21	245	21	177	17.1	72.2	0.68
chr14	6599967	6601402	CpG: 122	1435	122	1013	17.0	70.6	0.68
chr14	6610466	6610691	CpG: 18	225	18	136	16.0	60.4	0.90
chr14	6625028	6625294	CpG: 20	266	20	163	15.0	61.3	0.81
chr14	6677200	6677739	CpG: 39	539	39	346	14.5	64.2	0.70
chr14	6679098	6679389	CpG: 28	291	28	202	19.2	69.4	0.80
chr14	6679792	6679994	CpG: 16	202	16	119	15.8	58.9	0.92
chr14	6680206	6682186	CpG: 154	1980	154	1283	15.6	64.8	0.74
chr14	6756200	6756479	CpG: 24	279	24	173	17.2	62.0	0.91
chr14	6961656	6962178	CpG: 42	522	42	330	16.1	63.2	0.81
chr14	6962919	6987507	CpG: 1412	24588	1412	14925	11.5	60.7	0.62
chr14	7029963	7030184	CpG: 17	221	17	157	15.4	71.0	0.62
chr14	7030567	7030948	CpG: 26	381	26	253	13.6	66.4	0.66
chr14	7089018	7089302	CpG: 23	284	23	172	16.2	60.6	0.89
chr14	7092364	7093177	CpG: 118	813	118	567	29.0	69.7	1.46
chr14	7183724	7184146	CpG: 31	422	31	308	14.7	73.0	0.87
chr14	7203952	7204602	CpG: 44	650	44	430	13.5	66.2	0.62
chr14	7205452	7205881	CpG: 31	429	31	280	14.5	65.3	0.68
chr14	7218477	7219239	CpG: 60	762	60	532	15.7	69.8	0.65
chr14	7615958	7621798	CpG: 404	5840	404	3697	13.8	63.3	0.69
chr14	7631239	7631478	CpG: 17	239	17	144	14.2	60.3	0.82
chr14	7643519	7643744	CpG: 21	225	21	148	18.7	65.8	0.90
chr14	7648882	7649195	CpG: 26	313	26	212	16.6	67.7	0.79
chr14	7651132	7651487	CpG: 23	355	23	219	13.0	61.7	0.69
chr14	7730337	7731318	CpG: 81	981	81	665	16.5	67.8	0.72
chr14	7732363	7733230	CpG: 66	867	66	588	15.2	67.8	0.69
chr14	7788784	7789680	CpG: 66	896	66	568	14.7	63.4	0.73
chr14	8336694	8337444	CpG: 85	750	85	519	22.7	69.2	1.00
chr14	8364022	8364563	CpG: 69	541	69	372	25.5	68.8	1.12
chr14	8385736	8386401	CpG: 56	665	56	470	16.8	70.7	0.67
chr14	8432936	8435034	CpG: 277	2098	277	1395	26.4	66.5	1.23
chr14	8477151	8477828	CpG: 95	677	95	473	28.1	69.9	1.24
chr14	8507110	8507321	CpG: 18	211	18	125	17.1	59.2	0.99
chr14	8517265	8517557	CpG: 25	292	25	179	17.1	61.3	0.91
chr14	8548150	8548544	CpG: 70	394	70	307	35.5	77.9	1.23
chr14	8604792	8605874	CpG: 150	1082	150	749	27.7	69.2	1.28
chr14	8649551	8651564	CpG: 261	2013	261	1341	25.9	66.6	1.21
chr14	8678428	8678706	CpG: 25	278	25	175	18.0	62.9	0.92
chr14	8699251	8699850	CpG: 47	599	47	422	15.7	70.5	0.64
chr14	8720033	8722095	CpG: 269	2062	269	1396	26.1	67.7	1.20
chr14	8749993	8750870	CpG: 98	877	98	599	22.3	68.3	0.99
chr14	8771688	8771969	CpG: 24	281	24	174	17.1	61.9	0.91
chr14	8999615	8999889	CpG: 23	274	23	171	16.8	62.4	0.87
chr14	9476197	9477086	CpG: 76	889	76	580	17.1	65.2	0.81
chr14	9494608	9494878	CpG: 23	270	23	168	17.0	62.2	0.89
chr14	9531402	9531683	CpG: 23	281	23	173	16.4	61.6	0.87
chr14	9535958	9536220	CpG: 19	262	19	165	14.5	63.0	0.76
chr14	9537188	9538223	CpG: 80	1035	80	694	15.5	67.1	0.69
chr14	9645008	9645797	CpG: 52	789	52	496	13.2	62.9	0.67
chr14	9649697	9650587	CpG: 58	890	58	564	13.0	63.4	0.65
chr14	9661718	9662174	CpG: 31	456	31	258	13.6	56.6	0.87
chr14	9672780	9674771	CpG: 173	1991	173	1390	17.4	69.8	0.72
chr14	9678306	9678670	CpG: 31	364	31	260	17.0	71.4	0.69
chr14	9859184	9865049	CpG: 469	5865	469	3759	16.0	64.1	0.78
chr14	9874516	9874778	CpG: 17	262	17	153	13.0	58.4	0.79
chr14	9881059	9881272	CpG: 17	213	17	142	16.0	66.7	0.73
chr14	9882406	9882679	CpG: 20	273	20	167	14.7	61.2	0.79
chr14	9887396	9887678	CpG: 23	282	23	167	16.3	59.2	0.93
chr14	9890982	9891750	CpG: 50	768	50	488	13.0	63.5	0.65
chr14	9892222	9892532	CpG: 26	310	26	211	16.8	68.1	0.79
chr14	9893521	9893780	CpG: 18	259	18	173	13.9	66.8	0.64
chr14	9968710	9969497	CpG: 69	787	69	545	17.5	69.3	0.73
chr14	9971215	9971718	CpG: 44	503	44	333	17.5	66.2	0.80
chr14	10027324	10028134	CpG: 71	810	71	534	17.5	65.9	0.81
chr14	12792754	12793113	CpG: 26	359	26	209	14.5	58.2	0.86
chr14	12815755	12816030	CpG: 22	275	22	168	16.0	61.1	0.87
chr14	13086231	13086605	CpG: 34	374	34	249	18.2	66.6	0.83
chr14	13087134	13087816	CpG: 66	682	66	508	19.4	74.5	0.70
chr14	13130178	13130453	CpG: 26	275	26	200	18.9	72.7	0.74
chr14	13149636	13149965	CpG: 37	329	37	246	22.5	74.8	0.87
chr14	13279772	13280198	CpG: 68	426	68	290	31.9	68.1	1.38
chr14	13339681	13340290	CpG: 43	609	43	404	14.1	66.3	0.64
chr14	13350790	13351194	CpG: 33	404	33	281	16.3	69.6	0.70
chr14	13375422	13375866	CpG: 36	444	36	296	16.2	66.7	0.73
chr14	13410534	13412800	CpG: 209	2266	209	1559	18.4	68.8	0.78
chr14	13445836	13446137	CpG: 39	301	39	231	25.9	76.7	0.88
chr14	13471020	13471335	CpG: 23	315	23	205	14.6	65.1	0.69
chr14	13554966	13555281	CpG: 23	315	23	205	14.6	65.1	0.69
chr14	13580160	13580461	CpG: 41	301	41	232	27.2	77.1	0.92
chr14	13613496	13615761	CpG: 210	2265	210	1556	18.5	68.7	0.79
chr14	13650421	13650865	CpG: 37	444	37	297	16.7	66.9	0.75
chr14	13657940	13658498	CpG: 38	558	38	378	13.6	67.7	0.60
chr14	13675084	13675473	CpG: 31	389	31	271	15.9	69.7	0.69
chr14	13685931	13686605	CpG: 48	674	48	444	14.2	65.9	0.66
chr14	13746090	13746516	CpG: 68	426	68	290	31.9	68.1	1.38
chr14	13811274	13811505	CpG: 20	231	20	140	17.3	60.6	0.95
chr14	13832551	13832970	CpG: 35	419	35	298	16.7	71.1	0.67
chr14	13868284	13868610	CpG: 39	326	39	248	23.9	76.1	0.90
chr14	13887814	13888080	CpG: 28	266	28	195	21.1	73.3	0.81
chr14	14061358	14061569	CpG: 17	211	17	127	16.1	60.2	0.91
chr14	14065308	14066269	CpG: 72	961	72	654	15.0	68.1	0.65
chr14	14146552	14146830	CpG: 24	278	24	172	17.3	61.9	0.91
chr14	14430490	14430918	CpG: 31	428	31	254	14.5	59.3	0.83
chr14	14436217	14436487	CpG: 21	270	21	164	15.6	60.7	0.84
chr14	14539643	14540621	CpG: 72	978	72	584	14.7	59.7	0.83
chr14	14610319	14610520	CpG: 22	201	22	141	21.9	70.1	0.95
chr14	14632005	14632461	CpG: 37	456	37	312	16.2	68.4	0.72
chr14	14651484	14652767	CpG: 86	1283	86	735	13.4	57.3	0.83
chr14	14657901	14658452	CpG: 66	551	66	404	24.0	73.3	0.93
chr14	14666352	14666727	CpG: 33	375	33	256	17.6	68.3	0.80
chr14	14701352	14701600	CpG: 22	248	22	154	17.7	62.1	0.94
chr14	14786402	14786678	CpG: 23	276	23	172	16.7	62.3	0.87
chr14	14806830	14807049	CpG: 28	219	28	151	25.6	68.9	1.08
chr14	14820045	14820390	CpG: 27	345	27	216	15.7	62.6	0.80
chr14	14821886	14822090	CpG: 16	204	16	117	15.7	57.4	0.95
chr14	14823071	14823349	CpG: 21	278	21	165	15.1	59.4	0.88
chr14	14829798	14830003	CpG: 18	205	18	110	17.6	53.7	1.23
chr14	14850153	14850517	CpG: 27	364	27	198	14.8	54.4	1.00
chr14	14857036	14857365	CpG: 23	329	23	190	14.0	57.8	0.84
chr14	14874707	14874938	CpG: 19	231	19	141	16.5	61.0	0.90
chr14	14879772	14880175	CpG: 32	403	32	262	15.9	65.0	0.76
chr14	14881434	14881691	CpG: 24	257	24	186	18.7	72.4	0.71
chr14	14887046	14887327	CpG: 24	281	24	176	17.1	62.6	0.89
chr14	14889973	14890256	CpG: 25	283	25	177	17.7	62.5	0.91
chr14	14920499	14920813	CpG: 42	314	42	254	26.8	80.9	0.82
chr14	14926383	14926656	CpG: 21	273	21	167	15.4	61.2	0.83
chr14	14983090	14983368	CpG: 23	278	23	175	16.5	62.9	0.85
chr14	14984672	14984949	CpG: 22	277	22	167	15.9	60.3	0.88
chr14	15037334	15037582	CpG: 18	248	18	149	14.5	60.1	0.81
chr14	15084240	15084513	CpG: 21	273	21	166	15.4	60.8	0.84
chr14	15167326	15167600	CpG: 20	274	20	167	14.6	60.9	0.79
chr14	15168811	15169141	CpG: 28	330	28	224	17.0	67.9	0.74
chr14	15187100	15187405	CpG: 24	305	24	185	15.7	60.7	0.89
chr14	15187624	15187843	CpG: 16	219	16	127	14.6	58.0	0.87
chr14	15221979	15223514	CpG: 128	1535	128	1064	16.7	69.3	0.70
chr14	15265451	15265729	CpG: 26	278	26	176	18.7	63.3	0.94
chr14	15266353	15266626	CpG: 23	273	23	187	16.8	68.5	0.77
chr14	15267277	15267936	CpG: 80	659	80	491	24.3	74.5	0.89
chr14	15268982	15269316	CpG: 26	334	26	236	15.6	70.7	0.68
chr14	15287804	15290694	CpG: 227	2890	227	1933	15.7	66.9	0.70
chr14	15295514	15296082	CpG: 84	568	84	484	29.6	85.2	0.82
chr14	15301089	15301774	CpG: 63	685	63	460	18.4	67.2	0.82
chr14	15339155	15339399	CpG: 18	244	18	144	14.8	59.0	0.89
chr14	15375141	15375366	CpG: 18	225	18	139	16.0	61.8	0.85
chr14	15385378	15386315	CpG: 68	937	68	609	14.5	65.0	0.69
chr14	15466660	15467348	CpG: 50	688	50	390	14.5	56.7	0.91
chr14	15473585	15473904	CpG: 22	319	22	191	13.8	59.9	0.77
chr14	15498455	15498692	CpG: 28	237	28	174	23.6	73.4	0.88
chr14	15517790	15518056	CpG: 22	266	22	165	16.5	62.0	0.87
chr14	15580815	15581868	CpG: 81	1053	81	589	15.4	55.9	0.99
chr14	15584035	15584309	CpG: 19	274	19	167	13.9	60.9	0.76
chr14	15653473	15653799	CpG: 22	326	22	198	13.5	60.7	0.74
chr14	15674055	15675022	CpG: 69	967	69	601	14.3	62.2	0.74
chr14	15708167	15708921	CpG: 50	754	50	445	13.3	59.0	0.76
chr14	15723363	15723859	CpG: 38	496	38	347	15.3	70.0	0.68
chr14	15829737	15830003	CpG: 21	266	21	164	15.8	61.7	0.86
chr14	15840053	15840291	CpG: 20	238	20	144	16.8	60.5	0.94
chr14	15895112	15895802	CpG: 53	690	53	466	15.4	67.5	0.67
chr14	15931844	15932056	CpG: 18	212	18	128	17.0	60.4	0.94
chr14	16280681	16280961	CpG: 27	280	27	175	19.3	62.5	1.00
chr14	16308404	16308670	CpG: 27	266	27	170	20.3	63.9	1.01
chr14	16493606	16493876	CpG: 21	270	21	162	15.6	60.0	0.87
chr14	16523123	16523397	CpG: 23	274	23	169	16.8	61.7	0.89
chr14	16725578	16725852	CpG: 23	274	23	170	16.8	62.0	0.88
chr14	16786742	16787180	CpG: 39	438	39	253	17.8	57.8	1.08
chr14	16796264	16796594	CpG: 25	330	25	202	15.2	61.2	0.81
chr14	16837154	16837741	CpG: 49	587	49	431	16.7	73.4	0.62
chr14	16911314	16911601	CpG: 27	287	27	175	18.8	61.0	1.03
chr14	16964637	16965441	CpG: 57	804	57	496	14.2	61.7	0.75
chr14	17019939	17020198	CpG: 19	259	19	166	14.7	64.1	0.72
chr14	17020550	17021139	CpG: 43	589	43	379	14.6	64.3	0.71
chr14	17021871	17022140	CpG: 22	269	22	164	16.4	61.0	0.89
chr14	17022365	17022629	CpG: 18	264	18	158	13.6	59.8	0.78
chr14	17027837	17028167	CpG: 26	330	26	213	15.8	64.5	0.76
chr14	17034750	17035870	CpG: 100	1120	100	747	17.9	66.7	0.82
chr14	17043882	17044120	CpG: 20	238	20	165	16.8	69.3	0.72
chr14	17065988	17066269	CpG: 23	281	23	175	16.4	62.3	0.85
chr14	17069703	17070341	CpG: 61	638	61	466	19.1	73.0	0.72
chr14	17084589	17085253	CpG: 75	664	75	480	22.6	72.3	0.87
chr14	17116963	17117726	CpG: 51	763	51	427	13.4	56.0	0.85
chr14	17127278	17127620	CpG: 29	342	29	217	17.0	63.5	0.86
chr14	17157390	17157865	CpG: 46	475	46	332	19.4	69.9	0.79
chr14	17158025	17158340	CpG: 23	315	23	182	14.6	57.8	0.88
chr14	17181295	17183583	CpG: 208	2288	208	1581	18.2	69.1	0.76
chr14	17207333	17207838	CpG: 55	505	55	334	21.8	66.1	1.02
chr14	17210721	17210943	CpG: 31	222	31	168	27.9	75.7	0.98
chr14	17227727	17227958	CpG: 18	231	18	136	15.6	58.9	0.92
chr14	17248516	17249153	CpG: 80	637	80	485	25.1	76.1	0.87
chr14	17257891	17258770	CpG: 111	879	111	669	25.3	76.1	0.88
chr14	17259770	17260072	CpG: 28	302	28	196	18.5	64.9	1.05
chr14	17260293	17260571	CpG: 21	278	21	174	15.1	62.6	0.78
chr14	17262313	17262550	CpG: 18	237	18	143	15.2	60.3	0.85
chr14	17295413	17296159	CpG: 78	746	78	467	20.9	62.6	1.09
chr14	17404162	17404441	CpG: 25	279	25	176	17.9	63.1	0.91
chr14	17409800	17410036	CpG: 19	236	19	142	16.1	60.2	0.90
chr14	17424400	17424628	CpG: 17	228	17	135	14.9	59.2	0.87
chr14	17427321	17427564	CpG: 18	243	18	149	14.8	61.3	0.81
chr14	17431355	17431633	CpG: 22	278	22	171	15.8	61.5	0.85
chr14	17486910	17487245	CpG: 33	335	33	252	19.7	75.2	0.71
chr14	17502220	17504043	CpG: 194	1823	194	1293	21.3	70.9	0.85
chr14	17514790	17515181	CpG: 28	391	28	224	14.3	57.3	0.88
chr14	17522019	17523128	CpG: 105	1109	105	757	18.9	68.3	0.84
chr14	17530042	17530327	CpG: 24	285	24	180	16.8	63.2	0.86
chr14	17547693	17547917	CpG: 18	224	18	157	16.1	70.1	0.66
chr14	17552894	17553913	CpG: 92	1019	92	727	18.1	71.3	0.71
chr14	17566242	17567754	CpG: 144	1512	144	1098	19.0	72.6	0.72
chr14	17591163	17591459	CpG: 31	296	31	202	20.9	68.2	0.93
chr14	17620939	17621235	CpG: 31	296	31	202	20.9	68.2	0.93
chr14	17669758	17669962	CpG: 17	204	17	122	16.7	59.8	0.93
chr14	17751355	17752494	CpG: 87	1139	87	741	15.3	65.1	0.76
chr14	17756356	17756927	CpG: 51	571	51	384	17.9	67.3	0.79
chr14	17767742	17768437	CpG: 51	695	51	450	14.7	64.7	0.74
chr14	17771000	17771239	CpG: 18	239	18	141	15.1	59.0	0.89
chr14	17776246	17778287	CpG: 207	2041	207	1455	20.3	71.3	0.80
chr14	17906733	17907007	CpG: 24	274	24	170	17.5	62.0	0.92
chr14	17947518	17947792	CpG: 25	274	25	172	18.2	62.8	0.94
chr14	18092165	18092557	CpG: 30	392	30	279	15.3	71.2	0.61
chr14	18153893	18154264	CpG: 32	371	32	258	17.3	69.5	0.72
chr14	18170035	18170573	CpG: 53	538	53	375	19.7	69.7	0.81
chr14	18194319	18194555	CpG: 22	236	22	171	18.6	72.5	0.72
chr14	18210497	18211035	CpG: 52	538	52	376	19.3	69.9	0.79
chr14	18234521	18234906	CpG: 34	385	34	275	17.7	71.4	0.70
chr14	18250097	18250952	CpG: 94	855	94	632	22.0	73.9	0.81
chr14	18279424	18280255	CpG: 92	831	92	603	22.1	72.6	0.85
chr14	18292361	18292991	CpG: 57	630	57	463	18.1	73.5	0.67
chr14	18312372	18313347	CpG: 79	975	79	598	16.2	61.3	0.87
chr14	18330596	18330798	CpG: 16	202	16	142	15.8	70.3	0.64
chr14	18334184	18334862	CpG: 72	678	72	513	21.2	75.7	0.75
chr14	18339506	18340258	CpG: 69	752	69	489	18.4	65.0	0.88
chr14	18345422	18346215	CpG: 66	793	66	542	16.6	68.3	0.72
chr14	18357115	18357337	CpG: 16	222	16	131	14.4	59.0	0.84
chr14	18369833	18371321	CpG: 102	1488	102	926	13.7	62.2	0.71
chr14	18386659	18387325	CpG: 61	666	61	443	18.3	66.5	0.84
chr14	18391995	18392209	CpG: 16	214	16	130	15.0	60.7	0.83
chr14	18393544	18394611	CpG: 103	1067	103	731	19.3	68.5	0.82
chr14	18403666	18403944	CpG: 24	278	24	174	17.3	62.6	0.89
chr14	18411572	18412005	CpG: 39	433	39	294	18.0	67.9	0.82
chr14	18430813	18431159	CpG: 28	346	28	203	16.2	58.7	0.94
chr14	18440537	18441447	CpG: 81	910	81	578	17.8	63.5	0.88
chr14	18442546	18442806	CpG: 22	260	22	162	16.9	62.3	0.88
chr14	18469704	18470082	CpG: 51	378	51	281	27.0	74.3	0.98
chr14	18497758	18498502	CpG: 73	744	73	498	19.6	66.9	0.88
chr14	18509011	18510069	CpG: 108	1058	108	758	20.4	71.6	0.80
chr14	18514276	18514998	CpG: 76	722	76	504	21.1	69.8	0.86
chr14	18530095	18530330	CpG: 20	235	20	159	17.0	67.7	0.74
chr14	18530818	18531291	CpG: 47	473	47	329	19.9	69.6	0.82
chr14	18532066	18532298	CpG: 24	232	24	164	20.7	70.7	0.83
chr14	18532817	18533492	CpG: 59	675	59	478	17.5	70.8	0.70
chr14	18537774	18538131	CpG: 32	357	32	235	17.9	65.8	0.83
chr14	18565359	18565769	CpG: 39	410	39	286	19.0	69.8	0.78
chr14	18567420	18567872	CpG: 44	452	44	345	19.5	76.3	0.67
chr14	18568316	18568542	CpG: 17	226	17	160	15.0	70.8	0.61
chr14	18590532	18590806	CpG: 26	274	26	174	19.0	63.5	0.95
chr14	18597706	18598133	CpG: 44	427	44	306	20.6	71.7	0.82
chr14	18628314	18629014	CpG: 72	700	72	510	20.6	72.9	0.79
chr14	18640937	18641645	CpG: 54	708	54	440	15.3	62.1	0.81
chr14	18642665	18642939	CpG: 25	274	25	171	18.2	62.4	0.94
chr14	18767736	18768010	CpG: 22	274	22	168	16.1	61.3	0.86
chr14	18801117	18801387	CpG: 22	270	22	160	16.3	59.3	0.95
chr14	18819090	18819364	CpG: 25	274	25	171	18.2	62.4	0.94
chr14	19080307	19080585	CpG: 26	278	26	176	18.7	63.3	0.94
chr14	19129044	19129329	CpG: 23	285	23	177	16.1	62.1	0.85
chr14	19247461	19248649	CpG: 127	1188	127	838	21.4	70.5	0.86
chr14	19323141	19323415	CpG: 24	274	24	171	17.5	62.4	0.91
chr14	19433122	19433391	CpG: 22	269	22	168	16.4	62.5	0.85
chr14	19451866	19452110	CpG: 17	244	17	144	13.9	59.0	0.82
chr14	19713388	19713662	CpG: 22	274	22	168	16.1	61.3	0.86
chr14	19804516	19804792	CpG: 21	276	21	170	15.2	61.6	0.82
chr14	19876201	19876480	CpG: 25	279	25	176	17.9	63.1	0.91
chr14	20402993	20403308	CpG: 30	315	30	201	19.0	63.8	0.94
chr14	20581573	20581854	CpG: 23	281	23	175	16.4	62.3	0.86
chr14	20727866	20728096	CpG: 17	230	17	135	14.8	58.7	0.88
chr14	20795001	20795266	CpG: 27	265	27	203	20.4	76.6	0.82
chr14	20795710	20796399	CpG: 82	689	82	499	23.8	72.4	0.98
chr14	20832708	20833064	CpG: 30	356	30	222	16.9	62.4	0.87
chr14	20876875	20877082	CpG: 17	207	17	123	16.4	59.4	0.93
chr14	20949991	20950269	CpG: 23	278	23	175	16.5	62.9	0.85
chr14	20997598	20997880	CpG: 22	282	22	168	15.6	59.6	0.89
chr14	21041266	21041541	CpG: 24	275	24	173	17.5	62.9	0.88
chr14	21048279	21048560	CpG: 24	281	24	175	17.1	62.3	0.90
chr14	21052574	21052852	CpG: 22	278	22	172	15.8	61.9	0.84
chr14	21231600	21231878	CpG: 25	278	25	175	18.0	62.9	0.92
chr14	21628802	21629088	CpG: 23	286	23	178	16.1	62.2	0.84
chr14	21673089	21673351	CpG: 20	262	20	161	15.3	61.5	0.83
chr14	21739213	21739453	CpG: 18	240	18	142	15.0	59.2	0.88
chr14	21871197	21871440	CpG: 21	243	21	146	17.3	60.1	0.96
chr14	21995128	21995368	CpG: 23	240	23	148	19.2	61.7	1.04
chr14	22008446	22008650	CpG: 15	204	15	121	14.7	59.3	0.86
chr14	22043239	22043842	CpG: 57	603	57	447	18.9	74.1	0.69
chr14	22182643	22182916	CpG: 23	273	23	170	16.8	62.3	0.89
chr14	22309397	22309619	CpG: 16	222	16	132	14.4	59.5	0.83
chr14	22386450	22386706	CpG: 22	256	22	156	17.2	60.9	0.93
chr14	22475712	22475949	CpG: 20	237	20	144	16.9	60.8	0.94
chr14	22948608	22948849	CpG: 21	241	21	149	17.4	61.8	0.93
chr14	22963616	22966559	CpG: 283	2943	283	1942	19.2	66.0	0.89
chr14	22972130	22972490	CpG: 34	360	34	226	18.9	62.8	1.01
chr14	22976050	22976350	CpG: 23	300	23	157	15.3	52.3	1.12
chr14	22983091	22983795	CpG: 60	704	60	448	17.0	63.6	0.86
chr14	22990222	22990503	CpG: 24	281	24	175	17.1	62.3	0.90
chr14	23028061	23028329	CpG: 22	268	22	163	16.4	60.8	0.90
chr14	23244110	23244388	CpG: 23	278	23	171	16.5	61.5	0.89
chr14	23538457	23538731	CpG: 19	274	19	163	13.9	59.5	0.80
chr14	23755881	23756145	CpG: 19	264	19	159	14.4	60.2	0.81
chr14	23935074	23935359	CpG: 24	285	24	179	16.8	62.8	0.87
chr14	24124879	24126089	CpG: 147	1210	147	901	24.3	74.5	0.90
chr14	24205812	24206093	CpG: 23	281	23	174	16.4	61.9	0.87
chr14	24561390	24561816	CpG: 32	426	32	257	15.0	60.3	0.83
chr14	24611528	24611764	CpG: 20	236	20	144	16.9	61.0	0.93
chr14	24671994	24672237	CpG: 25	243	25	150	20.6	61.7	1.08
chr14	24736430	24736711	CpG: 23	281	23	172	16.4	61.2	0.89
chr14	24756746	24757425	CpG: 59	679	59	423	17.4	62.3	0.90
chr14	24888208	24888652	CpG: 33	444	33	266	14.9	59.9	0.83
chr14	25071636	25073038	CpG: 139	1402	139	1011	19.8	72.1	0.76
chr14	25172616	25172895	CpG: 25	279	25	176	17.9	63.1	0.91
chr14	25223421	25224683	CpG: 113	1262	113	876	17.9	69.4	0.74
chr14	25237426	25237717	CpG: 27	291	27	180	18.6	61.9	0.98
chr14	25280424	25280698	CpG: 21	274	21	169	15.3	61.7	0.82
chr14	25404643	25406208	CpG: 183	1565	183	1121	23.4	71.6	0.91
chr14	25411911	25412185	CpG: 25	274	25	172	18.2	62.8	0.93
chr14	25436211	25436433	CpG: 16	222	16	126	14.4	56.8	0.91
chr14	25606455	25606685	CpG: 19	230	19	140	16.5	60.9	0.90
chr14	25617604	25618460	CpG: 87	856	87	587	20.3	68.6	0.87
chr14	25654644	25655194	CpG: 61	550	61	375	22.2	68.2	0.95
chr14	25724489	25724846	CpG: 35	357	35	258	19.6	72.3	0.75
chr14	26134391	26134665	CpG: 24	274	24	172	17.5	62.8	0.90
chr14	26177973	26178247	CpG: 22	274	22	166	16.1	60.6	0.88
chr14	26230112	26230347	CpG: 21	235	21	143	17.9	60.9	0.99
chr14	26273693	26275558	CpG: 190	1865	190	1257	20.4	67.4	0.95
chr14	26325262	26325806	CpG: 41	544	41	380	15.1	69.9	0.62
chr14	26398838	26399974	CpG: 83	1136	83	670	14.6	59.0	0.84
chr14	26400787	26401336	CpG: 49	549	49	337	17.9	61.4	0.95
chr14	26490237	26490518	CpG: 23	281	23	174	16.4	61.9	0.87
chr14	26651410	26651639	CpG: 21	229	21	143	18.3	62.4	0.97
chr14	27034752	27035028	CpG: 22	276	22	172	15.9	62.3	0.83
chr14	27129785	27131944	CpG: 179	2159	179	1418	16.6	65.7	0.77
chr14	27135542	27136946	CpG: 183	1404	183	1054	26.1	75.1	0.92
chr14	27186354	27186625	CpG: 25	271	25	173	18.5	63.8	0.91
chr14	27219399	27219670	CpG: 21	271	21	167	15.5	61.6	0.83
chr14	27248005	27248286	CpG: 23	281	23	173	16.4	61.6	0.88
chr14	27443462	27443703	CpG: 18	241	18	147	14.9	61.0	0.82
chr14	27643474	27643755	CpG: 24	281	24	175	17.1	62.3	0.90
chr14	27986974	27987249	CpG: 22	275	22	169	16.0	61.5	0.86
chr14	27997059	27998593	CpG: 173	1534	173	1052	22.6	68.6	0.96
chr14	28062396	28062674	CpG: 22	278	22	172	15.8	61.9	0.84
chr14	28093284	28093568	CpG: 26	284	26	179	18.3	63.0	0.94
chr14	28147521	28148451	CpG: 98	930	98	640	21.1	68.8	0.89
chr14	28157545	28157765	CpG: 16	220	16	136	14.5	61.8	0.77
chr14	28170330	28170619	CpG: 24	289	24	176	16.6	60.9	0.91
chr14	28181457	28182162	CpG: 55	705	55	487	15.6	69.1	0.65
chr14	28221343	28221628	CpG: 25	285	25	178	17.5	62.5	0.91
chr14	28258227	28259066	CpG: 93	839	93	593	22.2	70.7	0.89
chr14	28277025	28277525	CpG: 44	500	44	366	17.6	73.2	0.66
chr14	28444507	28444724	CpG: 16	217	16	130	14.7	59.9	0.86
chr14	28538404	28538685	CpG: 22	281	22	172	15.7	61.2	0.85
chr14	28610267	28610608	CpG: 26	341	26	220	15.2	64.5	0.73
chr14	28650257	28650474	CpG: 18	217	18	132	16.6	60.8	0.91
chr14	28660696	28661395	CpG: 100	699	100	553	28.6	79.1	0.96
chr14	28674372	28675128	CpG: 59	756	59	523	15.6	69.2	0.65
chr14	28722019	28722286	CpG: 19	267	19	163	14.2	61.0	0.78
chr14	28738075	28738914	CpG: 69	839	69	520	16.4	62.0	0.86
chr14	28741148	28741418	CpG: 18	270	18	155	13.3	57.4	0.83
chr14	28743649	28743937	CpG: 21	288	21	166	14.6	57.6	0.89
chr14	28745117	28745883	CpG: 67	766	67	471	17.5	61.5	0.94
chr14	28746326	28746565	CpG: 20	239	20	141	16.7	59.0	0.97
chr14	28747920	28748505	CpG: 42	585	42	339	14.4	57.9	0.87
chr14	28751333	28751572	CpG: 20	239	20	141	16.7	59.0	0.97
chr14	28752015	28752781	CpG: 67	766	67	470	17.5	61.4	0.95
chr14	28753955	28754243	CpG: 21	288	21	166	14.6	57.6	0.89
chr14	28756474	28756744	CpG: 18	270	18	155	13.3	57.4	0.83
chr14	28761192	28761396	CpG: 16	204	16	123	15.7	60.3	0.87
chr14	28823196	28823474	CpG: 20	278	20	167	14.4	60.1	0.81
chr14	28825513	28826297	CpG: 86	784	86	560	21.9	71.4	0.88
chr14	28844056	28844322	CpG: 22	266	22	164	16.5	61.7	0.89
chr14	28901384	28903515	CpG: 198	2131	198	1664	18.6	78.1	0.61
chr14	28913350	28914160	CpG: 90	810	90	596	22.2	73.6	0.82
chr14	29035268	29035542	CpG: 25	274	25	172	18.2	62.8	0.94
chr14	29043079	29043357	CpG: 26	278	26	175	18.7	62.9	0.96
chr14	29072803	29074486	CpG: 204	1683	204	1217	24.2	72.3	0.94
chr14	29107138	29107405	CpG: 20	267	20	161	15.0	60.3	0.83
chr14	29134640	29134878	CpG: 19	238	19	140	16.0	58.8	0.96
chr14	29178646	29178861	CpG: 16	215	16	131	14.9	60.9	0.81
chr14	29181157	29182067	CpG: 65	910	65	539	14.3	59.2	0.81
chr14	29241101	29241381	CpG: 23	280	23	177	16.4	63.2	0.84
chr14	29243013	29243686	CpG: 77	673	77	484	22.9	71.9	0.89
chr14	29274427	29274708	CpG: 24	281	24	180	17.1	64.1	0.85
chr14	29289891	29290101	CpG: 17	210	17	123	16.2	58.6	0.97
chr14	29316826	29317089	CpG: 20	263	20	162	15.2	61.6	0.83
chr14	29317227	29317499	CpG: 22	272	22	164	16.2	60.3	0.89
chr14	29318874	29319751	CpG: 64	877	64	493	14.6	56.2	0.93
chr14	29336477	29336714	CpG: 20	237	20	144	16.9	60.8	0.95
chr14	29340031	29340763	CpG: 61	732	61	506	16.7	69.1	0.70
chr14	29478848	29479132	CpG: 21	284	21	170	14.8	59.9	0.84
chr14	29479802	29480256	CpG: 31	454	31	278	13.7	61.2	0.73
chr14	29556667	29557056	CpG: 32	389	32	254	16.5	65.3	0.77
chr14	29591552	29592495	CpG: 120	943	120	717	25.5	76.0	0.88
chr14	29721118	29723533	CpG: 262	2415	262	1700	21.7	70.4	0.88
chr14	29742132	29742368	CpG: 21	236	21	145	17.8	61.4	0.96
chr14	29996307	29997149	CpG: 72	842	72	562	17.1	66.7	0.77
chr14	30012262	30014686	CpG: 166	2424	166	1500	13.7	61.9	0.72
chr14	30061690	30061964	CpG: 23	274	23	174	16.8	63.5	0.84
chr14	30072565	30072981	CpG: 35	416	35	269	16.8	64.7	0.80
chr14	30135912	30136409	CpG: 35	497	35	299	14.1	60.2	0.85
chr14	30136938	30137759	CpG: 57	821	57	496	13.9	60.4	0.84
chr14	30278756	30279015	CpG: 19	259	19	156	14.7	60.2	0.82
chr14	30629609	30629846	CpG: 19	237	19	143	16.0	60.3	0.90
chr14	30693264	30693835	CpG: 62	571	62	407	21.7	71.3	0.85
chr14	30694643	30695520	CpG: 69	877	69	595	15.7	67.8	0.69
chr14	30697618	30698096	CpG: 44	478	44	327	18.4	68.4	0.84
chr14	30703507	30703805	CpG: 22	298	22	174	14.8	58.4	0.87
chr14	30706432	30710654	CpG: 338	4222	338	2791	16.0	66.1	0.73
chr14	30710951	30711287	CpG: 29	336	29	219	17.3	65.2	0.81
chr14	30711672	30712566	CpG: 62	894	62	561	13.9	62.8	0.72
chr14	30713566	30714566	CpG: 70	1000	70	616	14.0	61.6	0.74
chr14	30769465	30772035	CpG: 226	2570	226	1681	17.6	65.4	0.82
chr14	30772669	30772970	CpG: 22	301	22	202	14.6	67.1	0.65
chr14	30773266	30773822	CpG: 45	556	45	333	16.2	59.9	0.90
chr14	30836300	30837740	CpG: 130	1440	130	966	18.1	67.1	0.80
chr14	30845334	30845776	CpG: 39	442	39	278	17.6	62.9	0.90
chr14	30846901	30848389	CpG: 110	1488	110	955	14.8	64.2	0.72
chr14	30851296	30852900	CpG: 126	1604	126	999	15.7	62.3	0.81
chr14	30855615	30856450	CpG: 75	835	75	581	18.0	69.6	0.75
chr14	30920335	30920571	CpG: 19	236	19	143	16.1	60.6	0.88
chr14	31245661	31245930	CpG: 20	269	20	167	14.9	62.1	0.78
chr14	31275283	31275494	CpG: 16	211	16	128	15.2	60.7	0.83
chr14	31326431	31326690	CpG: 19	259	19	159	14.7	61.4	0.79
chr14	31361460	31362107	CpG: 61	647	61	415	18.9	64.1	0.92
chr14	31386910	31387717	CpG: 71	807	71	487	17.6	60.3	0.97
chr14	31640934	31641171	CpG: 21	237	21	144	17.7	60.8	0.99
chr14	31772571	31774093	CpG: 123	1522	123	1008	16.2	66.2	0.75
chr14	31776949	31777728	CpG: 65	779	65	514	16.7	66.0	0.77
chr14	31780768	31782046	CpG: 122	1278	122	875	19.1	68.5	0.82
chr14	31783590	31785589	CpG: 182	1999	182	1319	18.2	66.0	0.84
chr14	31787368	31789129	CpG: 126	1761	126	1101	14.3	62.5	0.73
chr14	31800157	31800596	CpG: 48	439	48	308	21.9	70.2	0.92
chr14	31811360	31812097	CpG: 84	737	84	517	22.8	70.1	0.93
chr14	31961524	31961759	CpG: 21	235	21	141	17.9	60.0	0.99
chr14	32079491	32079728	CpG: 20	237	20	143	16.9	60.3	0.96
chr14	32112563	32112837	CpG: 22	274	22	169	16.1	61.7	0.85
chr14	32363056	32363330	CpG: 25	274	25	170	18.2	62.0	0.96
chr14	32396648	32397281	CpG: 43	633	43	365	13.6	57.7	0.82
chr14	32397739	32400431	CpG: 186	2692	186	1658	13.8	61.6	0.73
chr14	32443739	32445022	CpG: 119	1283	119	879	18.6	68.5	0.79
chr14	32487913	32488181	CpG: 21	268	21	161	15.7	60.1	0.87
chr14	32550910	32551144	CpG: 18	234	18	141	15.4	60.3	0.87
chr14	32552427	32552712	CpG: 24	285	24	178	16.8	62.5	0.88
chr14	32561950	32562224	CpG: 23	274	23	172	16.8	62.8	0.87
chr14	32636206	32636442	CpG: 17	236	17	141	14.4	59.7	0.83
chr14	32731281	32731518	CpG: 17	237	17	141	14.3	59.5	0.82
chr14	32737452	32737727	CpG: 24	275	24	170	17.5	61.8	0.92
chr14	33020051	33020285	CpG: 17	234	17	140	14.5	59.8	0.83
chr14	33137930	33138204	CpG: 24	274	24	171	17.5	62.4	0.91
chr14	33206006	33206231	CpG: 19	225	19	132	16.9	58.7	0.98
chr14	33238525	33238737	CpG: 16	212	16	122	15.1	57.5	0.94
chr14	33291510	33292176	CpG: 63	666	63	485	18.9	72.8	0.71
chr14	33301514	33301791	CpG: 22	277	22	169	15.9	61.0	0.87
chr14	33302931	33303174	CpG: 22	243	22	148	18.1	60.9	0.99
chr14	33358841	33359472	CpG: 45	631	45	375	14.3	59.4	0.81
chr14	33363821	33364499	CpG: 59	678	59	441	17.4	65.0	0.83
chr14	33383131	33383372	CpG: 21	241	21	151	17.4	62.7	0.91
chr14	33455261	33456361	CpG: 108	1100	108	748	19.6	68.0	0.86
chr14	33623085	33624610	CpG: 158	1525	158	1032	20.7	67.7	0.91
chr14	33635699	33635958	CpG: 19	259	19	156	14.7	60.2	0.81
chr14	33794053	33794277	CpG: 19	224	19	136	17.0	60.7	0.94
chr14	33942021	33942294	CpG: 20	273	20	166	14.7	60.8	0.80
chr14	34033612	34033892	CpG: 26	280	26	175	18.6	62.5	0.96
chr14	34056463	34056699	CpG: 17	236	17	142	14.4	60.2	0.82
chr14	34191366	34191640	CpG: 24	274	24	177	17.5	64.6	0.85
chr14	34407529	34407787	CpG: 21	258	21	185	16.3	71.7	0.65
chr14	34645905	34646186	CpG: 23	281	23	174	16.4	61.9	0.87
chr14	34820140	34820564	CpG: 41	424	41	312	19.3	73.6	0.72
chr14	34831831	34832105	CpG: 21	274	21	167	15.3	60.9	0.84
chr14	35145352	35145680	CpG: 28	328	28	196	17.1	59.8	0.96
chr14	35345035	35345599	CpG: 56	564	56	416	19.9	73.8	0.73
chr14	35366045	35366321	CpG: 22	276	22	168	15.9	60.9	0.87
chr14	35405857	35406076	CpG: 18	219	18	127	16.4	58.0	0.98
chr14	35611185	35611463	CpG: 24	278	24	174	17.3	62.6	0.89
chr14	35745557	35745793	CpG: 21	236	21	145	17.8	61.4	0.96
chr14	35788539	35788867	CpG: 25	328	25	197	15.2	60.1	0.92
chr14	35797422	35799241	CpG: 145	1819	145	1090	15.9	59.9	0.89
chr14	35880395	35880632	CpG: 21	237	21	144	17.7	60.8	0.99
chr14	35955848	35956085	CpG: 19	237	19	142	16.0	59.9	0.92
chr14	36047476	36047738	CpG: 25	262	25	165	19.1	63.0	0.98
chr14	36081202	36081476	CpG: 21	274	21	168	15.3	61.3	0.82
chr14	36207936	36208212	CpG: 21	276	21	170	15.2	61.6	0.81
chr14	36304333	36304797	CpG: 56	464	56	356	24.1	76.7	0.82
chr14	36372481	36372759	CpG: 25	278	25	175	18.0	62.9	0.92
chr14	36510385	36510613	CpG: 19	228	19	135	16.7	59.2	0.96
chr14	36552386	36552642	CpG: 20	256	20	153	15.6	59.8	0.89
chr14	36636356	36636622	CpG: 18	266	18	153	13.5	57.5	0.83
chr14	36673227	36673609	CpG: 35	382	35	277	18.3	72.5	0.70
chr14	36916705	36916939	CpG: 19	234	19	140	16.2	59.8	0.93
chr14	37289176	37289431	CpG: 18	255	18	150	14.1	58.8	0.83
chr14	37534670	37534945	CpG: 23	275	23	169	16.7	61.5	0.89
chr14	37580077	37580374	CpG: 26	297	26	187	17.5	63.0	0.90
chr14	37723702	37724099	CpG: 31	397	31	282	15.6	71.0	0.62
chr14	37750340	37750621	CpG: 24	281	24	173	17.1	61.6	0.92
chr14	37757121	37757394	CpG: 21	273	21	165	15.4	60.4	0.84
chr14	37811492	37811769	CpG: 23	277	23	170	16.6	61.4	0.89
chr14	37854396	37854626	CpG: 17	230	17	136	14.8	59.1	0.86
chr14	38003191	38003462	CpG: 19	271	19	165	14.0	60.9	0.78
chr14	38347173	38347408	CpG: 20	235	20	145	17.0	61.7	0.91
chr14	38557303	38557576	CpG: 23	273	23	173	16.8	63.4	0.85
chr14	38575662	38576003	CpG: 28	341	28	247	16.4	72.4	0.63
chr14	38576606	38576821	CpG: 17	215	17	122	15.8	56.7	1.02
chr14	38792881	38793591	CpG: 58	710	58	508	16.3	71.5	0.64
chr14	38902616	38902858	CpG: 21	242	21	147	17.4	60.7	0.94
chr14	38919812	38920013	CpG: 16	201	16	117	15.9	58.2	0.95
chr14	38990392	38990942	CpG: 55	550	55	428	20.0	77.8	0.69
chr14	39079428	39079751	CpG: 22	323	22	181	13.6	56.0	0.87
chr14	39089143	39089864	CpG: 82	721	82	520	22.7	72.1	0.89
chr14	39103948	39104543	CpG: 73	595	73	449	24.5	75.5	0.86
chr14	39154439	39154926	CpG: 33	487	33	300	13.6	61.6	0.71
chr14	39160334	39160559	CpG: 19	225	19	141	16.9	62.7	0.88
chr14	39272460	39272853	CpG: 39	393	39	294	19.8	74.8	0.71
chr14	39275970	39276230	CpG: 32	260	32	195	24.6	75.0	0.90
chr14	39326182	39326715	CpG: 46	533	46	348	17.3	65.3	0.81
chr14	39327778	39328284	CpG: 40	506	40	292	15.8	57.7	0.96
chr14	39337792	39338028	CpG: 21	236	21	145	17.8	61.4	0.96
chr14	39442752	39443004	CpG: 20	252	20	144	15.9	57.1	0.99
chr14	39444955	39445609	CpG: 70	654	70	427	21.4	65.3	1.00
chr14	39611237	39611513	CpG: 23	276	23	170	16.7	61.6	0.89
chr14	39797060	39797299	CpG: 21	239	21	141	17.6	59.0	1.03
chr14	39827254	39828422	CpG: 99	1168	99	880	17.0	75.3	0.60
chr14	39896325	39896601	CpG: 23	276	23	170	16.7	61.6	0.89
chr14	40081342	40081738	CpG: 30	396	30	234	15.2	59.1	0.88
chr14	40594272	40594546	CpG: 21	274	21	170	15.3	62.0	0.81
chr14	40780942	40781220	CpG: 24	278	24	174	17.3	62.6	0.89
chr14	40847477	40847721	CpG: 18	244	18	144	14.8	59.0	0.87
chr14	40850481	40850772	CpG: 30	291	30	171	20.6	58.8	1.19
chr14	41019122	41019555	CpG: 46	433	46	319	21.2	73.7	0.78
chr14	41043859	41044076	CpG: 17	217	17	126	15.7	58.1	0.95
chr14	41117711	41117948	CpG: 20	237	20	142	16.9	59.9	0.96
chr14	41163841	41164107	CpG: 24	266	24	169	18.0	63.5	0.91
chr14	41218400	41218670	CpG: 25	270	25	163	18.5	60.4	1.03
chr14	41273158	41273391	CpG: 20	233	20	140	17.2	60.1	0.97
chr14	41278564	41278830	CpG: 21	266	21	165	15.8	62.0	0.83
chr14	41441180	41441495	CpG: 26	315	26	231	16.5	73.3	0.61
chr14	41738859	41739132	CpG: 25	273	25	176	18.3	64.5	0.89
chr14	41758948	41759222	CpG: 22	274	22	162	16.1	59.1	0.93
chr14	41825279	41825765	CpG: 45	486	45	359	18.5	73.9	0.68
chr14	41844163	41844396	CpG: 19	233	19	138	16.3	59.2	0.95
chr14	41873089	41875230	CpG: 214	2141	214	1434	20.0	67.0	0.89
chr14	42093415	42093681	CpG: 19	266	19	159	14.3	59.8	0.81
chr14	42099920	42100279	CpG: 28	359	28	213	15.6	59.3	0.89
chr14	42243414	42243650	CpG: 19	236	19	142	16.1	60.2	0.92
chr14	42385889	42386248	CpG: 27	359	27	212	15.0	59.1	0.86
chr14	42493444	42493717	CpG: 24	273	24	168	17.6	61.5	0.94
chr14	42553756	42554030	CpG: 24	274	24	171	17.5	62.4	0.91
chr14	42556399	42556680	CpG: 24	281	24	175	17.1	62.3	0.90
chr14	43203438	43203712	CpG: 22	274	22	169	16.1	61.7	0.85
chr14	43322366	43322580	CpG: 16	214	16	125	15.0	58.4	0.89
chr14	43783342	43783611	CpG: 20	269	20	156	14.9	58.0	0.89
chr14	43784184	43785076	CpG: 63	892	63	506	14.1	56.7	0.88
chr14	43796717	43798405	CpG: 163	1688	163	1111	19.3	65.8	0.89
chr14	43818461	43819767	CpG: 137	1306	137	870	21.0	66.6	0.95
chr14	43831219	43831458	CpG: 20	239	20	145	16.7	60.7	0.93
chr14	43831835	43833855	CpG: 204	2020	204	1378	20.2	68.2	0.87
chr14	43854116	43854357	CpG: 19	241	19	147	15.8	61.0	0.86
chr14	43882233	43882506	CpG: 20	273	20	161	14.7	59.0	0.85
chr14	43885807	43886567	CpG: 72	760	72	496	18.9	65.3	0.92
chr14	43888304	43888577	CpG: 24	273	24	169	17.6	61.9	0.93
chr14	43890994	43891751	CpG: 85	757	85	500	22.5	66.1	1.03
chr14	43973318	43974613	CpG: 146	1295	146	875	22.5	67.6	0.99
chr14	44026523	44027004	CpG: 38	481	38	344	15.8	71.5	0.62
chr14	44057931	44058137	CpG: 25	206	25	125	24.3	60.7	1.32
chr14	44058892	44059148	CpG: 23	256	23	165	18.0	64.5	0.89
chr14	44067318	44067554	CpG: 19	236	19	125	16.1	53.0	1.16
chr14	44067830	44068410	CpG: 51	580	51	358	17.6	61.7	0.92
chr14	44072213	44072601	CpG: 29	388	29	224	14.9	57.7	0.90
chr14	44073174	44073698	CpG: 44	524	44	355	16.8	67.7	0.76
chr14	44097838	44099295	CpG: 148	1457	148	991	20.3	68.0	0.89
chr14	44106608	44106845	CpG: 21	237	21	144	17.7	60.8	0.98
chr14	44117609	44117859	CpG: 21	250	21	154	16.8	61.6	0.93
chr14	44208484	44208888	CpG: 43	404	43	294	21.3	72.8	0.82
chr14	44279001	44280591	CpG: 144	1590	144	1220	18.1	76.7	0.62
chr14	44322491	44323025	CpG: 60	534	60	357	22.5	66.9	1.04
chr14	44421136	44421373	CpG: 17	237	17	136	14.3	57.4	0.88
chr14	44437327	44438315	CpG: 135	988	135	758	27.3	76.7	0.93
chr14	44518188	44519052	CpG: 94	864	94	609	21.8	70.5	0.88
chr14	44588411	44588614	CpG: 18	203	18	124	17.7	61.1	0.96
chr14	44602316	44603374	CpG: 104	1058	104	659	19.7	62.3	1.02
chr14	44738036	44739170	CpG: 131	1134	131	804	23.1	70.9	0.93
chr14	44766307	44767005	CpG: 62	698	62	488	17.8	69.9	0.73
chr14	44873904	44874722	CpG: 110	818	110	589	26.9	72.0	1.05
chr14	44912434	44912712	CpG: 23	278	23	175	16.5	62.9	0.85
chr14	44965645	44965911	CpG: 22	266	22	165	16.5	62.0	0.87
chr14	45036143	45037894	CpG: 198	1751	198	1248	22.6	71.3	0.90
chr14	45059326	45059606	CpG: 21	280	21	170	15.0	60.7	0.82
chr14	45069753	45070195	CpG: 32	442	32	254	14.5	57.5	0.88
chr14	45078421	45078855	CpG: 61	434	61	342	28.1	78.8	0.91
chr14	45150321	45151171	CpG: 88	850	88	605	20.7	71.2	0.82
chr14	45152356	45152592	CpG: 19	236	19	144	16.1	61.0	0.89
chr14	45162831	45163529	CpG: 58	698	58	477	16.6	68.3	0.71
chr14	45207672	45207942	CpG: 20	270	20	166	14.8	61.5	0.80
chr14	45299807	45302178	CpG: 199	2371	199	1586	16.8	66.9	0.75
chr14	45331158	45331372	CpG: 17	214	17	129	15.9	60.3	0.89
chr14	45341101	45341375	CpG: 24	274	24	170	17.5	62.0	0.92
chr14	45372535	45372775	CpG: 18	240	18	145	15.0	60.4	0.84
chr14	45446543	45447251	CpG: 59	708	59	437	16.7	61.7	0.88
chr14	45458746	45459024	CpG: 25	278	25	175	18.0	62.9	0.92
chr14	45473655	45473866	CpG: 17	211	17	125	16.1	59.2	0.93
chr14	45576114	45576358	CpG: 19	244	19	141	15.6	57.8	0.99
chr14	45674387	45675013	CpG: 45	626	45	418	14.4	66.8	0.65
chr14	45756473	45756737	CpG: 23	264	23	170	17.4	64.4	0.85
chr14	45835809	45836082	CpG: 22	273	22	163	16.1	59.7	0.92
chr14	45857329	45857599	CpG: 23	270	23	168	17.0	62.2	0.89
chr14	45858169	45859682	CpG: 167	1513	167	1101	22.1	72.8	0.84
chr14	45950734	45951010	CpG: 24	276	24	181	17.4	65.6	0.83
chr14	45951548	45951792	CpG: 18	244	18	165	14.8	67.6	0.68
chr14	45967063	45967420	CpG: 25	357	25	236	14.0	66.1	0.65
chr14	45982800	45983031	CpG: 19	231	19	142	16.5	61.5	0.88
chr14	46196454	46196919	CpG: 60	465	60	336	25.8	72.3	1.02
chr14	46274951	46277092	CpG: 161	2141	161	1400	15.0	65.4	0.70
chr14	46335052	46335330	CpG: 24	278	24	175	17.3	62.9	0.88
chr14	46474599	46475878	CpG: 111	1279	111	856	17.4	66.9	0.78
chr14	46497192	46497466	CpG: 24	274	24	171	17.5	62.4	0.91
chr14	46521064	46522386	CpG: 131	1322	131	910	19.8	68.8	0.85
chr14	46760166	46761542	CpG: 143	1376	143	970	20.8	70.5	0.84
chr14	46902927	46903869	CpG: 114	942	114	695	24.2	73.8	0.91
chr14	46914848	46915208	CpG: 26	360	26	217	14.4	60.3	0.80
chr14	46937683	46938525	CpG: 78	842	78	598	18.5	71.0	0.74
chr14	46939293	46939527	CpG: 17	234	17	138	14.5	59.0	0.85
chr14	46998741	46999695	CpG: 91	954	91	671	19.1	70.3	0.78
chr14	47014678	47014958	CpG: 24	280	24	167	17.1	59.6	0.97
chr14	47158330	47159561	CpG: 151	1231	151	905	24.5	73.5	0.91
chr14	47224137	47224397	CpG: 23	260	23	164	17.7	63.1	0.91
chr14	47360119	47361492	CpG: 167	1373	167	986	24.3	71.8	0.96
chr14	47425426	47425800	CpG: 35	374	35	281	18.7	75.1	0.66
chr14	47757735	47758001	CpG: 20	266	20	162	15.0	60.9	0.83
chr14	48154814	48155274	CpG: 56	460	56	343	24.3	74.6	0.88
chr14	48160184	48160388	CpG: 20	204	20	126	19.6	61.8	1.03
chr14	48161691	48164467	CpG: 220	2776	220	1724	15.9	62.1	0.83
chr14	48164849	48165355	CpG: 41	506	41	344	16.2	68.0	0.74
chr14	48171663	48172179	CpG: 43	516	43	327	16.7	63.4	0.84
chr14	48176488	48176762	CpG: 22	274	22	168	16.1	61.3	0.86
chr14	48184990	48185208	CpG: 17	218	17	123	15.6	56.4	0.99
chr14	48198155	48198417	CpG: 19	262	19	159	14.5	60.7	0.79
chr14	48398859	48399133	CpG: 22	274	22	170	16.1	62.0	0.84
chr14	48553858	48554175	CpG: 25	317	25	188	15.8	59.3	0.91
chr14	48598084	48599027	CpG: 74	943	74	671	15.7	71.2	0.62
chr14	48599786	48600107	CpG: 26	321	26	212	16.2	66.0	0.75
chr14	48601670	48602683	CpG: 95	1013	95	665	18.8	65.6	0.87
chr14	48646043	48646684	CpG: 89	641	89	481	27.8	75.0	0.99
chr14	48692419	48692693	CpG: 22	274	22	166	16.1	60.6	0.89
chr14	48693837	48694280	CpG: 48	443	48	317	21.7	71.6	0.85
chr14	48714756	48715440	CpG: 61	684	61	450	17.8	65.8	0.83
chr14	48770304	48773508	CpG: 321	3204	321	2256	20.0	70.4	0.81
chr14	48883745	48884019	CpG: 26	274	26	172	19.0	62.8	0.98
chr14	48965418	48965655	CpG: 22	237	22	182	18.6	76.8	0.64
chr14	49088426	49088705	CpG: 20	279	20	153	14.3	54.8	0.97
chr14	49091531	49091767	CpG: 18	236	18	144	15.3	61.0	0.84
chr14	49107023	49108389	CpG: 144	1366	144	960	21.1	70.3	0.85
chr14	49232085	49232503	CpG: 45	418	45	286	21.5	68.4	0.92
chr14	49256602	49257428	CpG: 100	826	100	596	24.2	72.2	0.93
chr14	49334169	49335164	CpG: 114	995	114	739	22.9	74.3	0.83
chr14	49381889	49382162	CpG: 21	273	21	166	15.4	60.8	0.84
chr14	49382749	49382974	CpG: 19	225	19	139	16.9	61.8	0.91
chr14	49396703	49397021	CpG: 26	318	26	189	16.4	59.4	0.94
chr14	49414027	49414267	CpG: 17	240	17	142	14.2	59.2	0.83
chr14	49476446	49477505	CpG: 123	1059	123	762	23.2	72.0	0.90
chr14	49503806	49504081	CpG: 25	275	25	181	18.2	65.8	0.88
chr14	49617315	49617694	CpG: 41	379	41	268	21.6	70.7	0.87
chr14	49646212	49646448	CpG: 24	236	24	169	20.3	71.6	0.86
chr14	49662006	49662459	CpG: 41	453	41	333	18.1	73.5	0.67
chr14	49785635	49786987	CpG: 173	1352	173	1005	25.6	74.3	0.93
chr14	49803873	49804143	CpG: 20	270	20	167	14.8	61.9	0.78
chr14	49971991	49972327	CpG: 23	336	23	196	13.7	58.3	0.81
chr14	50045124	50045588	CpG: 39	464	39	338	16.8	72.8	0.64
chr14	50046161	50046373	CpG: 17	212	17	121	16.0	57.1	1.01
chr14	50323525	50325291	CpG: 227	1766	227	1294	25.7	73.3	0.96
chr14	50653470	50653820	CpG: 29	350	29	213	16.6	60.9	0.90
chr14	50785497	50785829	CpG: 41	332	41	242	24.7	72.9	0.93
chr14	50799461	50799731	CpG: 22	270	22	167	16.3	61.9	0.86
chr14	50873366	50873760	CpG: 30	394	30	239	15.2	60.7	0.83
chr14	50944908	50945183	CpG: 23	275	23	166	16.7	60.4	0.93
chr14	50968558	50968790	CpG: 18	232	18	135	15.5	58.2	0.93
chr14	50999951	51001196	CpG: 98	1245	98	833	15.7	66.9	0.70
chr14	51003712	51004635	CpG: 89	923	89	678	19.3	73.5	0.72
chr14	51013680	51015913	CpG: 182	2233	182	1320	16.3	59.1	0.93
chr14	51017144	51017363	CpG: 21	219	21	144	19.2	65.8	0.92
chr14	51017785	51018192	CpG: 33	407	33	282	16.2	69.3	0.68
chr14	51022471	51023643	CpG: 92	1172	92	752	15.7	64.2	0.76
chr14	51048850	51049134	CpG: 21	284	21	177	14.8	62.3	0.77
chr14	51133893	51134168	CpG: 21	275	21	165	15.3	60.0	0.87
chr14	51196792	51197316	CpG: 45	524	45	381	17.2	72.7	0.65
chr14	51263126	51263440	CpG: 26	314	26	227	16.6	72.3	0.63
chr14	51318679	51319074	CpG: 32	395	32	241	16.2	61.0	0.88
chr14	51351891	51352127	CpG: 20	236	20	142	16.9	60.2	0.97
chr14	51392695	51392970	CpG: 21	275	21	168	15.3	61.1	0.84
chr14	51474835	51475433	CpG: 64	598	64	424	21.4	70.9	0.88
chr14	51550229	51550561	CpG: 25	332	25	197	15.1	59.3	0.86
chr14	51596688	51598095	CpG: 136	1407	136	982	19.3	69.8	0.79
chr14	51660886	51661190	CpG: 26	304	26	188	17.1	61.8	0.90
chr14	51807370	51807606	CpG: 20	236	20	144	16.9	61.0	0.93
chr14	51924366	51924596	CpG: 17	230	17	134	14.8	58.3	0.88
chr14	52071900	52073346	CpG: 140	1446	140	991	19.4	68.5	0.83
chr14	52239518	52239912	CpG: 29	394	29	233	14.7	59.1	0.85
chr14	52309482	52309759	CpG: 24	277	24	174	17.3	62.8	0.90
chr14	52358530	52359459	CpG: 103	929	103	648	22.2	69.8	0.91
chr14	52368093	52368370	CpG: 23	277	23	171	16.6	61.7	0.88
chr14	52387971	52388245	CpG: 24	274	24	172	17.5	62.8	0.90
chr14	52406787	52407418	CpG: 75	631	75	446	23.8	70.7	0.95
chr14	52409245	52409480	CpG: 19	235	19	138	16.2	58.7	0.95
chr14	52451560	52452106	CpG: 43	546	43	325	15.8	59.5	0.89
chr14	52504786	52505240	CpG: 34	454	34	282	15.0	62.1	0.80
chr14	52505452	52506665	CpG: 113	1213	113	841	18.6	69.3	0.78
chr14	52524359	52524589	CpG: 17	230	17	135	14.8	58.7	0.88
chr14	52594934	52595209	CpG: 20	275	20	167	14.5	60.7	0.80
chr14	52597252	52597592	CpG: 24	340	24	197	14.1	57.9	0.84
chr14	52602751	52603511	CpG: 88	760	88	548	23.2	72.1	0.89
chr14	52611201	52611475	CpG: 22	274	22	169	16.1	61.7	0.86
chr14	52633936	52634271	CpG: 29	335	29	211	17.3	63.0	0.87
chr14	52844658	52845936	CpG: 157	1278	157	944	24.6	73.9	0.92
chr14	52853428	52853997	CpG: 50	569	50	374	17.6	65.7	0.82
chr14	53033372	53033607	CpG: 17	235	17	140	14.5	59.6	0.83
chr14	53041094	53041420	CpG: 27	326	27	237	16.6	72.7	0.63
chr14	53266014	53266721	CpG: 49	707	49	471	13.9	66.6	0.63
chr14	53319919	53320192	CpG: 21	273	21	167	15.4	61.2	0.83
chr14	53394810	53396510	CpG: 130	1700	130	1078	15.3	63.4	0.77
chr14	53403890	53404122	CpG: 18	232	18	140	15.5	60.3	0.86
chr14	53455702	53455968	CpG: 20	266	20	162	15.0	60.9	0.82
chr14	53670835	53672452	CpG: 189	1617	189	1159	23.4	71.7	0.91
chr14	53690674	53691741	CpG: 119	1067	119	739	22.3	69.3	0.93
chr14	53783485	53783837	CpG: 27	352	27	240	15.3	68.2	0.66
chr14	53788516	53788763	CpG: 20	247	20	150	16.2	60.7	0.91
chr14	53837427	53837772	CpG: 51	345	51	261	29.6	75.7	1.06
chr14	53879606	53879887	CpG: 23	281	23	174	16.4	61.9	0.87
chr14	53934064	53934535	CpG: 50	471	50	336	21.2	71.3	0.83
chr14	54026854	54027187	CpG: 29	333	29	242	17.4	72.7	0.66
chr14	54034407	54034644	CpG: 17	237	17	138	14.3	58.2	0.86
chr14	54077503	54078178	CpG: 82	675	82	507	24.3	75.1	0.87
chr14	54124902	54125460	CpG: 50	558	50	360	17.9	64.5	0.86
chr14	54157500	54157826	CpG: 29	326	29	195	17.8	59.8	1.00
chr14	54170974	54171246	CpG: 21	272	21	167	15.4	61.4	0.84
chr14	54184636	54184908	CpG: 21	272	21	169	15.4	62.1	0.81
chr14	54192785	54193066	CpG: 24	281	24	176	17.1	62.6	0.89
chr14	54271309	54271583	CpG: 24	274	24	171	17.5	62.4	0.91
chr14	54297582	54298418	CpG: 85	836	85	521	20.3	62.3	1.05
chr14	54314773	54315047	CpG: 24	274	24	172	17.5	62.8	0.90
chr14	54371320	54371843	CpG: 57	523	57	384	21.8	73.4	0.82
chr14	54454940	54456381	CpG: 184	1441	184	1078	25.5	74.8	0.92
chr14	54461495	54461761	CpG: 24	266	24	167	18.0	62.8	0.93
chr14	54490656	54490931	CpG: 23	275	23	172	16.7	62.5	0.87
chr14	54534153	54534444	CpG: 34	291	34	224	23.4	77.0	0.79
chr14	54604030	54604264	CpG: 23	234	23	135	19.7	57.7	1.28
chr14	54631527	54631757	CpG: 20	230	20	141	17.4	61.3	0.94
chr14	54691567	54692537	CpG: 77	970	77	604	15.9	62.3	0.85
chr14	54713375	54713726	CpG: 32	351	32	219	18.2	62.4	0.94
chr14	54715335	54717783	CpG: 179	2448	179	1501	14.6	61.3	0.78
chr14	54721104	54722217	CpG: 132	1113	132	792	23.7	71.2	0.95
chr14	54832698	54832972	CpG: 24	274	24	171	17.5	62.4	0.91
chr14	54843716	54844401	CpG: 54	685	54	485	15.8	70.8	0.63
chr14	54848692	54849524	CpG: 68	832	68	549	16.3	66.0	0.75
chr14	54853841	54856291	CpG: 195	2450	195	1548	15.9	63.2	0.80
chr14	54863351	54864351	CpG: 107	1000	107	662	21.4	66.2	0.98
chr14	54927881	54930537	CpG: 230	2656	230	1777	17.3	66.9	0.78
chr14	55187485	55187963	CpG: 45	478	45	305	18.8	63.8	0.93
chr14	55267258	55267685	CpG: 33	427	33	256	15.5	60.0	0.86
chr14	55395103	55395804	CpG: 49	701	49	435	14.0	62.1	0.73
chr14	55478538	55478752	CpG: 20	214	20	132	18.7	61.7	1.01
chr14	55486691	55488028	CpG: 155	1337	155	935	23.2	69.9	0.96
chr14	55527775	55529362	CpG: 144	1587	144	1100	18.1	69.3	0.76
chr14	55694486	55694755	CpG: 20	269	20	165	14.9	61.3	0.79
chr14	55901696	55903080	CpG: 128	1384	128	933	18.5	67.4	0.82
chr14	55957575	55957927	CpG: 43	352	43	255	24.4	72.4	0.93
chr14	55969064	55969426	CpG: 48	362	48	247	26.5	68.2	1.17
chr14	55969933	55970173	CpG: 19	240	19	139	15.8	57.9	0.95
chr14	55988060	55988295	CpG: 16	235	16	137	13.6	58.3	0.84
chr14	56019261	56020174	CpG: 110	913	110	674	24.1	73.8	0.91
chr14	56023605	56023809	CpG: 16	204	16	121	15.7	59.3	0.91
chr14	56028058	56028332	CpG: 24	274	24	171	17.5	62.4	0.91
chr14	56071500	56072132	CpG: 50	632	50	396	15.8	62.7	0.81
chr14	56152863	56153138	CpG: 24	275	24	171	17.5	62.2	0.91
chr14	56264107	56264318	CpG: 25	211	25	148	23.7	70.1	1.00
chr14	56324183	56324783	CpG: 54	600	54	406	18.0	67.7	0.80
chr14	56601354	56601635	CpG: 24	281	24	174	17.1	61.9	0.91
chr14	56742883	56743290	CpG: 31	407	31	249	15.2	61.2	0.82
chr14	56915946	56916200	CpG: 24	254	24	161	18.9	63.4	0.95
chr14	56961959	56962233	CpG: 22	274	22	169	16.1	61.7	0.85
chr14	56966954	56967195	CpG: 18	241	18	141	14.9	58.5	0.90
chr14	57098044	57098285	CpG: 22	241	22	146	18.3	60.6	1.02
chr14	57107181	57107458	CpG: 24	277	24	171	17.3	61.7	0.92
chr14	57116689	57116975	CpG: 24	286	24	175	16.8	61.2	0.91
chr14	57252921	57253910	CpG: 105	989	105	717	21.2	72.5	0.81
chr14	57309508	57309759	CpG: 19	251	19	142	15.1	56.6	0.96
chr14	57329915	57330342	CpG: 32	427	32	255	15.0	59.7	0.84
chr14	57527832	57528105	CpG: 23	273	23	170	16.8	62.3	0.88
chr14	57628170	57628445	CpG: 24	275	24	170	17.5	61.8	0.92
chr14	57631864	57632110	CpG: 20	246	20	150	16.3	61.0	0.89
chr14	57671053	57671291	CpG: 19	238	19	146	16.0	61.3	0.86
chr14	57729466	57730550	CpG: 93	1084	93	775	17.2	71.5	0.67
chr14	57750028	57751205	CpG: 116	1177	116	811	19.7	68.9	0.84
chr14	57802471	57802715	CpG: 29	244	29	171	23.8	70.1	1.00
chr14	57847974	57848471	CpG: 35	497	35	285	14.1	57.3	0.86
chr14	57849019	57849628	CpG: 57	609	57	362	18.7	59.4	1.06
chr14	57934923	57935731	CpG: 112	808	112	614	27.7	76.0	0.97
chr14	57956654	57956882	CpG: 16	228	16	139	14.0	61.0	0.76
chr14	57958397	57959356	CpG: 85	959	85	695	17.7	72.5	0.68
chr14	57978466	57978741	CpG: 24	275	24	170	17.5	61.8	0.92
chr14	58010623	58011010	CpG: 30	387	30	275	15.5	71.1	0.62
chr14	58012818	58013041	CpG: 19	223	19	136	17.0	61.0	0.96
chr14	58060176	58061160	CpG: 137	984	137	758	27.8	77.0	0.97
chr14	58245043	58246454	CpG: 113	1411	113	986	16.0	69.9	0.66
chr14	58390672	58391504	CpG: 68	832	68	580	16.3	69.7	0.67
chr14	58448580	58448856	CpG: 21	276	21	168	15.2	60.9	0.83
chr14	58501728	58502286	CpG: 48	558	48	358	17.2	64.2	0.84
chr14	58517508	58517989	CpG: 32	481	32	270	13.3	56.1	0.85
chr14	58546095	58546771	CpG: 67	676	67	458	19.8	67.8	0.91
chr14	58563669	58563943	CpG: 20	274	20	164	14.6	59.9	0.83
chr14	58574609	58574847	CpG: 19	238	19	140	16.0	58.8	0.96
chr14	58578556	58578829	CpG: 22	273	22	168	16.1	61.5	0.87
chr14	58595204	58596025	CpG: 69	821	69	521	16.8	63.5	0.85
chr14	58672927	58673590	CpG: 77	663	77	487	23.2	73.5	0.86
chr14	58711008	58713222	CpG: 227	2214	227	1545	20.5	69.8	0.85
chr14	58747361	58750277	CpG: 249	2916	249	1793	17.1	61.5	0.91
chr14	58755555	58755817	CpG: 20	262	20	162	15.3	61.8	0.81
chr14	58757595	58757988	CpG: 46	393	46	280	23.4	71.2	0.92
chr14	58787505	58787775	CpG: 19	270	19	161	14.1	59.6	0.80
chr14	58809415	58809715	CpG: 37	300	37	214	24.7	71.3	0.98
chr14	58840702	58840979	CpG: 24	277	24	174	17.3	62.8	0.90
chr14	58865959	58866301	CpG: 38	342	38	250	22.2	73.1	0.84
chr14	58912009	58913132	CpG: 117	1123	117	793	20.8	70.6	0.84
chr14	58956930	58957328	CpG: 43	398	43	281	21.6	70.6	0.87
chr14	58980454	58980798	CpG: 35	344	35	227	20.3	66.0	0.94
chr14	59087396	59088631	CpG: 119	1235	119	876	19.3	70.9	0.77
chr14	59119225	59119532	CpG: 33	307	33	198	21.5	64.5	1.04
chr14	59176563	59177514	CpG: 113	951	113	709	23.8	74.6	0.86
chr14	59179103	59179332	CpG: 18	229	18	137	15.7	59.8	0.89
chr14	59188054	59188287	CpG: 18	233	18	133	15.5	57.1	0.98
chr14	59191541	59192152	CpG: 58	611	58	368	19.0	60.2	1.05
chr14	59265319	59265551	CpG: 20	232	20	142	17.2	61.2	0.93
chr14	59306575	59308132	CpG: 138	1557	138	1059	17.7	68.0	0.77
chr14	59308876	59309085	CpG: 17	209	17	126	16.3	60.3	0.92
chr14	59357234	59357500	CpG: 21	266	21	165	15.8	62.0	0.83
chr14	59377762	59378201	CpG: 31	439	31	262	14.1	59.7	0.81
chr14	59472149	59472427	CpG: 25	278	25	173	18.0	62.2	0.94
chr14	59484464	59485688	CpG: 79	1224	79	741	12.9	60.5	0.71
chr14	59522443	59522711	CpG: 22	268	22	167	16.4	62.3	0.87
chr14	59616533	59618417	CpG: 196	1884	196	1315	20.8	69.8	0.85
chr14	59837823	59838690	CpG: 64	867	64	601	14.8	69.3	0.61
chr14	59921417	59922284	CpG: 74	867	74	638	17.1	73.6	0.63
chr14	60055420	60055705	CpG: 23	285	23	177	16.1	62.1	0.85
chr14	60220602	60220911	CpG: 40	309	40	227	25.9	73.5	0.97
chr14	60550927	60551201	CpG: 22	274	22	170	16.1	62.0	0.85
chr14	60714636	60716502	CpG: 170	1866	170	1248	18.2	66.9	0.82
chr14	61233779	61234047	CpG: 20	268	20	164	14.9	61.2	0.80
chr14	61293495	61293760	CpG: 21	265	21	165	15.8	62.3	0.82
chr14	61309054	61309291	CpG: 18	237	18	144	15.2	60.8	0.86
chr14	61357286	61357559	CpG: 24	273	24	170	17.6	62.3	0.91
chr14	61448161	61449055	CpG: 111	894	111	647	24.8	72.4	0.96
chr14	61450639	61450913	CpG: 20	274	20	159	14.6	58.0	0.88
chr14	61547921	61548675	CpG: 53	754	53	516	14.1	68.4	0.60
chr14	61566547	61567934	CpG: 97	1387	97	795	14.0	57.3	0.85
chr14	61586799	61587029	CpG: 19	230	19	138	16.5	60.0	0.93
chr14	61618935	61619568	CpG: 67	633	67	443	21.2	70.0	0.88
chr14	61626700	61626929	CpG: 19	229	19	141	16.6	61.6	0.90
chr14	61680576	61681146	CpG: 48	570	48	374	16.8	65.6	0.80
chr14	61721914	61722780	CpG: 109	866	109	658	25.2	76.0	0.89
chr14	61739967	61740839	CpG: 102	872	102	660	23.4	75.7	0.82
chr14	61779200	61779415	CpG: 16	215	16	144	14.9	67.0	0.66
chr14	61806987	61807857	CpG: 81	870	81	556	18.6	63.9	0.91
chr14	61826690	61827370	CpG: 62	680	62	460	18.2	67.6	0.81
chr14	61874788	61875020	CpG: 17	232	17	138	14.7	59.5	0.84
chr14	61881376	61882367	CpG: 116	991	116	693	23.4	69.9	0.96
chr14	62026245	62026627	CpG: 27	382	27	219	14.1	57.3	0.87
chr14	62441810	62442088	CpG: 25	278	25	175	18.0	62.9	0.92
chr14	62563144	62563421	CpG: 19	277	19	168	13.7	60.6	0.76
chr14	62563690	62563928	CpG: 22	238	22	147	18.5	61.8	0.99
chr14	62756321	62756598	CpG: 26	277	26	173	18.8	62.5	0.97
chr14	62835182	62835574	CpG: 38	392	38	269	19.4	68.6	0.82
chr14	62996709	62997182	CpG: 41	473	41	319	17.3	67.4	0.79
chr14	63000218	63003047	CpG: 205	2829	205	1680	14.5	59.4	0.82
chr14	63023184	63023743	CpG: 75	559	75	420	26.8	75.1	0.95
chr14	63083717	63084110	CpG: 40	393	40	268	20.4	68.2	0.91
chr14	63127339	63127709	CpG: 24	370	24	209	13.0	56.5	0.82
chr14	63186975	63189167	CpG: 195	2192	195	1526	17.8	69.6	0.74
chr14	63364724	63366846	CpG: 185	2122	185	1458	17.4	68.7	0.74
chr14	63404514	63405160	CpG: 57	646	57	434	17.6	67.2	0.78
chr14	63472596	63474739	CpG: 225	2143	225	1507	21.0	70.3	0.85
chr14	63611151	63611511	CpG: 44	360	44	244	24.4	67.8	1.07
chr14	63696850	63698347	CpG: 146	1497	146	1048	19.5	70.0	0.80
chr14	63761000	63761450	CpG: 41	450	41	308	18.2	68.4	0.78
chr14	63779062	63782610	CpG: 347	3548	347	2420	19.6	68.2	0.84
chr14	63818970	63820034	CpG: 142	1064	142	799	26.7	75.1	0.95
chr14	63934417	63934905	CpG: 45	488	45	329	18.4	67.4	0.81
chr14	63972822	63973096	CpG: 23	274	23	169	16.8	61.7	0.89
chr14	63973842	63974067	CpG: 21	225	21	136	18.7	60.4	1.04
chr14	63974525	63975623	CpG: 99	1098	99	703	18.0	64.0	0.89
chr14	64057795	64058188	CpG: 32	393	32	258	16.3	65.6	0.76
chr14	64086857	64087441	CpG: 63	584	63	429	21.6	73.5	0.82
chr14	64091557	64091842	CpG: 26	285	26	181	18.2	63.5	0.92
chr14	64110384	64111088	CpG: 52	704	52	464	14.8	65.9	0.68
chr14	64253579	64253781	CpG: 16	202	16	127	15.8	62.9	0.81
chr14	64395141	64396860	CpG: 159	1719	159	1157	18.5	67.3	0.82
chr14	64440007	64440243	CpG: 34	236	34	182	28.8	77.1	1.02
chr14	64460595	64461210	CpG: 71	615	71	475	23.1	77.2	0.79
chr14	64565421	64565746	CpG: 25	325	25	166	15.4	51.1	1.18
chr14	64629528	64629758	CpG: 19	230	19	139	16.5	60.4	0.92
chr14	64683403	64684092	CpG: 57	689	57	509	16.5	73.9	0.61
chr14	64753331	64753690	CpG: 28	359	28	213	15.6	59.3	0.89
chr14	64806639	64806879	CpG: 25	240	25	159	20.8	66.2	1.17
chr14	64847295	64848604	CpG: 160	1309	160	929	24.4	71.0	0.97
chr14	64969905	64970187	CpG: 24	282	24	175	17.0	62.1	0.90
chr14	65004546	65004820	CpG: 24	274	24	171	17.5	62.4	0.91
chr14	65014592	65015891	CpG: 156	1299	156	979	24.0	75.4	0.88
chr14	65027846	65028602	CpG: 70	756	70	528	18.5	69.8	0.80
chr14	65054252	65054489	CpG: 17	237	17	137	14.3	57.8	0.88
chr14	65083725	65083976	CpG: 20	251	20	154	15.9	61.4	0.86
chr14	65112909	65114347	CpG: 176	1438	176	1076	24.5	74.8	0.87
chr14	65372961	65373300	CpG: 36	339	36	254	21.2	74.9	0.76
chr14	65457622	65457866	CpG: 17	244	17	143	13.9	58.6	0.81
chr14	65459743	65460133	CpG: 44	390	44	297	22.6	76.2	0.78
chr14	65525584	65526954	CpG: 145	1370	145	981	21.2	71.6	0.83
chr14	65582654	65582863	CpG: 22	209	22	163	21.1	78.0	0.70
chr14	65622718	65622947	CpG: 17	229	17	141	14.8	61.6	0.79
chr14	65757913	65758148	CpG: 17	235	17	136	14.5	57.9	0.89
chr14	65880069	65880347	CpG: 25	278	25	176	18.0	63.3	0.90
chr14	66123352	66123598	CpG: 22	246	22	150	17.9	61.0	0.98
chr14	66133138	66133413	CpG: 23	275	23	166	16.7	60.4	0.93
chr14	66137400	66138290	CpG: 118	890	118	643	26.5	72.2	1.02
chr14	66187407	66187632	CpG: 20	225	20	137	17.8	60.9	0.96
chr14	66465061	66465301	CpG: 18	240	18	142	15.0	59.2	0.87
chr14	66500447	66500721	CpG: 24	274	24	172	17.5	62.8	0.90
chr14	66658903	66659177	CpG: 22	274	22	169	16.1	61.7	0.85
chr14	66678746	66679017	CpG: 21	271	21	167	15.5	61.6	0.82
chr14	67097767	67099916	CpG: 174	2149	174	1315	16.2	61.2	0.87
chr14	67131602	67133302	CpG: 128	1700	128	1057	15.1	62.2	0.78
chr14	67133921	67134159	CpG: 20	238	20	142	16.8	59.7	0.97
chr14	67135417	67135745	CpG: 28	328	28	201	17.1	61.3	0.92
chr14	67232307	67232816	CpG: 43	509	43	351	16.9	69.0	0.73
chr14	67263836	67264599	CpG: 66	763	66	464	17.3	60.8	0.94
chr14	67265648	67265886	CpG: 20	238	20	144	16.8	60.5	0.92
chr14	67292985	67293259	CpG: 21	274	21	168	15.3	61.3	0.84
chr14	67302859	67303069	CpG: 16	210	16	126	15.2	60.0	0.85
chr14	67308845	67309048	CpG: 21	203	21	108	20.7	53.2	1.86
chr14	67315080	67315316	CpG: 22	236	22	145	18.6	61.4	1.02
chr14	67341736	67342585	CpG: 82	849	82	570	19.3	67.1	0.87
chr14	67343820	67344061	CpG: 20	241	20	148	16.6	61.4	0.92
chr14	67344223	67344466	CpG: 20	243	20	143	16.5	58.8	0.98
chr14	67442803	67443855	CpG: 119	1052	119	792	22.6	75.3	0.80
chr14	67445048	67445426	CpG: 40	378	40	279	21.2	73.8	0.78
chr14	67451037	67451660	CpG: 58	623	58	454	18.6	72.9	0.70
chr14	67475528	67475863	CpG: 39	335	39	230	23.3	68.7	0.99
chr14	67514328	67514544	CpG: 20	216	20	135	18.5	62.5	0.98
chr14	67594873	67595149	CpG: 24	276	24	171	17.4	62.0	0.92
chr14	67665853	67666701	CpG: 69	848	69	576	16.3	67.9	0.79
chr14	67682398	67682635	CpG: 19	237	19	144	16.0	60.8	0.88
chr14	67698294	67700143	CpG: 176	1849	176	1207	19.0	65.3	0.89
chr14	67744928	67745489	CpG: 75	561	75	407	26.7	72.5	1.02
chr14	67776933	67777499	CpG: 78	566	78	406	27.6	71.7	1.07
chr14	67797937	67799922	CpG: 167	1985	167	1280	16.8	64.5	0.81
chr14	67819991	67820612	CpG: 85	621	85	452	27.4	72.8	1.03
chr14	67841141	67842029	CpG: 77	888	77	601	17.3	67.7	0.76
chr14	67852350	67852556	CpG: 25	206	25	145	24.3	70.4	0.98
chr14	67895122	67895362	CpG: 23	240	23	147	19.2	61.2	1.04
chr14	67921351	67922097	CpG: 111	746	111	561	29.8	75.2	1.08
chr14	67926318	67926830	CpG: 47	512	47	366	18.4	71.5	0.74
chr14	67966462	67968045	CpG: 194	1583	194	1162	24.5	73.4	0.91
chr14	67987139	67987420	CpG: 23	281	23	173	16.4	61.6	0.88
chr14	67994231	67995032	CpG: 105	801	105	619	26.2	77.3	0.88
chr14	68045445	68045725	CpG: 25	280	25	176	17.9	62.9	0.91
chr14	68059355	68059728	CpG: 36	373	36	247	19.3	66.2	0.88
chr14	68059872	68060193	CpG: 22	321	22	181	13.7	56.4	0.86
chr14	68093441	68093693	CpG: 23	252	23	152	18.3	60.3	1.01
chr14	68094151	68094780	CpG: 59	629	59	426	18.8	67.7	0.83
chr14	68157506	68158308	CpG: 65	802	65	518	16.2	64.6	0.78
chr14	68226287	68227318	CpG: 110	1031	110	720	21.3	69.8	0.88
chr14	68250945	68251230	CpG: 24	285	24	178	16.8	62.5	0.88
chr14	68292305	68292685	CpG: 26	380	26	224	13.7	58.9	0.79
chr14	68309152	68309432	CpG: 25	280	25	176	17.9	62.9	0.91
chr14	68425528	68425763	CpG: 29	235	29	170	24.7	72.3	0.97
chr14	68447292	68449296	CpG: 196	2004	196	1363	19.6	68.0	0.85
chr14	68458708	68459019	CpG: 21	311	21	166	13.5	53.4	0.96
chr14	68464937	68466514	CpG: 127	1577	127	989	16.1	62.7	0.82
chr14	68510509	68510958	CpG: 47	449	47	312	20.9	69.5	0.87
chr14	68565112	68565314	CpG: 17	202	17	126	16.8	62.4	0.97
chr14	68633641	68634359	CpG: 97	718	97	560	27.0	78.0	0.91
chr14	68647973	68648190	CpG: 16	217	16	130	14.7	59.9	0.83
chr14	68701948	68703175	CpG: 104	1227	104	840	17.0	68.5	0.72
chr14	68794944	68795197	CpG: 23	253	23	173	18.2	68.4	0.78
chr14	68819707	68821986	CpG: 218	2279	218	1579	19.1	69.3	0.80
chr14	68922025	68922271	CpG: 19	246	19	153	15.4	62.2	0.80
chr14	68953439	68953725	CpG: 23	286	23	177	16.1	61.9	0.84
chr14	68972333	68972937	CpG: 76	604	76	424	25.2	70.2	1.04
chr14	69090882	69091458	CpG: 73	576	73	426	25.3	74.0	0.93
chr14	69092115	69092382	CpG: 22	267	22	166	16.5	62.2	0.87
chr14	69132110	69132531	CpG: 44	421	44	305	20.9	72.4	0.80
chr14	69164480	69165067	CpG: 67	587	67	438	22.8	74.6	0.82
chr14	69189888	69190156	CpG: 23	268	23	179	17.2	66.8	0.78
chr14	69203249	69203621	CpG: 31	372	31	268	16.7	72.0	0.64
chr14	69211697	69212264	CpG: 53	567	53	372	18.7	65.6	0.87
chr14	69241984	69242258	CpG: 22	274	22	169	16.1	61.7	0.85
chr14	69260504	69260942	CpG: 50	438	50	315	22.8	71.9	0.89
chr14	69278526	69279077	CpG: 53	551	53	374	19.2	67.9	0.84
chr14	69335974	69336692	CpG: 82	718	82	500	22.8	69.6	0.94
chr14	69385467	69386051	CpG: 52	584	52	391	17.8	67.0	0.80
chr14	69468439	69468720	CpG: 29	281	29	179	20.6	63.7	1.02
chr14	69486380	69489495	CpG: 241	3115	241	1972	15.5	63.3	0.77
chr14	69503016	69503270	CpG: 19	254	19	153	15.0	60.2	0.86
chr14	69503434	69503898	CpG: 50	464	50	343	21.6	73.9	0.81
chr14	69637015	69638176	CpG: 147	1161	147	897	25.3	77.3	0.85
chr14	69698207	69698443	CpG: 18	236	18	144	15.3	61.0	0.83
chr14	69755600	69755974	CpG: 28	374	28	247	15.0	66.0	0.69
chr14	69787363	69787875	CpG: 47	512	47	348	18.4	68.0	0.86
chr14	69870016	69870675	CpG: 65	659	65	425	19.7	64.5	0.95
chr14	70134041	70135118	CpG: 89	1077	89	779	16.5	72.3	0.63
chr14	70191471	70192237	CpG: 80	766	80	544	20.9	71.0	0.83
chr14	70194927	70195390	CpG: 41	463	41	303	17.7	65.4	0.83
chr14	70340449	70340711	CpG: 22	262	22	168	16.8	64.1	0.84
chr14	70343446	70343661	CpG: 15	215	15	116	14.0	54.0	0.97
chr14	70347800	70348164	CpG: 43	364	43	237	23.6	65.1	1.12
chr14	70360935	70361249	CpG: 27	314	27	221	17.2	70.4	0.72
chr14	70562203	70562437	CpG: 32	234	32	171	27.4	73.1	1.07
chr14	70585560	70586900	CpG: 115	1340	115	846	17.2	63.1	0.86
chr14	70623203	70623599	CpG: 44	396	44	317	22.2	80.1	1.03
chr14	70648754	70649108	CpG: 29	354	29	239	16.4	67.5	0.73
chr14	70700876	70701085	CpG: 17	209	17	133	16.3	63.6	0.81
chr14	70746178	70746535	CpG: 34	357	34	261	19.0	73.1	0.71
chr14	70916260	70916592	CpG: 28	332	28	241	16.9	72.6	0.66
chr14	70943862	70944657	CpG: 61	795	61	544	15.3	68.4	0.66
chr14	70970470	70971642	CpG: 147	1172	147	861	25.1	73.5	0.93
chr14	70985279	70985647	CpG: 43	368	43	258	23.4	70.1	0.95
chr14	71021658	71022494	CpG: 81	836	81	578	19.4	69.1	0.81
chr14	71107635	71108461	CpG: 66	826	66	579	16.0	70.1	0.65
chr14	71125399	71125637	CpG: 16	238	16	133	13.4	55.9	0.86
chr14	71166243	71166495	CpG: 31	252	31	189	24.6	75.0	0.90
chr14	71235329	71238664	CpG: 345	3335	345	2345	20.7	70.3	0.84
chr14	71242543	71242891	CpG: 31	348	31	228	17.8	65.5	0.83
chr14	71243094	71243414	CpG: 24	320	24	204	15.0	63.8	0.75
chr14	71258523	71258755	CpG: 23	232	23	143	19.8	61.6	1.06
chr14	71307406	71308218	CpG: 92	812	92	567	22.7	69.8	0.93
chr14	71334580	71335268	CpG: 77	688	77	467	22.4	67.9	0.97
chr14	71349330	71351749	CpG: 196	2419	196	1618	16.2	66.9	0.72
chr14	71391562	71391782	CpG: 23	220	23	165	20.9	75.0	0.79
chr14	71479735	71480774	CpG: 116	1039	116	765	22.3	73.6	0.83
chr14	71481224	71481461	CpG: 17	237	17	143	14.3	60.3	0.80
chr14	71529710	71531272	CpG: 139	1562	139	1054	17.8	67.5	0.78
chr14	71586133	71586778	CpG: 68	645	68	457	21.1	70.9	0.84
chr14	71666910	71667636	CpG: 51	726	51	434	14.0	59.8	0.81
chr14	71685035	71685358	CpG: 25	323	25	216	15.5	66.9	0.70
chr14	71707613	71708712	CpG: 146	1099	146	828	26.6	75.3	0.94
chr14	71775869	71776103	CpG: 19	234	19	142	16.2	60.7	0.91
chr14	71825603	71826269	CpG: 79	666	79	490	23.7	73.6	0.88
chr14	71851178	71851670	CpG: 39	492	39	318	15.9	64.6	0.77
chr14	71917066	71917562	CpG: 48	496	48	301	19.4	60.7	1.05
chr14	71956600	71957212	CpG: 50	612	50	449	16.3	73.4	0.61
chr14	71970059	71970580	CpG: 52	521	52	330	20.0	63.3	1.00
chr14	71990794	71991072	CpG: 25	278	25	176	18.0	63.3	0.91
chr14	72008999	72009387	CpG: 50	388	50	287	25.8	74.0	0.94
chr14	72016088	72016362	CpG: 22	274	22	172	16.1	62.8	0.82
chr14	72175110	72175529	CpG: 37	419	37	285	17.7	68.0	0.78
chr14	72189890	72190458	CpG: 50	568	50	403	17.6	71.0	0.70
chr14	72202667	72203480	CpG: 60	813	60	555	14.8	68.3	0.63
chr14	72223013	72223218	CpG: 18	205	18	145	17.6	70.7	0.73
chr14	72289576	72289804	CpG: 18	228	18	138	15.8	60.5	0.88
chr14	73088576	73088851	CpG: 23	275	23	170	16.7	61.8	0.88
chr14	73147493	73147758	CpG: 22	265	22	168	16.6	63.4	0.83
chr14	73257260	73257533	CpG: 23	273	23	167	16.8	61.2	0.91
chr14	73488709	73489615	CpG: 76	906	76	584	16.8	64.5	0.81
chr14	73523969	73524396	CpG: 33	427	33	257	15.5	60.2	0.86
chr14	73575348	73575621	CpG: 22	273	22	168	16.1	61.5	0.87
chr14	73651389	73651605	CpG: 18	216	18	133	16.7	61.6	0.90
chr14	74003272	74003534	CpG: 20	262	20	160	15.3	61.1	0.82
chr14	74028237	74028477	CpG: 20	240	20	150	16.7	62.5	0.87
chr14	74071746	74072063	CpG: 23	317	23	183	14.5	57.7	0.88
chr14	74074854	74075120	CpG: 23	266	23	167	17.3	62.8	0.89
chr14	74107823	74108105	CpG: 27	282	27	180	19.1	63.8	0.95
chr14	74244513	74244787	CpG: 23	274	23	170	16.8	62.0	0.88
chr14	74838313	74838594	CpG: 23	281	23	174	16.4	61.9	0.87
chr14	74885479	74885755	CpG: 24	276	24	171	17.4	62.0	0.92
chr14	74976329	74976615	CpG: 23	286	23	177	16.1	61.9	0.85
chr14	75113057	75113331	CpG: 25	274	25	172	18.2	62.8	0.94
chr14	75153526	75153941	CpG: 30	415	30	270	14.5	65.1	0.69
chr14	75166204	75166435	CpG: 19	231	19	137	16.5	59.3	0.94
chr14	75167120	75167387	CpG: 25	267	25	180	18.7	67.4	0.83
chr14	75185292	75185562	CpG: 22	270	22	168	16.3	62.2	0.85
chr14	75197167	75197441	CpG: 20	274	20	167	14.6	60.9	0.81
chr14	75284981	75285211	CpG: 20	230	20	141	17.4	61.3	0.93
chr14	75326552	75326771	CpG: 22	219	22	132	20.1	60.3	1.11
chr14	75342944	75343225	CpG: 23	281	23	174	16.4	61.9	0.87
chr14	75432215	75433713	CpG: 174	1498	174	1008	23.2	67.3	1.03
chr14	75456603	75456974	CpG: 31	371	31	273	16.7	73.6	0.62
chr14	75650471	75651611	CpG: 136	1140	136	825	23.9	72.4	0.92
chr14	75677884	75678479	CpG: 47	595	47	413	15.8	69.4	0.66
chr14	75748841	75749524	CpG: 52	683	52	448	15.2	65.6	0.73
chr14	75839169	75839717	CpG: 55	548	55	408	20.1	74.5	0.72
chr14	75865029	75865305	CpG: 23	276	23	170	16.7	61.6	0.89
chr14	76045037	76045389	CpG: 29	352	29	255	16.5	72.4	0.63
chr14	76075348	76075554	CpG: 17	206	17	121	16.5	58.7	0.96
chr14	76299748	76299992	CpG: 18	244	18	144	14.8	59.0	0.88
chr14	77097698	77097934	CpG: 20	236	20	144	16.9	61.0	0.94
chr14	77201873	77202154	CpG: 24	281	24	175	17.1	62.3	0.90
chr14	77215049	77215327	CpG: 24	278	24	173	17.3	62.2	0.90
chr14	77304406	77304787	CpG: 37	381	37	277	19.4	72.7	0.74
chr14	77305537	77305757	CpG: 17	220	17	125	15.5	56.8	0.99
chr14	77477639	77477922	CpG: 24	283	24	174	17.0	61.5	0.91
chr14	77737517	77737799	CpG: 27	282	27	178	19.1	63.1	0.97
chr14	77840591	77840865	CpG: 25	274	25	169	18.2	61.7	0.97
chr14	77852748	77852985	CpG: 19	237	19	144	16.0	60.8	0.87
chr14	78065904	78066138	CpG: 19	234	19	141	16.2	60.3	0.90
chr14	78094724	78095017	CpG: 25	293	25	180	17.1	61.4	0.92
chr14	78183804	78184070	CpG: 19	266	19	162	14.3	60.9	0.78
chr14	78363837	78364078	CpG: 19	241	19	151	15.8	62.7	0.84
chr14	78612841	78613437	CpG: 71	596	71	448	23.8	75.2	0.84
chr14	78725187	78725523	CpG: 24	336	24	182	14.3	54.2	1.01
chr14	78814186	78814422	CpG: 21	236	21	144	17.8	61.0	0.97
chr14	79026008	79026285	CpG: 24	277	24	171	17.3	61.7	0.92
chr14	79098246	79098458	CpG: 16	212	16	128	15.1	60.4	0.84
chr14	79512098	79512383	CpG: 25	285	25	178	17.5	62.5	0.91
chr14	79589821	79590077	CpG: 21	256	21	152	16.4	59.4	0.95
chr14	79646308	79646578	CpG: 20	270	20	163	14.8	60.4	0.82
chr14	79689813	79690050	CpG: 20	237	20	144	16.9	60.8	0.93
chr14	79717418	79717686	CpG: 19	268	19	160	14.2	59.7	0.81
chr14	79743796	79744260	CpG: 45	464	45	295	19.4	63.6	0.97
chr14	79744769	79745938	CpG: 91	1169	91	703	15.6	60.1	0.87
chr14	79746833	79747779	CpG: 113	946	113	673	23.9	71.1	0.95
chr14	79903274	79903540	CpG: 22	266	22	165	16.5	62.0	0.88
chr14	80035131	80035371	CpG: 18	240	18	144	15.0	60.0	0.85
chr14	80043476	80043935	CpG: 39	459	39	333	17.0	72.5	0.65
chr14	80058414	80058644	CpG: 21	230	21	142	18.3	61.7	0.97
chr14	80090282	80090561	CpG: 25	279	25	175	17.9	62.7	0.92
chr14	80099524	80099816	CpG: 22	292	22	176	15.1	60.3	0.83
chr14	80313187	80313472	CpG: 24	285	24	178	16.8	62.5	0.88
chr14	80460302	80460525	CpG: 18	223	18	139	16.1	62.3	0.85
chr14	80474765	80474980	CpG: 17	215	17	130	15.8	60.5	0.88
chr14	80614760	80615121	CpG: 25	361	25	206	13.9	57.1	0.86
chr14	80984115	80984353	CpG: 19	238	19	146	16.0	61.3	0.87
chr14	81086569	81086806	CpG: 21	237	21	146	17.7	61.6	0.95
chr14	81095899	81096180	CpG: 25	281	25	177	17.8	63.0	0.91
chr14	81126402	81126986	CpG: 54	584	54	422	18.5	72.3	0.71
chr14	81253969	81254244	CpG: 20	275	20	163	14.5	59.3	0.84
chr14	81310585	81310863	CpG: 24	278	24	174	17.3	62.6	0.89
chr14	81351806	81352085	CpG: 20	279	20	169	14.3	60.6	0.79
chr14	81356583	81356823	CpG: 17	240	17	140	14.2	58.3	0.85
chr14	81504302	81504576	CpG: 24	274	24	171	17.5	62.4	0.91
chr14	81668912	81669204	CpG: 26	292	26	183	17.8	62.7	0.92
chr14	81885263	81885533	CpG: 20	270	20	163	14.8	60.4	0.83
chr14	81973614	81973888	CpG: 25	274	25	174	18.2	63.5	0.91
chr14	82213184	82213977	CpG: 87	793	87	532	21.9	67.1	0.98
chr14	82337668	82337933	CpG: 19	265	19	165	14.3	62.3	0.75
chr14	82440772	82441052	CpG: 24	280	24	173	17.1	61.8	0.91
chr14	82544180	82545125	CpG: 116	945	116	696	24.6	73.7	0.91
chr14	82547435	82547947	CpG: 36	512	36	323	14.1	63.1	0.71
chr14	82606498	82606899	CpG: 38	401	38	278	19.0	69.3	0.79
chr14	82699651	82701002	CpG: 134	1351	134	925	19.8	68.5	0.85
chr14	82772138	82772659	CpG: 44	521	44	336	16.9	64.5	0.81
chr14	82775327	82775977	CpG: 101	650	101	515	31.1	79.2	0.99
chr14	82783658	82784418	CpG: 97	760	97	567	25.5	74.6	0.94
chr14	82907815	82908081	CpG: 23	266	23	167	17.3	62.8	0.89
chr14	83015665	83016856	CpG: 151	1191	151	860	25.4	72.2	0.98
chr14	83048179	83048616	CpG: 41	437	41	302	18.8	69.1	0.79
chr14	83050030	83050264	CpG: 19	234	19	139	16.2	59.4	0.96
chr14	83166080	83166321	CpG: 22	241	22	147	18.3	61.0	1.00
chr14	83202186	83202426	CpG: 23	240	23	150	19.2	62.5	1.00
chr14	83250436	83251683	CpG: 110	1247	110	823	17.6	66.0	0.81
chr14	83335311	83335555	CpG: 27	244	27	181	22.1	74.2	0.81
chr14	83386198	83386512	CpG: 22	314	22	205	14.0	65.3	0.66
chr14	83445569	83445799	CpG: 20	230	20	141	17.4	61.3	0.95
chr14	83520924	83521158	CpG: 17	234	17	137	14.5	58.5	0.88
chr14	83639796	83641653	CpG: 220	1857	220	1318	23.7	71.0	0.94
chr14	83835344	83835618	CpG: 19	274	19	168	13.9	61.3	0.75
chr14	83842841	83843187	CpG: 57	346	57	276	32.9	79.8	1.04
chr14	83869173	83869412	CpG: 22	239	22	148	18.4	61.9	0.98
chr14	83925098	83925825	CpG: 80	727	80	499	22.0	68.6	0.93
chr14	83962704	83962974	CpG: 19	270	19	165	14.1	61.1	0.76
chr14	84115964	84116222	CpG: 35	258	35	191	27.1	74.0	0.99
chr14	84120281	84120524	CpG: 21	243	21	151	17.3	62.1	0.90
chr14	84178752	84179027	CpG: 25	275	25	177	18.2	64.4	0.97
chr14	84179994	84180868	CpG: 87	874	87	573	19.9	65.6	0.93
chr14	84194098	84194376	CpG: 23	278	23	173	16.5	62.2	0.86
chr14	84281735	84282012	CpG: 24	277	24	176	17.3	63.5	0.87
chr14	84284555	84286809	CpG: 250	2254	250	1607	22.2	71.3	0.87
chr14	84423636	84423911	CpG: 24	275	24	171	17.5	62.2	0.91
chr14	84436696	84436923	CpG: 18	227	18	132	15.9	58.1	0.94
chr14	84475082	84475360	CpG: 22	278	22	174	15.8	62.6	0.82
chr14	84480760	84481207	CpG: 40	447	40	301	17.9	67.3	0.80
chr14	84481920	84482138	CpG: 19	218	19	129	17.4	59.2	1.02
chr14	84550954	84551227	CpG: 23	273	23	170	16.8	62.3	0.89
chr14	84556556	84556961	CpG: 36	405	36	270	17.8	66.7	0.84
chr14	84607380	84608767	CpG: 116	1387	116	839	16.7	60.5	0.92
chr14	84621426	84623286	CpG: 191	1860	191	1315	20.5	70.7	0.82
chr14	84750575	84750790	CpG: 29	215	29	149	27.0	69.3	1.12
chr14	84766512	84766717	CpG: 18	205	18	138	17.6	67.3	0.78
chr14	84798508	84798764	CpG: 23	256	23	178	18.0	69.5	0.89
chr14	84846283	84846604	CpG: 31	321	31	218	19.3	67.9	0.92
chr14	84943997	84944278	CpG: 23	281	23	175	16.4	62.3	0.86
chr14	84983718	84984236	CpG: 62	518	62	379	23.9	73.2	0.93
chr14	85022626	85022900	CpG: 24	274	24	171	17.5	62.4	0.91
chr14	85029667	85029877	CpG: 14	210	14	123	13.3	58.6	0.79
chr14	85041495	85042216	CpG: 108	721	108	592	30.0	82.1	0.89
chr14	85053784	85054038	CpG: 33	254	33	176	26.0	69.3	1.10
chr14	85059304	85059575	CpG: 22	271	22	166	16.2	61.3	0.88
chr14	85081251	85081491	CpG: 17	240	17	136	14.2	56.7	0.90
chr14	85110991	85111283	CpG: 21	292	21	164	14.4	56.2	0.95
chr14	85229694	85229950	CpG: 20	256	20	157	15.6	61.3	0.85
chr14	85230275	85230514	CpG: 17	239	17	144	14.2	60.3	0.79
chr14	85284487	85284732	CpG: 21	245	21	160	17.1	65.3	0.81
chr14	85285332	85286651	CpG: 145	1319	145	918	22.0	69.6	0.92
chr14	85415476	85415750	CpG: 25	274	25	173	18.2	63.1	0.93
chr14	85459235	85460392	CpG: 87	1157	87	771	15.0	66.6	0.68
chr14	85478714	85479366	CpG: 93	652	93	495	28.5	75.9	0.99
chr14	85489886	85490184	CpG: 49	298	49	243	32.9	81.5	0.99
chr14	85498039	85498288	CpG: 22	249	22	167	17.7	67.1	0.79
chr14	85501319	85501592	CpG: 26	273	26	170	19.0	62.3	0.99
chr14	85514412	85514696	CpG: 26	284	26	188	18.3	66.2	0.85
chr14	85529008	85529317	CpG: 28	309	28	203	18.1	65.7	0.85
chr14	85642257	85642462	CpG: 16	205	16	109	15.6	53.2	1.22
chr14	85642568	85644264	CpG: 189	1696	189	1218	22.3	71.8	0.86
chr14	85645247	85645459	CpG: 16	212	16	128	15.1	60.4	0.84
chr14	85661792	85662114	CpG: 25	322	25	187	15.5	58.1	0.93
chr14	85734574	85736230	CpG: 194	1656	194	1197	23.4	72.3	0.90
chr14	85782517	85783448	CpG: 71	931	71	657	15.3	70.6	0.61
chr14	85799276	85799741	CpG: 54	465	54	327	23.2	70.3	0.94
chr14	85874714	85874956	CpG: 21	242	21	145	17.4	59.9	0.97
chr14	85878530	85878764	CpG: 22	234	22	145	18.8	62.0	1.01
chr14	86065318	86066255	CpG: 103	937	103	700	22.0	74.7	0.79
chr14	86176697	86177440	CpG: 67	743	67	483	18.0	65.0	0.86
chr14	86181429	86181652	CpG: 18	223	18	136	16.1	61.0	0.88
chr14	86269134	86269947	CpG: 71	813	71	493	17.5	60.6	0.95
chr14	86335750	86336299	CpG: 62	549	62	390	22.6	71.0	0.91
chr14	86336589	86336835	CpG: 17	246	17	145	13.8	58.9	0.81
chr14	86351031	86352513	CpG: 119	1482	119	906	16.1	61.1	0.87
chr14	86417275	86417661	CpG: 28	386	28	267	14.5	69.2	0.61
chr14	86424402	86424632	CpG: 16	230	16	140	13.9	60.9	0.77
chr14	86552315	86552606	CpG: 21	291	21	191	14.4	65.6	0.68
chr14	86552792	86554114	CpG: 149	1322	149	952	22.5	72.0	0.87
chr14	86710077	86710333	CpG: 20	256	20	155	15.6	60.5	0.87
chr14	86742931	86744468	CpG: 157	1537	157	1091	20.4	71.0	0.81
chr14	86871691	86871897	CpG: 15	206	15	129	14.6	62.6	0.80
chr14	86918724	86920202	CpG: 134	1478	134	1039	18.1	70.3	0.73
chr14	86978522	86978796	CpG: 21	274	21	170	15.3	62.0	0.82
chr14	86980191	86980502	CpG: 36	311	36	220	23.2	70.7	0.95
chr14	87025720	87026337	CpG: 67	617	67	435	21.7	70.5	0.87
chr14	87028445	87028730	CpG: 26	285	26	182	18.2	63.9	0.91
chr14	87154885	87155713	CpG: 86	828	86	604	20.8	72.9	0.78
chr14	87290419	87291069	CpG: 44	650	44	470	13.5	72.3	0.87
chr14	87346730	87348443	CpG: 212	1713	212	1286	24.8	75.1	0.88
chr14	87366006	87366222	CpG: 15	216	15	129	13.9	59.7	0.80
chr14	87403030	87403266	CpG: 18	236	18	141	15.3	59.7	0.88
chr14	87416339	87417246	CpG: 122	907	122	694	26.9	76.5	0.92
chr14	87438673	87439462	CpG: 80	789	80	535	20.3	67.8	0.89
chr14	87455491	87455831	CpG: 27	340	27	221	15.9	65.0	0.76
chr14	87564246	87565337	CpG: 137	1091	137	783	25.1	71.8	1.00
chr14	87579010	87579704	CpG: 66	694	66	470	19.0	67.7	0.83
chr14	87657689	87658543	CpG: 64	854	64	547	15.0	64.1	0.73
chr14	88014969	88016762	CpG: 168	1793	168	1232	18.7	68.7	0.81
chr14	88031659	88031935	CpG: 23	276	23	170	16.7	61.6	0.89
chr14	88166198	88167183	CpG: 121	985	121	697	24.6	70.8	0.98
chr14	88189461	88189681	CpG: 19	220	19	132	17.3	60.0	0.97
chr14	88253608	88254266	CpG: 77	658	77	478	23.4	72.6	0.89
chr14	88307906	88308636	CpG: 80	730	80	472	21.9	64.7	1.05
chr14	88401277	88402584	CpG: 138	1307	138	976	21.1	74.7	0.78
chr14	88445594	88446016	CpG: 44	422	44	278	20.9	65.9	1.39
chr14	88460105	88460330	CpG: 17	225	17	134	15.1	59.6	0.87
chr14	88573291	88573702	CpG: 31	411	31	279	15.1	67.9	0.66
chr14	88724588	88724854	CpG: 22	266	22	165	16.5	62.0	0.87
chr14	88887681	88888460	CpG: 65	779	65	548	16.7	70.3	0.67
chr14	88998339	89000296	CpG: 200	1957	200	1296	20.4	66.2	0.93
chr14	89001349	89001938	CpG: 49	589	49	373	16.6	63.3	0.83
chr14	89003102	89003406	CpG: 35	304	35	197	23.0	64.8	1.10
chr14	89003810	89004068	CpG: 21	258	21	146	16.3	56.6	1.02
chr14	89094720	89094932	CpG: 23	212	23	144	21.7	67.9	0.94
chr14	89147947	89148290	CpG: 27	343	27	198	15.7	57.7	0.95
chr14	89211092	89211322	CpG: 18	230	18	138	15.7	60.0	0.88
chr14	89386961	89388101	CpG: 151	1140	151	856	26.5	75.1	0.94
chr14	89549404	89550553	CpG: 128	1149	128	828	22.3	72.1	0.86
chr14	89590528	89590794	CpG: 33	266	33	188	24.8	70.7	1.00
chr14	89619135	89619414	CpG: 25	279	25	176	17.9	63.1	0.91
chr14	89746782	89747901	CpG: 110	1119	110	805	19.7	71.9	0.76
chr14	89765031	89766220	CpG: 132	1189	132	820	22.2	69.0	0.93
chr14	89786315	89786588	CpG: 24	273	24	169	17.6	61.9	0.93
chr14	89912428	89912700	CpG: 22	272	22	167	16.2	61.4	0.87
chr14	89917900	89918172	CpG: 21	272	21	183	15.4	67.3	0.68
chr14	89932891	89933131	CpG: 20	240	20	145	16.7	60.4	0.94
chr14	89945504	89946096	CpG: 53	592	53	412	17.9	69.6	0.74
chr14	90107383	90108744	CpG: 162	1361	162	1022	23.8	75.1	0.85
chr14	90270206	90271329	CpG: 122	1123	122	809	21.7	72.0	0.84
chr14	90431100	90431378	CpG: 20	278	20	171	14.4	61.5	0.77
chr14	90594599	90595593	CpG: 113	994	113	723	22.7	72.7	0.87
chr14	90622814	90623986	CpG: 109	1172	109	799	18.6	68.2	0.82
chr14	90655703	90655906	CpG: 28	203	28	155	27.6	76.4	0.95
chr14	90717461	90717680	CpG: 18	219	18	132	16.4	60.3	0.93
chr14	90730061	90730298	CpG: 17	237	17	137	14.3	57.8	0.89
chr14	90733420	90734637	CpG: 123	1217	123	820	20.2	67.4	0.89
chr14	90738911	90739177	CpG: 25	266	25	167	18.8	62.8	0.96
chr14	90823997	90824781	CpG: 64	784	64	507	16.3	64.7	0.79
chr14	90825673	90825911	CpG: 19	238	19	144	16.0	60.5	0.91
chr14	90973168	90973725	CpG: 58	557	58	402	20.8	72.2	0.81
chr14	91028319	91028552	CpG: 19	233	19	141	16.3	60.5	0.90
chr14	91029012	91029901	CpG: 105	889	105	627	23.6	70.5	0.95
chr14	91265088	91265659	CpG: 62	571	62	410	21.7	71.8	0.85
chr14	91450572	91451459	CpG: 73	887	73	566	16.5	63.8	0.81
chr14	91455167	91455441	CpG: 24	274	24	171	17.5	62.4	0.91
chr14	91493031	91493305	CpG: 25	274	25	171	18.2	62.4	0.95
chr14	91650601	91650878	CpG: 22	277	22	175	15.9	63.2	0.81
chr14	91960838	91961114	CpG: 20	276	20	170	14.5	61.6	0.77
chr14	92221079	92221345	CpG: 27	266	27	170	20.3	63.9	1.00
chr14	92480333	92480597	CpG: 24	264	24	164	18.2	62.1	0.95
chr14	92696642	92696907	CpG: 21	265	21	167	15.8	63.0	0.81
chr14	92756591	92756853	CpG: 19	262	19	157	14.5	59.9	0.82
chr14	93009164	93009403	CpG: 18	239	18	147	15.1	61.5	0.83
chr14	93202508	93202774	CpG: 20	266	20	168	15.0	63.2	0.78
chr14	93349771	93350376	CpG: 53	605	53	361	17.5	59.7	0.99
chr14	93405580	93407987	CpG: 283	2407	283	1709	23.5	71.0	0.94
chr14	93462890	93463272	CpG: 30	382	30	269	15.7	70.4	0.65
chr14	93477069	93478663	CpG: 133	1594	133	1105	16.7	69.3	0.70
chr14	93501273	93506674	CpG: 384	5401	384	3289	14.2	60.9	0.77
chr14	93533302	93533576	CpG: 21	274	21	168	15.3	61.3	0.82
chr14	93552062	93552283	CpG: 19	221	19	159	17.2	71.9	0.68
chr14	93579751	93580321	CpG: 45	570	45	360	15.8	63.2	0.92
chr14	93651049	93651323	CpG: 24	274	24	170	17.5	62.0	0.92
chr14	93711394	93713421	CpG: 226	2027	226	1423	22.3	70.2	0.91
chr14	93834581	93837059	CpG: 327	2478	327	1856	26.4	74.9	0.94
chr14	93876367	93877075	CpG: 89	708	89	514	25.1	72.6	0.96
chr14	93883982	93884293	CpG: 22	311	22	202	14.1	65.0	0.67
chr14	93890749	93891774	CpG: 100	1025	100	737	19.5	71.9	0.79
chr14	93906501	93907165	CpG: 89	664	89	498	26.8	75.0	0.95
chr14	93913637	93913873	CpG: 17	236	17	143	14.4	60.6	0.81
chr14	93914833	93916280	CpG: 142	1447	142	1022	19.6	70.6	0.80
chr14	93961543	93961994	CpG: 59	451	59	358	26.2	79.4	0.86
chr14	93969132	93969354	CpG: 20	222	20	160	18.0	72.1	0.70
chr14	93988308	93988767	CpG: 31	459	31	264	13.5	57.5	0.82
chr14	94002281	94002517	CpG: 19	236	19	142	16.1	60.2	0.91
chr14	94024259	94025328	CpG: 174	1069	174	859	32.6	80.4	1.01
chr14	94168097	94168326	CpG: 21	229	21	138	18.3	60.3	1.01
chr14	94204085	94205567	CpG: 192	1482	192	1135	25.9	76.6	0.88
chr14	94211204	94211430	CpG: 18	226	18	136	15.9	60.2	0.89
chr14	94293202	94293477	CpG: 24	275	24	171	17.5	62.2	0.92
chr14	94377117	94377402	CpG: 21	285	21	180	14.7	63.2	0.74
chr14	94382251	94382657	CpG: 41	406	41	279	20.2	68.7	0.86
chr14	94392030	94393172	CpG: 143	1142	143	858	25.0	75.1	0.89
chr14	94398426	94398696	CpG: 25	270	25	180	18.5	66.7	0.84
chr14	94399892	94400162	CpG: 21	270	21	163	15.6	60.4	0.87
chr14	94403490	94403760	CpG: 19	270	19	164	14.1	60.7	0.77
chr14	94410943	94411298	CpG: 31	355	31	259	17.5	73.0	0.66
chr14	94424153	94424503	CpG: 24	350	24	202	13.7	57.7	0.83
chr14	94425807	94426322	CpG: 57	515	57	366	22.1	71.1	0.88
chr14	94440463	94440691	CpG: 19	228	19	127	16.7	55.7	1.10
chr14	94441234	94441571	CpG: 32	337	32	251	19.0	74.5	0.69
chr14	94446975	94447873	CpG: 97	898	97	663	21.6	73.8	0.79
chr14	94471072	94473776	CpG: 398	2704	398	2033	29.4	75.2	1.04
chr14	94476869	94477108	CpG: 18	239	18	143	15.1	59.8	0.87
chr14	94518364	94519031	CpG: 72	667	72	513	21.6	76.9	0.74
chr14	94525306	94526137	CpG: 94	831	94	595	22.6	71.6	0.88
chr14	94538517	94540370	CpG: 227	1853	227	1380	24.5	74.5	0.89
chr14	94561760	94562064	CpG: 22	304	22	208	14.5	68.4	0.62
chr14	94562306	94562689	CpG: 26	383	26	257	13.6	67.1	0.61
chr14	94577228	94578233	CpG: 82	1005	82	714	16.3	71.0	0.65
chr14	94609100	94609692	CpG: 71	592	71	421	24.0	71.1	0.95
chr14	94646200	94646474	CpG: 21	274	21	168	15.3	61.3	0.83
chr14	94746750	94746987	CpG: 19	237	19	143	16.0	60.3	0.91
chr14	94771531	94773145	CpG: 147	1614	147	1151	18.2	71.3	0.73
chr14	94780105	94780598	CpG: 77	493	77	392	31.2	79.5	1.04
chr14	94801083	94803038	CpG: 228	1955	228	1466	23.3	75.0	0.83
chr14	94820163	94821528	CpG: 157	1365	157	1022	23.0	74.9	0.82
chr14	94888499	94888856	CpG: 32	357	32	265	17.9	74.2	0.65
chr14	94934479	94934764	CpG: 22	285	22	177	15.4	62.1	0.82
chr14	94943762	94944834	CpG: 79	1072	79	705	14.7	65.8	0.68
chr14	94960949	94962313	CpG: 140	1364	140	923	20.5	67.7	0.90
chr14	94969195	94969507	CpG: 26	312	26	213	16.7	68.3	0.72
chr14	94970137	94970341	CpG: 15	204	15	107	14.7	52.5	1.11
chr14	95059074	95059419	CpG: 30	345	30	224	17.4	64.9	0.83
chr14	95060594	95061260	CpG: 45	666	45	420	13.5	63.1	0.68
chr14	95061414	95061652	CpG: 18	238	18	139	15.1	58.4	0.93
chr14	95061978	95063175	CpG: 87	1197	87	780	14.5	65.2	0.72
chr14	95118471	95118959	CpG: 36	488	36	294	14.8	60.2	0.83
chr14	95140030	95140343	CpG: 30	313	30	227	19.2	72.5	0.77
chr14	95300693	95301434	CpG: 48	741	48	424	13.0	57.2	0.80
chr14	95465387	95465743	CpG: 39	356	39	285	21.9	80.1	0.87
chr14	95600564	95600968	CpG: 29	404	29	268	14.4	66.3	0.65
chr14	95678116	95678357	CpG: 21	241	21	167	17.4	69.3	0.73
chr14	95678934	95679158	CpG: 18	224	18	134	16.1	59.8	0.94
chr14	95692909	95695329	CpG: 264	2420	264	1764	21.8	72.9	0.82
chr14	95761629	95761839	CpG: 15	210	15	134	14.3	63.8	0.70
chr14	95794906	95800484	CpG: 509	5578	509	3754	18.3	67.3	0.81
chr14	95819515	95820427	CpG: 67	912	67	548	14.7	60.1	0.81
chr14	95822785	95823080	CpG: 25	295	25	161	16.9	54.6	1.16
chr14	95827508	95827720	CpG: 17	212	17	130	16.0	61.3	0.87
chr14	95837487	95837727	CpG: 18	240	18	161	15.0	67.1	0.69
chr14	95863967	95864317	CpG: 39	350	39	245	22.3	70.0	0.91
chr14	95870278	95870709	CpG: 41	431	41	301	19.0	69.8	0.78
chr14	95878431	95878676	CpG: 20	245	20	146	16.3	59.6	0.94
chr14	95941115	95941817	CpG: 75	702	75	539	21.4	76.8	0.73
chr14	95996152	95998255	CpG: 236	2103	236	1577	22.4	75.0	0.88
chr14	96017066	96017685	CpG: 64	619	64	456	20.7	73.7	0.79
chr14	96127135	96127349	CpG: 17	214	17	138	15.9	64.5	0.77
chr14	96160876	96161130	CpG: 26	254	26	155	20.5	61.0	1.11
chr14	96164049	96164400	CpG: 25	351	25	213	14.2	60.7	0.78
chr14	96168020	96168248	CpG: 18	228	18	139	15.8	61.0	0.87
chr14	96182683	96183096	CpG: 28	413	28	242	13.6	58.6	0.80
chr14	96183532	96184497	CpG: 73	965	73	602	15.1	62.4	0.79
chr14	96185306	96185541	CpG: 19	235	19	145	16.2	61.7	0.86
chr14	96188013	96188220	CpG: 16	207	16	125	15.5	60.4	0.86
chr14	96191430	96191635	CpG: 24	205	24	149	23.4	72.7	0.89
chr14	96199865	96201176	CpG: 148	1311	148	950	22.6	72.5	0.86
chr14	96239574	96239810	CpG: 18	236	18	140	15.3	59.3	0.89
chr14	96251485	96251687	CpG: 16	202	16	125	15.8	61.9	0.86
chr14	96321976	96323323	CpG: 177	1347	177	985	26.3	73.1	0.99
chr14	96362173	96362417	CpG: 17	244	17	144	13.9	59.0	0.82
chr14	96371079	96371467	CpG: 34	388	34	281	17.5	72.4	0.67
chr14	96374843	96376223	CpG: 112	1380	112	934	16.2	67.7	0.72
chr14	96408099	96408649	CpG: 50	550	50	418	18.2	76.0	0.63
chr14	96411952	96412187	CpG: 16	235	16	127	13.6	54.0	0.93
chr14	96449552	96449784	CpG: 16	232	16	154	13.8	66.4	0.65
chr14	96464720	96465069	CpG: 32	349	32	226	18.3	64.8	0.88
chr14	96521620	96521965	CpG: 28	345	28	203	16.2	58.8	0.94
chr14	96540380	96540982	CpG: 45	602	45	387	15.0	64.3	0.75
chr14	96549889	96550340	CpG: 41	451	41	293	18.2	65.0	0.86
chr14	96552562	96552950	CpG: 37	388	37	248	19.1	63.9	0.95
chr14	96555187	96555795	CpG: 83	608	83	461	27.3	75.8	0.95
chr14	96598414	96599131	CpG: 91	717	91	532	25.4	74.2	0.96
chr14	96742882	96746486	CpG: 367	3604	367	2523	20.4	70.0	0.83
chr14	96752067	96752300	CpG: 17	233	17	141	14.6	60.5	0.81
chr14	96752517	96753513	CpG: 120	996	120	771	24.1	77.4	0.81
chr14	96780370	96781211	CpG: 92	841	92	627	21.9	74.6	0.79
chr14	96790918	96791577	CpG: 80	659	80	486	24.3	73.7	0.89
chr14	96798058	96798332	CpG: 26	274	26	173	19.0	63.1	0.96
chr14	96827814	96829932	CpG: 247	2118	247	1563	23.3	73.8	0.86
chr14	96849665	96849928	CpG: 23	263	23	164	17.5	62.4	0.91
chr14	96999697	97000016	CpG: 27	319	27	191	16.9	59.9	0.95
chr14	97013166	97014716	CpG: 263	1550	263	1249	33.9	80.6	1.06
chr14	97037216	97037478	CpG: 26	262	26	165	19.8	63.0	1.01
chr14	97048954	97049228	CpG: 21	274	21	167	15.3	60.9	0.84
chr14	97136191	97136478	CpG: 20	287	20	159	13.9	55.4	0.94
chr14	97143747	97144050	CpG: 27	303	27	208	17.8	68.6	0.76
chr14	97157997	97158217	CpG: 16	220	16	125	14.5	56.8	0.91
chr14	97158906	97160156	CpG: 105	1250	105	868	16.8	69.4	0.70
chr14	97164305	97166978	CpG: 292	2673	292	1965	21.8	73.5	0.81
chr14	97176114	97176591	CpG: 36	477	36	302	15.1	63.3	0.75
chr14	97200446	97200699	CpG: 24	253	24	175	19.0	69.2	0.80
chr14	97213288	97213560	CpG: 20	272	20	162	14.7	59.6	0.84
chr14	97292796	97294401	CpG: 211	1605	211	1217	26.3	75.8	0.92
chr14	97311617	97312262	CpG: 77	645	77	483	23.9	74.9	0.86
chr14	97313890	97314126	CpG: 20	236	20	144	16.9	61.0	0.92
chr14	97320359	97320833	CpG: 56	474	56	359	23.6	75.7	0.87
chr14	97327520	97328149	CpG: 63	629	63	462	20.0	73.4	0.74
chr14	97338295	97341447	CpG: 278	3152	278	2121	17.6	67.3	0.79
chr14	97358932	97359825	CpG: 98	893	98	661	21.9	74.0	0.80
chr14	97362813	97363502	CpG: 104	689	104	540	30.2	78.4	1.02
chr14	97368838	97369156	CpG: 24	318	24	164	15.1	51.6	1.14
chr14	97374118	97375083	CpG: 79	965	79	703	16.4	72.8	0.63
chr14	97388668	97388934	CpG: 20	266	20	160	15.0	60.2	0.85
chr14	97424823	97425689	CpG: 98	866	98	646	22.6	74.6	0.82
chr14	97443013	97443931	CpG: 102	918	102	670	22.2	73.0	0.84
chr14	97456150	97456968	CpG: 101	818	101	618	24.7	75.6	0.87
chr14	97508998	97510582	CpG: 152	1584	152	1099	19.2	69.4	0.80
chr14	97514599	97515963	CpG: 153	1364	153	982	22.4	72.0	0.87
chr14	97569327	97571183	CpG: 229	1856	229	1295	24.7	69.8	1.02
chr14	97589672	97589945	CpG: 25	273	25	168	18.3	61.5	0.98
chr14	97620815	97622306	CpG: 144	1491	144	992	19.3	66.5	0.87
chr14	97688436	97688710	CpG: 24	274	24	170	17.5	62.0	0.92
chr14	97741810	97742013	CpG: 16	203	16	121	15.8	59.6	0.93
chr14	97756770	97759503	CpG: 333	2733	333	2033	24.4	74.4	0.88
chr14	97764849	97765479	CpG: 69	630	69	438	21.9	69.5	0.92
chr14	97768650	97768909	CpG: 22	259	22	177	17.0	68.3	0.73
chr14	97770594	97770845	CpG: 21	251	21	172	16.7	68.5	0.72
chr14	97798016	97799379	CpG: 161	1363	161	995	23.6	73.0	0.89
chr14	97807879	97808119	CpG: 17	240	17	142	14.2	59.2	0.84
chr14	97840322	97840559	CpG: 18	237	18	142	15.2	59.9	0.87
chr14	97864289	97866209	CpG: 202	1920	202	1388	21.0	72.3	0.80
chr14	97876453	97876727	CpG: 20	274	20	168	14.6	61.3	0.78
chr14	97885784	97886014	CpG: 20	230	20	141	17.4	61.3	0.93
chr14	97909714	97909942	CpG: 16	228	16	135	14.0	59.2	0.82
chr14	97929719	97929939	CpG: 17	220	17	152	15.5	69.1	0.67
chr14	97934761	97934988	CpG: 17	227	17	159	15.0	70.0	0.62
chr14	97950975	97952672	CpG: 211	1697	211	1256	24.9	74.0	0.91
chr14	97963634	97964360	CpG: 60	726	60	484	16.5	66.7	0.74
chr14	97974800	97975059	CpG: 20	259	20	167	15.4	64.5	0.75
chr14	98082946	98084775	CpG: 233	1829	233	1410	25.5	77.1	0.86
chr14	98105162	98105447	CpG: 27	285	27	180	18.9	63.2	0.96
chr14	98133271	98133515	CpG: 19	244	19	148	15.6	60.7	0.88
chr14	98157199	98158081	CpG: 56	882	56	488	12.7	55.3	0.84
chr14	98158554	98159010	CpG: 45	456	45	319	19.7	70.0	0.81
chr14	98165504	98166209	CpG: 91	705	91	528	25.8	74.9	0.92
chr14	98322605	98323378	CpG: 87	773	87	613	22.5	79.3	0.75
chr14	98340492	98340773	CpG: 23	281	23	198	16.4	70.5	0.66
chr14	98354027	98355565	CpG: 179	1538	179	1134	23.3	73.7	0.86
chr14	98372949	98376662	CpG: 417	3713	417	2684	22.5	72.3	0.86
chr14	98393192	98393475	CpG: 27	283	27	203	19.1	71.7	0.74
chr14	98396574	98396848	CpG: 22	274	22	173	16.1	63.1	0.81
chr14	98401792	98402038	CpG: 19	246	19	175	15.4	71.1	0.65
chr14	98409343	98409929	CpG: 53	586	53	414	18.1	70.6	0.73
chr14	98410511	98411160	CpG: 50	649	50	447	15.4	68.9	0.65
chr14	98411738	98411958	CpG: 21	220	21	155	19.1	70.5	0.82
chr14	98416069	98416343	CpG: 25	274	25	200	18.2	73.0	0.70
chr14	98416822	98417031	CpG: 17	209	17	154	16.3	73.7	0.60
chr14	98417226	98417747	CpG: 42	521	42	350	16.1	67.2	0.75
chr14	98460104	98460322	CpG: 19	218	19	149	17.4	68.3	0.75
chr14	98462986	98463282	CpG: 22	296	22	196	14.9	66.2	0.68
chr14	98490800	98493417	CpG: 264	2617	264	1599	20.2	61.1	1.15
chr14	98512116	98512395	CpG: 20	279	20	173	14.3	62.0	0.76
chr14	98575162	98575695	CpG: 40	533	40	330	15.0	61.9	0.79
chr14	98670516	98671969	CpG: 94	1453	94	894	12.9	61.5	0.76
chr14	98703408	98704983	CpG: 128	1575	128	1180	16.3	74.9	0.67
chr14	98716462	98716794	CpG: 30	332	30	227	18.1	68.4	0.82
chr14	98817751	98818005	CpG: 19	254	19	170	15.0	66.9	0.67
chr14	98831317	98831584	CpG: 25	267	25	200	18.7	74.9	0.67
chr14	98846962	98847907	CpG: 101	945	101	668	21.4	70.7	0.89
chr14	98879940	98880216	CpG: 30	276	30	188	21.7	68.1	0.97
chr14	98882909	98883114	CpG: 16	205	16	140	15.6	68.3	0.67
chr14	98892918	98893345	CpG: 43	427	43	309	20.1	72.4	0.77
chr14	98896042	98896537	CpG: 47	495	47	353	19.0	71.3	0.80
chr14	98902696	98903238	CpG: 42	542	42	374	15.5	69.0	0.68
chr14	98920758	98921014	CpG: 25	256	25	188	19.5	73.4	0.74
chr14	98932032	98933085	CpG: 114	1053	114	795	21.7	75.5	0.76
chr14	98943789	98944013	CpG: 17	224	17	149	15.2	66.5	0.71
chr14	98944175	98944641	CpG: 43	466	43	322	18.5	69.1	0.78
chr14	98952946	98953363	CpG: 29	417	29	275	13.9	65.9	0.65
chr14	98955620	98956178	CpG: 40	558	40	389	14.3	69.7	0.60
chr14	98957527	98957960	CpG: 34	433	34	296	15.7	68.4	0.67
chr14	98960074	98960275	CpG: 21	201	21	154	20.9	76.6	0.74
chr14	98963180	98964388	CpG: 124	1208	124	737	20.5	61.0	1.15
chr14	98966469	98967539	CpG: 110	1070	110	792	20.6	74.0	0.75
chr14	98972329	98972769	CpG: 79	440	79	335	35.9	76.1	1.64
chr14	98994386	98996666	CpG: 230	2280	230	1589	20.2	69.7	0.83
chr14	99015812	99016140	CpG: 24	328	24	208	14.6	63.4	0.73
chr14	99016718	99017030	CpG: 26	312	26	214	16.7	68.6	0.74
chr14	99027950	99028166	CpG: 19	216	19	157	17.6	72.7	0.70
chr14	99037872	99038978	CpG: 168	1106	168	890	30.4	80.5	0.95
chr14	99042984	99044378	CpG: 189	1394	189	1054	27.1	75.6	0.95
chr14	99045025	99045303	CpG: 25	278	25	176	18.0	63.3	0.90
chr14	99061331	99062475	CpG: 136	1144	136	829	23.8	72.5	0.92
chr14	99072197	99073444	CpG: 105	1247	105	892	16.8	71.5	0.69
chr14	99089277	99090082	CpG: 71	805	71	552	17.6	68.6	0.77
chr14	99110079	99112216	CpG: 232	2137	232	1581	21.7	74.0	0.79
chr14	99118014	99118404	CpG: 36	390	36	250	18.5	64.1	1.22
chr14	99129743	99130953	CpG: 107	1210	107	868	17.7	71.7	0.71
chr14	99135368	99135598	CpG: 21	230	21	156	18.3	67.8	0.80
chr14	99139382	99139709	CpG: 26	327	26	222	15.9	67.9	0.69
chr14	99151086	99152888	CpG: 139	1802	139	1254	15.4	69.6	0.69
chr14	99177633	99180627	CpG: 266	2994	266	2213	17.8	73.9	0.68
chr14	99189920	99190126	CpG: 15	206	15	130	14.6	63.1	0.76
chr14	99205711	99205947	CpG: 19	236	19	143	16.1	60.6	0.89
chr14	99222208	99223366	CpG: 129	1158	129	846	22.3	73.1	0.84
chr14	99229501	99230702	CpG: 120	1201	120	832	20.0	69.3	0.84
chr14	99236396	99236806	CpG: 44	410	44	279	21.5	68.0	1.26
chr14	99264830	99266134	CpG: 173	1304	173	978	26.5	75.0	0.95
chr14	99278018	99278237	CpG: 46	219	46	154	42.0	70.3	1.79
chr14	99290275	99290527	CpG: 33	252	33	188	26.2	74.6	0.94
chr14	99300370	99300702	CpG: 25	332	25	212	15.1	63.9	0.74
chr14	99323568	99323946	CpG: 37	378	37	280	19.6	74.1	0.71
chr14	99331297	99332946	CpG: 142	1649	142	1172	17.2	71.1	0.69
chr14	99337554	99338471	CpG: 115	917	115	709	25.1	77.3	0.86
chr14	99355686	99355914	CpG: 19	228	19	138	16.7	60.5	0.92
chr14	99377059	99377276	CpG: 15	217	15	127	13.8	58.5	0.82
chr14	99378832	99379054	CpG: 17	222	17	138	15.3	62.2	0.84
chr14	99383669	99383997	CpG: 26	328	26	220	15.9	67.1	0.72
chr14	99384482	99384996	CpG: 52	514	52	365	20.2	71.0	0.81
chr14	99389898	99390440	CpG: 49	542	49	392	18.1	72.3	0.72
chr14	99390865	99391147	CpG: 20	282	20	193	14.2	68.4	0.63
chr14	99392510	99392832	CpG: 28	322	28	232	17.4	72.0	0.68
chr14	99397536	99397845	CpG: 28	309	28	207	18.1	67.0	0.81
chr14	99409139	99411361	CpG: 323	2222	323	1753	29.1	78.9	0.94
chr14	99422820	99423416	CpG: 98	596	98	492	32.9	82.6	1.01
chr14	99434009	99434688	CpG: 51	679	51	480	15.0	70.7	0.77
chr14	99438239	99438865	CpG: 59	626	59	469	18.8	74.9	0.68
chr14	99460977	99461258	CpG: 24	281	24	181	17.1	64.4	0.83
chr14	99494902	99496849	CpG: 219	1947	219	1351	22.5	69.4	0.93
chr14	99518682	99519187	CpG: 47	505	47	360	18.6	71.3	0.76
chr14	99547608	99549046	CpG: 188	1438	188	1078	26.1	75.0	0.93
chr14	99561391	99563079	CpG: 247	1688	247	1313	29.3	77.8	0.97
chr14	99577472	99577801	CpG: 23	329	23	222	14.0	67.5	0.72
chr14	99593955	99594242	CpG: 22	287	22	219	15.3	76.3	0.92
chr14	99598401	99598701	CpG: 27	300	27	216	18.0	72.0	0.71
chr14	99602097	99602312	CpG: 16	215	16	142	14.9	66.0	0.68
chr14	99602648	99602934	CpG: 20	286	20	193	14.0	67.5	0.61
chr14	99611771	99612035	CpG: 46	264	46	223	34.8	84.5	1.14
chr14	99617197	99617552	CpG: 30	355	30	242	16.9	68.2	0.73
chr14	99630884	99631159	CpG: 25	275	25	185	18.2	67.3	0.82
chr14	99632917	99633153	CpG: 18	236	18	162	15.3	68.6	0.65
chr14	99645646	99646631	CpG: 107	985	107	730	21.7	74.1	0.79
chr14	99658536	99659317	CpG: 84	781	84	572	21.5	73.2	0.80
chr14	99662500	99662935	CpG: 60	435	60	309	27.6	71.0	1.09
chr14	99664950	99665173	CpG: 15	223	15	132	13.5	59.2	0.78
chr14	99667205	99668000	CpG: 127	795	127	661	31.9	83.1	0.93
chr14	99692996	99693356	CpG: 25	360	25	240	13.9	66.7	0.63
chr14	99696810	99697220	CpG: 34	410	34	296	16.6	72.2	0.64
chr14	99711030	99712300	CpG: 88	1270	88	834	13.9	65.7	0.64
chr14	99713583	99714239	CpG: 55	656	55	468	16.8	71.3	0.67
chr14	99717069	99717646	CpG: 52	577	52	396	18.0	68.6	0.78
chr14	99721115	99722690	CpG: 189	1575	189	1195	24.0	75.9	0.83
chr14	99727236	99728732	CpG: 135	1496	135	1115	18.0	74.5	0.65
chr14	99735635	99737327	CpG: 147	1692	147	1200	17.4	70.9	0.69
chr14	99739206	99741228	CpG: 218	2022	218	1464	21.6	72.4	0.83
chr14	99746605	99746835	CpG: 19	230	19	156	16.5	67.8	0.73
chr14	99748015	99748331	CpG: 23	316	23	222	14.6	70.3	0.61
chr14	99777633	99781545	CpG: 390	3912	390	2856	19.9	73.0	0.76
chr14	99798086	99799634	CpG: 118	1548	118	1073	15.2	69.3	0.64
chr14	99800872	99801291	CpG: 29	419	29	266	13.8	63.5	0.69
chr14	99818466	99818688	CpG: 19	222	19	156	17.1	70.3	0.69
chr14	99825559	99825764	CpG: 18	205	18	155	17.6	75.6	0.70
chr14	99845456	99845657	CpG: 15	201	15	139	14.9	69.2	0.66
chr14	99852513	99853315	CpG: 60	802	60	532	15.0	66.3	0.68
chr14	99881708	99882144	CpG: 32	436	32	304	14.7	69.7	0.62
chr14	99901306	99901742	CpG: 32	436	32	304	14.7	69.7	0.62
chr14	99944720	99945318	CpG: 55	598	55	417	18.4	69.7	0.76
chr14	99959176	99959412	CpG: 20	236	20	163	16.9	69.1	0.71
chr14	99966311	99966516	CpG: 18	205	18	155	17.6	75.6	0.71
chr14	99979211	99979440	CpG: 20	229	20	160	17.5	69.9	0.72
chr14	99985349	99985550	CpG: 15	201	15	139	14.9	69.2	0.66
chr14	99992940	99993672	CpG: 53	732	53	481	14.5	65.7	0.67
chr14	100012600	100012890	CpG: 24	290	24	183	16.6	63.1	0.84
chr14	100040602	100040907	CpG: 25	305	25	192	16.4	63.0	0.83
chr14	100122032	100122424	CpG: 24	392	24	225	12.2	57.4	0.77
chr14	100127211	100127463	CpG: 20	252	20	171	15.9	67.9	0.69
chr14	100138839	100139217	CpG: 40	378	40	246	21.2	65.1	1.01
chr14	100213911	100214159	CpG: 20	248	20	151	16.1	60.9	0.91
chr14	100285778	100286056	CpG: 25	278	25	174	18.0	62.6	0.93
chr14	100477834	100478356	CpG: 41	522	41	330	15.7	63.2	0.80
chr14	100485380	100485602	CpG: 18	222	18	129	16.2	58.1	0.97
chr14	100558510	100558745	CpG: 22	235	22	158	18.7	67.2	0.84
chr14	100571884	100572163	CpG: 26	279	26	177	18.6	63.4	0.94
chr14	100604096	100604370	CpG: 24	274	24	171	17.5	62.4	0.91
chr14	100653039	100653313	CpG: 24	274	24	171	17.5	62.4	0.91
chr14	100707877	100708103	CpG: 20	226	20	136	17.7	60.2	1.00
chr14	100719328	100719678	CpG: 43	350	43	266	24.6	76.0	0.85
chr14	100721691	100722311	CpG: 64	620	64	446	20.6	71.9	0.83
chr14	100756589	100756826	CpG: 19	237	19	138	16.0	58.2	0.95
chr14	100780885	100781135	CpG: 22	250	22	164	17.6	65.6	0.82
chr14	100800506	100801045	CpG: 56	539	56	374	20.8	69.4	0.87
chr14	100802718	100803340	CpG: 64	622	64	449	20.6	72.2	0.82
chr14	100818922	100819203	CpG: 24	281	24	175	17.1	62.3	0.89
chr14	100884252	100884494	CpG: 18	242	18	143	14.9	59.1	0.87
chr14	100937145	100937375	CpG: 18	230	18	139	15.7	60.4	0.87
chr14	101088155	101088371	CpG: 17	216	17	153	15.7	70.8	0.63
chr14	101106410	101106653	CpG: 21	243	21	149	17.3	61.3	0.94
chr14	101119883	101120508	CpG: 57	625	57	429	18.2	68.6	0.80
chr14	101158464	101159825	CpG: 233	1361	233	1072	34.2	78.8	1.14
chr15	3363	4905	CpG: 283	1542	283	1190	36.7	77.2	1.26
chr15	52703	53488	CpG: 66	785	66	505	16.8	64.3	0.81
chr15	169730	170057	CpG: 26	327	26	214	15.9	65.4	0.74
chr15	173621	173951	CpG: 23	330	23	224	13.9	67.9	0.61
chr15	174329	174625	CpG: 31	296	31	215	20.9	72.6	0.79
chr15	255625	255965	CpG: 30	340	30	238	17.6	70.0	0.76
chr15	935486	936841	CpG: 96	1355	96	909	14.2	67.1	0.63
chr15	948902	949660	CpG: 52	758	52	492	13.7	64.9	0.67
chr15	954104	954309	CpG: 16	205	16	140	15.6	68.3	0.70
chr15	954947	956126	CpG: 90	1179	90	799	15.3	67.8	0.67
chr15	960823	961985	CpG: 86	1162	86	787	14.8	67.7	0.65
chr15	970269	970548	CpG: 18	279	18	169	12.9	60.6	0.71
chr15	979093	980445	CpG: 98	1352	98	891	14.5	65.9	0.67
chr15	987434	989359	CpG: 129	1925	129	1286	13.4	66.8	0.60
chr15	1024191	1024415	CpG: 19	224	19	155	17.0	69.2	0.76
chr15	1024766	1025292	CpG: 36	526	36	352	13.7	66.9	0.62
chr15	1025767	1026739	CpG: 66	972	66	619	13.6	63.7	0.68
chr15	1031053	1032759	CpG: 121	1706	121	1150	14.2	67.4	0.63
chr15	1043692	1043987	CpG: 27	295	27	198	18.3	67.1	0.81
chr15	1054163	1055542	CpG: 101	1379	101	924	14.6	67.0	0.65
chr15	1063572	1064173	CpG: 46	601	46	424	15.3	70.5	0.62
chr15	1072043	1073859	CpG: 125	1816	125	1220	13.8	67.2	0.61
chr15	1078747	1078962	CpG: 15	215	15	152	14.0	70.7	0.63
chr15	1533958	1534245	CpG: 25	287	25	195	17.4	67.9	0.81
chr15	1553407	1553624	CpG: 15	217	15	149	13.8	68.7	0.67
chr15	1555891	1556433	CpG: 44	542	44	364	16.2	67.2	0.73
chr15	1740589	1741076	CpG: 38	487	38	330	15.6	67.8	0.69
chr15	1835305	1835584	CpG: 25	279	25	174	17.9	62.4	0.93
chr15	1865940	1866252	CpG: 34	312	34	231	21.8	74.0	0.80
chr15	1870508	1870924	CpG: 39	416	39	284	18.8	68.3	0.80
chr15	2170684	2170900	CpG: 19	216	19	128	17.6	59.3	1.00
chr15	2182796	2183046	CpG: 18	250	18	152	14.4	60.8	0.78
chr15	2266649	2267089	CpG: 30	440	30	289	13.6	65.7	0.63
chr15	2501128	2501912	CpG: 51	784	51	484	13.0	61.7	0.68
chr15	2506548	2506803	CpG: 19	255	19	132	14.9	51.8	1.12
chr15	2508912	4707491	CpG: 163346	2198579	163346	1279573	14.9	58.2	0.88
chr15	4759597	4759928	CpG: 22	331	22	212	13.3	64.0	0.65
chr15	4761228	4761538	CpG: 20	310	20	197	12.9	63.5	0.64
chr15	4763972	4764515	CpG: 43	543	43	357	15.8	65.7	0.74
chr15	4768780	4769073	CpG: 28	293	28	212	19.1	72.4	0.73
chr15	4819006	4819213	CpG: 19	207	19	141	18.4	68.1	0.79
chr15	4819510	4819754	CpG: 19	244	19	168	15.6	68.9	0.69
chr15	4822071	4822406	CpG: 27	335	27	223	16.1	66.6	0.73
chr15	4832337	4832743	CpG: 32	406	32	288	15.8	70.9	0.63
chr15	4836562	4837219	CpG: 55	657	55	436	16.7	66.4	0.80
chr15	4875518	4875874	CpG: 28	356	28	247	15.7	69.4	0.69
chr15	4989691	4990605	CpG: 71	914	71	609	15.5	66.6	0.70
chr15	4995186	4996574	CpG: 105	1388	105	942	15.1	67.9	0.66
chr15	5003492	5005394	CpG: 129	1902	129	1278	13.6	67.2	0.60
chr15	5011191	5012606	CpG: 93	1415	93	932	13.1	65.9	0.61
chr15	5018406	5020337	CpG: 135	1931	135	1284	14.0	66.5	0.63
chr15	5022912	5023950	CpG: 76	1038	76	699	14.6	67.3	0.65
chr15	5029051	5030215	CpG: 80	1164	80	786	13.7	67.5	0.60
chr15	5030732	5030992	CpG: 20	260	20	175	15.4	67.3	0.72
chr15	5037952	5040369	CpG: 159	2417	159	1598	13.2	66.1	0.61
chr15	5048518	5049913	CpG: 100	1395	100	940	14.3	67.4	0.63
chr15	5055243	5056045	CpG: 64	802	64	569	16.0	70.9	0.63
chr15	5060104	5061247	CpG: 84	1143	84	764	14.7	66.8	0.66
chr15	5075149	5075412	CpG: 18	263	18	178	13.7	67.7	0.65
chr15	5075780	5076458	CpG: 53	678	53	470	15.6	69.3	0.65
chr15	5076940	5077169	CpG: 19	229	19	152	16.6	66.4	0.76
chr15	5084840	5086318	CpG: 108	1478	108	1005	14.6	68.0	0.63
chr15	5092441	5093129	CpG: 51	688	51	476	14.8	69.2	0.62
chr15	5096259	5098369	CpG: 144	2110	144	1407	13.6	66.7	0.61
chr15	5101555	5102734	CpG: 94	1179	94	810	15.9	68.7	0.68
chr15	5103320	5103615	CpG: 26	295	26	196	17.6	66.4	0.86
chr15	5112418	5114224	CpG: 119	1806	119	1197	13.2	66.3	0.60
chr15	5122551	5124512	CpG: 134	1961	134	1296	13.7	66.1	0.63
chr15	5133524	5135459	CpG: 137	1935	137	1316	14.2	68.0	0.61
chr15	5142229	5143974	CpG: 118	1745	118	1167	13.5	66.9	0.61
chr15	5262247	5263399	CpG: 124	1152	124	829	21.5	72.0	0.83
chr15	5481387	5481717	CpG: 31	330	31	233	18.8	70.6	0.78
chr15	14372215	14372492	CpG: 21	277	21	174	15.2	62.8	0.78
chr15	14502982	14503878	CpG: 73	896	73	575	16.3	64.2	0.79
chr15	14559276	14559584	CpG: 32	308	32	219	20.8	71.1	0.84
chr15	14559769	14559987	CpG: 17	218	17	145	15.6	66.5	0.74
chr15	14561193	14562178	CpG: 84	985	84	669	17.1	67.9	0.74
chr15	14644045	14644784	CpG: 49	739	49	462	13.3	62.5	0.68
chr15	14649214	14649638	CpG: 31	424	31	273	14.6	64.4	0.71
chr15	14666488	14668482	CpG: 155	1994	155	1360	15.5	68.2	0.67
chr15	14670454	14670752	CpG: 25	298	25	212	16.8	71.1	0.68
chr15	14671654	14672368	CpG: 55	714	55	496	15.4	69.5	0.64
chr15	14702455	14702731	CpG: 25	276	25	169	18.1	61.2	0.98
chr15	14705847	14706123	CpG: 26	276	26	172	18.8	62.3	0.98
chr15	14709240	14709516	CpG: 26	276	26	173	18.8	62.7	0.97
chr15	14712637	14712913	CpG: 26	276	26	172	18.8	62.3	0.98
chr15	14716027	14716303	CpG: 26	276	26	172	18.8	62.3	0.98
chr15	14719417	14719693	CpG: 26	276	26	172	18.8	62.3	0.98
chr15	14722810	14723086	CpG: 26	276	26	171	18.8	62.0	0.99
chr15	14726204	14726480	CpG: 25	276	25	170	18.1	61.6	0.97
chr15	14729595	14729871	CpG: 26	276	26	171	18.8	62.0	0.99
chr15	14732988	14733264	CpG: 26	276	26	171	18.8	62.0	0.99
chr15	14791515	14791876	CpG: 28	361	28	246	15.5	68.1	0.67
chr15	14795229	14797348	CpG: 142	2119	142	1386	13.4	65.4	0.63
chr15	14799536	14803925	CpG: 317	4389	317	2844	14.4	64.8	0.69
chr15	14810514	14810858	CpG: 26	344	26	219	15.1	63.7	0.75
chr15	14869363	14870234	CpG: 74	871	74	571	17.0	65.6	0.79
chr15	14927623	14928226	CpG: 44	603	44	403	14.6	66.8	0.68
chr15	14929298	14930266	CpG: 79	968	79	662	16.3	68.4	0.70
chr15	15061286	15061508	CpG: 15	222	15	136	13.5	61.3	0.73
chr15	15063211	15063527	CpG: 26	316	26	212	16.5	67.1	0.79
chr15	15064447	15064774	CpG: 29	327	29	206	17.7	63.0	0.90
chr15	15068670	15068894	CpG: 20	224	20	147	17.9	65.6	0.87
chr15	15080551	15080786	CpG: 17	235	17	130	14.5	55.3	0.95
chr15	15090303	15096243	CpG: 404	5940	404	3724	13.6	62.7	0.69
chr15	16572933	16573335	CpG: 36	402	36	277	17.9	68.9	0.75
chr15	16605904	16606962	CpG: 79	1058	79	710	14.9	67.1	0.66
chr15	16608244	16608776	CpG: 44	532	44	376	16.5	70.7	0.67
chr15	16636006	16636802	CpG: 66	796	66	525	16.6	66.0	0.76
chr15	16669009	16669233	CpG: 20	224	20	134	17.9	59.8	1.00
chr15	17802773	17803351	CpG: 57	578	57	394	19.7	68.2	0.85
chr15	17847381	17848654	CpG: 158	1273	158	868	24.8	68.2	1.17
chr15	17857432	17857726	CpG: 25	294	25	180	17.0	61.2	0.92
chr15	17987175	17987453	CpG: 25	278	25	175	18.0	62.9	0.92
chr15	18056317	18057045	CpG: 121	728	121	562	33.2	77.2	1.19
chr15	18076695	18077184	CpG: 47	489	47	337	19.2	68.9	0.83
chr15	18088456	18088692	CpG: 21	236	21	146	17.8	61.9	0.95
chr15	18112185	18112557	CpG: 34	372	34	286	18.3	76.9	0.62
chr15	18191140	18191454	CpG: 28	314	28	198	17.8	63.1	0.90
chr15	18207573	18208569	CpG: 120	996	120	720	24.1	72.3	0.95
chr15	18270448	18270679	CpG: 18	231	18	155	15.6	67.1	0.71
chr15	18361647	18361879	CpG: 16	232	16	133	13.8	57.3	0.85
chr15	18417786	18418387	CpG: 86	601	86	457	28.6	76.0	1.00
chr15	18493280	18494650	CpG: 104	1370	104	934	15.2	68.2	0.65
chr15	18591470	18591690	CpG: 17	220	17	131	15.5	59.5	0.88
chr15	18667614	18668502	CpG: 84	888	84	647	18.9	72.9	0.72
chr15	18687496	18688404	CpG: 98	908	98	654	21.6	72.0	0.83
chr15	18695234	18696478	CpG: 85	1244	85	809	13.7	65.0	0.65
chr15	18726438	18727058	CpG: 51	620	51	421	16.5	67.9	0.71
chr15	18794300	18795637	CpG: 141	1337	141	968	21.1	72.4	0.81
chr15	19162598	19164706	CpG: 250	2108	250	1533	23.7	72.7	0.91
chr15	19205785	19206059	CpG: 25	274	25	171	18.2	62.4	0.95
chr15	19270070	19270301	CpG: 18	231	18	155	15.6	67.1	0.71
chr15	19344730	19345726	CpG: 121	996	121	721	24.3	72.4	0.95
chr15	19361867	19362180	CpG: 28	313	28	197	17.9	62.9	0.91
chr15	19464557	19464793	CpG: 21	236	21	146	17.8	61.9	0.95
chr15	19476056	19476550	CpG: 51	494	51	346	20.6	70.0	0.86
chr15	19491600	19491830	CpG: 21	230	21	141	18.3	61.3	0.98
chr15	19496481	19497417	CpG: 164	936	164	733	35.0	78.3	1.24
chr15	19586571	19586861	CpG: 30	290	30	210	20.7	72.4	0.79
chr15	19623069	19623339	CpG: 24	270	24	170	17.8	63.0	0.91
chr15	19789117	19790454	CpG: 143	1337	143	971	21.4	72.6	0.82
chr15	19857539	19858159	CpG: 51	620	51	421	16.5	67.9	0.71
chr15	19888117	19889361	CpG: 85	1244	85	810	13.7	65.1	0.65
chr15	19896190	19897098	CpG: 99	908	99	657	21.8	72.4	0.83
chr15	19916095	19916975	CpG: 82	880	82	638	18.6	72.5	0.72
chr15	19992629	19992849	CpG: 17	220	17	131	15.5	59.5	0.88
chr15	20089591	20091048	CpG: 109	1457	109	994	15.0	68.2	0.64
chr15	20118064	20118350	CpG: 27	286	27	179	18.9	62.6	0.97
chr15	20166595	20167208	CpG: 88	613	88	462	28.7	75.4	1.02
chr15	20263436	20263653	CpG: 16	217	16	130	14.7	59.9	0.83
chr15	20309043	20309321	CpG: 22	278	22	171	15.8	61.5	0.85
chr15	20325605	20325836	CpG: 19	231	19	134	16.5	58.0	1.00
chr15	20336359	20337186	CpG: 118	827	118	635	28.5	76.8	0.98
chr15	20345031	20345298	CpG: 19	267	19	161	14.2	60.3	0.79
chr15	20355222	20355488	CpG: 25	266	25	168	18.8	63.2	0.95
chr15	20375178	20375454	CpG: 22	276	22	171	15.9	62.0	0.86
chr15	20386455	20387282	CpG: 92	827	92	591	22.2	71.5	0.87
chr15	20429623	20430037	CpG: 49	414	49	304	23.7	73.4	0.90
chr15	20457875	20459459	CpG: 185	1584	185	1133	23.4	71.5	0.91
chr15	20509091	20510971	CpG: 158	1880	158	1141	16.8	60.7	0.91
chr15	20562509	20562727	CpG: 16	218	16	144	14.7	66.1	0.68
chr15	20599719	20599923	CpG: 21	204	21	143	20.6	70.1	0.84
chr15	20604033	20604235	CpG: 20	202	20	129	19.8	63.9	0.97
chr15	20650930	20652977	CpG: 202	2047	202	1394	19.7	68.1	0.85
chr15	20711003	20711679	CpG: 94	676	94	490	27.8	72.5	1.06
chr15	20749952	20750464	CpG: 36	512	36	287	14.1	56.1	0.90
chr15	20752395	20753158	CpG: 51	763	51	442	13.4	57.9	0.80
chr15	20787469	20787752	CpG: 23	283	23	174	16.3	61.5	0.87
chr15	20797904	20798134	CpG: 17	230	17	138	14.8	60.0	0.83
chr15	20860037	20860289	CpG: 20	252	20	143	15.9	56.7	0.99
chr15	20863713	20864217	CpG: 61	504	61	393	24.2	78.0	0.80
chr15	20873509	20873718	CpG: 16	209	16	127	15.3	60.8	0.84
chr15	20896248	20896483	CpG: 17	235	17	139	14.5	59.1	0.85
chr15	20906849	20907080	CpG: 18	231	18	145	15.6	62.8	0.81
chr15	20914696	20914966	CpG: 26	270	26	199	19.3	73.7	0.72
chr15	20916935	20917700	CpG: 75	765	75	548	19.6	71.6	0.76
chr15	20920132	20920363	CpG: 20	231	20	147	17.3	63.6	0.88
chr15	20930732	20930967	CpG: 17	235	17	139	14.5	59.1	0.85
chr15	20940707	20940941	CpG: 17	234	17	143	14.5	61.1	0.80
chr15	20953482	20953691	CpG: 16	209	16	127	15.3	60.8	0.84
chr15	20962983	20963487	CpG: 61	504	61	393	24.2	78.0	0.80
chr15	20966902	20967154	CpG: 20	252	20	143	15.9	56.7	0.99
chr15	21035888	21036498	CpG: 82	610	82	456	26.9	74.8	0.97
chr15	21183669	21184178	CpG: 33	509	33	295	13.0	58.0	0.77
chr15	21202387	21202589	CpG: 14	202	14	112	13.9	55.4	0.92
chr15	21224299	21224573	CpG: 23	274	23	172	16.8	62.8	0.87
chr15	21350641	21350883	CpG: 17	242	17	137	14.0	56.6	0.89
chr15	21416108	21416349	CpG: 17	241	17	147	14.1	61.0	0.77
chr15	21420900	21421968	CpG: 104	1068	104	731	19.5	68.4	0.83
chr15	21448708	21448925	CpG: 18	217	18	130	16.6	59.9	0.93
chr15	21481607	21481881	CpG: 25	274	25	171	18.2	62.4	0.95
chr15	21537507	21537938	CpG: 39	431	39	317	18.1	73.5	0.67
chr15	21557916	21558156	CpG: 17	240	17	145	14.2	60.4	0.80
chr15	21612497	21612698	CpG: 21	201	21	128	20.9	63.7	1.03
chr15	21698549	21698845	CpG: 22	296	22	180	14.9	60.8	0.81
chr15	21835645	21836000	CpG: 32	355	32	239	18.0	67.3	0.87
chr15	21995044	21995342	CpG: 28	298	28	213	18.8	71.5	0.83
chr15	22085065	22085339	CpG: 24	274	24	171	17.5	62.4	0.91
chr15	22161149	22161502	CpG: 31	353	31	239	17.6	67.7	0.84
chr15	22211686	22211984	CpG: 30	298	30	212	20.1	71.1	0.91
chr15	22257620	22257890	CpG: 23	270	23	168	17.0	62.2	0.90
chr15	22411132	22411771	CpG: 59	639	59	444	18.5	69.5	0.77
chr15	22509662	22510394	CpG: 64	732	64	414	17.5	56.6	1.09
chr15	22569446	22569687	CpG: 19	241	19	148	15.8	61.4	0.86
chr15	22584585	22585036	CpG: 55	451	55	327	24.4	72.5	0.96
chr15	22614815	22615166	CpG: 36	351	36	221	20.5	63.0	1.04
chr15	22655872	22656096	CpG: 18	224	18	134	16.1	59.8	0.91
chr15	22691554	22692573	CpG: 77	1019	77	638	15.1	62.6	0.88
chr15	23011077	23011355	CpG: 25	278	25	175	18.0	62.9	0.92
chr15	23174827	23175894	CpG: 153	1067	153	808	28.7	75.7	1.00
chr15	23227166	23227439	CpG: 22	273	22	168	16.1	61.5	0.86
chr15	23290687	23290925	CpG: 20	238	20	147	16.8	61.8	0.90
chr15	23334480	23334770	CpG: 21	290	21	173	14.5	59.7	0.82
chr15	23451520	23451883	CpG: 28	363	28	236	15.4	65.0	0.73
chr15	23473798	23474014	CpG: 20	216	20	114	18.5	52.8	1.33
chr15	23602952	23604267	CpG: 159	1315	159	943	24.2	71.7	0.95
chr15	23679027	23679234	CpG: 15	207	15	126	14.5	60.9	0.80
chr15	23730073	23730319	CpG: 22	246	22	170	17.9	69.1	0.75
chr15	23797347	23797606	CpG: 23	259	23	188	17.8	72.6	0.67
chr15	23822779	23823180	CpG: 33	401	33	266	16.5	66.3	0.75
chr15	23864461	23864690	CpG: 17	229	17	136	14.8	59.4	0.87
chr15	24229618	24229882	CpG: 23	264	23	163	17.4	61.7	0.93
chr15	24256253	24256489	CpG: 20	236	20	144	16.9	61.0	0.93
chr15	24368014	24368288	CpG: 25	274	25	172	18.2	62.8	0.94
chr15	24369872	24370303	CpG: 38	431	38	290	17.6	67.3	0.80
chr15	24410994	24411558	CpG: 52	564	52	406	18.4	72.0	0.74
chr15	24513072	24515197	CpG: 240	2125	240	1568	22.6	73.8	0.83
chr15	24563203	24563440	CpG: 20	237	20	146	16.9	61.6	0.92
chr15	24572172	24572732	CpG: 48	560	48	413	17.1	73.8	0.63
chr15	24579865	24580095	CpG: 17	230	17	145	14.8	63.0	0.74
chr15	24607915	24609364	CpG: 185	1449	185	1108	25.5	76.5	0.89
chr15	24624134	24624820	CpG: 54	686	54	434	15.7	63.3	0.79
chr15	24632810	24633055	CpG: 17	245	17	155	13.9	63.3	0.70
chr15	24635368	24636134	CpG: 59	766	59	511	15.4	66.7	0.69
chr15	24637165	24637438	CpG: 19	273	19	163	13.9	59.7	0.78
chr15	24709331	24710184	CpG: 71	853	71	519	16.6	60.8	0.90
chr15	24712382	24713287	CpG: 109	905	109	675	24.1	74.6	0.87
chr15	24761991	24762272	CpG: 20	281	20	169	14.2	60.1	0.80
chr15	25057891	25058169	CpG: 21	278	21	168	15.1	60.4	0.83
chr15	25284014	25284356	CpG: 40	342	40	257	23.4	75.1	0.83
chr15	25456696	25456996	CpG: 19	300	19	155	12.7	51.7	0.95
chr15	25480824	25481180	CpG: 27	356	27	203	15.2	57.0	0.93
chr15	25512565	25513014	CpG: 49	449	49	331	21.8	73.7	0.81
chr15	25513745	25514002	CpG: 24	257	24	171	18.7	66.5	0.84
chr15	25547610	25548149	CpG: 42	539	42	359	15.6	66.6	0.72
chr15	25548898	25549150	CpG: 20	252	20	166	15.9	65.9	0.73
chr15	25645298	25645838	CpG: 39	540	39	355	14.4	65.7	0.67
chr15	25745944	25746541	CpG: 58	597	58	395	19.4	66.2	0.89
chr15	25816923	25817159	CpG: 20	236	20	142	16.9	60.2	0.96
chr15	25837155	25839823	CpG: 223	2668	223	1772	16.7	66.4	0.76
chr15	25841569	25842121	CpG: 54	552	54	387	19.6	70.1	0.85
chr15	25848989	25850485	CpG: 146	1496	146	1061	19.5	70.9	0.78
chr15	25850940	25851187	CpG: 19	247	19	144	15.4	58.3	0.94
chr15	25855544	25855874	CpG: 25	330	25	209	15.2	63.3	0.76
chr15	25936900	25937302	CpG: 29	402	29	233	14.4	58.0	0.86
chr15	25956993	25957377	CpG: 27	384	27	256	14.1	66.7	0.63
chr15	26064700	26065313	CpG: 87	613	87	461	28.4	75.2	1.02
chr15	26139167	26139451	CpG: 21	284	21	169	14.8	59.5	0.84
chr15	26140199	26140444	CpG: 19	245	19	142	15.5	58.0	0.92
chr15	26140752	26141093	CpG: 24	341	24	203	14.1	59.5	0.80
chr15	26145501	26146005	CpG: 63	504	63	395	25.0	78.4	0.82
chr15	26155284	26155493	CpG: 16	209	16	126	15.3	60.3	0.85
chr15	26201514	26201748	CpG: 16	234	16	140	13.7	59.8	0.79
chr15	26217929	26218164	CpG: 17	235	17	139	14.5	59.1	0.85
chr15	26228786	26229017	CpG: 17	231	17	144	14.7	62.3	0.78
chr15	26231461	26232352	CpG: 85	891	85	636	19.1	71.4	0.75
chr15	26234191	26234461	CpG: 26	270	26	200	19.3	74.1	0.72
chr15	26242076	26242307	CpG: 17	231	17	144	14.7	62.3	0.78
chr15	26252780	26253015	CpG: 18	235	18	139	15.3	59.1	0.91
chr15	26275542	26275751	CpG: 15	209	15	124	14.4	59.3	0.82
chr15	26285037	26285541	CpG: 63	504	63	394	25.0	78.2	0.82
chr15	26290631	26290884	CpG: 20	253	20	141	15.8	55.7	1.02
chr15	26365783	26366396	CpG: 87	613	87	460	28.4	75.0	1.02
chr15	26421589	26421821	CpG: 16	232	16	133	13.8	57.3	0.85
chr15	26462487	26462704	CpG: 16	217	16	130	14.7	59.9	0.83
chr15	26514244	26515072	CpG: 118	828	118	637	28.5	76.9	0.97
chr15	26522945	26523182	CpG: 17	237	17	143	14.3	60.3	0.80
chr15	26547870	26548140	CpG: 23	270	23	167	17.0	61.9	0.90
chr15	26553165	26553442	CpG: 22	277	22	170	15.9	61.4	0.87
chr15	26559720	26560175	CpG: 33	455	33	269	14.5	59.1	0.83
chr15	26561452	26561746	CpG: 22	294	22	174	15.0	59.2	0.85
chr15	26565751	26566583	CpG: 92	832	92	595	22.1	71.5	0.86
chr15	26599298	26599576	CpG: 20	278	20	167	14.4	60.1	0.81
chr15	26609134	26609809	CpG: 64	675	64	449	19.0	66.5	0.87
chr15	26626521	26627541	CpG: 83	1020	83	723	16.3	70.9	0.65
chr15	26643452	26643804	CpG: 27	352	27	201	15.3	57.1	0.95
chr15	26662500	26664067	CpG: 181	1567	181	1160	23.1	74.0	0.84
chr15	26696252	26696566	CpG: 24	314	24	184	15.3	58.6	0.89
chr15	26719303	26719523	CpG: 17	220	17	130	15.5	59.1	0.90
chr15	26734672	26734890	CpG: 16	218	16	127	14.7	58.3	0.88
chr15	26880956	26881605	CpG: 62	649	62	475	19.1	73.2	0.71
chr15	26891266	26891529	CpG: 19	263	19	159	14.4	60.5	0.80
chr15	26893008	26893542	CpG: 37	534	37	364	13.9	68.2	0.61
chr15	26957909	26958257	CpG: 26	348	26	199	14.9	57.2	0.92
chr15	27047660	27048309	CpG: 75	649	75	450	23.1	69.3	0.96
chr15	27205654	27205935	CpG: 22	281	22	164	15.7	58.4	0.92
chr15	27275290	27275568	CpG: 25	278	25	175	18.0	62.9	0.92
chr15	27360642	27362258	CpG: 249	1616	249	1275	30.8	78.9	0.99
chr15	27389422	27389652	CpG: 18	230	18	138	15.7	60.0	0.87
chr15	27391661	27391897	CpG: 18	236	18	143	15.3	60.6	0.85
chr15	27447726	27447951	CpG: 19	225	19	144	16.9	64.0	0.84
chr15	27465538	27466760	CpG: 107	1222	107	869	17.5	71.1	0.70
chr15	27592255	27592533	CpG: 23	278	23	173	16.5	62.2	0.87
chr15	27612272	27613782	CpG: 181	1510	181	1086	24.0	71.9	0.93
chr15	27759918	27760817	CpG: 138	899	138	707	30.7	78.6	1.01
chr15	27769274	27769543	CpG: 22	269	22	163	16.4	60.6	0.90
chr15	27776411	27776640	CpG: 16	229	16	134	14.0	58.5	0.83
chr15	27836168	27836660	CpG: 53	492	53	343	21.5	69.7	0.89
chr15	27848470	27848700	CpG: 19	230	19	141	16.5	61.3	0.89
chr15	27849424	27849657	CpG: 19	233	19	137	16.3	58.8	0.95
chr15	27895141	27896155	CpG: 94	1014	94	708	18.5	69.8	0.78
chr15	27984671	27986002	CpG: 120	1331	120	917	18.0	68.9	0.76
chr15	27988851	27989755	CpG: 83	904	83	642	18.4	71.0	0.73
chr15	28016232	28019519	CpG: 331	3287	331	2252	20.1	68.5	0.86
chr15	28039293	28039536	CpG: 18	243	18	147	14.8	60.5	0.81
chr15	28076226	28076501	CpG: 22	275	22	173	16.0	62.9	0.83
chr15	28080335	28080572	CpG: 19	237	19	145	16.0	61.2	0.89
chr15	28155652	28156150	CpG: 45	498	45	332	18.1	66.7	0.81
chr15	28186104	28187118	CpG: 94	1014	94	709	18.5	69.9	0.77
chr15	28220075	28220422	CpG: 27	347	27	205	15.6	59.1	0.89
chr15	28236713	28236949	CpG: 18	236	18	139	15.3	58.9	0.89
chr15	28255029	28255260	CpG: 17	231	17	139	14.7	60.2	0.83
chr15	28263999	28264848	CpG: 115	849	115	641	27.1	75.5	0.96
chr15	28280294	28280564	CpG: 20	270	20	164	14.8	60.7	0.81
chr15	28332341	28332688	CpG: 27	347	27	205	15.6	59.1	0.89
chr15	28365622	28366636	CpG: 94	1014	94	709	18.5	69.9	0.77
chr15	28419302	28419555	CpG: 21	253	21	180	16.6	71.1	0.72
chr15	28677075	28677303	CpG: 18	228	18	156	15.8	68.4	0.67
chr15	28689935	28690142	CpG: 16	207	16	127	15.5	61.4	0.83
chr15	28697452	28698171	CpG: 68	719	68	486	18.9	67.6	0.84
chr15	28785282	28786292	CpG: 117	1010	117	734	23.2	72.7	0.89
chr15	28791899	28792166	CpG: 22	267	22	163	16.5	61.0	0.89
chr15	28820175	28820422	CpG: 21	247	21	146	17.0	59.1	0.98
chr15	28874724	28875089	CpG: 26	365	26	246	14.2	67.4	0.70
chr15	28919547	28919825	CpG: 24	278	24	172	17.3	61.9	0.91
chr15	28963360	28963645	CpG: 24	285	24	177	16.8	62.1	0.89
chr15	28978233	28979082	CpG: 62	849	62	573	14.6	67.5	0.64
chr15	29009709	29010706	CpG: 94	997	94	729	18.9	73.1	0.72
chr15	29119672	29122817	CpG: 429	3145	429	2403	27.3	76.4	0.93
chr15	29123564	29123802	CpG: 19	238	19	164	16.0	68.9	0.69
chr15	29166182	29166464	CpG: 36	282	36	203	25.5	72.0	1.03
chr15	29185733	29187746	CpG: 159	2013	159	1383	15.8	68.7	0.68
chr15	29191422	29191629	CpG: 19	207	19	139	18.4	67.1	0.82
chr15	29235225	29235633	CpG: 51	408	51	305	25.0	74.8	0.89
chr15	29247612	29247897	CpG: 20	285	20	167	14.0	58.6	0.85
chr15	29277503	29279135	CpG: 239	1632	239	1180	29.3	72.3	1.12
chr15	29433073	29433309	CpG: 17	236	17	137	14.4	58.1	0.86
chr15	29566135	29566410	CpG: 23	275	23	171	16.7	62.2	0.87
chr15	29664112	29665152	CpG: 177	1040	177	833	34.0	80.1	1.09
chr15	29765367	29765603	CpG: 17	236	17	140	14.4	59.3	0.85
chr15	29793200	29793484	CpG: 23	284	23	178	16.2	62.7	0.83
chr15	29824108	29825004	CpG: 98	896	98	662	21.9	73.9	0.82
chr15	29845582	29845827	CpG: 18	245	18	153	14.7	62.4	0.75
chr15	29930903	29931177	CpG: 24	274	24	174	17.5	63.5	0.88
chr15	29962292	29962790	CpG: 46	498	46	333	18.5	66.9	0.83
chr15	30046006	30046240	CpG: 17	234	17	141	14.5	60.3	0.83
chr15	30050055	30050330	CpG: 22	275	22	173	16.0	62.9	0.82
chr15	30087114	30087425	CpG: 22	311	22	191	14.1	61.4	0.75
chr15	30107146	30110432	CpG: 333	3286	333	2257	20.3	68.7	0.86
chr15	30136934	30137812	CpG: 78	878	78	619	17.8	70.5	0.72
chr15	30140642	30141974	CpG: 120	1332	120	916	18.0	68.8	0.77
chr15	30212053	30212283	CpG: 20	230	20	141	17.4	61.3	0.94
chr15	30230708	30231722	CpG: 93	1014	93	708	18.3	69.8	0.77
chr15	30264739	30265087	CpG: 27	348	27	204	15.5	58.6	0.90
chr15	30332613	30333462	CpG: 115	849	115	641	27.1	75.5	0.96
chr15	30342210	30342441	CpG: 17	231	17	139	14.7	60.2	0.83
chr15	30377032	30377379	CpG: 26	347	26	204	15.0	58.8	0.87
chr15	30404117	30404353	CpG: 20	236	20	141	16.9	59.7	0.98
chr15	30412016	30412233	CpG: 19	217	19	154	17.5	71.0	0.78
chr15	30509551	30509829	CpG: 23	278	23	173	16.5	62.2	0.87
chr15	30513855	30516021	CpG: 228	2166	228	1492	21.1	68.9	0.89
chr15	30525609	30525849	CpG: 18	240	18	141	15.0	58.8	0.88
chr15	30815814	30816374	CpG: 44	560	44	403	15.7	72.0	0.61
chr15	30968414	30968649	CpG: 18	235	18	143	15.3	60.9	0.85
chr15	30991130	30991573	CpG: 37	443	37	297	16.7	67.0	0.75
chr15	31081788	31082022	CpG: 17	234	17	139	14.5	59.4	0.84
chr15	31095468	31095742	CpG: 20	274	20	167	14.6	60.9	0.79
chr15	31107087	31108274	CpG: 112	1187	112	838	18.9	70.6	0.76
chr15	31111110	31111342	CpG: 19	232	19	144	16.4	62.1	0.88
chr15	31257453	31257727	CpG: 22	274	22	169	16.1	61.7	0.86
chr15	31308268	31308542	CpG: 22	274	22	169	16.1	61.7	0.86
chr15	31735066	31735288	CpG: 17	222	17	137	15.3	61.7	0.81
chr15	31836555	31837456	CpG: 131	901	131	708	29.1	78.6	0.95
chr15	31845281	31845558	CpG: 20	277	20	168	14.4	60.6	0.79
chr15	31871254	31871543	CpG: 20	289	20	168	13.8	58.1	0.84
chr15	31895308	31895540	CpG: 17	232	17	136	14.7	58.6	0.88
chr15	31899819	31900269	CpG: 35	450	35	287	15.6	63.8	0.78
chr15	31935032	31935234	CpG: 15	202	15	118	14.9	58.4	0.87
chr15	31982258	31982527	CpG: 20	269	20	164	14.9	61.0	0.81
chr15	31991191	31991465	CpG: 22	274	22	169	16.1	61.7	0.85
chr15	32007748	32008546	CpG: 83	798	83	556	20.8	69.7	0.86
chr15	32135679	32136500	CpG: 90	821	90	573	21.9	69.8	0.90
chr15	32140911	32141456	CpG: 37	545	37	298	13.6	54.7	0.96
chr15	32167244	32168239	CpG: 96	995	96	719	19.3	72.3	0.74
chr15	32242277	32243606	CpG: 200	1329	200	998	30.1	75.1	1.08
chr15	32251583	32251857	CpG: 25	274	25	170	18.2	62.0	0.96
chr15	32253783	32254052	CpG: 21	269	21	168	15.6	62.5	0.81
chr15	32255240	32255472	CpG: 19	232	19	139	16.4	59.9	0.92
chr15	32260497	32260778	CpG: 23	281	23	174	16.4	61.9	0.86
chr15	32262134	32262410	CpG: 20	276	20	164	14.5	59.4	0.83
chr15	32296222	32296453	CpG: 34	231	34	180	29.4	77.9	1.11
chr15	32300011	32301657	CpG: 175	1646	175	1108	21.3	67.3	0.94
chr15	32319920	32320900	CpG: 84	980	84	678	17.1	69.2	0.72
chr15	32388349	32389913	CpG: 166	1564	166	1118	21.2	71.5	0.83
chr15	32398543	32398779	CpG: 19	236	19	143	16.1	60.6	0.90
chr15	32559433	32560470	CpG: 106	1037	106	707	20.4	68.2	0.89
chr15	32572599	32572880	CpG: 23	281	23	175	16.4	62.3	0.86
chr15	32703812	32704339	CpG: 34	527	34	314	12.9	59.6	0.73
chr15	32773521	32773767	CpG: 19	246	19	148	15.4	60.2	0.88
chr15	32774694	32775132	CpG: 34	438	34	272	15.5	62.1	0.81
chr15	32793396	32793840	CpG: 44	444	44	293	19.8	66.0	0.91
chr15	32823722	32823996	CpG: 20	274	20	163	14.6	59.5	0.84
chr15	32832530	32832792	CpG: 19	262	19	157	14.5	59.9	0.82
chr15	32833231	32833448	CpG: 17	217	17	127	15.7	58.5	0.92
chr15	32841236	32841470	CpG: 17	234	17	141	14.5	60.3	0.84
chr15	32858131	32858405	CpG: 24	274	24	170	17.5	62.0	0.92
chr15	32876942	32877185	CpG: 19	243	19	143	15.6	58.8	0.92
chr15	32888875	32889108	CpG: 18	233	18	141	15.5	60.5	0.86
chr15	32898077	32898412	CpG: 33	335	33	211	19.7	63.0	1.05
chr15	32927218	32927576	CpG: 35	358	35	242	19.6	67.6	0.86
chr15	33019140	33019414	CpG: 22	274	22	165	16.1	60.2	0.89
chr15	33074823	33075028	CpG: 17	205	17	125	16.6	61.0	0.91
chr15	33257089	33257351	CpG: 19	262	19	157	14.5	59.9	0.82
chr15	33351278	33351667	CpG: 56	389	56	288	28.8	74.0	1.05
chr15	33539914	33540192	CpG: 23	278	23	176	16.5	63.3	0.84
chr15	33601645	33601882	CpG: 18	237	18	143	15.2	60.3	0.85
chr15	33744716	33744991	CpG: 19	275	19	165	13.8	60.0	0.77
chr15	33774170	33774402	CpG: 19	232	19	141	16.4	60.8	0.91
chr15	33852237	33852628	CpG: 35	391	35	284	17.9	72.6	0.68
chr15	34000795	34001206	CpG: 32	411	32	249	15.6	60.6	0.85
chr15	34021284	34021568	CpG: 19	284	19	170	13.4	59.9	0.76
chr15	34159943	34160180	CpG: 18	237	18	143	15.2	60.3	0.86
chr15	34174139	34174350	CpG: 20	211	20	130	19.0	61.6	1.02
chr15	34181553	34181831	CpG: 23	278	23	169	16.5	60.8	0.91
chr15	34215906	34216177	CpG: 20	271	20	166	14.8	61.3	0.80
chr15	34265528	34265751	CpG: 16	223	16	135	14.3	60.5	0.82
chr15	34277053	34277304	CpG: 20	251	20	146	15.9	58.2	0.96
chr15	34292975	34293224	CpG: 22	249	22	154	17.7	61.8	0.94
chr15	34384300	34385217	CpG: 65	917	65	539	14.2	58.8	0.82
chr15	34395069	34395304	CpG: 18	235	18	144	15.3	61.3	0.84
chr15	34425558	34425828	CpG: 21	270	21	169	15.6	62.6	0.81
chr15	34623638	34624081	CpG: 38	443	38	286	17.2	64.6	0.82
chr15	34685463	34686269	CpG: 62	806	62	504	15.4	62.5	0.79
chr15	34692769	34693035	CpG: 23	266	23	180	17.3	67.7	0.76
chr15	34693834	34694165	CpG: 32	331	32	234	19.3	70.7	0.78
chr15	34797262	34797536	CpG: 23	274	23	170	16.8	62.0	0.88
chr15	34900596	34900824	CpG: 24	228	24	153	21.1	67.1	0.98
chr15	34903385	34903640	CpG: 30	255	30	174	23.5	68.2	1.04
chr15	34904006	34907450	CpG: 247	3444	247	1973	14.3	57.3	0.87
chr15	34908852	34909131	CpG: 23	279	23	169	16.5	60.6	0.91
chr15	34916246	34916541	CpG: 29	295	29	188	19.7	63.7	0.99
chr15	34925238	34925472	CpG: 18	234	18	138	15.4	59.0	0.92
chr15	35295878	35296142	CpG: 23	264	23	157	17.4	59.5	1.00
chr15	35303580	35303856	CpG: 22	276	22	170	15.9	61.6	0.85
chr15	35375334	35375608	CpG: 24	274	24	171	17.5	62.4	0.91
chr15	35465203	35465489	CpG: 23	286	23	177	16.1	61.9	0.85
chr15	35614093	35614366	CpG: 20	273	20	167	14.7	61.2	0.79
chr15	35815338	35815622	CpG: 23	284	23	173	16.2	60.9	0.88
chr15	35878034	35878367	CpG: 36	333	36	241	21.6	72.4	0.83
chr15	36057080	36058610	CpG: 147	1530	147	1076	19.2	70.3	0.79
chr15	36259364	36259875	CpG: 42	511	42	327	16.4	64.0	0.81
chr15	36369353	36370749	CpG: 149	1396	149	1001	21.3	71.7	0.84
chr15	36424721	36424951	CpG: 21	230	21	141	18.3	61.3	0.99
chr15	36555041	36555331	CpG: 24	290	24	179	16.6	61.7	0.89
chr15	36708101	36708375	CpG: 21	274	21	166	15.3	60.6	0.85
chr15	37032849	37033134	CpG: 25	285	25	179	17.5	62.8	0.90
chr15	37204392	37204626	CpG: 22	234	22	146	18.8	62.4	0.98
chr15	37226021	37226302	CpG: 22	281	22	170	15.7	60.5	0.86
chr15	37385133	37386173	CpG: 109	1040	109	734	21.0	70.6	0.86
chr15	37574198	37574464	CpG: 22	266	22	165	16.5	62.0	0.87
chr15	37587642	37588213	CpG: 62	571	62	396	21.7	69.4	0.91
chr15	37595744	37595987	CpG: 17	243	17	146	14.0	60.1	0.81
chr15	37596436	37596711	CpG: 23	275	23	170	16.7	61.8	0.89
chr15	37615061	37615272	CpG: 15	211	15	125	14.2	59.2	0.83
chr15	37725080	37726563	CpG: 154	1483	154	1038	20.8	70.0	0.85
chr15	37738793	37739057	CpG: 22	264	22	154	16.7	58.3	0.99
chr15	37739329	37739750	CpG: 51	421	51	319	24.2	75.8	0.85
chr15	37781719	37782199	CpG: 56	480	56	332	23.3	69.2	0.98
chr15	37828131	37828365	CpG: 17	234	17	146	14.5	62.4	0.76
chr15	37844060	37844630	CpG: 48	570	48	376	16.8	66.0	0.80
chr15	37880834	37881107	CpG: 19	273	19	149	13.9	54.6	0.96
chr15	37881594	37881980	CpG: 32	386	32	279	16.6	72.3	0.64
chr15	37915490	37915931	CpG: 54	441	54	315	24.5	71.4	0.96
chr15	37919742	37919988	CpG: 22	246	22	154	17.9	62.6	1.33
chr15	37967691	37968382	CpG: 50	691	50	419	14.5	60.6	0.81
chr15	38037318	38037592	CpG: 25	274	25	171	18.2	62.4	0.95
chr15	38045935	38046280	CpG: 32	345	32	240	18.6	69.6	0.77
chr15	38059035	38060195	CpG: 123	1160	123	827	21.2	71.3	0.84
chr15	38086790	38087470	CpG: 53	680	53	411	15.6	60.4	0.86
chr15	38088340	38090830	CpG: 275	2490	275	1803	22.1	72.4	0.84
chr15	38097783	38098479	CpG: 72	696	72	517	20.7	74.3	0.76
chr15	38129770	38131584	CpG: 218	1814	218	1333	24.0	73.5	0.89
chr15	38164712	38165762	CpG: 103	1050	103	744	19.6	70.9	0.79
chr15	38174632	38175560	CpG: 96	928	96	664	20.7	71.6	0.81
chr15	38181437	38181718	CpG: 26	281	26	177	18.5	63.0	0.95
chr15	38190012	38190621	CpG: 50	609	50	391	16.4	64.2	0.80
chr15	38212781	38213393	CpG: 48	612	48	420	15.7	68.6	0.67
chr15	38229519	38229793	CpG: 19	274	19	164	13.9	59.9	0.79
chr15	38248104	38249872	CpG: 240	1768	240	1379	27.1	78.0	0.90
chr15	38278201	38279347	CpG: 111	1146	111	834	19.4	72.8	0.74
chr15	38294785	38295194	CpG: 31	409	31	231	15.2	56.5	0.95
chr15	38314456	38314692	CpG: 20	236	20	164	16.9	69.5	0.70
chr15	38318758	38319359	CpG: 66	601	66	423	22.0	70.4	0.89
chr15	38374904	38375608	CpG: 60	704	60	457	17.0	64.9	0.81
chr15	38389516	38389791	CpG: 24	275	24	168	17.5	61.1	0.95
chr15	38399923	38400445	CpG: 50	522	50	335	19.2	64.2	0.93
chr15	38407316	38407543	CpG: 19	227	19	139	16.7	61.2	0.92
chr15	38407772	38408006	CpG: 18	234	18	135	15.4	57.7	0.94
chr15	38482632	38483021	CpG: 36	389	36	283	18.5	72.8	0.70
chr15	38484171	38484399	CpG: 17	228	17	138	14.9	60.5	0.83
chr15	38500355	38501256	CpG: 99	901	99	601	22.0	66.7	1.00
chr15	38553385	38553657	CpG: 23	272	23	168	16.9	61.8	0.90
chr15	38560593	38561758	CpG: 89	1165	89	764	15.3	65.6	0.72
chr15	38568852	38570611	CpG: 136	1759	136	1122	15.5	63.8	0.76
chr15	38613069	38613731	CpG: 56	662	56	433	16.9	65.4	0.79
chr15	38649549	38651040	CpG: 149	1491	149	1059	20.0	71.0	0.79
chr15	38679669	38680393	CpG: 75	724	75	524	20.7	72.4	0.79
chr15	38684143	38684428	CpG: 23	285	23	173	16.1	60.7	0.89
chr15	38700063	38700977	CpG: 68	914	68	593	14.9	64.9	0.72
chr15	38731574	38736965	CpG: 389	5391	389	3504	14.4	65.0	0.68
chr15	38742230	38742660	CpG: 30	430	30	281	14.0	65.3	0.65
chr15	38747623	38748181	CpG: 82	558	82	445	29.4	79.7	0.93
chr15	38758620	38759739	CpG: 96	1119	96	756	17.2	67.6	0.75
chr15	38767558	38767950	CpG: 35	392	35	285	17.9	72.7	0.68
chr15	38921942	38922739	CpG: 93	797	93	559	23.3	70.1	0.95
chr15	38957620	38958150	CpG: 41	530	41	380	15.5	71.7	0.60
chr15	38969545	38969786	CpG: 20	241	20	147	16.6	61.0	0.91
chr15	38970868	38971130	CpG: 20	262	20	161	15.3	61.5	0.81
chr15	38998919	38999182	CpG: 21	263	21	160	16.0	60.8	0.89
chr15	39036816	39037720	CpG: 84	904	84	588	18.6	65.0	0.88
chr15	39090022	39090517	CpG: 51	495	51	341	20.6	68.9	0.88
chr15	39138328	39139306	CpG: 82	978	82	603	16.8	61.7	0.88
chr15	39183577	39183851	CpG: 19	274	19	164	13.9	59.9	0.78
chr15	39205738	39206006	CpG: 24	268	24	167	17.9	62.3	0.93
chr15	39208456	39208719	CpG: 22	263	22	170	16.7	64.6	0.86
chr15	39208914	39209263	CpG: 25	349	25	198	14.3	56.7	0.92
chr15	39210202	39210441	CpG: 20	239	20	145	16.7	60.7	0.93
chr15	39222871	39223915	CpG: 107	1044	107	740	20.5	70.9	0.84
chr15	39276847	39277077	CpG: 17	230	17	135	14.8	58.7	0.87
chr15	39292362	39292957	CpG: 58	595	58	422	19.5	70.9	0.79
chr15	39299581	39302504	CpG: 284	2923	284	2090	19.4	71.5	0.76
chr15	39307526	39309269	CpG: 149	1743	149	1168	17.1	67.0	0.76
chr15	39317329	39319490	CpG: 200	2161	200	1495	18.5	69.2	0.77
chr15	39350100	39350567	CpG: 37	467	37	297	15.8	63.6	0.81
chr15	39364896	39365921	CpG: 133	1025	133	793	26.0	77.4	0.88
chr15	39391428	39391858	CpG: 61	430	61	328	28.4	76.3	0.98
chr15	39417117	39417542	CpG: 32	425	32	252	15.1	59.3	0.87
chr15	39427290	39428317	CpG: 110	1027	110	676	21.4	65.8	1.01
chr15	39466534	39467221	CpG: 86	687	86	456	25.0	66.4	1.14
chr15	39467822	39468337	CpG: 42	515	42	305	16.3	59.2	0.95
chr15	39580173	39580915	CpG: 68	742	68	486	18.3	65.5	0.85
chr15	39633343	39634337	CpG: 90	994	90	672	18.1	67.6	0.80
chr15	39687845	39688616	CpG: 84	771	84	576	21.8	74.7	0.78
chr15	39706673	39707015	CpG: 27	342	27	214	15.8	62.6	0.81
chr15	39725193	39725475	CpG: 22	282	22	178	15.6	63.1	0.78
chr15	39777930	39778635	CpG: 96	705	96	528	27.2	74.9	0.97
chr15	39842129	39842529	CpG: 31	400	31	292	15.5	73.0	0.60
chr15	39885427	39885635	CpG: 21	208	21	146	20.2	70.2	0.84
chr15	40013991	40014392	CpG: 35	401	35	265	17.5	66.1	0.81
chr15	40075691	40075972	CpG: 23	281	23	173	16.4	61.6	0.88
chr15	40079287	40079626	CpG: 32	339	32	207	18.9	61.1	1.01
chr15	40080033	40080239	CpG: 15	206	15	115	14.6	55.8	0.96
chr15	40239213	40239445	CpG: 17	232	17	141	14.7	60.8	0.82
chr15	40296803	40297221	CpG: 40	418	40	282	19.1	67.5	0.88
chr15	40354314	40354968	CpG: 68	654	68	446	20.8	68.2	0.92
chr15	40382140	40383057	CpG: 101	917	101	659	22.0	71.9	0.88
chr15	40388365	40388703	CpG: 37	338	37	242	21.9	71.6	0.86
chr15	40408379	40408601	CpG: 25	222	25	187	22.5	84.2	0.64
chr15	40543347	40544553	CpG: 129	1206	129	886	21.4	73.5	0.79
chr15	40727349	40728534	CpG: 105	1185	105	773	17.7	65.2	0.83
chr15	40745562	40745836	CpG: 19	274	19	164	13.9	59.9	0.78
chr15	40883269	40884428	CpG: 97	1159	97	834	16.7	72.0	0.65
chr15	40920566	40920905	CpG: 24	339	24	183	14.2	54.0	0.99
chr15	40940762	40941361	CpG: 63	599	63	431	21.0	72.0	0.81
chr15	40974398	40975384	CpG: 74	986	74	680	15.0	69.0	0.63
chr15	40992545	40993248	CpG: 67	703	67	494	19.1	70.3	0.79
chr15	41033160	41033408	CpG: 18	248	18	138	14.5	55.6	0.97
chr15	41033866	41034367	CpG: 50	501	50	367	20.0	73.3	0.74
chr15	41038857	41039131	CpG: 23	274	23	170	16.8	62.0	0.88
chr15	41136939	41138062	CpG: 112	1123	112	716	19.9	63.8	0.98
chr15	41175572	41175847	CpG: 24	275	24	170	17.5	61.8	0.92
chr15	41177732	41178805	CpG: 96	1073	96	730	17.9	68.0	0.77
chr15	41260249	41260485	CpG: 19	236	19	141	16.1	59.7	0.92
chr15	41280219	41280448	CpG: 17	229	17	127	14.8	55.5	0.98
chr15	41281375	41281602	CpG: 20	227	20	164	17.6	72.2	0.69
chr15	41300395	41300642	CpG: 30	247	30	162	24.3	65.6	1.17
chr15	41318034	41318560	CpG: 50	526	50	364	19.0	69.2	0.79
chr15	41358979	41359254	CpG: 20	275	20	164	14.5	59.6	0.83
chr15	41397253	41397687	CpG: 45	434	45	301	20.7	69.4	0.98
chr15	41401174	41401786	CpG: 50	612	50	419	16.3	68.5	0.70
chr15	41456027	41456863	CpG: 93	836	93	604	22.2	72.2	0.87
chr15	41457452	41457695	CpG: 18	243	18	143	14.8	58.8	0.86
chr15	41497090	41497524	CpG: 45	434	45	301	20.7	69.4	0.98
chr15	41501011	41501623	CpG: 50	612	50	419	16.3	68.5	0.70
chr15	41552827	41553079	CpG: 20	252	20	151	15.9	59.9	0.90
chr15	41553465	41554281	CpG: 98	816	98	594	24.0	72.8	0.92
chr15	41583748	41584954	CpG: 90	1206	90	781	14.9	64.8	0.71
chr15	41596233	41596469	CpG: 17	236	17	144	14.4	61.0	0.79
chr15	41599309	41600437	CpG: 95	1128	95	730	16.8	64.7	0.82
chr15	41607902	41608305	CpG: 31	403	31	256	15.4	63.5	0.84
chr15	41631847	41632200	CpG: 29	353	29	191	16.4	54.1	1.13
chr15	41634209	41634437	CpG: 28	228	28	162	24.6	71.1	0.97
chr15	41970310	41970632	CpG: 23	322	23	178	14.3	55.3	0.94
chr15	42001977	42003096	CpG: 108	1119	108	784	19.3	70.1	0.79
chr15	42086594	42086882	CpG: 19	288	19	167	13.2	58.0	0.80
chr15	42094021	42094295	CpG: 25	274	25	171	18.2	62.4	0.95
chr15	42096286	42097038	CpG: 63	752	63	507	16.8	67.4	0.74
chr15	42137624	42137853	CpG: 16	229	16	136	14.0	59.4	0.82
chr15	42180855	42181133	CpG: 23	278	23	174	16.5	62.6	0.85
chr15	42217884	42218107	CpG: 19	223	19	134	17.0	60.1	0.97
chr15	42233990	42234265	CpG: 25	275	25	166	18.2	60.4	1.01
chr15	42234670	42235622	CpG: 67	952	67	573	14.1	60.2	0.79
chr15	42263553	42263826	CpG: 21	273	21	171	15.4	62.6	0.79
chr15	42329336	42329610	CpG: 25	274	25	173	18.2	63.1	0.93
chr15	42339008	42339282	CpG: 24	274	24	170	17.5	62.0	0.92
chr15	42344407	42345719	CpG: 143	1312	143	928	21.8	70.7	0.87
chr15	42471065	42471757	CpG: 63	692	63	473	18.2	68.4	0.78
chr15	42519238	42520185	CpG: 76	947	76	605	16.1	63.9	0.79
chr15	42584687	42584910	CpG: 16	223	16	131	14.3	58.7	0.84
chr15	42726816	42727093	CpG: 22	277	22	168	15.9	60.6	0.87
chr15	42830724	42831365	CpG: 50	641	50	417	15.6	65.1	0.74
chr15	42842860	42843251	CpG: 43	391	43	291	22.0	74.4	0.79
chr15	42843787	42844196	CpG: 29	409	29	226	14.2	55.3	0.96
chr15	42919071	42921259	CpG: 169	2188	169	1442	15.4	65.9	0.71
chr15	42922290	42922705	CpG: 35	415	35	258	16.9	62.2	0.89
chr15	42924396	42925351	CpG: 78	955	78	623	16.3	65.2	0.77
chr15	42937060	42938218	CpG: 96	1158	96	796	16.6	68.7	0.71
chr15	42943121	42944031	CpG: 94	910	94	657	20.7	72.2	0.79
chr15	42960311	42960529	CpG: 19	218	19	132	17.4	60.6	1.08
chr15	42974175	42974441	CpG: 19	266	19	155	14.3	58.3	0.85
chr15	42974612	42975391	CpG: 93	779	93	571	23.9	73.3	0.89
chr15	42995318	42996307	CpG: 107	989	107	742	21.6	75.0	0.77
chr15	42996510	42996731	CpG: 17	221	17	127	15.4	57.5	1.17
chr15	43006574	43007054	CpG: 34	480	34	285	14.2	59.4	0.80
chr15	43008942	43009233	CpG: 27	291	27	175	18.6	60.1	1.06
chr15	43023273	43023485	CpG: 24	212	24	126	22.6	59.4	1.31
chr15	43085677	43085955	CpG: 26	278	26	176	18.7	63.3	0.94
chr15	43101134	43102045	CpG: 74	911	74	636	16.2	69.8	0.67
chr15	43122296	43122507	CpG: 23	211	23	158	21.8	74.9	0.78
chr15	43146180	43146453	CpG: 25	273	25	169	18.3	61.9	0.97
chr15	43185945	43187004	CpG: 114	1059	114	724	21.5	68.4	0.92
chr15	43188015	43188254	CpG: 17	239	17	141	14.2	59.0	0.86
chr15	43210387	43211771	CpG: 156	1384	156	974	22.5	70.4	0.91
chr15	43238535	43238913	CpG: 57	378	57	279	30.2	73.8	1.11
chr15	43282712	43282989	CpG: 21	277	21	170	15.2	61.4	0.82
chr15	43330296	43331305	CpG: 123	1009	123	714	24.4	70.8	0.97
chr15	43385495	43385769	CpG: 23	274	23	170	16.8	62.0	0.88
chr15	43395237	43395881	CpG: 61	644	61	430	18.9	66.8	0.85
chr15	43442840	43443721	CpG: 75	881	75	591	17.0	67.1	0.76
chr15	43512428	43513380	CpG: 72	952	72	632	15.1	66.4	0.76
chr15	43752290	43752567	CpG: 23	277	23	175	16.6	63.2	0.84
chr15	43905758	43906154	CpG: 33	396	33	281	16.7	71.0	0.66
chr15	44307288	44307571	CpG: 23	283	23	165	16.3	58.3	0.96
chr15	44416503	44416781	CpG: 26	278	26	176	18.7	63.3	0.94
chr15	44757457	44757689	CpG: 18	232	18	138	15.5	59.5	0.88
chr15	44766730	44766992	CpG: 25	262	25	164	19.1	62.6	1.00
chr15	44973606	44973898	CpG: 21	292	21	174	14.4	59.6	0.81
chr15	44982729	44983003	CpG: 23	274	23	169	16.8	61.7	0.89
chr15	44992091	44993221	CpG: 102	1130	102	725	18.1	64.2	0.88
chr15	45059855	45060087	CpG: 21	232	21	143	18.1	61.6	0.97
chr15	45122316	45122590	CpG: 23	274	23	170	16.8	62.0	0.88
chr15	45122881	45123156	CpG: 24	275	24	170	17.5	61.8	0.92
chr15	45519038	45519319	CpG: 25	281	25	176	17.8	62.6	0.92
chr15	45525237	45526861	CpG: 129	1624	129	1034	15.9	63.7	0.79
chr15	45728491	45728727	CpG: 17	236	17	140	14.4	59.3	0.84
chr15	45985908	45986529	CpG: 64	621	64	449	20.6	72.3	0.79
chr15	46066152	46066430	CpG: 25	278	25	175	18.0	62.9	0.92
chr15	46110615	46110900	CpG: 25	285	25	180	17.5	63.2	0.89
chr15	46130009	46130290	CpG: 24	281	24	176	17.1	62.6	0.88
chr15	46139287	46140715	CpG: 140	1428	140	980	19.6	68.6	0.84
chr15	46452804	46454571	CpG: 173	1767	173	1205	19.6	68.2	0.86
chr15	46573868	46574145	CpG: 22	277	22	168	15.9	60.6	0.87
chr15	46618734	46618941	CpG: 16	207	16	134	15.5	64.7	0.74
chr15	46619272	46619699	CpG: 34	427	34	269	15.9	63.0	0.80
chr15	46686156	46686722	CpG: 50	566	50	354	17.7	62.5	0.92
chr15	46700077	46700352	CpG: 21	275	21	164	15.3	59.6	0.87
chr15	46771029	46771609	CpG: 47	580	47	372	16.2	64.1	0.79
chr15	46784018	46784305	CpG: 37	287	37	212	25.8	73.9	0.95
chr15	46785537	46785813	CpG: 21	276	21	165	15.2	59.8	0.85
chr15	46848800	46849081	CpG: 23	281	23	173	16.4	61.6	0.87
chr15	46854412	46854820	CpG: 43	408	43	290	21.1	71.1	0.84
chr15	46963354	46964082	CpG: 51	728	51	449	14.0	61.7	0.74
chr15	47085242	47085962	CpG: 51	720	51	417	14.2	57.9	0.85
chr15	47162600	47162843	CpG: 21	243	21	147	17.3	60.5	0.95
chr15	47204478	47204789	CpG: 23	311	23	190	14.8	61.1	0.80
chr15	47307305	47307579	CpG: 24	274	24	171	17.5	62.4	0.91
chr15	47429169	47429667	CpG: 54	498	54	342	21.7	68.7	0.92
chr15	47527784	47527995	CpG: 15	211	15	126	14.2	59.7	0.81
chr15	47592564	47592792	CpG: 19	228	19	138	16.7	60.5	0.91
chr15	47610962	47611235	CpG: 24	273	24	168	17.6	61.5	0.94
chr15	47727802	47728044	CpG: 18	242	18	148	14.9	61.2	0.82
chr15	47966104	47966763	CpG: 49	659	49	458	14.9	69.5	0.62
chr15	47980507	47981404	CpG: 73	897	73	639	16.3	71.2	0.64
chr15	47990182	47991210	CpG: 98	1028	98	701	19.1	68.2	0.82
chr15	48151137	48151349	CpG: 15	212	15	126	14.2	59.4	0.82
chr15	48153893	48154110	CpG: 16	217	16	125	14.7	57.6	0.91
chr15	48162398	48163703	CpG: 142	1305	142	894	21.8	68.5	0.93
chr15	48231678	48232039	CpG: 25	361	25	206	13.9	57.1	0.86
chr15	48232232	48232737	CpG: 47	505	47	326	18.6	64.6	0.89
chr15	48316939	48317208	CpG: 19	269	19	162	14.1	60.2	0.79
chr15	48446154	48446428	CpG: 24	274	24	171	17.5	62.4	0.91
chr15	48493202	48494058	CpG: 97	856	97	590	22.7	68.9	0.96
chr15	48503564	48503776	CpG: 16	212	16	127	15.1	59.9	0.86
chr15	48513168	48513441	CpG: 24	273	24	171	17.6	62.6	0.91
chr15	48572399	48572983	CpG: 71	584	71	432	24.3	74.0	0.89
chr15	48618884	48619126	CpG: 21	242	21	176	17.4	72.7	0.66
chr15	48639622	48639854	CpG: 20	232	20	142	17.2	61.2	0.93
chr15	48710464	48710901	CpG: 35	437	35	266	16.0	60.9	0.88
chr15	48715331	48716343	CpG: 120	1012	120	701	23.7	69.3	0.99
chr15	48716912	48717360	CpG: 36	448	36	244	16.1	54.5	1.08
chr15	48844910	48845152	CpG: 20	242	20	147	16.5	60.7	0.90
chr15	48878399	48878679	CpG: 23	280	23	170	16.4	60.7	0.90
chr15	48901334	48902677	CpG: 149	1343	149	952	22.2	70.9	0.88
chr15	48903006	48903229	CpG: 16	223	16	141	14.3	63.2	0.73
chr15	49075002	49075406	CpG: 40	404	40	270	19.8	66.8	0.89
chr15	49101461	49102531	CpG: 82	1070	82	750	15.3	70.1	0.62
chr15	49149297	49149891	CpG: 69	594	69	434	23.2	73.1	0.87
chr15	49230569	49230996	CpG: 33	427	33	257	15.5	60.2	0.86
chr15	49429423	49430652	CpG: 122	1229	122	853	19.9	69.4	0.83
chr15	49488793	49489098	CpG: 25	305	25	199	16.4	65.2	0.80
chr15	49544545	49545450	CpG: 122	905	122	692	27.0	76.5	0.92
chr15	49558731	49559756	CpG: 114	1025	114	749	22.2	73.1	0.83
chr15	49637128	49637764	CpG: 82	636	82	469	25.8	73.7	0.96
chr15	49693342	49694122	CpG: 59	780	59	547	15.1	70.1	0.62
chr15	49779009	49780449	CpG: 101	1440	101	822	14.0	57.1	0.86
chr15	49781262	49781497	CpG: 17	235	17	139	14.5	59.1	0.86
chr15	49827738	49828699	CpG: 140	961	140	733	29.1	76.3	1.00
chr15	49907623	49907866	CpG: 19	243	19	150	15.6	61.7	0.84
chr15	49920640	49921869	CpG: 114	1229	114	822	18.6	66.9	0.83
chr15	49930279	49930538	CpG: 21	259	21	159	16.2	61.4	0.89
chr15	49988038	49989100	CpG: 122	1062	122	771	23.0	72.6	0.88
chr15	50093882	50094658	CpG: 63	776	63	543	16.2	70.0	0.66
chr15	50100054	50100325	CpG: 21	271	21	168	15.5	62.0	0.82
chr15	50103443	50104262	CpG: 89	819	89	612	21.7	74.7	0.78
chr15	50105334	50105609	CpG: 22	275	22	172	16.0	62.5	0.82
chr15	50268077	50268982	CpG: 71	905	71	617	15.7	68.2	0.68
chr15	50336434	50337740	CpG: 145	1306	145	935	22.2	71.6	0.87
chr15	50376855	50377513	CpG: 76	658	76	453	23.1	68.8	1.00
chr15	50483883	50484155	CpG: 23	272	23	168	16.9	61.8	0.90
chr15	50486788	50487944	CpG: 113	1156	113	816	19.6	70.6	0.83
chr15	50592297	50594036	CpG: 128	1739	128	1108	14.7	63.7	0.73
chr15	50595330	50595689	CpG: 27	359	27	236	15.0	65.7	0.70
chr15	50596568	50599806	CpG: 258	3238	258	2137	15.9	66.0	0.73
chr15	50602725	50602954	CpG: 17	229	17	134	14.8	58.5	0.87
chr15	50603307	50603584	CpG: 24	277	24	182	17.3	65.7	0.81
chr15	50612098	50612566	CpG: 39	468	39	309	16.7	66.0	0.77
chr15	50613645	50614565	CpG: 94	920	94	643	20.4	69.9	0.84
chr15	51033341	51033577	CpG: 22	236	22	147	18.6	62.3	0.99
chr15	51350241	51350593	CpG: 29	352	29	211	16.5	59.9	0.92
chr15	51568954	51569303	CpG: 40	349	40	270	22.9	77.4	0.77
chr15	51834477	51834702	CpG: 20	225	20	139	17.8	61.8	0.94
chr15	51977054	51977296	CpG: 20	242	20	151	16.5	62.4	0.88
chr15	52591046	52591877	CpG: 60	831	60	549	14.4	66.1	0.67
chr15	52820808	52821087	CpG: 26	279	26	176	18.6	63.1	0.94
chr15	52825126	52825362	CpG: 19	236	19	148	16.1	62.7	0.83
chr15	52894759	52895044	CpG: 22	285	22	176	15.4	61.8	0.83
chr15	52999705	53000257	CpG: 52	552	52	337	18.8	61.1	1.01
chr15	53018528	53018859	CpG: 29	331	29	199	17.5	60.1	0.98
chr15	53092764	53093565	CpG: 88	801	88	565	22.0	70.5	0.89
chr15	53094467	53094690	CpG: 17	223	17	129	15.2	57.8	0.92
chr15	53121308	53121676	CpG: 29	368	29	219	15.8	59.5	0.89
chr15	53122076	53122599	CpG: 42	523	42	310	16.1	59.3	0.92
chr15	53183559	53183799	CpG: 19	240	19	147	15.8	61.2	0.87
chr15	53193171	53193443	CpG: 21	272	21	163	15.4	59.9	0.86
chr15	53200150	53200426	CpG: 23	276	23	168	16.7	60.9	0.91
chr15	53210164	53210416	CpG: 22	252	22	158	17.5	62.7	0.89
chr15	53211174	53211840	CpG: 68	666	68	451	20.4	67.7	0.89
chr15	53301322	53301898	CpG: 44	576	44	337	15.3	58.5	0.89
chr15	53379335	53379609	CpG: 24	274	24	170	17.5	62.0	0.92
chr15	53390743	53392179	CpG: 182	1436	182	1043	25.3	72.6	0.96
chr15	53393045	53393285	CpG: 19	240	19	143	15.8	59.6	0.91
chr15	53445027	53445308	CpG: 23	281	23	174	16.4	61.9	0.87
chr15	53448287	53448560	CpG: 22	273	22	166	16.1	60.8	0.88
chr15	53545548	53546732	CpG: 143	1184	143	876	24.2	74.0	0.89
chr15	53715005	53715240	CpG: 21	235	21	144	17.9	61.3	0.97
chr15	53782803	53783087	CpG: 25	284	25	178	17.6	62.7	0.91
chr15	53796504	53797539	CpG: 122	1035	122	740	23.6	71.5	0.92
chr15	53806483	53806719	CpG: 21	236	21	145	17.8	61.4	0.96
chr15	53810626	53810835	CpG: 38	209	38	182	36.4	87.1	1.19
chr15	53861079	53861353	CpG: 24	274	24	165	17.5	60.2	0.98
chr15	53943128	53943334	CpG: 18	206	18	124	17.5	60.2	0.97
chr15	54046306	54046905	CpG: 78	599	78	463	26.0	77.3	0.87
chr15	54119643	54120003	CpG: 28	360	28	212	15.6	58.9	0.90
chr15	54168104	54168510	CpG: 40	406	40	252	19.7	62.1	1.02
chr15	54267841	54268045	CpG: 25	204	25	134	24.5	65.7	1.16
chr15	54285061	54285305	CpG: 19	244	19	145	15.6	59.4	0.90
chr15	54343117	54343598	CpG: 33	481	33	311	13.7	64.7	0.66
chr15	54344604	54344839	CpG: 19	235	19	141	16.2	60.0	0.91
chr15	54536280	54537084	CpG: 98	804	98	589	24.4	73.3	0.91
chr15	54569338	54569576	CpG: 19	238	19	144	16.0	60.5	0.89
chr15	54582586	54582845	CpG: 22	259	22	189	17.0	73.0	0.64
chr15	54690292	54690853	CpG: 67	561	67	406	23.9	72.4	0.93
chr15	54721291	54723070	CpG: 222	1779	222	1283	25.0	72.1	0.96
chr15	54765131	54765358	CpG: 19	227	19	137	16.7	60.4	0.96
chr15	54870506	54870780	CpG: 24	274	24	170	17.5	62.0	0.92
chr15	55109066	55109841	CpG: 58	775	58	512	15.0	66.1	0.69
chr15	55129054	55129324	CpG: 21	270	21	168	15.6	62.2	0.81
chr15	55178967	55179658	CpG: 88	691	88	525	25.5	76.0	0.91
chr15	55367161	55367395	CpG: 17	234	17	136	14.5	58.1	0.88
chr15	55394634	55394994	CpG: 56	360	56	289	31.1	80.3	0.97
chr15	55508949	55509630	CpG: 68	681	68	430	20.0	63.1	1.00
chr15	55540770	55541006	CpG: 16	236	16	138	13.6	58.5	0.81
chr15	55867419	55868885	CpG: 162	1466	162	1045	22.1	71.3	0.87
chr15	55928183	55928474	CpG: 23	291	23	175	15.8	60.1	0.88
chr15	56019074	56019310	CpG: 16	236	16	138	13.6	58.5	0.81
chr15	56107940	56108180	CpG: 20	240	20	147	16.7	61.2	0.92
chr15	56224177	56224406	CpG: 18	229	18	141	15.7	61.6	0.84
chr15	56422659	56422940	CpG: 24	281	24	175	17.1	62.3	0.90
chr15	56550861	56552063	CpG: 136	1202	136	856	22.6	71.2	0.90
chr15	56573040	56573876	CpG: 94	836	94	598	22.5	71.5	0.88
chr15	56596925	56597150	CpG: 19	225	19	135	16.9	60.0	0.98
chr15	56609425	56609669	CpG: 17	244	17	141	13.9	57.8	0.84
chr15	56666874	56667423	CpG: 48	549	48	393	17.5	71.6	0.69
chr15	56735125	56736150	CpG: 132	1025	132	716	25.8	69.9	1.06
chr15	56789633	56790612	CpG: 79	979	79	598	16.1	61.1	0.91
chr15	56907153	56907632	CpG: 49	479	49	325	20.5	67.8	0.91
chr15	57008834	57009213	CpG: 28	379	28	231	14.8	60.9	0.80
chr15	57173759	57174977	CpG: 146	1218	146	879	24.0	72.2	0.92
chr15	57224861	57225132	CpG: 19	271	19	163	14.0	60.1	0.79
chr15	57239601	57240269	CpG: 93	668	93	500	27.8	74.9	1.00
chr15	57251233	57251500	CpG: 22	267	22	166	16.5	62.2	0.86
chr15	57458887	57459363	CpG: 51	476	51	340	21.4	71.4	0.85
chr15	57478407	57478614	CpG: 21	207	21	141	20.3	68.1	0.88
chr15	57490753	57491314	CpG: 69	561	69	397	24.6	70.8	0.99
chr15	57491541	57491768	CpG: 19	227	19	135	16.7	59.5	0.99
chr15	57796594	57797150	CpG: 38	556	38	348	13.7	62.6	0.70
chr15	57798813	57799021	CpG: 27	208	27	154	26.0	74.0	0.96
chr15	57801367	57801655	CpG: 21	288	21	185	14.6	64.2	0.71
chr15	57805622	57808007	CpG: 225	2385	225	1584	18.9	66.4	0.88
chr15	57853488	57853761	CpG: 20	273	20	161	14.7	59.0	0.85
chr15	57881548	57881784	CpG: 17	236	17	143	14.4	60.6	0.81
chr15	57890924	57891154	CpG: 17	230	17	138	14.8	60.0	0.83
chr15	58169123	58170908	CpG: 155	1785	155	1355	17.4	75.9	0.60
chr15	58200688	58201369	CpG: 71	681	71	521	20.9	76.5	0.76
chr15	58201646	58201921	CpG: 23	275	23	200	16.7	72.7	0.63
chr15	58216105	58216317	CpG: 18	212	18	130	17.0	61.3	0.92
chr15	58282102	58282593	CpG: 46	491	46	322	18.7	65.6	0.88
chr15	58364357	58364627	CpG: 25	270	25	169	18.5	62.6	0.95
chr15	58394351	58396403	CpG: 233	2052	233	1469	22.7	71.6	0.89
chr15	58749515	58750177	CpG: 49	662	49	446	14.8	67.4	0.65
chr15	59030671	59031081	CpG: 32	410	32	253	15.6	61.7	0.82
chr15	59031473	59032763	CpG: 126	1290	126	855	19.5	66.3	0.89
chr15	59133292	59133531	CpG: 19	239	19	145	15.9	60.7	0.88
chr15	59247415	59247685	CpG: 24	270	24	166	17.8	61.5	0.95
chr15	59287478	59287759	CpG: 26	281	26	176	18.5	62.6	0.96
chr15	59350053	59350275	CpG: 17	222	17	134	15.3	60.4	0.88
chr15	59492287	59492595	CpG: 26	308	26	188	16.9	61.0	0.92
chr15	59700057	59700282	CpG: 20	225	20	135	17.8	60.0	0.99
chr15	59727550	59727826	CpG: 24	276	24	172	17.4	62.3	0.90
chr15	59829757	59830038	CpG: 25	281	25	173	17.8	61.6	0.95
chr15	59864000	59864865	CpG: 83	865	83	589	19.2	68.1	0.83
chr15	59871601	59872769	CpG: 164	1168	164	892	28.1	76.4	0.97
chr15	59967841	59969474	CpG: 192	1633	192	1194	23.5	73.1	0.88
chr15	59990614	59990949	CpG: 27	335	27	244	16.1	72.8	0.61
chr15	60028141	60028622	CpG: 45	481	45	344	18.7	71.5	0.73
chr15	60136185	60136781	CpG: 47	596	47	396	15.8	66.4	0.72
chr15	60193898	60195792	CpG: 186	1894	186	1261	19.6	66.6	0.88
chr15	60249640	60249885	CpG: 18	245	18	153	14.7	62.4	0.77
chr15	60470516	60470748	CpG: 16	232	16	140	13.8	60.3	0.77
chr15	60493395	60494413	CpG: 84	1018	84	723	16.5	71.0	0.65
chr15	60501203	60501481	CpG: 21	278	21	183	15.1	65.8	0.70
chr15	60597331	60597605	CpG: 24	274	24	171	17.5	62.4	0.91
chr15	60756845	60757144	CpG: 28	299	28	205	18.7	68.6	0.81
chr15	60758364	60758642	CpG: 24	278	24	174	17.3	62.6	0.89
chr15	60845862	60847692	CpG: 164	1830	164	1230	17.9	67.2	0.80
chr15	60851940	60853093	CpG: 109	1153	109	811	18.9	70.3	0.77
chr15	60903274	60904041	CpG: 60	767	60	529	15.6	69.0	0.66
chr15	60926579	60927513	CpG: 92	934	92	681	19.7	72.9	0.74
chr15	60962000	60962605	CpG: 56	605	56	414	18.5	68.4	0.79
chr15	60994030	60994735	CpG: 72	705	72	497	20.4	70.5	0.83
chr15	61081877	61082681	CpG: 103	804	103	597	25.6	74.3	0.96
chr15	61126139	61126557	CpG: 32	418	32	288	15.3	68.9	0.65
chr15	61186375	61186647	CpG: 33	272	33	200	24.3	73.5	0.90
chr15	61221903	61222214	CpG: 26	311	26	172	16.7	55.3	1.10
chr15	61255241	61255477	CpG: 17	236	17	137	14.4	58.1	0.88
chr15	61263790	61264167	CpG: 31	377	31	278	16.4	73.7	0.61
chr15	61282563	61284246	CpG: 158	1683	158	1299	18.8	77.2	0.63
chr15	61311183	61312692	CpG: 179	1509	179	1093	23.7	72.4	0.91
chr15	61407829	61408951	CpG: 126	1122	126	767	22.5	68.4	0.96
chr15	61596280	61596554	CpG: 24	274	24	170	17.5	62.0	0.92
chr15	61640501	61641644	CpG: 120	1143	120	800	21.0	70.0	0.86
chr15	61853146	61853932	CpG: 95	786	95	599	24.2	76.2	0.83
chr15	61868029	61868452	CpG: 34	423	34	309	16.1	73.0	0.60
chr15	61900829	61901276	CpG: 31	447	31	262	13.9	58.6	0.81
chr15	61902939	61903582	CpG: 61	643	61	433	19.0	67.3	0.84
chr15	61954871	61955111	CpG: 18	240	18	147	15.0	61.2	0.82
chr15	61958564	61959798	CpG: 129	1234	129	900	20.9	72.9	0.79
chr15	61969867	61970554	CpG: 77	687	77	499	22.4	72.6	0.85
chr15	62136641	62136883	CpG: 23	242	23	149	19.0	61.6	1.00
chr15	62165259	62165868	CpG: 48	609	48	406	15.8	66.7	0.73
chr15	62197129	62197455	CpG: 25	326	25	211	15.3	64.7	0.81
chr15	62269853	62270504	CpG: 79	651	79	493	24.3	75.7	0.93
chr15	62350565	62350851	CpG: 27	286	27	180	18.9	62.9	0.96
chr15	62367144	62367410	CpG: 23	266	23	169	17.3	63.5	0.87
chr15	62512126	62512716	CpG: 58	590	58	425	19.7	72.0	0.77
chr15	62551143	62551392	CpG: 18	249	18	147	14.5	59.0	0.83
chr15	62583973	62585431	CpG: 209	1458	209	1139	28.7	78.1	0.94
chr15	62585845	62586081	CpG: 21	236	21	161	17.8	68.2	0.77
chr15	62608277	62609222	CpG: 71	945	71	657	15.0	69.5	0.62
chr15	62633095	62633649	CpG: 74	554	74	415	26.7	74.9	0.95
chr15	62639945	62640211	CpG: 20	266	20	162	15.0	60.9	0.82
chr15	62641783	62642037	CpG: 17	254	17	137	13.4	53.9	0.93
chr15	62644379	62644829	CpG: 37	450	37	265	16.4	58.9	0.95
chr15	62645045	62645266	CpG: 21	221	21	151	19.0	68.3	0.82
chr15	62650456	62651552	CpG: 98	1096	98	792	17.9	72.3	0.70
chr15	62714135	62714374	CpG: 20	239	20	144	16.7	60.3	0.95
chr15	62714885	62715149	CpG: 22	264	22	166	16.7	62.9	0.85
chr15	62720816	62721478	CpG: 70	662	70	492	21.1	74.3	0.78
chr15	62798990	62799437	CpG: 61	447	61	345	27.3	77.2	0.92
chr15	62838419	62839068	CpG: 68	649	68	467	21.0	72.0	0.81
chr15	62877104	62877622	CpG: 65	518	65	405	25.1	78.2	0.82
chr15	62886206	62887533	CpG: 170	1327	170	949	25.6	71.5	1.00
chr15	62911497	62912125	CpG: 67	628	67	468	21.3	74.5	0.78
chr15	62942375	62943316	CpG: 129	941	129	710	27.4	75.5	0.97
chr15	62993806	62995067	CpG: 99	1261	99	823	15.7	65.3	0.74
chr15	63002387	63002625	CpG: 19	238	19	144	16.0	60.5	0.90
chr15	63062699	63062973	CpG: 24	274	24	171	17.5	62.4	0.91
chr15	63095628	63096505	CpG: 106	877	106	650	24.2	74.1	0.88
chr15	63110462	63111002	CpG: 48	540	48	394	17.8	73.0	0.67
chr15	63111461	63111689	CpG: 19	228	19	154	16.7	67.5	0.74
chr15	63112534	63112813	CpG: 19	279	19	170	13.6	60.9	0.74
chr15	63164515	63165528	CpG: 103	1013	103	708	20.3	69.9	0.83
chr15	63171024	63171371	CpG: 34	347	34	227	19.6	65.4	0.92
chr15	63186336	63187643	CpG: 153	1307	153	978	23.4	74.8	0.86
chr15	63205064	63205564	CpG: 68	500	68	369	27.2	73.8	1.00
chr15	63206167	63206387	CpG: 23	220	23	150	20.9	68.2	0.92
chr15	63225561	63225797	CpG: 17	236	17	139	14.4	58.9	0.85
chr15	63231768	63232601	CpG: 119	833	119	651	28.6	78.2	0.95
chr15	63238621	63238902	CpG: 24	281	24	174	17.1	61.9	0.91
chr15	63239248	63239515	CpG: 24	267	24	167	18.0	62.5	0.93
chr15	63326514	63327227	CpG: 71	713	71	488	19.9	68.4	0.85
chr15	63338955	63339185	CpG: 17	230	17	133	14.8	57.8	0.89
chr15	63339763	63340618	CpG: 93	855	93	606	21.8	70.9	0.87
chr15	63415374	63415646	CpG: 25	272	25	171	18.4	62.9	0.94
chr15	63420271	63420730	CpG: 51	459	51	314	22.2	68.4	0.95
chr15	63466760	63466997	CpG: 17	237	17	142	14.3	59.9	0.81
chr15	63600927	63602013	CpG: 117	1086	117	753	21.5	69.3	0.91
chr15	63653001	63653282	CpG: 22	281	22	173	15.7	61.6	0.84
chr15	63678635	63679679	CpG: 82	1044	82	673	15.7	64.5	0.81
chr15	63791655	63791959	CpG: 31	304	31	218	20.4	71.7	0.79
chr15	64073745	64075611	CpG: 185	1866	185	1295	19.8	69.4	0.83
chr15	64115096	64115822	CpG: 92	726	92	564	25.3	77.7	0.84
chr15	64176515	64176751	CpG: 20	236	20	140	16.9	59.3	1.00
chr15	64177868	64178262	CpG: 36	394	36	263	18.3	66.8	0.86
chr15	64208008	64209076	CpG: 117	1068	117	761	21.9	71.3	0.87
chr15	64319069	64319384	CpG: 32	315	32	220	20.3	69.8	0.83
chr15	64443462	64444097	CpG: 70	635	70	483	22.0	76.1	0.78
chr15	64476427	64476854	CpG: 41	427	41	322	19.2	75.4	0.68
chr15	64522681	64526014	CpG: 355	3333	355	2296	21.3	68.9	0.90
chr15	64552952	64553188	CpG: 20	236	20	145	16.9	61.4	0.92
chr15	64602769	64603406	CpG: 74	637	74	452	23.2	71.0	0.93
chr15	64664299	64664956	CpG: 92	657	92	513	28.0	78.1	0.93
chr15	64673122	64673383	CpG: 22	261	22	166	16.9	63.6	0.87
chr15	64674899	64675366	CpG: 33	467	33	261	14.1	55.9	0.93
chr15	64855522	64855792	CpG: 45	270	45	207	33.3	76.7	1.16
chr15	64879651	64879871	CpG: 19	220	19	132	17.3	60.0	0.99
chr15	64886896	64888664	CpG: 201	1768	201	1285	22.7	72.7	0.86
chr15	65064063	65064350	CpG: 24	287	24	180	16.7	62.7	0.87
chr15	65076263	65076988	CpG: 68	725	68	487	18.8	67.2	0.83
chr15	65318746	65319031	CpG: 22	285	22	176	15.4	61.8	0.82
chr15	65343051	65343862	CpG: 103	811	103	602	25.4	74.2	0.93
chr15	65364461	65365178	CpG: 86	717	86	509	24.0	71.0	0.97
chr15	65398986	65399259	CpG: 23	273	23	170	16.8	62.3	0.88
chr15	65642742	65643095	CpG: 29	353	29	242	16.4	68.6	0.70
chr15	65644986	65652076	CpG: 605	7090	605	4623	17.1	65.2	0.80
chr15	65655524	65656071	CpG: 43	547	43	360	15.7	65.8	0.75
chr15	65656419	65657899	CpG: 117	1480	117	971	15.8	65.6	0.74
chr15	65662138	65662569	CpG: 47	431	47	290	21.8	67.3	0.98
chr15	65685366	65685619	CpG: 32	253	32	177	25.3	70.0	1.04
chr15	65706455	65706902	CpG: 44	447	44	318	19.7	71.1	0.79
chr15	65789771	65789980	CpG: 17	209	17	140	16.3	67.0	0.76
chr15	65875580	65876685	CpG: 100	1105	100	761	18.1	68.9	0.78
chr15	65880678	65880916	CpG: 20	238	20	139	16.8	58.4	1.00
chr15	66047816	66048625	CpG: 108	809	108	625	26.7	77.3	0.90
chr15	66055581	66055866	CpG: 25	285	25	178	17.5	62.5	0.91
chr15	66072596	66072874	CpG: 22	278	22	172	15.8	61.9	0.84
chr15	66075432	66075963	CpG: 49	531	49	378	18.5	71.2	0.73
chr15	66096375	66097459	CpG: 119	1084	119	754	22.0	69.6	0.91
chr15	66253908	66255232	CpG: 120	1324	120	936	18.1	70.7	0.73
chr15	66367724	66367945	CpG: 17	221	17	133	15.4	60.2	0.87
chr15	66382394	66382774	CpG: 35	380	35	258	18.4	67.9	0.81
chr15	66401214	66402555	CpG: 163	1341	163	982	24.3	73.2	0.91
chr15	66524093	66524330	CpG: 20	237	20	144	16.9	60.8	0.93
chr15	66579851	66580132	CpG: 23	281	23	174	16.4	61.9	0.87
chr15	66639924	66644216	CpG: 394	4292	394	2833	18.4	66.0	0.84
chr15	66666442	66666647	CpG: 19	205	19	144	18.5	70.2	0.79
chr15	66751458	66751780	CpG: 33	322	33	240	20.5	74.5	0.74
chr15	66752768	66753559	CpG: 78	791	78	552	19.7	69.8	0.81
chr15	66805252	66805533	CpG: 25	281	25	175	17.8	62.3	0.93
chr15	66854154	66854458	CpG: 33	304	33	203	21.7	66.8	0.97
chr15	66855534	66855756	CpG: 28	222	28	170	25.2	76.6	0.92
chr15	66896520	66896995	CpG: 38	475	38	306	16.0	64.4	0.78
chr15	66982664	66984152	CpG: 123	1488	123	973	16.5	65.4	0.80
chr15	67095950	67096233	CpG: 27	283	27	177	19.1	62.5	0.99
chr15	67121318	67121932	CpG: 74	614	74	466	24.1	75.9	0.84
chr15	67236254	67237090	CpG: 94	836	94	586	22.5	70.1	0.92
chr15	67274791	67275488	CpG: 72	697	72	477	20.7	68.4	0.88
chr15	67284419	67284999	CpG: 46	580	46	363	15.9	62.6	0.81
chr15	67295174	67295458	CpG: 25	284	25	178	17.6	62.7	0.91
chr15	67334791	67335069	CpG: 25	278	25	175	18.0	62.9	0.92
chr15	67543817	67544150	CpG: 23	333	23	193	13.8	58.0	0.83
chr15	67855875	67856319	CpG: 34	444	34	292	15.3	65.8	0.71
chr15	67884437	67884781	CpG: 28	344	28	213	16.3	61.9	0.85
chr15	67917689	67923117	CpG: 452	5428	452	3414	16.7	62.9	0.84
chr15	68407789	68408367	CpG: 56	578	56	415	19.4	71.8	0.75
chr15	68408997	68409213	CpG: 20	216	20	125	18.5	57.9	1.12
chr15	68409917	68410335	CpG: 39	418	39	309	18.7	73.9	0.68
chr15	68585497	68586829	CpG: 121	1332	121	908	18.2	68.2	0.78
chr15	68602435	68602640	CpG: 15	205	15	119	14.6	58.0	0.90
chr15	68635336	68635574	CpG: 19	238	19	143	16.0	60.1	0.89
chr15	68648543	68648821	CpG: 20	278	20	167	14.4	60.1	0.81
chr15	68676620	68677445	CpG: 116	825	116	645	28.1	78.2	0.93
chr15	68684402	68684680	CpG: 25	278	25	176	18.0	63.3	0.91
chr15	68694774	68695691	CpG: 67	917	67	622	14.6	67.8	0.64
chr15	68715222	68715635	CpG: 42	413	42	285	20.3	69.0	0.85
chr15	68938600	68939442	CpG: 117	842	117	647	27.8	76.8	0.94
chr15	68997435	68997851	CpG: 30	416	30	247	14.4	59.4	0.82
chr15	69038972	69039375	CpG: 59	403	59	314	29.3	77.9	0.96
chr15	69107002	69107236	CpG: 16	234	16	135	13.7	57.7	0.83
chr15	69168070	69168297	CpG: 16	227	16	132	14.1	58.1	0.86
chr15	69407102	69407376	CpG: 23	274	23	169	16.8	61.7	0.90
chr15	69412224	69412460	CpG: 20	236	20	143	16.9	60.6	0.94
chr15	69518260	69518461	CpG: 16	201	16	121	15.9	60.2	0.88
chr15	69630301	69630544	CpG: 19	243	19	169	15.6	69.5	0.65
chr15	69630801	69631028	CpG: 18	227	18	162	15.9	71.4	0.62
chr15	69822355	69822637	CpG: 19	282	19	163	13.5	57.8	0.81
chr15	69934257	69935397	CpG: 122	1140	122	796	21.4	69.8	0.89
chr15	69936205	69936485	CpG: 20	280	20	168	14.3	60.0	0.80
chr15	70001063	70001356	CpG: 26	293	26	217	17.7	74.1	0.65
chr15	70013865	70014616	CpG: 95	751	95	553	25.3	73.6	0.94
chr15	70046483	70048590	CpG: 191	2107	191	1414	18.1	67.1	0.81
chr15	70088771	70089494	CpG: 84	723	84	530	23.2	73.3	0.87
chr15	70105562	70106449	CpG: 77	887	77	645	17.4	72.7	0.66
chr15	70136079	70137026	CpG: 99	947	99	680	20.9	71.8	0.82
chr15	70163714	70163990	CpG: 25	276	25	172	18.1	62.3	0.94
chr15	70192504	70193121	CpG: 57	617	57	404	18.5	65.5	0.86
chr15	70291182	70292615	CpG: 163	1433	163	1017	22.7	71.0	0.91
chr15	70352239	70352512	CpG: 21	273	21	171	15.4	62.6	0.79
chr15	70454090	70454551	CpG: 40	461	40	300	17.4	65.1	0.82
chr15	70503280	70503748	CpG: 39	468	39	294	16.7	62.8	0.85
chr15	70504487	70504724	CpG: 19	237	19	138	16.0	58.2	0.95
chr15	70520192	70520475	CpG: 25	283	25	175	17.7	61.8	0.93
chr15	70600555	70601632	CpG: 108	1077	108	724	20.1	67.2	0.89
chr15	70613956	70614666	CpG: 69	710	69	490	19.4	69.0	0.82
chr15	70868719	70870306	CpG: 196	1587	196	1189	24.7	74.9	0.89
chr15	70955774	70956048	CpG: 25	274	25	168	18.2	61.3	0.98
chr15	71135967	71136323	CpG: 29	356	29	248	16.3	69.7	0.67
chr15	71184652	71186807	CpG: 252	2155	252	1573	23.4	73.0	0.88
chr15	71260134	71260421	CpG: 21	287	21	182	14.6	63.4	0.74
chr15	71331261	71331619	CpG: 29	358	29	215	16.2	60.1	0.90
chr15	71449862	71450754	CpG: 101	892	101	662	22.6	74.2	0.83
chr15	71473631	71473920	CpG: 22	289	22	164	15.2	56.7	0.97
chr15	71501351	71502195	CpG: 94	844	94	647	22.3	76.7	0.76
chr15	71548705	71548954	CpG: 20	249	20	128	16.1	51.4	1.22
chr15	71549527	71550036	CpG: 51	509	51	378	20.0	74.3	0.73
chr15	71568378	71568583	CpG: 19	205	19	139	18.5	67.8	0.84
chr15	71569591	71570915	CpG: 171	1324	171	1026	25.8	77.5	0.86
chr15	71743701	71745378	CpG: 184	1677	184	1234	21.9	73.6	0.81
chr15	71790936	71791450	CpG: 46	514	46	373	17.9	72.6	0.68
chr15	71809256	71809825	CpG: 65	569	65	420	22.8	73.8	0.85
chr15	71815348	71815764	CpG: 31	416	31	269	14.9	64.7	0.71
chr15	71840205	71840738	CpG: 60	533	60	364	22.5	68.3	0.98
chr15	71965915	71966377	CpG: 40	462	40	298	17.3	64.5	0.84
chr15	71993450	71996624	CpG: 221	3174	221	2000	13.9	63.0	0.70
chr15	71998671	72002690	CpG: 342	4019	342	2580	17.0	64.2	0.83
chr15	72041192	72041471	CpG: 25	279	25	184	17.9	65.9	0.88
chr15	72113214	72113519	CpG: 28	305	28	209	18.4	68.5	0.79
chr15	72233445	72233982	CpG: 66	537	66	386	24.6	71.9	0.97
chr15	72241571	72242386	CpG: 61	815	61	554	15.0	68.0	0.66
chr15	72278436	72278638	CpG: 15	202	15	130	14.9	64.4	0.73
chr15	72300706	72301870	CpG: 134	1164	134	871	23.0	74.8	0.83
chr15	72328747	72329364	CpG: 50	617	50	389	16.2	63.0	0.82
chr15	72348216	72348448	CpG: 22	232	22	168	19.0	72.4	0.73
chr15	72371074	72371358	CpG: 20	284	20	173	14.1	60.9	0.77
chr15	72408623	72409343	CpG: 76	720	76	509	21.1	70.7	0.85
chr15	72484498	72486098	CpG: 176	1600	176	1141	22.0	71.3	0.87
chr15	72565722	72566225	CpG: 39	503	39	321	15.5	63.8	0.82
chr15	72595733	72596883	CpG: 103	1150	103	782	17.9	68.0	0.78
chr15	72598283	72599150	CpG: 71	867	71	609	16.4	70.2	0.66
chr15	72651746	72652717	CpG: 122	971	122	747	25.1	76.9	0.86
chr15	72672902	72673113	CpG: 22	211	22	136	20.9	64.5	1.02
chr15	72696268	72696605	CpG: 39	337	39	256	23.1	76.0	0.83
chr15	72712691	72713410	CpG: 92	719	92	536	25.6	74.5	0.92
chr15	72742861	72743397	CpG: 54	536	54	374	20.1	69.8	0.83
chr15	72759722	72760114	CpG: 37	392	37	258	18.9	65.8	0.92
chr15	72776179	72777034	CpG: 89	855	89	579	20.8	67.7	0.91
chr15	72807338	72808375	CpG: 109	1037	109	707	21.0	68.2	0.92
chr15	72825819	72827706	CpG: 189	1887	189	1279	20.0	67.8	0.87
chr15	72828677	72829500	CpG: 59	823	59	512	14.3	62.2	0.78
chr15	72865340	72866345	CpG: 91	1005	91	696	18.1	69.3	0.76
chr15	72870969	72871250	CpG: 23	281	23	172	16.4	61.2	0.89
chr15	72893504	72893827	CpG: 34	323	34	217	21.1	67.2	0.97
chr15	72963826	72964099	CpG: 20	273	20	165	14.7	60.4	0.81
chr15	72966372	72966702	CpG: 25	330	25	210	15.2	63.6	0.75
chr15	72986198	72986451	CpG: 28	253	28	191	22.1	75.5	0.78
chr15	72990066	72990342	CpG: 19	276	19	165	13.8	59.8	0.79
chr15	72990449	72990676	CpG: 16	227	16	137	14.1	60.4	0.79
chr15	73035389	73035668	CpG: 24	279	24	170	17.2	60.9	0.94
chr15	73048615	73048923	CpG: 35	308	35	224	22.7	72.7	0.86
chr15	73071629	73073031	CpG: 158	1402	158	1028	22.5	73.3	0.85
chr15	73078558	73078857	CpG: 27	299	27	201	18.1	67.2	0.81
chr15	73205971	73206398	CpG: 35	427	35	286	16.4	67.0	0.74
chr15	73217080	73218463	CpG: 119	1383	119	943	17.2	68.2	0.74
chr15	73226137	73226442	CpG: 26	305	26	209	17.0	68.5	0.73
chr15	73238143	73238815	CpG: 66	672	66	472	19.6	70.2	0.80
chr15	73276496	73276773	CpG: 22	277	22	173	15.9	62.5	0.82
chr15	73288875	73289150	CpG: 20	275	20	165	14.5	60.0	0.83
chr15	73320833	73326194	CpG: 418	5361	418	3436	15.6	64.1	0.77
chr15	73342263	73342472	CpG: 16	209	16	128	15.3	61.2	0.82
chr15	73350417	73352402	CpG: 174	1985	174	1495	17.5	75.3	0.62
chr15	73352788	73353062	CpG: 24	274	24	173	17.5	63.1	0.89
chr15	73355886	73356173	CpG: 23	287	23	177	16.0	61.7	0.85
chr15	73429357	73430027	CpG: 50	670	50	439	14.9	65.5	0.70
chr15	73445718	73445977	CpG: 23	259	23	162	17.8	62.5	0.92
chr15	73449165	73450359	CpG: 142	1194	142	842	23.8	70.5	0.96
chr15	73479908	73480189	CpG: 19	281	19	170	13.5	60.5	0.75
chr15	73494655	73494933	CpG: 25	278	25	176	18.0	63.3	0.91
chr15	73495968	73496577	CpG: 54	609	54	417	17.7	68.5	0.78
chr15	73500996	73501316	CpG: 23	320	23	195	14.4	60.9	0.77
chr15	73505475	73505707	CpG: 16	232	16	134	13.8	57.8	0.85
chr15	73510319	73511149	CpG: 89	830	89	541	21.4	65.2	1.01
chr15	73517871	73519198	CpG: 120	1327	120	905	18.1	68.2	0.78
chr15	73539030	73539368	CpG: 27	338	27	197	16.0	58.3	0.95
chr15	73553382	73553740	CpG: 28	358	28	248	15.6	69.3	0.65
chr15	73558305	73558772	CpG: 34	467	34	305	14.6	65.3	0.68
chr15	73559674	73559976	CpG: 25	302	25	206	16.6	68.2	0.71
chr15	73608953	73610071	CpG: 94	1118	94	774	16.8	69.2	0.70
chr15	73713697	73715373	CpG: 183	1676	183	1172	21.8	69.9	0.90
chr15	73774505	73775352	CpG: 78	847	78	563	18.4	66.5	0.84
chr15	73775630	73775866	CpG: 20	236	20	144	16.9	61.0	0.94
chr15	73921751	73922017	CpG: 23	266	23	166	17.3	62.4	0.90
chr15	73930059	73930908	CpG: 113	849	113	642	26.6	75.6	0.93
chr15	74062822	74063141	CpG: 39	319	39	233	24.5	73.0	0.92
chr15	74101197	74101769	CpG: 41	572	41	330	14.3	57.7	0.87
chr15	74162528	74162761	CpG: 17	233	17	143	14.6	61.4	0.79
chr15	74182316	74182779	CpG: 51	463	51	321	22.0	69.3	0.92
chr15	74183127	74183364	CpG: 18	237	18	141	15.2	59.5	0.87
chr15	74205984	74206657	CpG: 55	673	55	398	16.3	59.1	0.94
chr15	74207819	74208028	CpG: 24	209	24	143	23.0	68.4	0.98
chr15	74208851	74214337	CpG: 404	5486	404	3511	14.7	64.0	0.72
chr15	74217294	74218645	CpG: 132	1351	132	913	19.5	67.6	0.86
chr15	74658997	74659216	CpG: 22	219	22	136	20.1	62.1	1.06
chr15	74758692	74758930	CpG: 20	238	20	156	16.8	65.5	0.78
chr15	74763951	74764588	CpG: 77	637	77	469	24.2	73.6	0.90
chr15	74790480	74791175	CpG: 96	695	96	529	27.6	76.1	0.95
chr15	74803053	74803319	CpG: 22	266	22	161	16.5	60.5	0.92
chr15	74812676	74812938	CpG: 21	262	21	163	16.0	62.2	0.84
chr15	74891328	74891567	CpG: 18	239	18	161	15.1	67.4	0.67
chr15	74930933	74931755	CpG: 109	822	109	624	26.5	75.9	0.94
chr15	75279727	75281012	CpG: 156	1285	156	923	24.3	71.8	0.95
chr15	75329702	75329942	CpG: 21	240	21	148	17.5	61.7	0.94
chr15	75474705	75476491	CpG: 127	1786	127	1125	14.2	63.0	0.73
chr15	75492553	75493973	CpG: 178	1420	178	1083	25.1	76.3	0.86
chr15	75495026	75495347	CpG: 33	321	33	236	20.6	73.5	0.79
chr15	75680715	75682717	CpG: 253	2002	253	1530	25.3	76.4	0.88
chr15	75756459	75756713	CpG: 30	254	30	195	23.6	76.8	0.81
chr15	75766167	75766426	CpG: 23	259	23	184	17.8	71.0	0.72
chr15	75806587	75806965	CpG: 33	378	33	253	17.5	66.9	0.79
chr15	75939722	75940453	CpG: 102	731	102	557	27.9	76.2	0.97
chr15	75993564	75994384	CpG: 106	820	106	623	25.9	76.0	0.91
chr15	76011711	76012477	CpG: 88	766	88	576	23.0	75.2	0.82
chr15	76108678	76109218	CpG: 42	540	42	386	15.6	71.5	0.61
chr15	76126623	76127759	CpG: 137	1136	137	834	24.1	73.4	0.90
chr15	76166030	76166302	CpG: 19	272	19	166	14.0	61.0	0.76
chr15	76202828	76204346	CpG: 117	1518	117	962	15.4	63.4	0.77
chr15	76300420	76301430	CpG: 93	1010	93	660	18.4	65.3	0.89
chr15	76337440	76337713	CpG: 22	273	22	170	16.1	62.3	0.85
chr15	76367809	76368085	CpG: 21	276	21	166	15.2	60.1	0.85
chr15	76369876	76370657	CpG: 64	781	64	514	16.4	65.8	0.77
chr15	76402997	76403628	CpG: 61	631	61	418	19.3	66.2	0.88
chr15	76428056	76428600	CpG: 68	544	68	398	25.0	73.2	0.96
chr15	76429641	76429883	CpG: 21	242	21	146	17.4	60.3	0.97
chr15	76465390	76465624	CpG: 16	234	16	121	13.7	51.7	1.03
chr15	76483371	76484752	CpG: 150	1381	150	1003	21.7	72.6	0.83
chr15	76504267	76504901	CpG: 57	634	57	462	18.0	72.9	0.69
chr15	76614507	76614771	CpG: 20	264	20	183	15.2	69.3	0.63
chr15	76622769	76622995	CpG: 23	226	23	165	20.4	73.0	0.79
chr15	76627394	76627629	CpG: 20	235	20	165	17.0	70.2	0.69
chr15	76663888	76664237	CpG: 48	349	48	251	27.5	71.9	1.06
chr15	76674045	76675958	CpG: 180	1913	180	1356	18.8	70.9	0.75
chr15	76694275	76695858	CpG: 121	1583	121	1029	15.3	65.0	0.72
chr15	76710536	76710927	CpG: 31	391	31	283	15.9	72.4	0.61
chr15	76736286	76737396	CpG: 109	1110	109	747	19.6	67.3	0.93
chr15	76739674	76739913	CpG: 20	239	20	141	16.7	59.0	0.97
chr15	76805233	76805462	CpG: 17	229	17	136	14.8	59.4	0.84
chr15	76808368	76808897	CpG: 64	529	64	388	24.2	73.3	0.90
chr15	76953169	76955574	CpG: 212	2405	212	1546	17.6	64.3	0.86
chr15	77146010	77146391	CpG: 36	381	36	272	18.9	71.4	0.75
chr15	77147239	77147450	CpG: 24	211	24	145	22.7	68.7	0.98
chr15	77174391	77175272	CpG: 84	881	84	627	19.1	71.2	0.75
chr15	77240994	77241267	CpG: 24	273	24	173	17.6	63.4	0.89
chr15	77295090	77296621	CpG: 161	1531	161	1041	21.0	68.0	0.91
chr15	77354670	77355146	CpG: 33	476	33	280	13.9	58.8	0.81
chr15	77462893	77463167	CpG: 25	274	25	171	18.2	62.4	0.95
chr15	77482653	77482927	CpG: 22	274	22	170	16.1	62.0	0.84
chr15	77532983	77533256	CpG: 24	273	24	171	17.6	62.6	0.91
chr15	77759639	77760306	CpG: 84	667	84	501	25.2	75.1	0.90
chr15	77768000	77768214	CpG: 15	214	15	128	14.0	59.8	0.79
chr15	77785965	77787107	CpG: 124	1142	124	799	21.7	70.0	0.89
chr15	77787366	77787583	CpG: 18	217	18	130	16.6	59.9	0.93
chr15	77788091	77788319	CpG: 18	228	18	138	15.8	60.5	0.87
chr15	77789086	77789417	CpG: 34	331	34	245	20.5	74.0	0.75
chr15	77822907	77823148	CpG: 17	241	17	134	14.1	55.6	0.93
chr15	77855991	77856255	CpG: 21	264	21	158	15.9	59.8	0.90
chr15	77879945	77880212	CpG: 24	267	24	195	18.0	73.0	0.67
chr15	77922752	77923724	CpG: 125	972	125	713	25.7	73.4	0.96
chr15	78015835	78016586	CpG: 58	751	58	551	15.4	73.4	0.64
chr15	78084377	78084600	CpG: 17	223	17	131	15.2	58.7	0.90
chr15	78115107	78115755	CpG: 94	648	94	498	29.0	76.9	0.98
chr15	78195486	78195847	CpG: 26	361	26	246	14.4	68.1	0.62
chr15	78267318	78268635	CpG: 158	1317	158	979	24.0	74.3	0.87
chr15	78510752	78511470	CpG: 52	718	52	498	14.5	69.4	0.60
chr15	78558413	78559951	CpG: 201	1538	201	1149	26.1	74.7	0.94
chr15	78642464	78644417	CpG: 159	1953	159	1303	16.3	66.7	0.73
chr15	78853181	78853720	CpG: 56	539	56	367	20.8	68.1	0.91
chr15	78864097	78866913	CpG: 336	2816	336	2039	23.9	72.4	0.91
chr15	78964054	78964328	CpG: 23	274	23	170	16.8	62.0	0.88
chr15	78982480	78982832	CpG: 39	352	39	249	22.2	70.7	0.89
chr15	78998151	78998354	CpG: 21	203	21	138	20.7	68.0	0.90
chr15	79022629	79023022	CpG: 41	393	41	293	20.9	74.6	0.75
chr15	79023661	79024019	CpG: 27	358	27	204	15.1	57.0	0.96
chr15	79026904	79027178	CpG: 24	274	24	171	17.5	62.4	0.91
chr15	79187984	79188694	CpG: 66	710	66	478	18.6	67.3	0.82
chr15	79277968	79278217	CpG: 28	249	28	189	22.5	75.9	0.79
chr15	79301053	79301295	CpG: 19	242	19	147	15.7	60.7	0.87
chr15	79538213	79538455	CpG: 18	242	18	143	14.9	59.1	0.85
chr15	79555750	79556031	CpG: 24	281	24	176	17.1	62.6	0.89
chr15	79594413	79594731	CpG: 26	318	26	184	16.4	57.9	0.98
chr15	79601884	79602157	CpG: 23	273	23	172	16.8	63.0	0.86
chr15	79661992	79662420	CpG: 34	428	34	258	15.9	60.3	0.88
chr15	79734842	79735076	CpG: 25	234	25	146	21.4	62.4	1.10
chr15	79809724	79809959	CpG: 17	235	17	139	14.5	59.1	0.85
chr15	79859329	79859571	CpG: 24	242	24	147	19.8	60.7	1.08
chr15	79902770	79903006	CpG: 19	236	19	141	16.1	59.7	0.93
chr15	79907182	79911904	CpG: 451	4722	451	3168	19.1	67.1	0.85
chr15	79970441	79970715	CpG: 25	274	25	171	18.2	62.4	0.95
chr15	80034200	80034474	CpG: 22	274	22	169	16.1	61.7	0.85
chr15	80126561	80127252	CpG: 70	691	70	477	20.3	69.0	0.85
chr15	80162677	80163018	CpG: 44	341	44	245	25.8	71.8	1.00
chr15	80191114	80191413	CpG: 21	299	21	192	14.0	64.2	0.71
chr15	80198371	80198597	CpG: 20	226	20	161	17.7	71.2	0.73
chr15	80219065	80220079	CpG: 126	1014	126	745	24.9	73.5	0.92
chr15	80309268	80310242	CpG: 87	974	87	685	17.9	70.3	0.73
chr15	80377229	80378243	CpG: 126	1014	126	745	24.9	73.5	0.92
chr15	80404104	80405149	CpG: 96	1045	96	682	18.4	65.3	0.86
chr15	80443863	80444148	CpG: 21	285	21	174	14.7	61.1	0.80
chr15	80470769	80471043	CpG: 23	274	23	170	16.8	62.0	0.88
chr15	80481985	80482215	CpG: 20	230	20	140	17.4	60.9	0.95
chr15	80510590	80513015	CpG: 235	2425	235	1688	19.4	69.6	0.80
chr15	80544303	80545329	CpG: 91	1026	91	704	17.7	68.6	0.76
chr15	80573498	80574559	CpG: 116	1061	116	763	21.9	71.9	0.85
chr15	80598748	80599022	CpG: 22	274	22	169	16.1	61.7	0.86
chr15	80614536	80615106	CpG: 43	570	43	337	15.1	59.1	0.87
chr15	80673905	80674812	CpG: 132	907	132	690	29.1	76.1	1.02
chr15	80752819	80753245	CpG: 32	426	32	254	15.0	59.6	0.85
chr15	80816568	80817345	CpG: 116	777	116	629	29.9	81.0	0.91
chr15	80817964	80818208	CpG: 21	244	21	142	17.2	58.2	1.02
chr15	80850209	80850864	CpG: 45	655	45	393	13.7	60.0	0.76
chr15	80875596	80876121	CpG: 54	525	54	368	20.6	70.1	0.84
chr15	80930867	80931711	CpG: 103	844	103	607	24.4	71.9	0.95
chr15	80971110	80972196	CpG: 127	1086	127	797	23.4	73.4	0.87
chr15	81070976	81072467	CpG: 206	1491	206	1126	27.6	75.5	0.98
chr15	81151154	81153104	CpG: 236	1950	236	1373	24.2	70.4	0.98
chr15	81204885	81205116	CpG: 17	231	17	134	14.7	58.0	0.88
chr15	81227912	81228184	CpG: 23	272	23	169	16.9	62.1	0.88
chr15	81246982	81247265	CpG: 24	283	24	192	17.0	67.8	0.76
chr15	81251713	81252007	CpG: 29	294	29	185	19.7	62.9	1.00
chr15	81314919	81316093	CpG: 111	1174	111	814	18.9	69.3	0.79
chr15	81324370	81324729	CpG: 29	359	29	214	16.2	59.6	0.91
chr15	81341494	81341760	CpG: 20	266	20	162	15.0	60.9	0.82
chr15	81521507	81522956	CpG: 170	1449	170	1051	23.5	72.5	0.90
chr15	81690120	81691472	CpG: 109	1352	109	965	16.1	71.4	0.63
chr15	81945794	81946486	CpG: 65	692	65	459	18.8	66.3	0.86
chr15	82038504	82039400	CpG: 82	896	82	631	18.3	70.4	0.74
chr15	82095274	82096288	CpG: 126	1014	126	744	24.9	73.4	0.93
chr15	82117546	82118442	CpG: 82	896	82	632	18.3	70.5	0.74
chr15	82195697	82196711	CpG: 126	1014	126	744	24.9	73.4	0.93
chr15	82252572	82253468	CpG: 82	896	82	631	18.3	70.4	0.74
chr15	82322567	82323547	CpG: 93	980	93	685	19.0	69.9	0.79
chr15	82353274	82353845	CpG: 60	571	60	399	21.0	69.9	0.86
chr15	82354449	82354674	CpG: 17	225	17	134	15.1	59.6	0.86
chr15	82383452	82383984	CpG: 37	532	37	295	13.9	55.5	0.91
chr15	82385824	82386798	CpG: 119	974	119	683	24.4	70.1	0.99
chr15	82406414	82406877	CpG: 40	463	40	303	17.3	65.4	0.81
chr15	82410378	82410900	CpG: 59	522	59	388	22.6	74.3	0.82
chr15	82424792	82425597	CpG: 63	805	63	551	15.7	68.4	0.67
chr15	82468012	82468998	CpG: 83	986	83	627	16.8	63.6	0.83
chr15	82500239	82501520	CpG: 167	1281	167	994	26.1	77.6	0.88
chr15	82530142	82530383	CpG: 19	241	19	146	15.8	60.6	0.88
chr15	82568650	82568896	CpG: 20	246	20	149	16.3	60.6	0.91
chr15	82569324	82569997	CpG: 77	673	77	522	22.9	77.6	0.77
chr15	82732525	82734877	CpG: 273	2352	273	1679	23.2	71.4	0.91
chr15	82769224	82769497	CpG: 22	273	22	169	16.1	61.9	0.86
chr15	82986089	82987103	CpG: 126	1014	126	745	24.9	73.5	0.92
chr15	83007704	83007930	CpG: 21	226	21	161	18.6	71.2	0.76
chr15	83048117	83048351	CpG: 19	234	19	141	16.2	60.3	0.92
chr15	83093798	83094023	CpG: 18	225	18	133	16.0	59.1	0.92
chr15	83123830	83124067	CpG: 19	237	19	142	16.0	59.9	0.92
chr15	83132417	83133493	CpG: 137	1076	137	787	25.5	73.1	0.95
chr15	83151266	83151547	CpG: 24	281	24	175	17.1	62.3	0.90
chr15	83163550	83163784	CpG: 18	234	18	142	15.4	60.7	0.86
chr15	83186142	83186455	CpG: 27	313	27	192	17.3	61.3	0.92
chr15	83214798	83215072	CpG: 21	274	21	167	15.3	60.9	0.83
chr15	83493114	83493320	CpG: 17	206	17	141	16.5	68.4	0.71
chr15	83510849	83511113	CpG: 20	264	20	164	15.2	62.1	0.79
chr15	83521030	83521924	CpG: 61	894	61	565	13.6	63.2	0.69
chr15	83546297	83547308	CpG: 109	1011	109	700	21.6	69.2	0.90
chr15	83593338	83593576	CpG: 27	238	27	161	22.7	67.6	0.99
chr15	83595330	83595615	CpG: 23	285	23	176	16.1	61.8	0.86
chr15	83606616	83606918	CpG: 23	302	23	180	15.2	59.6	0.87
chr15	83654710	83654979	CpG: 21	269	21	165	15.6	61.3	0.85
chr15	84283031	84283390	CpG: 25	359	25	211	13.9	58.8	0.81
chr15	85264469	85264778	CpG: 25	309	25	182	16.2	58.9	0.94
chr15	85636087	85636323	CpG: 16	236	16	139	13.6	58.9	0.80
chr15	85811533	85811810	CpG: 27	277	27	173	19.5	62.5	1.01
chr15	85960683	85961280	CpG: 47	597	47	357	15.7	59.8	0.88
chr15	86010029	86012393	CpG: 202	2364	202	1541	17.1	65.2	0.81
chr15	86221812	86222600	CpG: 56	788	56	474	14.2	60.2	0.79
chr15	86268420	86268694	CpG: 25	274	25	172	18.2	62.8	0.94
chr15	86278184	86278774	CpG: 45	590	45	390	15.3	66.1	0.70
chr15	86359117	86360655	CpG: 100	1538	100	984	13.0	64.0	0.64
chr15	86369616	86369865	CpG: 21	249	21	153	16.9	61.4	0.90
chr15	86375850	86376426	CpG: 64	576	64	417	22.2	72.4	0.85
chr15	86423936	86424210	CpG: 24	274	24	172	17.5	62.8	0.90
chr15	86459797	86460299	CpG: 48	502	48	368	19.1	73.3	0.74
chr15	86496425	86496700	CpG: 28	275	28	201	20.4	73.1	0.77
chr15	86524130	86524594	CpG: 35	464	35	297	15.1	64.0	0.78
chr15	86556280	86556517	CpG: 18	237	18	145	15.2	61.2	0.83
chr15	86557451	86558611	CpG: 110	1160	110	834	19.0	71.9	0.76
chr15	86636041	86636282	CpG: 22	241	22	156	18.3	64.7	0.89
chr15	86649588	86650262	CpG: 61	674	61	486	18.1	72.1	0.70
chr15	86667601	86668242	CpG: 66	641	66	456	20.6	71.1	0.82
chr15	86772525	86772804	CpG: 24	279	24	167	17.2	59.9	0.99
chr15	86786547	86787080	CpG: 45	533	45	390	16.9	73.2	0.63
chr15	86843169	86844051	CpG: 72	882	72	589	16.3	66.8	0.74
chr15	86998597	86999290	CpG: 63	693	63	437	18.2	63.1	0.92
chr15	87051654	87052414	CpG: 61	760	61	548	16.1	72.1	0.62
chr15	87087982	87090189	CpG: 190	2207	190	1437	17.2	65.1	0.81
chr15	87114739	87115610	CpG: 90	871	90	605	20.7	69.5	0.86
chr15	87116272	87116546	CpG: 27	274	27	191	19.7	69.7	0.82
chr15	87117648	87118876	CpG: 102	1228	102	849	16.6	69.1	0.70
chr15	87123347	87125003	CpG: 138	1656	138	1105	16.7	66.7	0.76
chr15	87127139	87127887	CpG: 88	748	88	527	23.5	70.5	0.95
chr15	87133594	87135569	CpG: 165	1975	165	1294	16.7	65.5	0.78
chr15	87155394	87156654	CpG: 117	1260	117	866	18.6	68.7	0.79
chr15	87162176	87163914	CpG: 123	1738	123	1013	14.2	58.3	0.83
chr15	87165049	87165839	CpG: 59	790	59	472	14.9	59.7	0.84
chr15	87167381	87167960	CpG: 51	579	51	385	17.6	66.5	0.80
chr15	87172541	87172789	CpG: 23	248	23	170	18.5	68.5	0.83
chr15	87186586	87187062	CpG: 38	476	38	303	16.0	63.7	0.79
chr15	87242729	87243126	CpG: 32	397	32	270	16.1	68.0	0.70
chr15	87252263	87252783	CpG: 50	520	50	359	19.2	69.0	0.81
chr15	87331487	87332081	CpG: 66	594	66	429	22.2	72.2	0.85
chr15	87384367	87384606	CpG: 18	239	18	163	15.1	68.2	0.66
chr15	87404183	87405322	CpG: 130	1139	130	833	22.8	73.1	0.86
chr15	87410788	87411521	CpG: 81	733	81	535	22.1	73.0	0.84
chr15	87421386	87421931	CpG: 70	545	70	404	25.7	74.1	0.94
chr15	87445730	87445998	CpG: 20	268	20	164	14.9	61.2	0.80
chr15	87446178	87446731	CpG: 47	553	47	359	17.0	64.9	0.82
chr15	87505867	87507379	CpG: 156	1512	156	1098	20.6	72.6	0.79
chr15	87532264	87533133	CpG: 95	869	95	636	21.9	73.2	0.82
chr15	87570031	87571202	CpG: 114	1171	114	821	19.5	70.1	0.81
chr15	87649800	87650404	CpG: 57	604	57	382	18.9	63.2	0.94
chr15	87668347	87669048	CpG: 79	701	79	507	22.5	72.3	0.87
chr15	87733651	87734197	CpG: 45	546	45	382	16.5	70.0	0.68
chr15	87756182	87758683	CpG: 221	2501	221	1696	17.7	67.8	0.77
chr15	87823200	87824406	CpG: 87	1206	87	800	14.4	66.3	0.66
chr15	87857798	87858964	CpG: 130	1166	130	857	22.3	73.5	0.83
chr15	87940673	87941364	CpG: 70	691	70	508	20.3	73.5	0.75
chr15	87956924	87958116	CpG: 117	1192	117	862	19.6	72.3	0.75
chr15	87989474	87990411	CpG: 98	937	98	684	20.9	73.0	0.79
chr15	88005321	88005691	CpG: 34	370	34	252	18.4	68.1	0.79
chr15	88021332	88022009	CpG: 58	677	58	441	17.1	65.1	0.81
chr15	88030907	88031360	CpG: 53	453	53	305	23.4	67.3	1.03
chr15	88034720	88034953	CpG: 16	233	16	138	13.7	59.2	0.81
chr15	88041793	88042026	CpG: 20	233	20	141	17.2	60.5	0.96
chr15	88108252	88108770	CpG: 45	518	45	337	17.4	65.1	0.83
chr15	88115099	88115380	CpG: 24	281	24	175	17.1	62.3	0.90
chr15	88143065	88143460	CpG: 34	395	34	237	17.2	60.0	0.96
chr15	88143943	88144800	CpG: 95	857	95	629	22.2	73.4	0.85
chr15	88151357	88151635	CpG: 20	278	20	168	14.4	60.4	0.80
chr15	88285486	88286773	CpG: 169	1287	169	978	26.3	76.0	0.93
chr15	88423420	88424298	CpG: 84	878	84	618	19.1	70.4	0.78
chr15	88475483	88476018	CpG: 54	535	54	349	20.2	65.2	0.95
chr15	88578586	88578987	CpG: 35	401	35	282	17.5	70.3	0.72
chr15	88630331	88631877	CpG: 215	1546	215	1238	27.8	80.1	0.87
chr15	88639696	88639950	CpG: 23	254	23	176	18.1	69.3	0.78
chr15	88640943	88641204	CpG: 19	261	19	181	14.6	69.3	0.62
chr15	88643806	88644272	CpG: 50	466	50	359	21.5	77.0	0.73
chr15	88661916	88663121	CpG: 148	1205	148	890	24.6	73.9	0.90
chr15	88689667	88690244	CpG: 47	577	47	353	16.3	61.2	0.87
chr15	88691979	88692279	CpG: 38	300	38	220	25.3	73.3	0.94
chr15	88694470	88695336	CpG: 73	866	73	610	16.9	70.4	0.70
chr15	88714347	88714968	CpG: 61	621	61	426	19.6	68.6	0.84
chr15	88716246	88717171	CpG: 99	925	99	673	21.4	72.8	0.81
chr15	88753589	88754571	CpG: 123	982	123	701	25.1	71.4	0.99
chr15	88781812	88782382	CpG: 44	570	44	358	15.4	62.8	0.78
chr15	88860400	88861194	CpG: 77	794	77	512	19.4	64.5	0.93
chr15	89057496	89057888	CpG: 40	392	40	250	20.4	63.8	1.03
chr15	89238917	89239156	CpG: 18	239	18	142	15.1	59.4	0.87
chr15	89567632	89567868	CpG: 21	236	21	145	17.8	61.4	0.97
chr15	89614533	89616161	CpG: 188	1628	188	1219	23.1	74.9	0.83
chr15	89677787	89678199	CpG: 50	412	50	283	24.3	68.7	1.03
chr15	90155896	90157740	CpG: 187	1844	187	1302	20.3	70.6	0.82
chr15	90417492	90418293	CpG: 104	801	104	605	26.0	75.5	0.92
chr15	90473400	90474164	CpG: 67	764	67	532	17.5	69.6	0.72
chr15	90476570	90477285	CpG: 68	715	68	463	19.0	64.8	0.91
chr15	90530306	90531740	CpG: 111	1434	111	994	15.5	69.3	0.65
chr15	90570873	90572114	CpG: 110	1241	110	777	17.7	62.6	0.91
chr15	90630742	90631003	CpG: 22	261	22	159	16.9	60.9	0.93
chr15	90644806	90645784	CpG: 133	978	133	747	27.2	76.4	0.96
chr15	90652484	90652765	CpG: 24	281	24	175	17.1	62.3	0.90
chr15	90666536	90666856	CpG: 37	320	37	221	23.1	69.1	0.97
chr15	90734834	90735108	CpG: 23	274	23	170	16.8	62.0	0.88
chr15	90794102	90794493	CpG: 35	391	35	282	17.9	72.1	0.69
chr15	90807216	90807684	CpG: 33	468	33	317	14.1	67.7	0.62
chr15	90814358	90814809	CpG: 38	451	38	299	16.9	66.3	0.80
chr15	90828264	90829036	CpG: 61	772	61	505	15.8	65.4	0.74
chr15	90834737	90836300	CpG: 135	1563	135	1063	17.3	68.0	0.76
chr15	90850546	90852232	CpG: 183	1686	183	1152	21.7	68.3	0.93
chr15	90871805	90872099	CpG: 27	294	27	184	18.4	62.6	0.95
chr15	91042583	91042833	CpG: 23	250	23	156	18.4	62.4	0.97
chr15	91054444	91054718	CpG: 22	274	22	168	16.1	61.3	0.86
chr15	91080497	91080728	CpG: 17	231	17	131	14.7	56.7	0.94
chr15	91095093	91095329	CpG: 18	236	18	140	15.3	59.3	0.89
chr15	91095493	91095728	CpG: 17	235	17	143	14.5	60.9	0.84
chr15	91115938	91116230	CpG: 23	292	23	175	15.8	59.9	0.89
chr15	91194347	91194573	CpG: 27	226	27	157	23.9	69.5	0.99
chr15	91233525	91233802	CpG: 19	277	19	171	13.7	61.7	0.73
chr15	91437250	91437677	CpG: 35	427	35	261	16.4	61.1	0.88
chr15	91543056	91543301	CpG: 19	245	19	147	15.5	60.0	0.87
chr15	91697081	91697285	CpG: 16	204	16	116	15.7	56.9	0.98
chr15	91781451	91781715	CpG: 20	264	20	154	15.2	58.3	0.91
chr15	91864683	91864968	CpG: 26	285	26	180	18.2	63.2	0.93
chr15	91964616	91964897	CpG: 23	281	23	173	16.4	61.6	0.88
chr15	91994488	91994853	CpG: 46	365	46	276	25.2	75.6	0.88
chr15	92199686	92199960	CpG: 25	274	25	170	18.2	62.0	0.96
chr15	92577540	92577770	CpG: 20	230	20	140	17.4	60.9	0.95
chr15	92608870	92609505	CpG: 82	635	82	466	25.8	73.4	0.96
chr15	92619608	92620895	CpG: 96	1287	96	858	14.9	66.7	0.67
chr15	93090879	93091246	CpG: 53	367	53	273	28.9	74.4	1.05
chr15	93105415	93105645	CpG: 18	230	18	136	15.7	59.1	0.91
chr15	93276088	93276362	CpG: 24	274	24	171	17.5	62.4	0.91
chr15	93402796	93403074	CpG: 24	278	24	174	17.3	62.6	0.90
chr15	93775157	93775435	CpG: 24	278	24	173	17.3	62.2	0.91
chr15	94070183	94070445	CpG: 21	262	21	160	16.0	61.1	0.88
chr15	94086235	94088141	CpG: 153	1906	153	1224	16.1	64.2	0.78
chr15	94094764	94099083	CpG: 385	4319	385	2773	17.8	64.2	0.87
chr15	94105297	94105889	CpG: 54	592	54	402	18.2	67.9	0.80
chr15	94108771	94108972	CpG: 15	201	15	133	14.9	66.2	0.68
chr15	94109149	94109386	CpG: 18	237	18	141	15.2	59.5	0.86
chr15	94110314	94110773	CpG: 41	459	41	313	17.9	68.2	0.79
chr15	94116676	94117099	CpG: 40	423	40	296	18.9	70.0	0.77
chr15	94118307	94119425	CpG: 91	1118	91	739	16.3	66.1	0.75
chr15	94121521	94122023	CpG: 60	502	60	342	23.9	68.1	1.04
chr15	94124696	94125096	CpG: 36	400	36	274	18.0	68.5	0.77
chr15	94126107	94126435	CpG: 24	328	24	205	14.6	62.5	0.75
chr15	94131203	94131418	CpG: 18	215	18	149	16.7	69.3	0.70
chr15	94132899	94133196	CpG: 24	297	24	197	16.2	66.3	0.75
chr15	94173927	94174592	CpG: 72	665	72	438	21.7	65.9	1.00
chr15	94180722	94181912	CpG: 105	1190	105	775	17.6	65.1	0.83
chr15	94256406	94256837	CpG: 44	431	44	327	20.4	75.9	0.71
chr15	94748972	94749524	CpG: 62	552	62	414	22.5	75.0	0.80
chr15	94988986	94989476	CpG: 50	490	50	364	20.4	74.3	0.74
chr15	94991786	94992060	CpG: 26	274	26	173	19.0	63.1	0.96
chr15	95036248	95036559	CpG: 23	311	23	189	14.8	60.8	0.80
chr15	95061041	95061257	CpG: 17	216	17	128	15.7	59.3	0.90
chr15	95175374	95175648	CpG: 22	274	22	170	16.1	62.0	0.84
chr15	95300698	95300968	CpG: 23	270	23	166	17.0	61.5	0.91
chr15	95418085	95418455	CpG: 32	370	32	231	17.3	62.4	0.89
chr15	95637340	95637625	CpG: 23	285	23	177	16.1	62.1	0.85
chr15	95641241	95641518	CpG: 39	277	39	218	28.2	78.7	0.93
chr15	95670640	95670869	CpG: 17	229	17	134	14.8	58.5	0.88
chr15	95712613	95712849	CpG: 20	236	20	146	16.9	61.9	0.91
chr15	95725959	95727074	CpG: 115	1115	115	792	20.6	71.0	0.82
chr15	95843713	95843993	CpG: 23	280	23	172	16.4	61.4	0.89
chr15	95857012	95857306	CpG: 21	294	21	174	14.3	59.2	0.82
chr15	95869619	95870361	CpG: 58	742	58	528	15.6	71.2	0.62
chr15	95928265	95928550	CpG: 25	285	25	179	17.5	62.8	0.90
chr15	96092960	96093238	CpG: 24	278	24	174	17.3	62.6	0.89
chr15	96185757	96186519	CpG: 68	762	68	505	17.8	66.3	0.81
chr15	96192322	96193026	CpG: 59	704	59	427	16.8	60.7	0.92
chr15	96197420	96197692	CpG: 20	272	20	166	14.7	61.0	0.80
chr15	96200239	96200514	CpG: 21	275	21	170	15.3	61.8	0.80
chr15	96257411	96258073	CpG: 48	662	48	457	14.5	69.0	0.61
chr15	96261973	96262210	CpG: 21	237	21	142	17.7	59.9	1.01
chr15	96312453	96312910	CpG: 51	457	51	294	22.3	64.3	1.08
chr15	96313939	96314193	CpG: 22	254	22	187	17.3	73.6	0.64
chr15	96382389	96382659	CpG: 22	270	22	171	16.3	63.3	0.83
chr15	96390075	96390305	CpG: 19	230	19	144	16.5	62.6	0.85
chr15	96411586	96415699	CpG: 470	4113	470	2850	22.9	69.3	0.95
chr15	96471962	96472186	CpG: 18	224	18	138	16.1	61.6	0.87
chr15	96616575	96617117	CpG: 47	542	47	363	17.3	67.0	0.77
chr15	96655718	96656066	CpG: 30	348	30	228	17.2	65.5	0.80
chr15	96721635	96721884	CpG: 23	249	23	166	18.5	66.7	0.85
chr15	96733838	96734064	CpG: 19	226	19	142	16.8	62.8	0.86
chr15	96745572	96745804	CpG: 18	232	18	145	15.5	62.5	0.81
chr15	96771714	96771980	CpG: 19	266	19	139	14.3	52.3	1.06
chr15	96772677	96772960	CpG: 33	283	33	213	23.3	75.3	0.82
chr15	96777431	96777669	CpG: 20	238	20	145	16.8	60.9	0.92
chr15	96779114	96780384	CpG: 125	1270	125	894	19.7	70.4	0.80
chr15	96812261	96812495	CpG: 18	234	18	145	15.4	62.0	0.82
chr15	96823372	96824018	CpG: 80	646	80	491	24.8	76.0	0.88
chr15	96849001	96849235	CpG: 17	234	17	141	14.5	60.3	0.83
chr15	96864822	96865256	CpG: 46	434	46	296	21.2	68.2	0.93
chr15	96869273	96870688	CpG: 204	1415	204	1075	28.8	76.0	1.00
chr15	97014897	97015611	CpG: 78	714	78	488	21.8	68.3	0.95
chr15	97053453	97053734	CpG: 23	281	23	174	16.4	61.9	0.87
chr15	97056180	97056467	CpG: 21	287	21	176	14.6	61.3	0.79
chr15	97113657	97113942	CpG: 24	285	24	178	16.8	62.5	0.88
chr15	97150912	97151148	CpG: 22	236	22	148	18.6	62.7	0.97
chr15	97328900	97330597	CpG: 185	1697	185	1218	21.8	71.8	0.86
chr15	97431026	97431266	CpG: 19	240	19	145	15.8	60.4	0.89
chr15	97496465	97497455	CpG: 104	990	104	720	21.0	72.7	0.80
chr15	97525813	97526055	CpG: 19	242	19	151	15.7	62.4	0.83
chr15	97540027	97540571	CpG: 38	544	38	322	14.0	59.2	0.80
chr15	97569596	97571096	CpG: 154	1500	154	1020	20.5	68.0	0.89
chr15	97683322	97684635	CpG: 167	1313	167	987	25.4	75.2	1.31
chr15	97748957	97749184	CpG: 19	227	19	144	16.7	63.4	0.84
chr15	97753464	97753678	CpG: 19	214	19	150	17.8	70.1	0.73
chr15	98027199	98027461	CpG: 20	262	20	160	15.3	61.1	0.83
chr15	98029312	98029574	CpG: 22	262	22	162	16.8	61.8	0.89
chr15	98049047	98049425	CpG: 36	378	36	226	19.0	59.8	1.07
chr15	98097757	98099239	CpG: 198	1482	198	1113	26.7	75.1	0.95
chr15	98107044	98107296	CpG: 23	252	23	164	18.3	65.1	0.88
chr15	98115772	98116018	CpG: 21	246	21	151	17.1	61.4	0.92
chr15	98130509	98131251	CpG: 85	742	85	557	22.9	75.1	0.82
chr15	98175924	98176165	CpG: 19	241	19	143	15.8	59.3	0.90
chr15	98302511	98303413	CpG: 97	902	97	666	21.5	73.8	0.79
chr15	98312752	98313947	CpG: 119	1195	119	802	19.9	67.1	0.89
chr15	98356429	98357591	CpG: 79	1162	79	747	13.6	64.3	0.67
chr15	98529904	98530758	CpG: 67	854	67	592	15.7	69.3	0.65
chr15	98603731	98604014	CpG: 26	283	26	185	18.4	65.4	0.88
chr15	98604582	98605544	CpG: 76	962	76	611	15.8	63.5	0.78
chr15	98634114	98635986	CpG: 242	1872	242	1400	25.9	74.8	0.93
chr15	98672618	98674555	CpG: 197	1937	197	1329	20.3	68.6	0.87
chr15	98705466	98705740	CpG: 23	274	23	172	16.8	62.8	0.87
chr15	98727701	98728779	CpG: 123	1078	123	760	22.8	70.5	0.92
chr15	98763125	98763348	CpG: 20	223	20	152	17.9	68.2	0.77
chr15	98807854	98808289	CpG: 40	435	40	305	18.4	70.1	0.75
chr15	98840309	98840541	CpG: 16	232	16	135	13.8	58.2	0.83
chr15	98840756	98841274	CpG: 60	518	60	384	23.2	74.1	0.95
chr15	98843550	98843880	CpG: 33	330	33	223	20.0	67.6	0.88
chr15	99005956	99007537	CpG: 256	1581	256	1230	32.4	77.8	1.08
chr15	99032073	99032742	CpG: 88	669	88	478	26.3	71.4	1.03
chr15	99049789	99050792	CpG: 100	1003	100	672	19.9	67.0	0.89
chr15	99153713	99153941	CpG: 24	228	24	153	21.1	67.1	0.94
chr15	99164488	99164810	CpG: 26	322	26	196	16.1	60.9	0.88
chr15	99243913	99245727	CpG: 261	1814	261	1424	28.8	78.5	0.93
chr15	99350369	99350601	CpG: 19	232	19	139	16.4	59.9	0.93
chr15	99384589	99384823	CpG: 20	234	20	141	17.1	60.3	0.94
chr15	99409966	99411501	CpG: 142	1535	142	1002	18.5	65.3	0.87
chr15	99473041	99473311	CpG: 23	270	23	167	17.0	61.9	0.90
chr15	99481770	99482530	CpG: 92	760	92	581	24.2	76.4	0.83
chr15	99503193	99504696	CpG: 158	1503	158	1018	21.0	67.7	0.92
chr15	99510381	99531438	CpG: 1355	21057	1355	12445	12.9	59.1	0.74
chr15	99558837	99559115	CpG: 26	278	26	174	18.7	62.6	0.97
chr15	99700360	99700638	CpG: 26	278	26	174	18.7	62.6	0.97
chr15	99708381	99708654	CpG: 30	273	30	190	22.0	69.6	0.92
chr15	99730446	99731521	CpG: 116	1075	116	787	21.6	73.2	0.83
chr15	99749022	99750108	CpG: 157	1086	157	785	28.9	72.3	1.11
chr16	2673	3847	CpG: 223	1174	223	940	38.0	80.1	1.20
chr16	15771	16079	CpG: 29	308	29	212	18.8	68.8	0.80
chr16	37597	37874	CpG: 21	277	21	170	15.2	61.4	0.81
chr16	42117	42353	CpG: 17	236	17	142	14.4	60.2	0.81
chr16	46046	46317	CpG: 19	271	19	168	14.0	62.0	0.74
chr16	46547	47766	CpG: 114	1219	114	823	18.7	67.5	0.83
chr16	54534	56701	CpG: 172	2167	172	1452	15.9	67.0	0.71
chr16	65555	66419	CpG: 109	864	109	673	25.2	77.9	0.83
chr16	70994	72177	CpG: 132	1183	132	883	22.3	74.6	0.81
chr16	128322	128596	CpG: 24	274	24	171	17.5	62.4	0.91
chr16	131670	133079	CpG: 113	1409	113	912	16.0	64.7	0.81
chr16	147325	148508	CpG: 140	1183	140	877	23.7	74.1	0.87
chr16	149042	149316	CpG: 20	274	20	167	14.6	60.9	0.79
chr16	158386	160754	CpG: 255	2368	255	1705	21.5	72.0	0.84
chr16	166411	167489	CpG: 126	1078	126	789	23.4	73.2	0.88
chr16	170216	171297	CpG: 127	1081	127	792	23.5	73.3	0.88
chr16	174204	175804	CpG: 164	1600	164	1138	20.5	71.1	0.81
chr16	176194	176405	CpG: 18	211	18	132	17.1	62.6	0.88
chr16	180370	181132	CpG: 83	762	83	511	21.8	67.1	1.08
chr16	222665	223322	CpG: 82	657	82	474	25.0	72.1	0.96
chr16	224915	225143	CpG: 18	228	18	151	15.8	66.2	0.72
chr16	228142	229207	CpG: 106	1065	106	724	19.9	68.0	0.87
chr16	230438	230675	CpG: 24	237	24	151	20.3	63.7	1.03
chr16	244798	245058	CpG: 20	260	20	159	15.4	61.2	0.84
chr16	263448	263732	CpG: 26	284	26	188	18.3	66.2	0.85
chr16	264770	265073	CpG: 21	303	21	187	13.9	61.7	0.74
chr16	269627	271009	CpG: 150	1382	150	1035	21.7	74.9	0.77
chr16	274892	275833	CpG: 127	941	127	748	27.0	79.5	0.87
chr16	277390	277635	CpG: 20	245	20	169	16.3	69.0	0.72
chr16	279316	279636	CpG: 30	320	30	225	18.8	70.3	0.80
chr16	280701	280906	CpG: 19	205	19	141	18.5	68.8	1.17
chr16	285954	286294	CpG: 34	340	34	236	20.0	69.4	0.83
chr16	291902	292291	CpG: 28	389	28	264	14.4	67.9	0.66
chr16	292713	293109	CpG: 33	396	33	280	16.7	70.7	0.67
chr16	299118	299321	CpG: 29	203	29	142	28.6	70.0	1.21
chr16	305967	306209	CpG: 19	242	19	146	15.7	60.3	0.90
chr16	315634	315863	CpG: 18	229	18	135	15.7	59.0	0.92
chr16	318033	318307	CpG: 19	274	19	166	13.9	60.6	0.76
chr16	319605	320201	CpG: 45	596	45	396	15.1	66.4	0.70
chr16	336101	336513	CpG: 37	412	37	301	18.0	73.1	0.67
chr16	346845	348336	CpG: 217	1491	217	1188	29.1	79.7	0.93
chr16	354857	356364	CpG: 108	1507	108	961	14.3	63.8	0.71
chr16	364733	366384	CpG: 143	1651	143	1222	17.3	74.0	0.75
chr16	369519	370071	CpG: 39	552	39	367	14.1	66.5	0.64
chr16	373063	374412	CpG: 93	1349	93	921	13.8	68.3	0.63
chr16	377077	378698	CpG: 196	1621	196	1213	24.2	74.8	0.86
chr16	392798	393542	CpG: 97	744	97	547	26.1	73.5	0.97
chr16	397079	398377	CpG: 137	1298	137	900	21.1	69.3	0.88
chr16	406396	406964	CpG: 43	568	43	392	15.1	69.0	0.65
chr16	420955	423004	CpG: 266	2049	266	1520	26.0	74.2	0.95
chr16	424009	424285	CpG: 21	276	21	165	15.2	59.8	0.87
chr16	481768	481970	CpG: 16	202	16	132	15.8	65.3	0.74
chr16	487397	487640	CpG: 19	243	19	148	15.6	60.9	0.87
chr16	513097	513358	CpG: 27	261	27	188	20.7	72.0	0.81
chr16	514084	514289	CpG: 15	205	15	139	14.6	67.8	0.65
chr16	514520	514725	CpG: 15	205	15	139	14.6	67.8	0.65
chr16	518497	518858	CpG: 39	361	39	234	21.6	64.8	1.03
chr16	529802	531588	CpG: 218	1786	218	1357	24.4	76.0	0.85
chr16	540644	541249	CpG: 53	605	53	399	17.5	66.0	0.81
chr16	543170	543445	CpG: 25	275	25	211	18.2	76.7	0.62
chr16	544404	544667	CpG: 19	263	19	182	14.4	69.2	0.62
chr16	546179	546577	CpG: 27	398	27	250	13.6	62.8	0.70
chr16	558219	558766	CpG: 46	547	46	381	16.8	69.7	0.70
chr16	563190	564595	CpG: 180	1405	180	1109	25.6	78.9	0.83
chr16	568209	568512	CpG: 26	303	26	222	17.2	73.3	0.64
chr16	569099	569344	CpG: 18	245	18	166	14.7	67.8	0.68
chr16	573222	573763	CpG: 78	541	78	431	28.8	79.7	0.92
chr16	582878	583720	CpG: 63	842	63	598	15.0	71.0	0.60
chr16	587684	587960	CpG: 19	276	19	188	13.8	68.1	0.60
chr16	592361	594626	CpG: 278	2265	278	1622	24.5	71.6	0.97
chr16	603386	604060	CpG: 47	674	47	362	13.9	53.7	0.97
chr16	611585	611866	CpG: 21	281	21	173	14.9	61.6	0.80
chr16	618105	618656	CpG: 37	551	37	303	13.4	55.0	0.95
chr16	626299	626844	CpG: 43	545	43	341	15.8	62.6	0.81
chr16	629940	630173	CpG: 21	233	21	149	18.0	63.9	0.88
chr16	630827	631032	CpG: 17	205	17	124	16.6	60.5	0.92
chr16	631401	632162	CpG: 53	761	53	495	13.9	65.0	0.66
chr16	636667	641548	CpG: 357	4881	357	3329	14.6	68.2	0.63
chr16	645665	646768	CpG: 138	1103	138	846	25.0	76.7	0.85
chr16	650563	650870	CpG: 27	307	27	229	17.6	74.6	0.63
chr16	652894	654312	CpG: 152	1418	152	1039	21.4	73.3	0.80
chr16	655896	656105	CpG: 18	209	18	148	17.2	70.8	0.70
chr16	666309	666515	CpG: 16	206	16	144	15.5	69.9	0.65
chr16	666810	667122	CpG: 22	312	22	209	14.1	67.0	0.63
chr16	672006	673139	CpG: 125	1133	125	830	22.1	73.3	0.83
chr16	674757	675241	CpG: 38	484	38	325	15.7	67.1	0.70
chr16	679585	689890	CpG: 722	10305	722	6987	14.0	67.8	0.61
chr16	690825	691469	CpG: 53	644	53	424	16.5	65.8	0.76
chr16	694082	694836	CpG: 64	754	64	488	17.0	64.7	0.81
chr16	697546	697777	CpG: 16	231	16	158	13.9	68.4	0.60
chr16	697999	700018	CpG: 202	2019	202	1466	20.0	72.6	0.76
chr16	704579	705632	CpG: 98	1053	98	751	18.6	71.3	0.73
chr16	709218	710877	CpG: 195	1659	195	1266	23.5	76.3	0.81
chr16	718930	720176	CpG: 170	1246	170	981	27.3	78.7	0.88
chr16	721322	721560	CpG: 21	238	21	171	17.6	71.8	0.69
chr16	724794	726332	CpG: 169	1538	169	1137	22.0	73.9	0.80
chr16	730810	733591	CpG: 286	2781	286	2011	20.6	72.3	0.79
chr16	738541	739208	CpG: 47	667	47	429	14.1	64.3	0.69
chr16	741244	741501	CpG: 21	257	21	158	16.3	61.5	0.87
chr16	744385	745574	CpG: 116	1189	116	845	19.5	71.1	0.77
chr16	745734	746047	CpG: 23	313	23	178	14.7	56.9	0.92
chr16	752039	752561	CpG: 35	522	35	325	13.4	62.3	0.69
chr16	771445	772569	CpG: 111	1124	111	883	19.8	78.6	1.09
chr16	773799	774013	CpG: 25	214	25	197	23.4	92.1	0.67
chr16	776929	777153	CpG: 17	224	17	137	15.2	61.2	0.83
chr16	787538	787753	CpG: 20	215	20	160	18.6	74.4	0.67
chr16	792087	794050	CpG: 204	1963	204	1427	20.8	72.7	0.79
chr16	796057	796261	CpG: 17	204	17	128	16.7	62.7	0.87
chr16	796610	797249	CpG: 49	639	49	429	15.3	67.1	0.69
chr16	800078	800691	CpG: 50	613	50	476	16.3	77.7	0.61
chr16	805051	805630	CpG: 47	579	47	417	16.2	72.0	0.63
chr16	812166	813325	CpG: 109	1159	109	761	18.8	65.7	0.87
chr16	818103	818801	CpG: 68	698	68	497	19.5	71.2	0.77
chr16	821857	822658	CpG: 70	801	70	538	17.5	67.2	0.78
chr16	829261	829477	CpG: 20	216	20	126	18.5	58.3	1.13
chr16	830143	831844	CpG: 130	1701	130	1162	15.3	68.3	0.66
chr16	833522	833825	CpG: 22	303	22	186	14.5	61.4	0.77
chr16	850536	851561	CpG: 74	1025	74	631	14.4	61.6	0.76
chr16	852469	853535	CpG: 64	1066	64	578	12.0	54.2	0.82
chr16	855669	855914	CpG: 24	245	24	155	19.6	63.3	0.98
chr16	857137	857933	CpG: 64	796	64	439	16.1	55.2	1.14
chr16	861306	861559	CpG: 18	253	18	170	14.2	67.2	0.63
chr16	863809	869820	CpG: 477	6011	477	3853	15.9	64.1	1.06
chr16	880105	880364	CpG: 19	259	19	179	14.7	69.1	0.61
chr16	883550	883874	CpG: 26	324	26	225	16.0	69.4	0.67
chr16	886366	886625	CpG: 25	259	25	168	19.3	64.9	0.94
chr16	888357	888595	CpG: 17	238	17	148	14.3	62.2	0.74
chr16	910588	910890	CpG: 23	302	23	201	15.2	66.6	0.69
chr16	913988	914267	CpG: 19	279	19	182	13.6	65.2	0.64
chr16	919845	920393	CpG: 39	548	39	339	14.2	61.9	0.75
chr16	923217	923931	CpG: 53	714	53	481	14.8	67.4	0.66
chr16	928572	928857	CpG: 30	285	30	193	21.1	67.7	0.93
chr16	932758	933154	CpG: 29	396	29	241	14.6	60.9	0.79
chr16	933949	934406	CpG: 32	457	32	258	14.0	56.5	1.12
chr16	940686	940927	CpG: 18	241	18	155	14.9	64.3	0.72
chr16	941049	941403	CpG: 28	354	28	239	15.8	67.5	0.70
chr16	959960	960313	CpG: 23	353	23	197	13.0	55.8	0.84
chr16	967267	967716	CpG: 46	449	46	293	20.5	65.3	1.15
chr16	971842	973066	CpG: 97	1224	97	741	15.8	60.5	0.88
chr16	975532	975769	CpG: 21	237	21	150	17.7	63.3	0.89
chr16	981008	982073	CpG: 121	1065	121	803	22.7	75.4	0.80
chr16	984455	984730	CpG: 20	275	20	158	14.5	57.5	0.90
chr16	991080	996261	CpG: 488	5181	488	3694	18.8	71.3	0.74
chr16	997620	998248	CpG: 49	628	49	396	15.6	63.1	0.78
chr16	1001765	1002165	CpG: 29	400	29	239	14.5	59.8	0.84
chr16	1008296	1008872	CpG: 40	576	40	383	13.9	66.5	0.63
chr16	1013258	1013744	CpG: 36	486	36	305	14.8	62.8	0.75
chr16	1017718	1017926	CpG: 18	208	18	141	17.3	67.8	0.77
chr16	1021363	1021672	CpG: 23	309	23	207	14.9	67.0	0.68
chr16	1022064	1022275	CpG: 16	211	16	145	15.2	68.7	0.71
chr16	1030104	1031024	CpG: 75	920	75	600	16.3	65.2	0.77
chr16	1031766	1032031	CpG: 19	265	19	181	14.3	68.3	0.62
chr16	1037348	1037690	CpG: 25	342	25	201	14.6	58.8	0.87
chr16	1038934	1039179	CpG: 22	245	22	143	18.0	58.4	1.06
chr16	1040095	1040431	CpG: 27	336	27	238	16.1	70.8	0.64
chr16	1041675	1042140	CpG: 37	465	37	338	15.9	72.7	0.60
chr16	1049853	1050196	CpG: 30	343	30	228	17.5	66.5	0.80
chr16	1051817	1052160	CpG: 31	343	31	243	18.1	70.8	0.77
chr16	1055674	1056427	CpG: 56	753	56	529	14.9	70.3	0.60
chr16	1060270	1060556	CpG: 23	286	23	214	16.1	74.8	0.61
chr16	1062307	1062529	CpG: 22	222	22	135	19.8	60.8	1.07
chr16	1069288	1069546	CpG: 22	258	22	193	17.1	74.8	0.61
chr16	1072586	1072908	CpG: 23	322	23	214	14.3	66.5	0.65
chr16	1077049	1078150	CpG: 88	1101	88	762	16.0	69.2	0.71
chr16	1081832	1082130	CpG: 23	298	23	202	15.4	67.8	0.68
chr16	1084289	1084670	CpG: 46	381	46	304	24.1	79.8	0.79
chr16	1089980	1092151	CpG: 167	2171	167	1474	15.4	67.9	0.67
chr16	1101489	1101694	CpG: 17	205	17	148	16.6	72.2	0.64
chr16	1104072	1106404	CpG: 196	2332	196	1439	16.8	61.7	0.95
chr16	1114729	1115672	CpG: 82	943	82	714	17.4	75.7	0.66
chr16	1117257	1117636	CpG: 30	379	30	251	15.8	66.2	0.72
chr16	1142272	1142596	CpG: 26	324	26	231	16.0	71.3	0.63
chr16	1149383	1149764	CpG: 27	381	27	223	14.2	58.5	0.84
chr16	1150269	1150542	CpG: 21	273	21	165	15.4	60.4	0.84
chr16	1161169	1161451	CpG: 22	282	22	173	15.6	61.3	0.83
chr16	1162472	1162746	CpG: 28	274	28	175	20.4	63.9	1.01
chr16	1165061	1167271	CpG: 308	2210	308	1737	27.9	78.6	0.91
chr16	1179167	1180055	CpG: 65	888	65	569	14.6	64.1	0.71
chr16	1182078	1182290	CpG: 22	212	22	152	20.8	71.7	0.83
chr16	1184457	1184857	CpG: 31	400	31	283	15.5	70.8	0.64
chr16	1189909	1190125	CpG: 19	216	19	154	17.6	71.3	0.71
chr16	1192761	1192966	CpG: 15	205	15	135	14.6	65.9	0.69
chr16	1197937	1202406	CpG: 487	4469	487	3160	21.8	70.7	1.03
chr16	1209815	1210757	CpG: 74	942	74	654	15.7	69.4	0.68
chr16	1213999	1214930	CpG: 76	931	76	650	16.3	69.8	0.81
chr16	1215713	1216123	CpG: 36	410	36	281	17.6	68.5	0.75
chr16	1217001	1217591	CpG: 47	590	47	401	15.9	68.0	0.70
chr16	1219544	1219811	CpG: 26	267	26	189	19.5	70.8	0.78
chr16	1230460	1230970	CpG: 40	510	40	351	15.7	68.8	0.66
chr16	1233175	1233915	CpG: 63	740	63	510	17.0	68.9	0.72
chr16	1247835	1248256	CpG: 39	421	39	299	18.5	71.0	0.75
chr16	1252279	1252590	CpG: 29	311	29	229	18.6	73.6	0.71
chr16	1264918	1265229	CpG: 29	311	29	229	18.6	73.6	0.71
chr16	1269281	1269702	CpG: 39	421	39	299	18.5	71.0	0.75
chr16	1273691	1273995	CpG: 26	304	26	204	17.1	67.1	0.80
chr16	1275197	1275455	CpG: 19	258	19	170	14.7	65.9	0.71
chr16	1304417	1304739	CpG: 26	322	26	216	16.1	67.1	0.72
chr16	1324908	1326411	CpG: 209	1503	209	1154	27.8	76.8	0.94
chr16	1329990	1330673	CpG: 45	683	45	432	13.2	63.3	0.66
chr16	1331369	1331588	CpG: 18	219	18	157	16.4	71.7	0.64
chr16	1335231	1335703	CpG: 42	472	42	308	17.8	65.3	0.85
chr16	1349091	1350909	CpG: 187	1818	187	1354	20.6	74.5	0.74
chr16	1358717	1358926	CpG: 17	209	17	141	16.3	67.5	0.72
chr16	1359207	1359414	CpG: 16	207	16	142	15.5	68.6	1.01
chr16	1359746	1360051	CpG: 24	305	24	206	15.7	67.5	0.74
chr16	1363854	1364421	CpG: 48	567	48	385	16.9	67.9	0.73
chr16	1367408	1368524	CpG: 133	1116	133	821	23.8	73.6	0.88
chr16	1371008	1371411	CpG: 41	403	41	284	20.3	70.5	0.87
chr16	1373648	1373966	CpG: 24	318	24	195	15.1	61.3	0.81
chr16	1378023	1378499	CpG: 39	476	39	323	16.4	67.9	0.71
chr16	1380548	1380981	CpG: 30	433	30	284	13.9	65.6	0.65
chr16	1384465	1384746	CpG: 22	281	22	172	15.7	61.2	0.85
chr16	1386051	1386587	CpG: 39	536	39	365	14.6	68.1	0.66
chr16	1388903	1389174	CpG: 20	271	20	188	14.8	69.4	0.63
chr16	1389983	1390540	CpG: 46	557	46	398	16.5	71.5	0.65
chr16	1393987	1395040	CpG: 126	1053	126	796	23.9	75.6	0.85
chr16	1400135	1400525	CpG: 41	390	41	280	21.0	71.8	0.83
chr16	1405416	1405631	CpG: 19	215	19	143	17.7	66.5	0.80
chr16	1413960	1414210	CpG: 24	250	24	171	19.2	68.4	0.82
chr16	1422783	1423074	CpG: 31	291	31	201	21.3	69.1	0.89
chr16	1428386	1429639	CpG: 153	1253	153	952	24.4	76.0	0.86
chr16	1433928	1434223	CpG: 23	295	23	176	15.6	59.7	0.88
chr16	1435113	1435894	CpG: 81	781	81	505	20.7	64.7	0.99
chr16	1442834	1443425	CpG: 49	591	49	425	16.6	71.9	0.65
chr16	1445505	1445706	CpG: 18	201	18	139	17.9	69.2	0.75
chr16	1447212	1447862	CpG: 54	650	54	466	16.6	71.7	0.65
chr16	1451677	1452698	CpG: 78	1021	78	701	15.3	68.7	0.66
chr16	1458158	1458432	CpG: 29	274	29	207	21.2	75.5	0.74
chr16	1462109	1462596	CpG: 37	487	37	337	15.2	69.2	0.63
chr16	1463008	1463269	CpG: 23	261	23	173	17.6	66.3	0.81
chr16	1464908	1465259	CpG: 29	351	29	243	16.5	69.2	0.71
chr16	1467288	1467518	CpG: 18	230	18	165	15.7	71.7	0.61
chr16	1470636	1470862	CpG: 19	226	19	151	16.8	66.8	0.77
chr16	1472015	1472363	CpG: 37	348	37	232	21.3	66.7	0.96
chr16	1475592	1476133	CpG: 38	541	38	361	14.0	66.7	0.63
chr16	1479123	1479570	CpG: 34	447	34	292	15.2	65.3	0.72
chr16	1489233	1490247	CpG: 142	1014	142	769	28.0	75.8	0.97
chr16	1490847	1491101	CpG: 19	254	19	152	15.0	59.8	0.84
chr16	1499612	1499893	CpG: 24	281	24	175	17.1	62.3	0.89
chr16	1500960	1501611	CpG: 43	651	43	427	13.2	65.6	0.61
chr16	1502734	1503165	CpG: 35	431	35	290	16.2	67.3	0.72
chr16	1508126	1509454	CpG: 131	1328	131	924	19.7	69.6	0.82
chr16	1515179	1515864	CpG: 53	685	53	485	15.5	70.8	0.62
chr16	1519623	1519910	CpG: 20	287	20	172	13.9	59.9	0.78
chr16	1520092	1520294	CpG: 17	202	17	133	16.8	65.8	0.78
chr16	1524992	1525221	CpG: 17	229	17	154	14.8	67.2	0.67
chr16	1538735	1538938	CpG: 15	203	15	142	14.8	70.0	0.62
chr16	1539546	1540017	CpG: 36	471	36	314	15.3	66.7	0.69
chr16	1548840	1549672	CpG: 67	832	67	573	16.1	68.9	0.68
chr16	1552714	1552930	CpG: 16	216	16	127	14.8	58.8	0.86
chr16	1556844	1557138	CpG: 22	294	22	200	15.0	68.0	0.65
chr16	1559702	1559976	CpG: 21	274	21	168	15.3	61.3	0.82
chr16	1563983	1564188	CpG: 17	205	17	137	16.6	66.8	0.74
chr16	1569995	1570376	CpG: 30	381	30	230	15.7	60.4	0.87
chr16	1584096	1584340	CpG: 22	244	22	149	18.0	61.1	1.00
chr16	1609644	1609849	CpG: 19	205	19	135	18.5	65.9	0.87
chr16	1625900	1630941	CpG: 490	5041	490	3342	19.4	66.3	0.89
chr16	1641888	1642143	CpG: 18	255	18	159	14.1	62.4	0.73
chr16	1671713	1672091	CpG: 28	378	28	259	14.8	68.5	0.63
chr16	1672542	1672788	CpG: 19	246	19	177	15.4	72.0	0.61
chr16	1693786	1694705	CpG: 120	919	120	698	26.1	76.0	0.93
chr16	1721001	1721287	CpG: 21	286	21	159	14.7	55.6	0.96
chr16	1721671	1722780	CpG: 128	1109	128	813	23.1	73.3	0.86
chr16	1745285	1745664	CpG: 35	379	35	257	18.5	67.8	0.84
chr16	1750030	1750268	CpG: 19	238	19	165	16.0	69.3	0.67
chr16	1750829	1756541	CpG: 512	5712	512	3387	17.9	59.3	1.03
chr16	1762643	1763062	CpG: 32	419	32	284	15.3	67.8	0.67
chr16	1777307	1777603	CpG: 21	296	21	188	14.2	63.5	0.74
chr16	1779486	1780311	CpG: 75	825	75	587	18.2	71.2	0.73
chr16	1784381	1784745	CpG: 31	364	31	254	17.0	69.8	0.71
chr16	1786140	1789787	CpG: 371	3647	371	2527	20.3	69.3	0.85
chr16	1792938	1793239	CpG: 25	301	25	211	16.6	70.1	0.68
chr16	1793659	1793987	CpG: 23	328	23	224	14.0	68.3	0.60
chr16	1797556	1799821	CpG: 228	2265	228	1499	20.1	66.2	0.92
chr16	1802519	1802851	CpG: 30	332	30	234	18.1	70.5	0.73
chr16	1806462	1808527	CpG: 153	2065	153	1429	14.8	69.2	0.62
chr16	1834932	1835152	CpG: 19	220	19	143	17.3	65.0	0.83
chr16	1841966	1843486	CpG: 200	1520	200	1125	26.3	74.0	0.96
chr16	1858598	1859175	CpG: 42	577	42	338	14.6	58.6	0.85
chr16	1887148	1887384	CpG: 19	236	19	144	16.1	61.0	0.89
chr16	1889157	1890359	CpG: 136	1202	136	829	22.6	69.0	0.96
chr16	1930150	1930426	CpG: 19	276	19	165	13.8	59.8	0.79
chr16	1930609	1931229	CpG: 57	620	57	430	18.4	69.4	0.78
chr16	1936951	1938123	CpG: 143	1172	143	892	24.4	76.1	0.84
chr16	1939390	1939605	CpG: 15	215	15	144	14.0	67.0	0.69
chr16	1939729	1940335	CpG: 45	606	45	419	14.9	69.1	0.70
chr16	1949459	1950263	CpG: 80	804	80	596	19.9	74.1	0.74
chr16	1962639	1963631	CpG: 85	992	85	691	17.1	69.7	0.75
chr16	1978098	1978657	CpG: 51	559	51	413	18.2	73.9	0.67
chr16	1979294	1980040	CpG: 83	746	83	546	22.3	73.2	0.86
chr16	1984122	1985409	CpG: 133	1287	133	861	20.7	66.9	0.94
chr16	1988475	1988747	CpG: 25	272	25	197	18.4	72.4	0.70
chr16	1989468	1989674	CpG: 18	206	18	135	17.5	65.5	0.82
chr16	1991382	1992548	CpG: 113	1166	113	764	19.4	65.5	0.90
chr16	1994736	1995040	CpG: 25	304	25	205	16.4	67.4	0.73
chr16	1998156	1998404	CpG: 21	248	21	171	16.9	69.0	0.73
chr16	1998787	2000667	CpG: 162	1880	162	1308	17.2	69.6	0.71
chr16	2003356	2004744	CpG: 168	1388	168	999	24.2	72.0	0.93
chr16	2009801	2012970	CpG: 294	3169	294	2202	18.6	69.5	0.77
chr16	2018147	2018707	CpG: 38	560	38	370	13.6	66.1	0.62
chr16	2022162	2022671	CpG: 46	509	46	333	18.1	65.4	0.86
chr16	2023972	2024241	CpG: 21	269	21	179	15.6	66.5	0.71
chr16	2029284	2030011	CpG: 108	727	108	566	29.7	77.9	1.01
chr16	2039670	2040818	CpG: 126	1148	126	841	22.0	73.3	0.82
chr16	2046685	2047426	CpG: 109	741	109	599	29.4	80.8	0.91
chr16	2056229	2056701	CpG: 34	472	34	324	14.4	68.6	0.62
chr16	2058561	2058806	CpG: 24	245	24	173	19.6	70.6	0.80
chr16	2067273	2068173	CpG: 103	900	103	646	22.9	71.8	0.89
chr16	2072044	2072325	CpG: 23	281	23	175	16.4	62.3	0.86
chr16	2075144	2075520	CpG: 26	376	26	250	13.8	66.5	0.63
chr16	2082971	2083274	CpG: 25	303	25	212	16.5	70.0	0.68
chr16	2083954	2084347	CpG: 26	393	26	253	13.2	64.4	0.64
chr16	2095281	2095503	CpG: 17	222	17	126	15.3	56.8	0.95
chr16	2095762	2096098	CpG: 23	336	23	228	13.7	67.9	0.62
chr16	2098830	2099055	CpG: 17	225	17	145	15.1	64.4	0.73
chr16	2099262	2099772	CpG: 36	510	36	336	14.1	65.9	0.65
chr16	2104362	2104735	CpG: 28	373	28	260	15.0	69.7	0.62
chr16	2109909	2112292	CpG: 209	2383	209	1721	17.5	72.2	0.68
chr16	2115690	2115944	CpG: 21	254	21	173	16.5	68.1	0.74
chr16	2119966	2120647	CpG: 50	681	50	451	14.7	66.2	0.67
chr16	2123364	2123997	CpG: 49	633	49	424	15.5	67.0	0.70
chr16	2128338	2129355	CpG: 78	1017	78	700	15.3	68.8	0.65
chr16	2130333	2134610	CpG: 325	4277	325	2891	15.2	67.6	0.66
chr16	2137849	2138091	CpG: 19	242	19	171	15.7	70.7	0.63
chr16	2149600	2149801	CpG: 17	201	17	126	16.9	62.7	0.88
chr16	2157612	2158879	CpG: 173	1267	173	977	27.3	77.1	0.92
chr16	2170914	2171588	CpG: 94	674	94	531	27.9	78.8	0.90
chr16	2177668	2178728	CpG: 127	1060	127	719	24.0	67.8	1.04
chr16	2186627	2188387	CpG: 154	1760	154	1104	17.5	62.7	0.97
chr16	2192922	2193372	CpG: 36	450	36	324	16.0	72.0	0.62
chr16	2198547	2198819	CpG: 20	272	20	184	14.7	67.6	0.64
chr16	2200658	2203638	CpG: 307	2980	307	2217	20.6	74.4	0.75
chr16	2206265	2206594	CpG: 30	329	30	231	18.2	70.2	0.74
chr16	2209180	2209407	CpG: 16	227	16	155	14.1	68.3	0.61
chr16	2211712	2212044	CpG: 26	332	26	231	15.7	69.6	0.65
chr16	2218335	2219569	CpG: 169	1234	169	998	27.4	80.9	0.84
chr16	2227626	2228421	CpG: 91	795	91	572	22.9	71.9	0.88
chr16	2236373	2238502	CpG: 234	2129	234	1446	22.0	67.9	0.95
chr16	2245666	2246528	CpG: 98	862	98	613	22.7	71.1	0.91
chr16	2256564	2256794	CpG: 22	230	22	158	19.1	68.7	0.81
chr16	2259048	2260521	CpG: 159	1473	159	1044	21.6	70.9	0.86
chr16	2272028	2272276	CpG: 18	248	18	145	14.5	58.5	0.88
chr16	2273545	2274415	CpG: 106	870	106	620	24.4	71.3	0.97
chr16	2289890	2291892	CpG: 218	2002	218	1383	21.8	69.1	0.91
chr16	2306553	2306792	CpG: 18	239	18	162	15.1	67.8	0.67
chr16	2310436	2310927	CpG: 33	491	33	327	13.4	66.6	0.61
chr16	2311704	2311997	CpG: 22	293	22	201	15.0	68.6	0.66
chr16	2319729	2320083	CpG: 26	354	26	233	14.7	65.8	0.68
chr16	2362090	2364548	CpG: 286	2458	286	1819	23.3	74.0	0.86
chr16	2422302	2423074	CpG: 55	772	55	525	14.2	68.0	0.62
chr16	2451101	2452382	CpG: 166	1281	166	951	25.9	74.2	0.95
chr16	2481816	2482740	CpG: 83	924	83	656	18.0	71.0	0.71
chr16	2489736	2490739	CpG: 115	1003	115	735	22.9	73.3	0.86
chr16	2493215	2498058	CpG: 439	4843	439	3540	18.1	73.1	0.68
chr16	2518394	2519169	CpG: 61	775	61	502	15.7	64.8	0.75
chr16	2522177	2522638	CpG: 32	461	32	312	13.9	67.7	0.62
chr16	2535559	2537032	CpG: 182	1473	182	1089	24.7	73.9	0.92
chr16	2541680	2543192	CpG: 150	1512	150	1036	19.8	68.5	0.85
chr16	2549923	2550488	CpG: 42	565	42	391	14.9	69.2	0.62
chr16	2553847	2554769	CpG: 98	922	98	644	21.3	69.8	0.91
chr16	2558905	2559131	CpG: 17	226	17	135	15.0	59.7	0.89
chr16	2559612	2560708	CpG: 139	1096	139	819	25.4	74.7	0.92
chr16	2587073	2587326	CpG: 21	253	21	163	16.6	64.4	0.81
chr16	2599290	2599555	CpG: 24	265	24	181	18.1	68.3	0.78
chr16	2601447	2601656	CpG: 17	209	17	109	16.3	52.2	1.20
chr16	2605635	2606076	CpG: 35	441	35	287	15.9	65.1	0.75
chr16	2625371	2625997	CpG: 52	626	52	420	16.6	67.1	0.74
chr16	2632922	2633128	CpG: 17	206	17	136	16.5	66.0	0.77
chr16	2636702	2636969	CpG: 22	267	22	185	16.5	69.3	0.69
chr16	2638416	2638857	CpG: 35	441	35	287	15.9	65.1	0.75
chr16	2642836	2643050	CpG: 17	214	17	114	15.9	53.3	1.14
chr16	2644942	2645207	CpG: 24	265	24	181	18.1	68.3	0.78
chr16	2657170	2657423	CpG: 21	253	21	163	16.6	64.4	0.81
chr16	2693127	2694044	CpG: 114	917	114	695	24.9	75.8	0.88
chr16	2702502	2703170	CpG: 70	668	70	468	21.0	70.1	0.85
chr16	2716741	2717008	CpG: 23	267	23	185	17.2	69.3	0.72
chr16	2717109	2717325	CpG: 17	216	17	142	15.7	65.7	0.73
chr16	2727750	2728126	CpG: 30	376	30	242	16.0	64.4	0.77
chr16	2735832	2736068	CpG: 28	236	28	169	23.7	71.6	0.93
chr16	2740350	2741786	CpG: 137	1436	137	997	19.1	69.4	0.79
chr16	2767729	2768003	CpG: 23	274	23	169	16.8	61.7	0.89
chr16	2768586	2768860	CpG: 22	274	22	169	16.1	61.7	0.85
chr16	2772127	2773626	CpG: 178	1499	178	1061	23.7	70.8	0.95
chr16	2776528	2776796	CpG: 29	268	29	193	21.6	72.0	0.83
chr16	2782483	2782791	CpG: 24	308	24	194	15.6	63.0	0.79
chr16	2785792	2787012	CpG: 105	1220	105	720	17.2	59.0	1.03
chr16	2796792	2798007	CpG: 153	1215	153	874	25.2	71.9	0.98
chr16	2805277	2806172	CpG: 83	895	83	645	18.5	72.1	0.72
chr16	2818999	2819718	CpG: 73	719	73	525	20.3	73.0	0.77
chr16	2822486	2823337	CpG: 65	851	65	591	15.3	69.4	0.63
chr16	2837764	2838574	CpG: 81	810	81	575	20.0	71.0	0.84
chr16	2863117	2863348	CpG: 25	231	25	148	21.6	64.1	1.06
chr16	2873383	2873911	CpG: 51	528	51	385	19.3	72.9	0.73
chr16	2878110	2878370	CpG: 24	260	24	177	18.5	68.1	0.80
chr16	2894808	2895334	CpG: 43	526	43	341	16.3	64.8	0.78
chr16	2908593	2910396	CpG: 150	1803	150	1222	16.6	67.8	0.73
chr16	2911681	2911954	CpG: 20	273	20	168	14.7	61.5	0.78
chr16	2920298	2920573	CpG: 21	275	21	165	15.3	60.0	0.86
chr16	2920923	2921316	CpG: 36	393	36	265	18.3	67.4	0.82
chr16	2921990	2922249	CpG: 19	259	19	156	14.7	60.2	0.82
chr16	2930827	2932518	CpG: 137	1691	137	1157	16.2	68.4	0.71
chr16	2936376	2936634	CpG: 20	258	20	157	15.5	60.9	0.85
chr16	2937757	2939219	CpG: 139	1462	139	955	19.0	65.3	0.90
chr16	2950657	2950892	CpG: 19	235	19	142	16.2	60.4	0.90
chr16	2989694	2997004	CpG: 574	7310	574	5015	15.7	68.6	0.67
chr16	3006430	3007632	CpG: 125	1202	125	874	20.8	72.7	0.79
chr16	3007838	3008158	CpG: 23	320	23	184	14.4	57.5	0.88
chr16	3010371	3010927	CpG: 52	556	52	350	18.7	62.9	0.94
chr16	3029852	3031607	CpG: 188	1755	188	1221	21.4	69.6	0.89
chr16	3038908	3039172	CpG: 18	264	18	180	13.6	68.2	0.64
chr16	3040250	3040552	CpG: 24	302	24	213	15.9	70.5	0.64
chr16	3044092	3044929	CpG: 64	837	64	590	15.3	70.5	0.62
chr16	3046473	3047876	CpG: 131	1403	131	946	18.7	67.4	0.83
chr16	3050257	3051014	CpG: 69	757	69	516	18.2	68.2	0.79
chr16	3054712	3055124	CpG: 49	412	49	307	23.8	74.5	0.86
chr16	3056107	3056525	CpG: 52	418	52	298	24.9	71.3	0.98
chr16	3061793	3062040	CpG: 19	247	19	167	15.4	67.6	0.68
chr16	3062854	3063627	CpG: 72	773	72	581	18.6	75.2	0.67
chr16	3071639	3071909	CpG: 21	270	21	165	15.6	61.1	0.84
chr16	3072152	3073602	CpG: 146	1450	146	1063	20.1	73.3	0.76
chr16	3084796	3086206	CpG: 140	1410	140	1036	19.9	73.5	0.73
chr16	3115511	3117014	CpG: 151	1503	151	1057	20.1	70.3	0.82
chr16	3126622	3126894	CpG: 26	272	26	190	19.1	69.9	0.80
chr16	3132734	3133374	CpG: 75	640	75	472	23.4	73.8	0.87
chr16	3133512	3133784	CpG: 20	272	20	164	14.7	60.3	0.81
chr16	3134958	3135196	CpG: 18	238	18	140	15.1	58.8	0.90
chr16	3145843	3146780	CpG: 88	937	88	645	18.8	68.8	0.80
chr16	3150590	3151464	CpG: 73	874	73	574	16.7	65.7	0.78
chr16	3160751	3161934	CpG: 105	1183	105	778	17.8	65.8	0.82
chr16	3167255	3167879	CpG: 65	624	65	435	20.8	69.7	0.86
chr16	3168671	3169286	CpG: 43	615	43	390	14.0	63.4	0.87
chr16	3176346	3176550	CpG: 19	204	19	145	18.6	71.1	0.74
chr16	3176997	3179506	CpG: 162	2509	162	1387	12.9	55.3	0.85
chr16	3184215	3186060	CpG: 148	1845	148	1208	16.0	65.5	0.75
chr16	3186597	3187135	CpG: 40	538	40	345	14.9	64.1	0.73
chr16	3187440	3187662	CpG: 17	222	17	132	15.3	59.5	0.89
chr16	3197048	3197966	CpG: 67	918	67	580	14.6	63.2	0.73
chr16	3201387	3201731	CpG: 25	344	25	208	14.5	60.5	0.80
chr16	3201965	3202402	CpG: 30	437	30	267	13.7	61.1	0.74
chr16	3209243	3210957	CpG: 131	1714	131	1070	15.3	62.4	0.79
chr16	3214543	3216398	CpG: 122	1855	122	1117	13.2	60.2	0.73
chr16	3219232	3220193	CpG: 74	961	74	583	15.4	60.7	0.84
chr16	3261747	3262666	CpG: 76	919	76	616	16.5	67.0	0.74
chr16	3266779	3267060	CpG: 21	281	21	170	14.9	60.5	0.83
chr16	3281407	3281752	CpG: 34	345	34	259	19.7	75.1	0.72
chr16	3290566	3291844	CpG: 117	1278	117	810	18.3	63.4	0.91
chr16	3292277	3292568	CpG: 26	291	26	179	17.9	61.5	0.96
chr16	3309450	3310896	CpG: 126	1446	126	937	17.4	64.8	0.83
chr16	3321036	3321271	CpG: 18	235	18	142	15.3	60.4	0.87
chr16	3322194	3322654	CpG: 54	460	54	344	23.5	74.8	0.86
chr16	3324536	3324810	CpG: 20	274	20	164	14.6	59.9	0.83
chr16	3330901	3331182	CpG: 22	281	22	169	15.7	60.1	0.88
chr16	3332070	3333062	CpG: 110	992	110	681	22.2	68.6	0.94
chr16	3365627	3365900	CpG: 22	273	22	167	16.1	61.2	0.87
chr16	3391998	3392201	CpG: 21	203	21	127	20.7	62.6	1.06
chr16	3427987	3428938	CpG: 104	951	104	664	21.9	69.8	0.90
chr16	3429753	3430031	CpG: 23	278	23	173	16.5	62.2	0.87
chr16	3470367	3470838	CpG: 40	471	40	291	17.0	61.8	0.92
chr16	3484811	3485872	CpG: 122	1061	122	788	23.0	74.3	0.84
chr16	3523624	3524027	CpG: 32	403	32	253	15.9	62.8	0.81
chr16	3527323	3528983	CpG: 139	1660	139	1003	16.7	60.4	0.92
chr16	3590370	3590816	CpG: 32	446	32	304	14.3	68.2	0.62
chr16	3591586	3591871	CpG: 24	285	24	197	16.8	69.1	0.71
chr16	3616359	3616573	CpG: 17	214	17	141	15.9	65.9	0.73
chr16	3638388	3639043	CpG: 81	655	81	473	24.7	72.2	0.95
chr16	3639761	3639977	CpG: 18	216	18	136	16.7	63.0	0.84
chr16	3655856	3656216	CpG: 26	360	26	206	14.4	57.2	0.88
chr16	3701610	3702115	CpG: 38	505	38	329	15.0	65.1	0.72
chr16	3744079	3745204	CpG: 131	1125	131	793	23.3	70.5	0.94
chr16	3753403	3753804	CpG: 29	401	29	260	14.5	64.8	0.69
chr16	3758470	3758674	CpG: 15	204	15	132	14.7	64.7	0.72
chr16	3769097	3769325	CpG: 16	228	16	135	14.0	59.2	0.81
chr16	3871094	3871372	CpG: 24	278	24	174	17.3	62.6	0.89
chr16	3878853	3879081	CpG: 21	228	21	141	18.4	61.8	0.98
chr16	3906687	3908855	CpG: 284	2168	284	1626	26.2	75.0	0.93
chr16	3951763	3951988	CpG: 18	225	18	136	16.0	60.4	0.90
chr16	3966353	3966784	CpG: 34	431	34	300	15.8	69.6	0.65
chr16	3992272	3992542	CpG: 23	270	23	193	17.0	71.5	0.67
chr16	3993504	3994353	CpG: 66	849	66	513	15.5	60.4	0.85
chr16	4004748	4005027	CpG: 22	279	22	187	15.8	67.0	0.70
chr16	4006475	4006731	CpG: 21	256	21	177	16.4	69.1	0.69
chr16	4142117	4144312	CpG: 277	2195	277	1613	25.2	73.5	0.94
chr16	4154039	4154302	CpG: 20	263	20	159	15.2	60.5	0.84
chr16	4210545	4212028	CpG: 147	1483	147	1034	19.8	69.7	0.82
chr16	4280355	4281554	CpG: 111	1199	111	767	18.5	64.0	0.91
chr16	4289023	4289270	CpG: 25	247	25	173	20.2	70.0	0.86
chr16	4298586	4298833	CpG: 20	247	20	171	16.2	69.2	0.69
chr16	4298967	4301399	CpG: 227	2432	227	1688	18.7	69.4	0.78
chr16	4334716	4335543	CpG: 78	827	78	567	18.9	68.6	0.80
chr16	4341130	4341452	CpG: 30	322	30	208	18.6	64.6	0.91
chr16	4342267	4344282	CpG: 237	2015	237	1535	23.5	76.2	0.81
chr16	4354805	4355542	CpG: 72	737	72	559	19.5	75.8	0.68
chr16	4364029	4364274	CpG: 18	245	18	158	14.7	64.5	0.77
chr16	4379633	4380743	CpG: 103	1110	103	741	18.6	66.8	0.83
chr16	4400821	4401419	CpG: 80	598	80	472	26.8	78.9	0.86
chr16	4410176	4411880	CpG: 123	1704	123	1184	14.4	69.5	0.61
chr16	4445069	4446084	CpG: 122	1015	122	767	24.0	75.6	0.84
chr16	4454628	4455529	CpG: 89	901	89	575	19.8	63.8	0.98
chr16	4486376	4486653	CpG: 24	277	24	171	17.3	61.7	0.92
chr16	4503658	4504232	CpG: 57	574	57	404	19.9	70.4	0.80
chr16	4505815	4506447	CpG: 68	632	68	463	21.5	73.3	0.81
chr16	4510580	4510857	CpG: 24	277	24	171	17.3	61.7	0.93
chr16	4517039	4517390	CpG: 23	351	23	207	13.1	59.0	0.79
chr16	4567296	4568350	CpG: 119	1054	119	764	22.6	72.5	0.86
chr16	4643452	4646626	CpG: 306	3174	306	2111	19.3	66.5	0.87
chr16	4654160	4654907	CpG: 99	747	99	563	26.5	75.4	0.93
chr16	4677683	4678413	CpG: 62	730	62	530	17.0	72.6	0.69
chr16	4682092	4682315	CpG: 21	223	21	150	18.8	67.3	0.83
chr16	4704116	4704409	CpG: 23	293	23	181	15.7	61.8	0.83
chr16	4709723	4709948	CpG: 26	225	26	148	23.1	65.8	1.09
chr16	4722494	4723807	CpG: 156	1313	156	955	23.8	72.7	0.91
chr16	4757532	4757801	CpG: 18	269	18	162	13.4	60.2	0.75
chr16	4763318	4764466	CpG: 109	1148	109	786	19.0	68.5	0.81
chr16	4769919	4770132	CpG: 15	213	15	140	14.1	65.7	0.65
chr16	4781866	4782244	CpG: 30	378	30	255	15.9	67.5	0.70
chr16	4796210	4797008	CpG: 78	798	78	546	19.5	68.4	0.84
chr16	4798113	4798504	CpG: 40	391	40	263	20.5	67.3	0.91
chr16	4825920	4826194	CpG: 20	274	20	163	14.6	59.5	0.83
chr16	4831670	4832729	CpG: 123	1059	123	780	23.2	73.7	0.87
chr16	4876095	4877732	CpG: 224	1637	224	1210	27.4	73.9	1.01
chr16	4913112	4914052	CpG: 70	940	70	599	14.9	63.7	0.75
chr16	4914515	4914776	CpG: 21	261	21	166	16.1	63.6	0.84
chr16	4965701	4967067	CpG: 133	1366	133	1000	19.5	73.2	0.73
chr16	4987227	4988223	CpG: 71	996	71	655	14.3	65.8	0.68
chr16	5007637	5007913	CpG: 24	276	24	170	17.4	61.6	0.93
chr16	5017026	5017828	CpG: 66	802	66	566	16.5	70.6	0.68
chr16	5027945	5028233	CpG: 25	288	25	179	17.4	62.2	0.91
chr16	5062736	5063524	CpG: 105	788	105	573	26.6	72.7	1.01
chr16	5101248	5101691	CpG: 45	443	45	301	20.3	67.9	0.89
chr16	5119854	5120062	CpG: 15	208	15	135	14.4	64.9	0.69
chr16	5126756	5128346	CpG: 142	1590	142	1123	17.9	70.6	0.76
chr16	5150969	5151243	CpG: 20	274	20	170	14.6	62.0	0.77
chr16	5215864	5216256	CpG: 31	392	31	283	15.8	72.2	0.61
chr16	5269240	5270044	CpG: 93	804	93	604	23.1	75.1	0.83
chr16	5491894	5492137	CpG: 19	243	19	152	15.6	62.6	0.82
chr16	5844301	5844583	CpG: 21	282	21	172	14.9	61.0	0.82
chr16	5926773	5927066	CpG: 25	293	25	183	17.1	62.5	0.90
chr16	6029366	6029659	CpG: 22	293	22	181	15.0	61.8	0.82
chr16	6048733	6050220	CpG: 136	1487	136	1016	18.3	68.3	0.79
chr16	6082351	6082587	CpG: 19	236	19	142	16.1	60.2	0.91
chr16	6130118	6130356	CpG: 20	238	20	145	16.8	60.9	0.92
chr16	6415900	6416120	CpG: 19	220	19	135	17.3	61.4	0.94
chr16	6513003	6513967	CpG: 84	964	84	620	17.4	64.3	0.86
chr16	6604552	6604802	CpG: 21	250	21	153	16.8	61.2	0.90
chr16	6871964	6872206	CpG: 21	242	21	141	17.4	58.3	1.07
chr16	6884792	6885007	CpG: 16	215	16	128	14.9	59.5	0.85
chr16	7246814	7247059	CpG: 17	245	17	144	13.9	58.8	0.80
chr16	7335609	7335884	CpG: 23	275	23	177	16.7	64.4	0.81
chr16	7444107	7444337	CpG: 18	230	18	142	15.7	61.7	0.83
chr16	7522726	7522988	CpG: 26	262	26	166	19.8	63.4	1.00
chr16	7539201	7539441	CpG: 22	240	22	145	18.3	60.4	1.02
chr16	7549769	7549987	CpG: 22	218	22	142	20.2	65.1	1.02
chr16	7685332	7685611	CpG: 30	279	30	207	21.5	74.2	0.81
chr16	8048748	8049029	CpG: 24	281	24	175	17.1	62.3	0.90
chr16	8146703	8147521	CpG: 58	818	58	548	14.2	67.0	0.63
chr16	8400288	8400562	CpG: 25	274	25	171	18.2	62.4	0.95
chr16	8411049	8411323	CpG: 22	274	22	169	16.1	61.7	0.85
chr16	8602215	8602672	CpG: 32	457	32	311	14.0	68.1	0.62
chr16	8621630	8622587	CpG: 79	957	79	658	16.5	68.8	0.71
chr16	8654150	8654458	CpG: 35	308	35	221	22.7	71.8	0.90
chr16	8694028	8694308	CpG: 19	280	19	170	13.6	60.7	0.74
chr16	8707071	8707434	CpG: 45	363	45	277	24.8	76.3	0.85
chr16	8757679	8757911	CpG: 18	232	18	136	15.5	58.6	0.92
chr16	8830217	8830823	CpG: 57	606	57	405	18.8	66.8	0.85
chr16	8901069	8902070	CpG: 102	1001	102	742	20.4	74.1	0.74
chr16	8903045	8903316	CpG: 24	271	24	159	17.7	58.7	1.06
chr16	8912599	8912874	CpG: 24	275	24	170	17.5	61.8	0.92
chr16	8986398	8986882	CpG: 45	484	45	348	18.6	71.9	0.72
chr16	8995183	8997080	CpG: 273	1897	273	1447	28.8	76.3	0.99
chr16	9014275	9014886	CpG: 51	611	51	408	16.7	66.8	0.75
chr16	9031574	9031810	CpG: 17	236	17	141	14.4	59.7	0.83
chr16	9092642	9092921	CpG: 23	279	23	175	16.5	62.7	0.85
chr16	9123041	9125643	CpG: 273	2602	273	1837	21.0	70.6	0.85
chr16	9197334	9197563	CpG: 23	229	23	144	20.1	62.9	1.03
chr16	9217517	9218021	CpG: 48	504	48	366	19.0	72.6	0.72
chr16	9623586	9624013	CpG: 34	427	34	266	15.9	62.3	0.83
chr16	10214792	10218299	CpG: 287	3507	287	2339	16.4	66.7	0.74
chr16	10258835	10259073	CpG: 18	238	18	142	15.1	59.7	0.86
chr16	10286912	10287309	CpG: 33	397	33	268	16.6	67.5	0.75
chr16	10421503	10422071	CpG: 59	568	59	387	20.8	68.1	0.91
chr16	10538332	10538553	CpG: 20	221	20	139	18.1	62.9	0.93
chr16	10561926	10562195	CpG: 22	269	22	158	16.4	58.7	0.97
chr16	10615937	10616792	CpG: 91	855	91	631	21.3	73.8	0.78
chr16	10663480	10663720	CpG: 18	240	18	157	15.0	65.4	0.71
chr16	10746755	10747026	CpG: 18	271	18	162	13.3	59.8	0.75
chr16	10779647	10780357	CpG: 61	710	61	447	17.2	63.0	0.95
chr16	10854181	10854741	CpG: 55	560	55	414	19.6	73.9	0.72
chr16	10914895	10915418	CpG: 43	523	43	350	16.4	66.9	0.74
chr16	10942889	10943143	CpG: 21	254	21	170	16.5	66.9	0.74
chr16	10943756	10943982	CpG: 20	226	20	157	17.7	69.5	0.73
chr16	10977616	10978816	CpG: 127	1200	127	829	21.2	69.1	0.89
chr16	10980278	10980950	CpG: 82	672	82	477	24.4	71.0	0.97
chr16	11028519	11028793	CpG: 26	274	26	171	19.0	62.4	0.98
chr16	11048596	11048832	CpG: 17	236	17	137	14.4	58.1	0.88
chr16	11210315	11210634	CpG: 28	319	28	201	17.6	63.0	0.89
chr16	11214669	11214926	CpG: 22	257	22	176	17.1	68.5	0.77
chr16	11269386	11269612	CpG: 21	226	21	152	18.6	67.3	0.82
chr16	11285631	11286120	CpG: 50	489	50	339	20.4	69.3	0.88
chr16	11290913	11293175	CpG: 252	2262	252	1654	22.3	73.1	0.83
chr16	11312302	11312584	CpG: 23	282	23	182	16.3	64.5	0.79
chr16	11322697	11322951	CpG: 19	254	19	155	15.0	61.0	0.81
chr16	11381663	11382244	CpG: 77	581	77	434	26.5	74.7	0.96
chr16	11530022	11530257	CpG: 21	235	21	182	17.9	77.4	0.85
chr16	11622238	11623505	CpG: 138	1267	138	915	21.8	72.2	0.84
chr16	11668095	11668319	CpG: 16	224	16	122	14.3	54.5	0.97
chr16	11703933	11705438	CpG: 191	1505	191	1145	25.4	76.1	0.88
chr16	11721411	11721629	CpG: 17	218	17	129	15.6	59.2	0.90
chr16	11745538	11745771	CpG: 19	233	19	140	16.3	60.1	0.92
chr16	11750405	11750643	CpG: 24	238	24	145	20.2	60.9	1.12
chr16	11777744	11779327	CpG: 161	1583	161	1045	20.3	66.0	0.94
chr16	11785511	11785780	CpG: 21	269	21	162	15.6	60.2	0.87
chr16	11832502	11833785	CpG: 153	1283	153	899	23.9	70.1	0.97
chr16	11842412	11842648	CpG: 17	236	17	140	14.4	59.3	0.84
chr16	11863062	11863299	CpG: 18	237	18	142	15.2	59.9	0.89
chr16	11887259	11888403	CpG: 86	1144	86	718	15.0	62.8	0.76
chr16	11889529	11889777	CpG: 20	248	20	147	16.1	59.3	0.93
chr16	11944542	11944816	CpG: 25	274	25	171	18.2	62.4	0.95
chr16	11951066	11952300	CpG: 163	1234	163	917	26.4	74.3	0.96
chr16	11953399	11953639	CpG: 21	240	21	142	17.5	59.2	1.00
chr16	12011282	12011556	CpG: 24	274	24	170	17.5	62.0	0.92
chr16	12012499	12013126	CpG: 70	627	70	454	22.3	72.4	0.86
chr16	12078984	12079216	CpG: 21	232	21	154	18.1	66.4	0.83
chr16	12152920	12153725	CpG: 83	805	83	434	20.6	53.9	1.44
chr16	12297664	12298646	CpG: 67	982	67	620	13.6	63.1	0.71
chr16	12605548	12605863	CpG: 24	315	24	200	15.2	63.5	0.81
chr16	12840540	12841064	CpG: 48	524	48	363	18.3	69.3	0.76
chr16	12899448	12899711	CpG: 22	263	22	190	16.7	72.2	1.04
chr16	12937835	12940935	CpG: 262	3100	262	2086	16.9	67.3	0.75
chr16	13350199	13350473	CpG: 24	274	24	171	17.5	62.4	0.91
chr16	13526104	13526308	CpG: 15	204	15	124	14.7	60.8	0.83
chr16	13644291	13644532	CpG: 22	241	22	131	18.3	54.4	1.24
chr16	13684365	13684595	CpG: 21	230	21	139	18.3	60.4	1.01
chr16	13888292	13888565	CpG: 22	273	22	172	16.1	63.0	0.82
chr16	13957133	13957677	CpG: 56	544	56	361	20.6	66.4	0.94
chr16	14108230	14109060	CpG: 107	830	107	622	25.8	74.9	0.94
chr16	14196912	14197187	CpG: 25	275	25	172	18.2	62.5	0.94
chr16	14322580	14323293	CpG: 79	713	79	476	22.2	66.8	1.00
chr16	14338982	14340453	CpG: 150	1471	150	1080	20.4	73.4	0.76
chr16	14405075	14405352	CpG: 26	277	26	176	18.8	63.5	0.94
chr16	14442792	14443067	CpG: 23	275	23	170	16.7	61.8	0.89
chr16	14667285	14667849	CpG: 55	564	55	396	19.5	70.2	0.80
chr16	14670199	14671532	CpG: 99	1333	99	826	14.9	62.0	0.78
chr16	14731613	14731980	CpG: 29	367	29	257	15.8	70.0	0.64
chr16	14740668	14741321	CpG: 70	653	70	482	21.4	73.8	0.79
chr16	14823009	14823337	CpG: 32	328	32	238	19.5	72.6	0.78
chr16	14831979	14832579	CpG: 68	600	68	432	22.7	72.0	0.89
chr16	14835116	14835397	CpG: 22	281	22	173	15.7	61.6	0.84
chr16	14909348	14910642	CpG: 171	1294	171	987	26.4	76.3	0.91
chr16	14919673	14919926	CpG: 20	253	20	177	15.8	70.0	0.65
chr16	14923347	14923574	CpG: 18	227	18	159	15.9	70.0	0.65
chr16	14924196	14925188	CpG: 73	992	73	681	14.7	68.6	0.63
chr16	14933681	14934318	CpG: 42	637	42	413	13.2	64.8	0.63
chr16	14958742	14958986	CpG: 21	244	21	166	17.2	68.0	0.77
chr16	14975713	14976658	CpG: 96	945	96	664	20.3	70.3	0.83
chr16	14990552	14991350	CpG: 94	798	94	614	23.6	76.9	0.80
chr16	15056399	15057302	CpG: 95	903	95	646	21.0	71.5	0.82
chr16	15095129	15095523	CpG: 41	394	41	252	20.8	64.0	1.02
chr16	15128671	15129305	CpG: 43	634	43	418	13.6	65.9	0.63
chr16	15129850	15130065	CpG: 16	215	16	128	14.9	59.5	0.85
chr16	15130826	15131365	CpG: 37	539	37	357	13.7	66.2	0.63
chr16	15132019	15132639	CpG: 48	620	48	412	15.5	66.5	0.71
chr16	15138112	15139127	CpG: 74	1015	74	696	14.6	68.6	0.62
chr16	15158860	15160145	CpG: 168	1285	168	979	26.1	76.2	0.90
chr16	15213621	15213855	CpG: 17	234	17	139	14.5	59.4	0.84
chr16	15236469	15236670	CpG: 15	201	15	119	14.9	59.2	0.89
chr16	15400465	15401014	CpG: 69	549	69	395	25.1	71.9	0.98
chr16	15439280	15440016	CpG: 63	736	63	500	17.1	67.9	0.76
chr16	15508135	15508387	CpG: 18	252	18	140	14.3	55.6	0.95
chr16	15616006	15616326	CpG: 23	320	23	183	14.4	57.2	0.90
chr16	15647854	15648205	CpG: 43	351	43	262	24.5	74.6	0.97
chr16	15654808	15655472	CpG: 78	664	78	482	23.5	72.6	0.90
chr16	15761771	15762034	CpG: 22	263	22	166	16.7	63.1	0.85
chr16	15861916	15862342	CpG: 44	426	44	295	20.7	69.2	0.86
chr16	15863108	15863499	CpG: 45	391	45	293	23.0	74.9	0.83
chr16	15881813	15882088	CpG: 18	275	18	162	13.1	58.9	0.77
chr16	15893329	15893756	CpG: 36	427	36	275	16.9	64.4	0.84
chr16	15894398	15894628	CpG: 19	230	19	138	16.5	60.0	0.92
chr16	15954286	15955013	CpG: 109	727	109	585	30.0	80.5	0.93
chr16	16006256	16006507	CpG: 18	251	18	151	14.3	60.2	0.80
chr16	16156721	16156922	CpG: 15	201	15	113	14.9	56.2	0.97
chr16	16228888	16229216	CpG: 33	328	33	239	20.1	72.9	0.80
chr16	16237970	16238552	CpG: 67	582	67	423	23.0	72.7	0.89
chr16	16315157	16316451	CpG: 174	1294	174	989	26.9	76.4	0.92
chr16	16325480	16325733	CpG: 20	253	20	177	15.8	70.0	0.65
chr16	16329154	16329408	CpG: 19	254	19	177	15.0	69.7	0.62
chr16	16330003	16330995	CpG: 71	992	71	679	14.3	68.4	0.61
chr16	16339505	16340142	CpG: 41	637	41	414	12.9	65.0	0.61
chr16	16365903	16366516	CpG: 47	613	47	428	15.3	69.8	0.63
chr16	16367089	16367502	CpG: 32	413	32	297	15.5	71.9	0.60
chr16	16368323	16368620	CpG: 23	297	23	211	15.5	71.0	0.62
chr16	16371909	16376171	CpG: 312	4262	312	2864	14.6	67.2	0.65
chr16	16386618	16387255	CpG: 44	637	44	420	13.8	65.9	0.64
chr16	16492198	16492472	CpG: 25	274	25	172	18.2	62.8	0.94
chr16	16503899	16504172	CpG: 24	273	24	168	17.6	61.5	0.94
chr16	16537075	16537317	CpG: 18	242	18	147	14.9	60.7	0.83
chr16	16560802	16561165	CpG: 30	363	30	211	16.5	58.1	0.98
chr16	16812155	16812385	CpG: 20	230	20	141	17.4	61.3	0.94
chr16	16848721	16849002	CpG: 23	281	23	174	16.4	61.9	0.87
chr16	16901220	16901435	CpG: 18	215	18	131	16.7	60.9	0.92
chr16	16941183	16941419	CpG: 16	236	16	141	13.6	59.7	0.78
chr16	16984749	16984978	CpG: 17	229	17	138	14.8	60.3	0.84
chr16	17020367	17020610	CpG: 21	243	21	148	17.3	60.9	0.95
chr16	17304751	17305024	CpG: 21	273	21	168	15.4	61.5	0.82
chr16	17323859	17324134	CpG: 22	275	22	169	16.0	61.5	0.85
chr16	17477289	17478248	CpG: 151	959	151	777	31.5	81.0	0.96
chr16	17521876	17522154	CpG: 23	278	23	173	16.5	62.2	0.86
chr16	17546494	17546771	CpG: 20	277	20	169	14.4	61.0	0.79
chr16	17684867	17685137	CpG: 25	270	25	168	18.5	62.2	0.97
chr16	17722563	17722837	CpG: 24	274	24	171	17.5	62.4	0.91
chr16	17878783	17878997	CpG: 19	214	19	131	17.8	61.2	0.97
chr16	17880616	17880850	CpG: 19	234	19	140	16.2	59.8	0.93
chr16	17984892	17985128	CpG: 20	236	20	144	16.9	61.0	0.94
chr16	18059354	18059639	CpG: 22	285	22	176	15.4	61.8	0.83
chr16	18127645	18127879	CpG: 17	234	17	139	14.5	59.4	0.84
chr16	18194325	18194531	CpG: 15	206	15	120	14.6	58.3	0.91
chr16	18344551	18344755	CpG: 18	204	18	139	17.6	68.1	0.77
chr16	18355223	18359485	CpG: 308	4262	308	2860	14.5	67.1	0.64
chr16	18362774	18363071	CpG: 23	297	23	211	15.5	71.0	0.62
chr16	18364878	18365491	CpG: 47	613	47	429	15.3	70.0	0.63
chr16	18391254	18391891	CpG: 41	637	41	413	12.9	64.8	0.62
chr16	18400428	18401420	CpG: 72	992	72	679	14.5	68.4	0.62
chr16	18402015	18402269	CpG: 19	254	19	177	15.0	69.7	0.62
chr16	18405690	18405943	CpG: 20	253	20	178	15.8	70.4	0.64
chr16	18414969	18416263	CpG: 174	1294	174	989	26.9	76.4	0.92
chr16	18492888	18493469	CpG: 67	581	67	420	23.1	72.3	0.90
chr16	18502181	18502509	CpG: 33	328	33	240	20.1	73.2	0.79
chr16	18726364	18727390	CpG: 77	1026	77	626	15.0	61.0	0.81
chr16	18737502	18739325	CpG: 140	1823	140	1107	15.4	60.7	0.83
chr16	18825448	18825665	CpG: 15	217	15	132	13.8	60.8	0.76
chr16	18856304	18857403	CpG: 130	1099	130	813	23.7	74.0	0.87
chr16	18879367	18879655	CpG: 24	288	24	178	16.7	61.8	0.88
chr16	18914669	18915090	CpG: 51	421	51	323	24.2	76.7	0.83
chr16	18998361	18999035	CpG: 64	674	64	429	19.0	63.6	0.95
chr16	19017275	19017773	CpG: 47	498	47	319	18.9	64.1	0.92
chr16	19044655	19046126	CpG: 155	1471	155	1061	21.1	72.1	0.81
chr16	19046640	19046843	CpG: 18	203	18	144	17.7	70.9	0.71
chr16	19098535	19099977	CpG: 136	1442	136	1035	18.9	71.8	0.73
chr16	19114414	19114740	CpG: 23	326	23	191	14.1	58.6	0.87
chr16	19171468	19171742	CpG: 24	274	24	171	17.5	62.4	0.91
chr16	19289480	19289754	CpG: 22	274	22	168	16.1	61.3	0.86
chr16	19341731	19342413	CpG: 60	682	60	465	17.6	68.2	0.77
chr16	19350696	19350929	CpG: 18	233	18	139	15.5	59.7	0.88
chr16	19452531	19453066	CpG: 50	535	50	372	18.7	69.5	0.78
chr16	19454192	19454407	CpG: 17	215	17	123	15.8	57.2	1.00
chr16	19454624	19455186	CpG: 49	562	49	382	17.4	68.0	0.79
chr16	19486036	19486938	CpG: 63	902	63	561	14.0	62.2	0.72
chr16	19576154	19576376	CpG: 18	222	18	134	16.2	60.4	0.90
chr16	19648675	19649529	CpG: 96	854	96	586	22.5	68.6	0.96
chr16	19814413	19816604	CpG: 176	2191	176	1496	16.1	68.3	0.72
chr16	19983442	19983674	CpG: 18	232	18	147	15.5	63.4	0.79
chr16	20004108	20004917	CpG: 73	809	73	557	18.0	68.9	0.77
chr16	20052634	20052911	CpG: 24	277	24	177	17.3	63.9	0.86
chr16	20279440	20280171	CpG: 74	731	74	500	20.2	68.4	0.87
chr16	20422833	20423046	CpG: 16	213	16	148	15.0	69.5	0.63
chr16	20462477	20462690	CpG: 16	213	16	149	15.0	70.0	0.62
chr16	20672255	20672889	CpG: 65	634	65	422	20.5	66.6	0.94
chr16	20698163	20698443	CpG: 26	280	26	178	18.6	63.6	0.93
chr16	20737109	20738137	CpG: 90	1028	90	666	17.5	64.8	0.84
chr16	20831158	20832208	CpG: 87	1050	87	697	16.6	66.4	0.76
chr16	20919657	20919904	CpG: 19	247	19	136	15.4	55.1	1.04
chr16	20920535	20920924	CpG: 35	389	35	283	18.0	72.8	0.68
chr16	20979226	20979586	CpG: 25	360	25	212	13.9	58.9	0.81
chr16	21083522	21083913	CpG: 39	391	39	296	19.9	75.7	0.70
chr16	21089433	21089881	CpG: 48	448	48	321	21.4	71.7	0.85
chr16	21213390	21213790	CpG: 36	400	36	276	18.0	69.0	0.77
chr16	21218951	21219385	CpG: 54	434	54	334	24.9	77.0	0.84
chr16	21236139	21237305	CpG: 102	1166	102	777	17.5	66.6	0.82
chr16	21311889	21312115	CpG: 19	226	19	149	16.8	65.9	0.78
chr16	21337567	21337843	CpG: 28	276	28	176	20.3	63.8	1.00
chr16	21436268	21437379	CpG: 127	1111	127	815	22.9	73.4	0.85
chr16	21439628	21439896	CpG: 19	268	19	158	14.2	59.0	0.82
chr16	21453548	21453786	CpG: 21	238	21	146	17.6	61.3	0.95
chr16	21454549	21455560	CpG: 127	1011	127	740	25.1	73.2	0.95
chr16	21597371	21597732	CpG: 27	361	27	192	15.0	53.2	1.07
chr16	21609282	21609556	CpG: 25	274	25	172	18.2	62.8	0.94
chr16	21643778	21644073	CpG: 31	295	31	210	21.0	71.2	0.83
chr16	21677437	21677710	CpG: 24	273	24	171	17.6	62.6	0.91
chr16	21680853	21681655	CpG: 58	802	58	489	14.5	61.0	0.79
chr16	21779508	21780336	CpG: 101	828	101	610	24.4	73.7	0.90
chr16	21842049	21843457	CpG: 152	1408	152	976	21.6	69.3	0.90
chr16	21855012	21855246	CpG: 18	234	18	140	15.4	59.8	0.90
chr16	21890954	21891382	CpG: 35	428	35	294	16.4	68.7	0.69
chr16	21919167	21920067	CpG: 93	900	93	640	20.7	71.1	0.82
chr16	22010444	22011235	CpG: 78	791	78	578	19.7	73.1	0.74
chr16	22021283	22021497	CpG: 19	214	19	124	17.8	57.9	1.07
chr16	22025743	22027146	CpG: 115	1403	115	941	16.4	67.1	0.80
chr16	22054613	22054855	CpG: 32	242	32	189	26.4	78.1	0.88
chr16	22062253	22062534	CpG: 25	281	25	176	17.8	62.6	0.92
chr16	22208455	22209525	CpG: 122	1070	122	789	22.8	73.7	0.89
chr16	22264150	22264408	CpG: 19	258	19	159	14.7	61.6	0.78
chr16	22381159	22382213	CpG: 72	1054	72	637	13.7	60.4	0.77
chr16	22385372	22385646	CpG: 24	274	24	172	17.5	62.8	0.90
chr16	22396320	22396782	CpG: 45	462	45	287	19.5	62.1	1.01
chr16	22459636	22459931	CpG: 31	295	31	210	21.0	71.2	0.83
chr16	22552631	22553225	CpG: 52	594	52	394	17.5	66.3	0.80
chr16	22579046	22579258	CpG: 22	212	22	152	20.8	71.7	0.81
chr16	22586439	22586700	CpG: 22	261	22	190	16.9	72.8	0.64
chr16	22616571	22617573	CpG: 126	1002	126	743	25.1	74.2	0.92
chr16	22696110	22697121	CpG: 127	1011	127	741	25.1	73.3	0.95
chr16	22697884	22698122	CpG: 21	238	21	146	17.6	61.3	0.95
chr16	22711747	22712015	CpG: 19	268	19	158	14.2	59.0	0.82
chr16	22713383	22713594	CpG: 16	211	16	125	15.2	59.2	0.87
chr16	22714264	22715381	CpG: 129	1117	129	819	23.1	73.3	0.86
chr16	22735412	22735745	CpG: 26	333	26	193	15.6	58.0	0.94
chr16	22813871	22814147	CpG: 28	276	28	176	20.3	63.8	1.00
chr16	22817296	22817569	CpG: 24	273	24	171	17.6	62.6	0.91
chr16	22850940	22851235	CpG: 31	295	31	210	21.0	71.2	0.83
chr16	22885476	22885750	CpG: 25	274	25	172	18.2	62.8	0.94
chr16	22897285	22897643	CpG: 27	358	27	192	15.1	53.6	1.07
chr16	23000686	23001076	CpG: 33	390	33	280	16.9	71.8	0.66
chr16	23090964	23092820	CpG: 195	1856	195	1305	21.0	70.3	0.85
chr16	23192807	23193103	CpG: 24	296	24	180	16.2	60.8	0.89
chr16	23225889	23226339	CpG: 32	450	32	289	14.2	64.2	0.70
chr16	23424580	23425625	CpG: 161	1045	161	812	30.8	77.7	1.02
chr16	23458396	23459453	CpG: 97	1057	97	746	18.4	70.6	0.75
chr16	23462230	23462495	CpG: 22	265	22	167	16.6	63.0	0.87
chr16	23548227	23548504	CpG: 20	277	20	170	14.4	61.4	0.77
chr16	23577811	23578518	CpG: 78	707	78	498	22.1	70.4	0.89
chr16	23684162	23684461	CpG: 27	299	27	233	18.1	77.9	1.16
chr16	23728747	23729525	CpG: 65	778	65	482	16.7	62.0	0.87
chr16	23729721	23729922	CpG: 18	201	18	114	17.9	56.7	1.14
chr16	23735346	23735552	CpG: 15	206	15	123	14.6	59.7	0.83
chr16	23786230	23786685	CpG: 60	455	60	358	26.4	78.7	0.87
chr16	23832876	23833966	CpG: 113	1090	113	780	20.7	71.6	0.81
chr16	23859094	23859609	CpG: 42	515	42	357	16.3	69.3	0.68
chr16	23871690	23872334	CpG: 67	644	67	447	20.8	69.4	0.87
chr16	23890518	23890750	CpG: 20	232	20	141	17.2	60.8	0.95
chr16	23903012	23903297	CpG: 22	285	22	176	15.4	61.8	0.82
chr16	23916874	23918041	CpG: 90	1167	90	713	15.4	61.1	0.83
chr16	23954372	23955152	CpG: 77	780	77	499	19.7	64.0	0.97
chr16	23988754	23989259	CpG: 46	505	46	359	18.2	71.1	0.73
chr16	24003067	24003455	CpG: 26	388	26	228	13.4	58.8	0.80
chr16	24028478	24029378	CpG: 86	900	86	622	19.1	69.1	0.81
chr16	24110998	24112159	CpG: 140	1161	140	880	24.1	75.8	0.84
chr16	24386206	24386497	CpG: 20	291	20	187	13.7	64.3	0.67
chr16	24423553	24423787	CpG: 17	234	17	138	14.5	59.0	0.86
chr16	24532215	24532813	CpG: 46	598	46	393	15.4	65.7	0.71
chr16	24592819	24593093	CpG: 22	274	22	169	16.1	61.7	0.85
chr16	24816224	24817329	CpG: 126	1105	126	788	22.8	71.3	0.90
chr16	24850938	24852189	CpG: 108	1251	108	896	17.3	71.6	0.68
chr16	25006268	25007419	CpG: 131	1151	131	788	22.8	68.5	0.98
chr16	25045059	25045265	CpG: 15	206	15	125	14.6	60.7	0.80
chr16	25294368	25295232	CpG: 99	864	99	641	22.9	74.2	0.83
chr16	25311422	25311731	CpG: 28	309	28	206	18.1	66.7	0.82
chr16	25313040	25313287	CpG: 19	247	19	140	15.4	56.7	0.99
chr16	25338490	25338881	CpG: 40	391	40	293	20.5	74.9	0.73
chr16	25346326	25346811	CpG: 53	485	53	369	21.9	76.1	0.76
chr16	25386198	25386806	CpG: 58	608	58	414	19.1	68.1	0.83
chr16	25391018	25391701	CpG: 54	683	54	417	15.8	61.1	0.85
chr16	25478079	25478289	CpG: 17	210	17	128	16.2	61.0	0.89
chr16	25504982	25505196	CpG: 16	214	16	123	15.0	57.5	0.92
chr16	25536956	25537900	CpG: 118	944	118	694	25.0	73.5	0.95
chr16	25798212	25798425	CpG: 15	213	15	124	14.1	58.2	0.84
chr16	25888776	25889006	CpG: 20	230	20	142	17.4	61.7	0.92
chr16	25968162	25969836	CpG: 212	1674	212	1257	25.3	75.1	0.90
chr16	25991496	25991784	CpG: 27	288	27	183	18.8	63.5	0.94
chr16	26441822	26442051	CpG: 20	229	20	134	17.5	58.5	1.03
chr16	26448205	26448478	CpG: 23	273	23	171	16.8	62.6	0.87
chr16	26648401	26648637	CpG: 21	236	21	145	17.8	61.4	0.96
chr16	26654044	26654318	CpG: 23	274	23	170	16.8	62.0	0.88
chr16	26761246	26761520	CpG: 23	274	23	171	16.8	62.4	0.87
chr16	27026910	27027144	CpG: 19	234	19	140	16.2	59.8	0.93
chr16	27112945	27113342	CpG: 34	397	34	288	17.1	72.5	0.65
chr16	27157952	27158194	CpG: 17	242	17	141	14.0	58.3	0.85
chr16	27386457	27386827	CpG: 44	370	44	278	23.8	75.1	0.84
chr16	27482064	27482970	CpG: 82	906	82	574	18.1	63.4	0.92
chr16	27547196	27547553	CpG: 35	357	35	233	19.6	65.3	0.97
chr16	27585207	27585413	CpG: 17	206	17	118	16.5	57.3	2.04
chr16	27592309	27593119	CpG: 108	810	108	618	26.7	76.3	0.93
chr16	27676435	27676660	CpG: 17	225	17	135	15.1	60.0	0.85
chr16	27696836	27697109	CpG: 20	273	20	162	14.7	59.3	0.84
chr16	27828380	27828999	CpG: 65	619	65	432	21.0	69.8	0.86
chr16	28121091	28121311	CpG: 31	220	31	119	28.2	54.1	1.93
chr16	28342957	28344436	CpG: 198	1479	198	1136	26.8	76.8	0.92
chr16	28491676	28492793	CpG: 116	1117	116	801	20.8	71.7	0.81
chr16	28539641	28539863	CpG: 18	222	18	160	16.2	72.1	0.62
chr16	28572828	28574000	CpG: 133	1172	133	859	22.7	73.3	0.85
chr16	28600438	28601702	CpG: 165	1264	165	943	26.1	74.6	0.94
chr16	28644840	28645457	CpG: 70	617	70	457	22.7	74.1	0.83
chr16	28648181	28649025	CpG: 81	844	81	598	19.2	70.9	0.78
chr16	28654667	28654948	CpG: 22	281	22	201	15.7	71.5	0.62
chr16	28657280	28658039	CpG: 58	759	58	527	15.3	69.4	0.63
chr16	28683879	28684524	CpG: 67	645	67	407	20.8	63.1	1.04
chr16	28716090	28716346	CpG: 23	256	23	187	18.0	73.0	0.68
chr16	28771626	28771843	CpG: 18	217	18	133	16.6	61.3	0.88
chr16	28771972	28772563	CpG: 76	591	76	425	25.7	71.9	1.00
chr16	28781636	28782078	CpG: 43	442	43	322	19.5	72.9	0.74
chr16	28794625	28795067	CpG: 43	442	43	322	19.5	72.9	0.74
chr16	28810950	28811184	CpG: 18	234	18	139	15.4	59.4	0.89
chr16	28841330	28841937	CpG: 75	607	75	415	24.7	68.4	1.07
chr16	28886427	28886689	CpG: 23	262	23	162	17.6	61.8	0.93
chr16	28897588	28897860	CpG: 22	272	22	184	16.2	67.6	0.71
chr16	28903578	28904256	CpG: 52	678	52	434	15.3	64.0	0.75
chr16	28960094	28960350	CpG: 23	256	23	185	18.0	72.3	0.69
chr16	28991787	28992432	CpG: 67	645	67	407	20.8	63.1	1.04
chr16	29018263	29019022	CpG: 58	759	58	526	15.3	69.3	0.64
chr16	29021224	29021591	CpG: 27	367	27	256	14.7	69.8	0.61
chr16	29027229	29028064	CpG: 80	835	80	594	19.2	71.1	0.78
chr16	29030787	29031404	CpG: 70	617	70	457	22.7	74.1	0.83
chr16	29074155	29074411	CpG: 23	256	23	185	18.0	72.3	0.69
chr16	29103167	29105132	CpG: 208	1965	208	1427	21.2	72.6	0.81
chr16	29126452	29127387	CpG: 84	935	84	630	18.0	67.4	0.79
chr16	29143855	29144739	CpG: 80	884	80	599	18.1	67.8	0.79
chr16	29160133	29161047	CpG: 81	914	81	627	17.7	68.6	0.76
chr16	29181117	29181356	CpG: 23	239	23	157	19.2	65.7	0.89
chr16	29205841	29206824	CpG: 102	983	102	702	20.8	71.4	0.86
chr16	29217795	29218245	CpG: 35	450	35	300	15.6	66.7	0.72
chr16	29226919	29227140	CpG: 18	221	18	137	16.3	62.0	1.11
chr16	29231255	29232586	CpG: 119	1331	119	862	17.9	64.8	0.87
chr16	29255675	29256455	CpG: 78	780	78	542	20.0	69.5	0.83
chr16	29278833	29279111	CpG: 25	278	25	175	18.0	62.9	0.92
chr16	29356052	29356266	CpG: 24	214	24	146	22.4	68.2	0.98
chr16	29363160	29363662	CpG: 71	502	71	375	28.3	74.7	1.02
chr16	29423194	29423404	CpG: 17	210	17	128	16.2	61.0	0.93
chr16	29439792	29440308	CpG: 46	516	46	351	17.8	68.0	0.78
chr16	29449034	29449343	CpG: 22	309	22	182	14.2	58.9	0.82
chr16	29466476	29466705	CpG: 20	229	20	139	17.5	60.7	0.95
chr16	29499940	29500271	CpG: 29	331	29	213	17.5	64.4	0.85
chr16	29501863	29502325	CpG: 37	462	37	300	16.0	64.9	0.77
chr16	29518442	29518646	CpG: 31	204	31	159	30.4	77.9	1.27
chr16	29532902	29533132	CpG: 17	230	17	143	14.8	62.2	0.77
chr16	29567200	29567440	CpG: 19	240	19	166	15.8	69.2	0.69
chr16	29580654	29581144	CpG: 35	490	35	281	14.3	57.3	1.99
chr16	29735823	29737613	CpG: 159	1790	159	1224	17.8	68.4	0.76
chr16	29737996	29738232	CpG: 17	236	17	141	14.4	59.7	0.83
chr16	29747858	29748971	CpG: 94	1113	94	780	16.9	70.1	0.70
chr16	29765485	29765761	CpG: 28	276	28	176	20.3	63.8	1.00
chr16	29876683	29877664	CpG: 110	981	110	718	22.4	73.2	0.84
chr16	29878486	29878698	CpG: 17	212	17	126	16.0	59.4	0.92
chr16	29894104	29894342	CpG: 20	238	20	144	16.8	60.5	0.93
chr16	29895110	29896114	CpG: 125	1004	125	733	24.9	73.0	0.95
chr16	29942004	29942229	CpG: 16	225	16	134	14.2	59.6	0.83
chr16	29946567	29946842	CpG: 23	275	23	194	16.7	70.5	0.69
chr16	29974035	29975032	CpG: 67	997	67	559	13.4	56.1	0.86
chr16	29976898	29977158	CpG: 21	260	21	188	16.2	72.3	0.63
chr16	30030357	30030596	CpG: 21	239	21	176	17.6	73.6	0.65
chr16	30037709	30038064	CpG: 27	355	27	217	15.2	61.1	0.82
chr16	30067163	30067559	CpG: 36	396	36	258	18.2	65.2	0.86
chr16	30072532	30073381	CpG: 80	849	80	557	18.8	65.6	0.89
chr16	30087092	30090399	CpG: 372	3307	372	2441	22.5	73.8	0.83
chr16	30094008	30094751	CpG: 70	743	70	524	18.8	70.5	0.77
chr16	30097507	30099144	CpG: 125	1637	125	1012	15.3	61.8	0.81
chr16	30123917	30124239	CpG: 25	322	25	212	15.5	65.8	0.72
chr16	30127217	30127509	CpG: 20	292	20	188	13.7	64.4	0.66
chr16	30145232	30145830	CpG: 62	598	62	423	20.7	70.7	0.83
chr16	30159113	30160084	CpG: 71	971	71	645	14.6	66.4	0.67
chr16	30167575	30167787	CpG: 16	212	16	126	15.1	59.4	0.87
chr16	30182662	30183437	CpG: 74	775	74	557	19.1	71.9	0.74
chr16	30184211	30184518	CpG: 23	307	23	210	15.0	68.4	0.64
chr16	30207414	30207653	CpG: 16	239	16	142	13.4	59.4	0.77
chr16	30208353	30209249	CpG: 91	896	91	618	20.3	69.0	0.86
chr16	30243496	30243735	CpG: 17	239	17	136	14.2	56.9	0.90
chr16	30244335	30244882	CpG: 68	547	68	396	24.9	72.4	0.95
chr16	30255978	30256773	CpG: 75	795	75	536	18.9	67.4	0.83
chr16	30268953	30269166	CpG: 19	213	19	148	17.8	69.5	0.74
chr16	30270103	30270323	CpG: 17	220	17	156	15.5	70.9	0.62
chr16	30277897	30279193	CpG: 118	1296	118	827	18.2	63.8	0.89
chr16	30293450	30294326	CpG: 102	876	102	653	23.3	74.5	0.84
chr16	30304098	30304445	CpG: 30	347	30	236	17.3	68.0	0.76
chr16	30335062	30335342	CpG: 21	280	21	168	15.0	60.0	0.84
chr16	30335529	30336007	CpG: 52	478	52	335	21.8	70.1	0.89
chr16	30347635	30349197	CpG: 154	1562	154	1064	19.7	68.1	0.85
chr16	30357923	30358164	CpG: 17	241	17	148	14.1	61.4	0.77
chr16	30358562	30359168	CpG: 75	606	75	431	24.8	71.1	1.02
chr16	30374135	30375014	CpG: 77	879	77	590	17.5	67.1	0.78
chr16	30378560	30379284	CpG: 91	724	91	556	25.1	76.8	0.86
chr16	30405546	30406152	CpG: 73	606	73	464	24.1	76.6	0.90
chr16	30467730	30468618	CpG: 95	888	95	658	21.4	74.1	0.79
chr16	30477924	30479714	CpG: 159	1790	159	1223	17.8	68.3	0.76
chr16	30480098	30480334	CpG: 17	236	17	141	14.4	59.7	0.83
chr16	30489970	30491083	CpG: 94	1113	94	780	16.9	70.1	0.70
chr16	30507582	30508510	CpG: 65	928	65	563	14.0	60.7	0.78
chr16	30579896	30581686	CpG: 159	1790	159	1224	17.8	68.4	0.76
chr16	30582069	30582305	CpG: 17	236	17	141	14.4	59.7	0.83
chr16	30591939	30593052	CpG: 94	1113	94	780	16.9	70.1	0.70
chr16	30609541	30609817	CpG: 28	276	28	176	20.3	63.8	1.00
chr16	30712096	30712471	CpG: 31	375	31	224	16.5	59.7	0.94
chr16	30720928	30721741	CpG: 101	813	101	622	24.8	76.5	0.85
chr16	30726484	30726758	CpG: 21	274	21	169	15.3	61.7	0.81
chr16	30741087	30741642	CpG: 52	555	52	371	18.7	66.8	0.84
chr16	30755959	30756834	CpG: 111	875	111	670	25.4	76.6	0.87
chr16	30763917	30765513	CpG: 127	1596	127	1065	15.9	66.7	0.75
chr16	30781173	30782173	CpG: 121	1000	121	749	24.2	74.9	0.86
chr16	30786308	30787003	CpG: 62	695	62	445	17.8	64.0	0.87
chr16	30787190	30787457	CpG: 20	267	20	157	15.0	58.8	0.87
chr16	30792680	30793011	CpG: 27	331	27	185	16.3	55.9	1.05
chr16	30793207	30794151	CpG: 84	944	84	641	17.8	67.9	0.79
chr16	30803751	30804680	CpG: 150	929	150	688	32.3	74.1	1.18
chr16	30815978	30816558	CpG: 46	580	46	369	15.9	63.6	0.79
chr16	30831648	30832286	CpG: 55	638	55	408	17.2	63.9	0.85
chr16	30837582	30837855	CpG: 24	273	24	171	17.6	62.6	0.91
chr16	30861025	30861364	CpG: 35	339	35	249	20.6	73.5	0.77
chr16	30894153	30894426	CpG: 23	273	23	172	16.8	63.0	0.85
chr16	30911489	30912184	CpG: 57	695	57	464	16.4	66.8	0.76
chr16	30913176	30914541	CpG: 149	1365	149	1022	21.8	74.9	0.80
chr16	30919515	30919980	CpG: 44	465	44	324	18.9	69.7	0.78
chr16	30921171	30922160	CpG: 90	989	90	663	18.2	67.0	0.82
chr16	30942088	30942924	CpG: 77	836	77	579	18.4	69.3	0.78
chr16	30944827	30945695	CpG: 83	868	83	584	19.1	67.3	0.85
chr16	30948339	30948797	CpG: 45	458	45	303	19.7	66.2	0.90
chr16	30956885	30957192	CpG: 31	307	31	219	20.2	71.3	0.79
chr16	30958394	30959491	CpG: 86	1097	86	687	15.7	62.6	0.80
chr16	30969624	30970184	CpG: 46	560	46	374	16.4	66.8	0.76
chr16	30972146	30972584	CpG: 46	438	46	308	21.0	70.3	0.85
chr16	30973272	30973487	CpG: 19	215	19	136	17.7	63.3	0.88
chr16	30973620	30973856	CpG: 19	236	19	145	16.1	61.4	0.88
chr16	30991438	30991947	CpG: 48	509	48	346	18.9	68.0	0.85
chr16	30996661	30997487	CpG: 77	826	77	545	18.6	66.0	0.86
chr16	31021352	31021785	CpG: 46	433	46	281	21.2	64.9	1.02
chr16	31037629	31038899	CpG: 109	1270	109	874	17.2	68.8	0.74
chr16	31044757	31046937	CpG: 226	2180	226	1489	20.7	68.3	0.89
chr16	31056136	31056422	CpG: 24	286	24	206	16.8	72.0	0.65
chr16	31071816	31072056	CpG: 17	240	17	146	14.2	60.8	0.79
chr16	31084934	31086070	CpG: 125	1136	125	815	22.0	71.7	0.86
chr16	31122175	31122449	CpG: 23	274	23	170	16.8	62.0	0.88
chr16	31135081	31135998	CpG: 78	917	78	635	17.0	69.2	0.73
chr16	31136347	31136614	CpG: 20	267	20	158	15.0	59.2	0.86
chr16	31148630	31150104	CpG: 135	1474	135	957	18.3	64.9	0.87
chr16	31162740	31163586	CpG: 90	846	90	590	21.3	69.7	0.89
chr16	31169838	31171390	CpG: 124	1552	124	1004	16.0	64.7	0.78
chr16	31173882	31174915	CpG: 83	1033	83	751	16.1	72.7	0.61
chr16	31186698	31186979	CpG: 24	281	24	175	17.1	62.3	0.90
chr16	31192863	31193393	CpG: 49	530	49	364	18.5	68.7	0.78
chr16	31194425	31194646	CpG: 18	221	18	132	16.3	59.7	0.93
chr16	31201694	31202144	CpG: 44	450	44	308	19.6	68.4	0.84
chr16	31208457	31208731	CpG: 29	274	29	198	21.2	72.3	0.81
chr16	31221825	31222369	CpG: 46	544	46	377	16.9	69.3	0.71
chr16	31262275	31262984	CpG: 79	709	79	494	22.3	69.7	0.92
chr16	31281213	31281920	CpG: 96	707	96	540	27.2	76.4	0.93
chr16	31283166	31283399	CpG: 23	233	23	139	19.7	59.7	1.35
chr16	31289498	31290085	CpG: 84	587	84	463	28.6	78.9	0.93
chr16	31309557	31311915	CpG: 172	2358	172	1542	14.6	65.4	0.69
chr16	31317571	31318075	CpG: 44	504	44	357	17.5	70.8	0.70
chr16	31334272	31334637	CpG: 27	365	27	252	14.8	69.0	0.69
chr16	31335384	31335675	CpG: 22	291	22	191	15.1	65.6	0.70
chr16	31335907	31337007	CpG: 84	1100	84	769	15.3	69.9	0.63
chr16	31344564	31345954	CpG: 150	1390	150	974	21.6	70.1	0.88
chr16	31352118	31352354	CpG: 17	236	17	140	14.4	59.3	1.07
chr16	31377002	31377203	CpG: 16	201	16	129	15.9	64.2	0.78
chr16	31384409	31385160	CpG: 62	751	62	508	16.5	67.6	0.72
chr16	31397893	31398497	CpG: 57	604	57	453	18.9	75.0	0.79
chr16	31420469	31421611	CpG: 99	1142	99	750	17.3	65.7	0.84
chr16	31429010	31429917	CpG: 68	907	68	576	15.0	63.5	0.75
chr16	31449087	31449705	CpG: 65	618	65	417	21.0	67.5	0.93
chr16	31449921	31450473	CpG: 36	552	36	308	13.0	55.8	0.85
chr16	31451185	31451857	CpG: 61	672	61	454	18.2	67.6	0.80
chr16	31460450	31462155	CpG: 144	1705	144	1091	16.9	64.0	0.83
chr16	31467496	31467903	CpG: 38	407	38	281	18.7	69.0	0.78
chr16	31481567	31482437	CpG: 84	870	84	568	19.3	65.3	0.92
chr16	31493241	31493575	CpG: 30	334	30	234	18.0	70.1	0.74
chr16	31495697	31496884	CpG: 115	1187	115	839	19.4	70.7	0.78
chr16	31503734	31503965	CpG: 19	231	19	139	16.5	60.2	0.93
chr16	31504232	31505595	CpG: 108	1363	108	846	15.8	62.1	0.83
chr16	31529714	31530632	CpG: 97	918	97	674	21.1	73.4	0.80
chr16	31535734	31536167	CpG: 42	433	42	318	19.4	73.4	0.73
chr16	31556837	31557173	CpG: 31	336	31	248	18.5	73.8	0.68
chr16	31566930	31568747	CpG: 168	1817	168	1159	18.5	63.8	0.91
chr16	31589666	31590387	CpG: 69	721	69	506	19.1	70.2	0.78
chr16	31602065	31604373	CpG: 181	2308	181	1537	15.7	66.6	0.71
chr16	31611641	31612220	CpG: 73	579	73	418	25.2	72.2	0.97
chr16	31619165	31620298	CpG: 92	1133	92	827	16.2	73.0	0.61
chr16	31718552	31719240	CpG: 53	688	53	471	15.4	68.5	0.68
chr16	31740979	31741257	CpG: 23	278	23	173	16.5	62.2	0.86
chr16	31759005	31759218	CpG: 17	213	17	138	16.0	64.8	0.77
chr16	31814234	31814515	CpG: 22	281	22	173	15.7	61.6	0.84
chr16	31814968	31815776	CpG: 90	808	90	592	22.3	73.3	0.83
chr16	31829429	31830649	CpG: 117	1220	117	813	19.2	66.6	0.86
chr16	31846049	31847369	CpG: 156	1320	156	917	23.6	69.5	0.98
chr16	31851855	31852267	CpG: 45	412	45	305	21.8	74.0	0.81
chr16	31859343	31859928	CpG: 59	585	59	432	20.2	73.8	0.77
chr16	31863219	31865034	CpG: 152	1815	152	1212	16.7	66.8	0.76
chr16	31874722	31876636	CpG: 177	1914	177	1309	18.5	68.4	0.79
chr16	31895453	31896037	CpG: 61	584	61	408	20.9	69.9	0.86
chr16	31916919	31917155	CpG: 31	236	31	180	26.3	76.3	0.99
chr16	31924695	31925256	CpG: 57	561	57	422	20.3	75.2	0.75
chr16	31956143	31956390	CpG: 22	247	22	158	17.8	64.0	0.87
chr16	31956632	31957096	CpG: 65	464	65	348	28.0	75.0	1.01
chr16	32087911	32088443	CpG: 52	532	52	368	19.5	69.2	0.82
chr16	32100720	32101140	CpG: 44	420	44	284	21.0	67.6	0.92
chr16	32206698	32207279	CpG: 56	581	56	434	19.3	74.7	0.72
chr16	32261188	32261746	CpG: 51	558	51	383	18.3	68.6	0.78
chr16	32369336	32369699	CpG: 41	363	41	261	22.6	71.9	0.89
chr16	32436972	32437253	CpG: 23	281	23	174	16.4	61.9	0.87
chr16	32471790	32473460	CpG: 177	1670	177	1096	21.2	65.6	1.01
chr16	32485792	32486063	CpG: 23	271	23	165	17.0	60.9	0.92
chr16	32503041	32504270	CpG: 147	1229	147	854	23.9	69.5	1.04
chr16	32524624	32524898	CpG: 23	274	23	170	16.8	62.0	0.88
chr16	32575343	32575801	CpG: 59	458	59	346	25.8	75.5	0.97
chr16	32589675	32590415	CpG: 76	740	76	533	20.5	72.0	0.79
chr16	32611708	32611991	CpG: 22	283	22	172	15.5	60.8	0.85
chr16	32628678	32628932	CpG: 19	254	19	167	15.0	65.7	0.70
chr16	32640640	32641553	CpG: 65	913	65	573	14.2	62.8	0.76
chr16	32657022	32657298	CpG: 20	276	20	167	14.5	60.5	0.81
chr16	32665879	32666818	CpG: 90	939	90	654	19.2	69.6	0.79
chr16	32705575	32706098	CpG: 39	523	39	350	14.9	66.9	0.67
chr16	32725912	32726877	CpG: 103	965	103	680	21.3	70.5	0.88
chr16	32742761	32743039	CpG: 24	278	24	174	17.3	62.6	0.89
chr16	32764290	32765124	CpG: 106	834	106	625	25.4	74.9	0.94
chr16	32797908	32798181	CpG: 21	273	21	165	15.4	60.4	0.85
chr16	32875528	32875782	CpG: 19	254	19	157	15.0	61.8	0.80
chr16	32878082	32878410	CpG: 26	328	26	202	15.9	61.6	0.84
chr16	32894442	32894731	CpG: 36	289	36	196	24.9	67.8	1.17
chr16	33064872	33065823	CpG: 93	951	93	664	19.6	69.8	0.80
chr16	33089783	33090696	CpG: 65	913	65	573	14.2	62.8	0.76
chr16	33102376	33102630	CpG: 19	254	19	167	15.0	65.7	0.70
chr16	33119321	33119604	CpG: 22	283	22	171	15.5	60.4	0.86
chr16	33140909	33141648	CpG: 73	739	73	532	19.8	72.0	0.76
chr16	33155509	33155968	CpG: 58	459	58	346	25.3	75.4	0.95
chr16	33224839	33225782	CpG: 104	943	104	649	22.1	68.8	0.96
chr16	33242818	33243051	CpG: 20	233	20	139	17.2	59.7	0.98
chr16	33255392	33257078	CpG: 181	1686	181	1108	21.5	65.7	1.03
chr16	33358868	33359234	CpG: 38	366	38	261	20.8	71.3	0.84
chr16	33383052	33383330	CpG: 22	278	22	170	15.8	61.2	0.86
chr16	33398169	33400067	CpG: 207	1898	207	1429	21.8	75.3	0.77
chr16	33437716	33438752	CpG: 121	1036	121	720	23.4	69.5	0.98
chr16	33472406	33473538	CpG: 135	1132	135	784	23.9	69.3	1.02
chr16	33494364	33494600	CpG: 20	236	20	144	16.9	61.0	0.94
chr16	33543146	33543605	CpG: 58	459	58	346	25.3	75.4	0.95
chr16	33557462	33558201	CpG: 73	739	73	532	19.8	72.0	0.76
chr16	33579512	33579795	CpG: 22	283	22	171	15.5	60.4	0.86
chr16	33596490	33596743	CpG: 19	253	19	166	15.0	65.6	0.70
chr16	33608424	33609337	CpG: 65	913	65	573	14.2	62.8	0.76
chr16	33633306	33634267	CpG: 95	961	95	669	19.8	69.6	0.82
chr16	33672591	33673114	CpG: 39	523	39	350	14.9	66.9	0.67
chr16	33692914	33693879	CpG: 103	965	103	679	21.3	70.4	0.88
chr16	33731069	33731957	CpG: 107	888	107	659	24.1	74.2	0.91
chr16	33748214	33748448	CpG: 24	234	24	159	20.5	67.9	0.89
chr16	33857606	33858099	CpG: 46	493	46	344	18.7	69.8	0.78
chr16	33883789	33884273	CpG: 51	484	51	322	21.1	66.5	0.95
chr16	33944921	33945957	CpG: 132	1036	132	750	25.5	72.4	0.97
chr16	33999548	33999776	CpG: 20	228	20	157	17.5	68.9	0.75
chr16	34035992	34036273	CpG: 23	281	23	175	16.4	62.3	0.86
chr16	34101017	34101383	CpG: 41	366	41	263	22.4	71.9	0.89
chr16	34142233	34144126	CpG: 204	1893	204	1422	21.6	75.1	0.76
chr16	34181778	34182792	CpG: 118	1014	118	703	23.3	69.3	0.98
chr16	34216462	34217662	CpG: 142	1200	142	838	23.7	69.8	1.01
chr16	34238480	34238754	CpG: 23	274	23	170	16.8	62.0	0.88
chr16	34289183	34289641	CpG: 60	458	60	345	26.2	75.3	0.98
chr16	34303505	34304244	CpG: 75	739	75	532	20.3	72.0	0.78
chr16	34325558	34325846	CpG: 22	288	22	177	15.3	61.5	0.82
chr16	34342503	34342757	CpG: 19	254	19	167	15.0	65.7	0.70
chr16	34354462	34355375	CpG: 65	913	65	573	14.2	62.8	0.76
chr16	34370843	34371119	CpG: 19	276	19	166	13.8	60.1	0.78
chr16	34379695	34380634	CpG: 91	939	91	655	19.4	69.8	0.80
chr16	34580558	34580847	CpG: 37	289	37	197	25.6	68.2	1.20
chr16	34596893	34597573	CpG: 47	680	47	411	13.8	60.4	0.76
chr16	34599523	34599777	CpG: 19	254	19	157	15.0	61.8	0.80
chr16	34681017	34681290	CpG: 21	273	21	165	15.4	60.4	0.85
chr16	34713898	34714912	CpG: 116	1014	116	742	22.9	73.2	0.88
chr16	34752238	34753035	CpG: 101	797	101	578	25.3	72.5	0.99
chr16	34772894	34773417	CpG: 35	523	35	346	13.4	66.2	0.61
chr16	34867009	34868023	CpG: 116	1014	116	741	22.9	73.1	0.88
chr16	35005955	35006191	CpG: 19	236	19	145	16.1	61.4	0.88
chr16	35024750	35025640	CpG: 118	890	118	671	26.5	75.4	0.93
chr16	35068102	35068625	CpG: 39	523	39	349	14.9	66.7	0.67
chr16	35088381	35089367	CpG: 112	986	112	700	22.7	71.0	0.92
chr16	35126557	35127445	CpG: 107	888	107	659	24.1	74.2	0.91
chr16	35143701	35143935	CpG: 24	234	24	159	20.5	67.9	0.89
chr16	35252886	35253364	CpG: 41	478	41	330	17.2	69.0	0.73
chr16	35255655	35255933	CpG: 24	278	24	174	17.3	62.6	0.89
chr16	35279382	35279873	CpG: 49	491	49	327	20.0	66.6	0.90
chr16	35342564	35343684	CpG: 146	1120	146	812	26.1	72.5	1.00
chr16	35500406	35500772	CpG: 38	366	38	261	20.8	71.3	0.84
chr16	35530561	35530987	CpG: 32	426	32	255	15.0	59.9	0.84
chr16	35547439	35549333	CpG: 205	1894	205	1424	21.6	75.2	0.76
chr16	35586985	35587903	CpG: 110	918	110	639	24.0	69.6	1.00
chr16	35622487	35623615	CpG: 119	1128	119	737	21.1	65.3	1.01
chr16	35711700	35711981	CpG: 20	281	20	182	14.2	64.8	0.70
chr16	35713760	35714655	CpG: 64	895	64	578	14.3	64.6	0.69
chr16	35717910	35718181	CpG: 24	271	24	160	17.7	59.0	1.02
chr16	35718514	35718718	CpG: 20	204	20	137	19.6	67.2	0.92
chr16	35731204	35731613	CpG: 27	409	27	236	13.2	57.7	0.79
chr16	35736540	35741726	CpG: 443	5186	443	3350	17.1	64.6	0.82
chr16	35775200	35775481	CpG: 23	281	23	173	16.4	61.6	0.88
chr16	37852119	37852411	CpG: 23	292	23	174	15.8	59.6	0.89
chr16	38006788	38007018	CpG: 21	230	21	140	18.3	60.9	1.03
chr16	38016258	38017842	CpG: 162	1584	162	1026	20.5	64.8	1.00
chr16	38535380	38535654	CpG: 24	274	24	171	17.5	62.4	0.91
chr16	38553079	38554498	CpG: 95	1419	95	938	13.4	66.1	0.63
chr16	38575317	38575890	CpG: 45	573	45	342	15.7	59.7	0.88
chr16	38585121	38585391	CpG: 23	270	23	183	17.0	67.8	0.77
chr16	38621806	38622488	CpG: 47	682	47	431	13.8	63.2	0.71
chr16	38703239	38703702	CpG: 39	463	39	300	16.8	64.8	0.80
chr16	38776187	38776594	CpG: 38	407	38	272	18.7	66.8	0.84
chr16	38778682	38778965	CpG: 22	283	22	172	15.5	60.8	0.85
chr16	38800951	38801224	CpG: 23	273	23	173	16.8	63.4	0.85
chr16	38920956	38921544	CpG: 44	588	44	372	15.0	63.3	0.76
chr16	38932326	38932555	CpG: 19	229	19	137	16.6	59.8	0.94
chr16	38955408	38955691	CpG: 27	283	27	199	19.1	70.3	0.78
chr16	38958543	38958812	CpG: 40	269	40	206	29.7	76.6	1.11
chr16	38982886	38983142	CpG: 19	256	19	156	14.8	60.9	0.81
chr16	38984992	38985515	CpG: 38	523	38	308	14.5	58.9	0.84
chr16	38988032	38988283	CpG: 21	251	21	159	16.7	63.3	0.86
chr16	38994769	38995043	CpG: 24	274	24	170	17.5	62.0	0.92
chr16	39067176	39067799	CpG: 49	623	49	415	15.7	66.6	0.71
chr16	39105536	39106538	CpG: 93	1002	93	725	18.6	72.4	0.72
chr16	39148911	39149299	CpG: 33	388	33	251	17.0	64.7	0.81
chr16	39154046	39155094	CpG: 100	1048	100	756	19.1	72.1	0.73
chr16	39198327	39198601	CpG: 24	274	24	170	17.5	62.0	0.92
chr16	39280161	39281779	CpG: 104	1618	104	956	12.9	59.1	0.78
chr16	39301955	39302229	CpG: 23	274	23	170	16.8	62.0	0.88
chr16	39324888	39327062	CpG: 278	2174	278	1509	25.6	69.4	1.12
chr16	52224246	52225762	CpG: 124	1516	124	926	16.4	61.1	0.93
chr16	52353940	52354172	CpG: 19	232	19	142	16.4	61.2	0.89
chr16	52417940	52418312	CpG: 43	372	43	263	23.1	70.7	0.95
chr16	52450136	52450879	CpG: 61	743	61	519	16.4	69.9	0.67
chr16	52485526	52487238	CpG: 140	1712	140	1108	16.4	64.7	0.78
chr16	52586814	52587246	CpG: 39	432	39	319	18.1	73.8	0.67
chr16	52589677	52589920	CpG: 17	243	17	145	14.0	59.7	0.81
chr16	52627436	52628544	CpG: 137	1108	137	818	24.7	73.8	0.91
chr16	52632719	52632941	CpG: 18	222	18	135	16.2	60.8	0.89
chr16	52640784	52641550	CpG: 76	766	76	521	19.8	68.0	0.86
chr16	52680749	52681930	CpG: 130	1181	130	849	22.0	71.9	0.86
chr16	52691573	52691851	CpG: 19	278	19	170	13.7	61.2	0.74
chr16	52769735	52770937	CpG: 135	1202	135	835	22.5	69.5	0.93
chr16	52810690	52811041	CpG: 28	351	28	245	16.0	69.8	0.66
chr16	52834285	52835068	CpG: 82	783	82	557	20.9	71.1	0.84
chr16	52876141	52876415	CpG: 21	274	21	166	15.3	60.6	0.85
chr16	52939705	52941368	CpG: 242	1663	242	1266	29.1	76.1	1.01
chr16	52979747	52979984	CpG: 22	237	22	143	18.6	60.3	1.02
chr16	53257604	53258314	CpG: 79	710	79	501	22.3	70.6	0.89
chr16	53269327	53269587	CpG: 19	260	19	153	14.6	58.8	0.86
chr16	53817920	53818279	CpG: 27	359	27	213	15.0	59.3	0.86
chr16	53854742	53854978	CpG: 21	236	21	146	17.8	61.9	0.94
chr16	53856231	53856434	CpG: 17	203	17	146	16.7	71.9	0.65
chr16	53866394	53866667	CpG: 21	273	21	171	15.4	62.6	0.79
chr16	54026287	54026572	CpG: 20	285	20	175	14.0	61.4	0.76
chr16	54040955	54041552	CpG: 60	597	60	416	20.1	69.7	0.83
chr16	54163078	54163555	CpG: 41	477	41	308	17.2	64.6	0.82
chr16	54181789	54183263	CpG: 207	1474	207	1138	28.1	77.2	0.95
chr16	54213920	54214648	CpG: 56	728	56	487	15.4	66.9	0.69
chr16	54263439	54263713	CpG: 24	274	24	171	17.5	62.4	0.91
chr16	54294276	54294575	CpG: 29	299	29	210	19.4	70.2	0.79
chr16	54407058	54407987	CpG: 118	929	118	674	25.4	72.6	0.97
chr16	54429129	54429403	CpG: 24	274	24	171	17.5	62.4	0.91
chr16	54571920	54572136	CpG: 17	216	17	126	15.7	58.3	0.93
chr16	54580684	54580959	CpG: 24	275	24	170	17.5	61.8	0.92
chr16	54608330	54609043	CpG: 87	713	87	531	24.4	74.5	0.88
chr16	54749114	54750061	CpG: 74	947	74	680	15.6	71.8	0.61
chr16	54902136	54902371	CpG: 20	235	20	143	17.0	60.9	0.94
chr16	55022209	55022445	CpG: 19	236	19	143	16.1	60.6	0.90
chr16	55072982	55073212	CpG: 24	230	24	164	20.9	71.3	0.82
chr16	55075272	55076167	CpG: 61	895	61	504	13.6	56.3	0.86
chr16	55077896	55081122	CpG: 310	3226	310	2165	19.2	67.1	0.86
chr16	55204818	55205146	CpG: 26	328	26	169	15.9	51.5	1.23
chr16	55262740	55263256	CpG: 39	516	39	361	15.1	70.0	0.64
chr16	55290160	55290576	CpG: 45	416	45	314	21.6	75.5	0.76
chr16	55398329	55398540	CpG: 18	211	18	131	17.1	62.1	0.91
chr16	55433302	55434169	CpG: 59	867	59	550	13.6	63.4	0.68
chr16	55436174	55436456	CpG: 22	282	22	172	15.6	61.0	0.84
chr16	55450200	55450421	CpG: 15	221	15	127	13.6	57.5	0.83
chr16	55496135	55496499	CpG: 28	364	28	245	15.4	67.3	0.71
chr16	55636151	55636712	CpG: 63	561	63	429	22.5	76.5	0.77
chr16	55652265	55657152	CpG: 489	4887	489	3470	20.0	71.0	0.79
chr16	55666072	55666289	CpG: 22	217	22	162	20.3	74.7	0.73
chr16	55674032	55674686	CpG: 57	654	57	477	17.4	72.9	0.69
chr16	55743264	55743538	CpG: 24	274	24	170	17.5	62.0	0.92
chr16	55822684	55823257	CpG: 62	573	62	401	21.6	70.0	0.92
chr16	55863547	55864365	CpG: 102	818	102	592	24.9	72.4	0.96
chr16	55950481	55952233	CpG: 216	1752	216	1298	24.7	74.1	0.90
chr16	55982232	55982501	CpG: 22	269	22	168	16.4	62.5	0.86
chr16	56043636	56044513	CpG: 97	877	97	679	22.1	77.4	0.74
chr16	56166177	56167007	CpG: 121	830	121	652	29.2	78.6	0.95
chr16	56265824	56266324	CpG: 56	500	56	381	22.4	76.2	0.77
chr16	56293937	56294299	CpG: 27	362	27	219	14.9	60.5	0.82
chr16	56345316	56347307	CpG: 201	1991	201	1420	20.2	71.3	0.81
chr16	56376917	56377396	CpG: 40	479	40	292	16.7	61.0	1.09
chr16	56449057	56449338	CpG: 23	281	23	174	16.4	61.9	0.87
chr16	56470995	56471745	CpG: 74	750	74	513	19.7	68.4	0.84
chr16	56491095	56491365	CpG: 36	270	36	220	26.7	81.5	0.85
chr16	56539356	56540360	CpG: 119	1004	119	743	23.7	74.0	0.87
chr16	56638838	56639097	CpG: 28	259	28	164	21.6	63.3	1.08
chr16	56725287	56725573	CpG: 24	286	24	177	16.8	61.9	0.89
chr16	56911438	56911892	CpG: 40	454	40	266	17.6	58.6	1.03
chr16	56914689	56914925	CpG: 17	236	17	142	14.4	60.2	0.81
chr16	56932213	56933057	CpG: 77	844	77	582	18.2	69.0	0.77
chr16	56947662	56954220	CpG: 499	6558	499	4059	15.2	61.9	0.79
chr16	57010452	57010730	CpG: 25	278	25	175	18.0	62.9	0.92
chr16	57416791	57417066	CpG: 23	275	23	170	16.7	61.8	0.89
chr16	57434212	57434448	CpG: 20	236	20	144	16.9	61.0	0.93
chr16	57502223	57502505	CpG: 25	282	25	173	17.7	61.3	0.95
chr16	57768267	57768547	CpG: 22	280	22	173	15.7	61.8	0.84
chr16	57772400	57772637	CpG: 18	237	18	141	15.2	59.5	0.88
chr16	58178803	58179077	CpG: 24	274	24	169	17.5	61.7	0.93
chr16	58343606	58345580	CpG: 196	1974	196	1407	19.9	71.3	0.78
chr16	58443915	58444152	CpG: 20	237	20	142	16.9	59.9	0.97
chr16	58852563	58853126	CpG: 54	563	54	399	19.2	70.9	0.76
chr16	58907461	58907727	CpG: 19	266	19	159	14.3	59.8	0.82
chr16	58927839	58929697	CpG: 245	1858	245	1421	26.4	76.5	0.90
chr16	59171243	59171725	CpG: 40	482	40	311	16.6	64.5	0.80
chr16	59219166	59219388	CpG: 21	222	21	165	18.9	74.3	0.69
chr16	59232180	59233105	CpG: 106	925	106	627	22.9	67.8	1.00
chr16	59300392	59301571	CpG: 113	1179	113	843	19.2	71.5	0.75
chr16	59336508	59337450	CpG: 69	942	69	652	14.6	69.2	0.61
chr16	59501538	59502156	CpG: 51	618	51	393	16.5	63.6	0.82
chr16	59547282	59547558	CpG: 23	276	23	170	16.7	61.6	0.89
chr16	59581147	59581368	CpG: 19	221	19	133	17.2	60.2	0.97
chr16	59589548	59589836	CpG: 24	288	24	174	16.7	60.4	0.92
chr16	59638811	59639094	CpG: 23	283	23	174	16.3	61.5	0.87
chr16	59840255	59840547	CpG: 22	292	22	175	15.1	59.9	0.84
chr16	59920050	59920277	CpG: 21	227	21	165	18.5	72.7	0.70
chr16	59992328	59992583	CpG: 19	255	19	174	14.9	68.2	0.64
chr16	59993162	59993439	CpG: 20	277	20	167	14.4	60.3	0.80
chr16	60079683	60088684	CpG: 699	9001	699	5644	15.5	62.7	0.79
chr16	60089120	60089783	CpG: 51	663	51	414	15.4	62.4	0.79
chr16	60194343	60194580	CpG: 20	237	20	142	16.9	59.9	0.97
chr16	60206126	60206405	CpG: 22	279	22	169	15.8	60.6	0.87
chr16	60218214	60218488	CpG: 24	274	24	170	17.5	62.0	0.92
chr16	60342124	60342398	CpG: 23	274	23	170	16.8	62.0	0.88
chr16	60365204	60365478	CpG: 24	274	24	170	17.5	62.0	0.92
chr16	60424481	60424755	CpG: 23	274	23	170	16.8	62.0	0.88
chr16	60500601	60500837	CpG: 21	236	21	146	17.8	61.9	0.95
chr16	60667748	60668024	CpG: 23	276	23	170	16.7	61.6	0.89
chr16	60726482	60732006	CpG: 541	5524	541	3690	19.6	66.8	0.88
chr16	60734502	60737047	CpG: 179	2545	179	1550	14.1	60.9	0.76
chr16	60817108	60817314	CpG: 16	206	16	128	15.5	62.1	0.80
chr16	60854830	60855160	CpG: 42	330	42	218	25.5	66.1	1.18
chr16	60979746	60980015	CpG: 22	269	22	166	16.4	61.7	0.86
chr16	61121768	61123287	CpG: 125	1519	125	1041	16.5	68.5	0.70
chr16	61127007	61127557	CpG: 43	550	43	355	15.6	64.5	0.75
chr16	61129094	61129754	CpG: 45	660	45	407	13.6	61.7	0.74
chr16	61130032	61130293	CpG: 21	261	21	152	16.1	58.2	0.99
chr16	61277072	61277740	CpG: 68	668	68	478	20.4	71.6	0.80
chr16	61307131	61307485	CpG: 42	354	42	248	23.7	70.1	0.97
chr16	61453821	61455118	CpG: 126	1297	126	882	19.4	68.0	0.84
chr16	61559023	61559376	CpG: 25	353	25	211	14.2	59.8	0.79
chr16	61627556	61628159	CpG: 41	603	41	371	13.6	61.5	0.72
chr16	61784259	61784557	CpG: 28	298	28	215	18.8	72.1	0.72
chr16	61985705	61987484	CpG: 190	1779	190	1254	21.4	70.5	0.87
chr16	62158950	62159152	CpG: 15	202	15	125	14.9	61.9	0.79
chr16	62161135	62161369	CpG: 18	234	18	143	15.4	61.1	0.85
chr16	62189522	62189803	CpG: 23	281	23	175	16.4	62.3	0.86
chr16	62219819	62220907	CpG: 145	1088	145	866	26.7	79.6	0.85
chr16	62246027	62246936	CpG: 71	909	71	573	15.6	63.0	0.81
chr16	62314691	62315237	CpG: 60	546	60	392	22.0	71.8	0.87
chr16	62326832	62327061	CpG: 20	229	20	138	17.5	60.3	0.98
chr16	62384087	62384967	CpG: 87	880	87	602	19.8	68.4	0.85
chr16	62403182	62403648	CpG: 54	466	54	329	23.2	70.6	0.94
chr16	62412030	62412433	CpG: 41	403	41	280	20.3	69.5	0.85
chr16	62420160	62420713	CpG: 57	553	57	383	20.6	69.3	0.87
chr16	62427012	62427708	CpG: 68	696	68	484	19.5	69.5	0.82
chr16	62430104	62430794	CpG: 70	690	70	478	20.3	69.3	0.85
chr16	62433004	62433598	CpG: 59	594	59	396	19.9	66.7	0.92
chr16	62438188	62438666	CpG: 38	478	38	324	15.9	67.8	0.69
chr16	62452596	62453088	CpG: 40	492	40	340	16.3	69.1	0.68
chr16	62457952	62458353	CpG: 38	401	38	271	19.0	67.6	0.83
chr16	62462928	62463273	CpG: 33	345	33	242	19.1	70.1	0.78
chr16	62464452	62464713	CpG: 27	261	27	186	20.7	71.3	0.82
chr16	62470742	62471018	CpG: 26	276	26	197	18.8	71.4	0.75
chr16	62477057	62477496	CpG: 36	439	36	289	16.4	65.8	0.76
chr16	62524870	62525523	CpG: 61	653	61	449	18.7	68.8	0.81
chr16	62684936	62685172	CpG: 18	236	18	142	15.3	60.2	0.87
chr16	62728153	62728895	CpG: 85	742	85	540	22.9	72.8	0.87
chr16	62785590	62786168	CpG: 54	578	54	404	18.7	69.9	0.79
chr16	62888402	62889468	CpG: 143	1066	143	836	26.8	78.4	0.87
chr16	62981845	62982942	CpG: 91	1097	91	697	16.6	63.5	0.82
chr16	63040835	63041777	CpG: 95	942	95	654	20.2	69.4	0.84
chr16	63080026	63081040	CpG: 120	1014	120	730	23.7	72.0	0.91
chr16	63090408	63090611	CpG: 17	203	17	113	16.7	55.7	1.12
chr16	63095818	63096049	CpG: 19	231	19	132	16.5	57.1	1.01
chr16	63096467	63096757	CpG: 23	290	23	177	15.9	61.0	0.85
chr16	63177183	63177547	CpG: 26	364	26	241	14.3	66.2	0.65
chr16	63211836	63212045	CpG: 17	209	17	142	16.3	67.9	0.71
chr16	63242198	63242930	CpG: 74	732	74	516	20.2	70.5	0.83
chr16	63257741	63258303	CpG: 53	562	53	378	18.9	67.3	0.84
chr16	63277096	63277370	CpG: 20	274	20	167	14.6	60.9	0.80
chr16	63281448	63281854	CpG: 56	406	56	324	27.6	79.8	0.87
chr16	63288459	63288747	CpG: 20	288	20	159	13.9	55.2	0.93
chr16	63323737	63324611	CpG: 127	874	127	660	29.1	75.5	1.02
chr16	63331130	63332388	CpG: 128	1258	128	899	20.3	71.5	0.80
chr16	63445968	63446204	CpG: 19	236	19	143	16.1	60.6	0.90
chr16	63521285	63521537	CpG: 26	252	26	168	20.6	66.7	0.94
chr16	63530111	63530394	CpG: 21	283	21	179	14.8	63.3	0.75
chr16	63530890	63531267	CpG: 30	377	30	271	15.9	71.9	0.69
chr16	63555953	63556305	CpG: 29	352	29	243	16.5	69.0	0.69
chr16	63597225	63598259	CpG: 112	1034	112	721	21.7	69.7	0.93
chr16	63679214	63679684	CpG: 44	470	44	333	18.7	70.9	0.75
chr16	63698960	63699189	CpG: 16	229	16	142	14.0	62.0	0.74
chr16	63779786	63780856	CpG: 93	1070	93	739	17.4	69.1	0.74
chr16	63781048	63781397	CpG: 25	349	25	236	14.3	67.6	0.63
chr16	63791595	63793014	CpG: 119	1419	119	931	16.8	65.6	0.78
chr16	63795332	63796933	CpG: 175	1601	175	1185	21.9	74.0	0.81
chr16	63820084	63822849	CpG: 271	2765	271	1927	19.6	69.7	0.81
chr16	63835186	63835399	CpG: 18	213	18	142	16.9	66.7	0.76
chr16	63840320	63840702	CpG: 32	382	32	265	16.8	69.4	0.71
chr16	63924504	63925432	CpG: 85	928	85	600	18.3	64.7	0.88
chr16	63992987	63994040	CpG: 148	1053	148	829	28.1	78.7	0.92
chr16	64045397	64045778	CpG: 41	381	41	273	21.5	71.7	0.84
chr16	64067364	64067602	CpG: 16	238	16	141	13.4	59.2	0.80
chr16	64131126	64131359	CpG: 17	233	17	135	14.6	57.9	0.88
chr16	64187524	64188206	CpG: 64	682	64	431	18.8	63.2	0.94
chr16	64203313	64203549	CpG: 18	236	18	145	15.3	61.4	0.84
chr16	64258366	64259928	CpG: 204	1562	204	1179	26.1	75.5	0.92
chr16	64282906	64283178	CpG: 28	272	28	194	20.6	71.3	0.82
chr16	64296369	64296925	CpG: 41	556	41	372	14.7	66.9	0.66
chr16	64310356	64311568	CpG: 134	1212	134	865	22.1	71.4	0.87
chr16	64421589	64422662	CpG: 85	1073	85	689	15.8	64.2	0.80
chr16	64423434	64424008	CpG: 41	574	41	333	14.3	58.0	0.86
chr16	64476912	64477306	CpG: 32	394	32	272	16.2	69.0	0.69
chr16	64503109	64503345	CpG: 18	236	18	129	15.3	54.7	1.02
chr16	64526051	64526932	CpG: 82	881	82	620	18.6	70.4	0.76
chr16	64541187	64541641	CpG: 44	454	44	339	19.4	74.7	0.70
chr16	64583221	64583469	CpG: 21	248	21	176	16.9	71.0	0.67
chr16	64638324	64639194	CpG: 66	870	66	605	15.2	69.5	0.63
chr16	64657246	64657514	CpG: 22	268	22	168	16.4	62.7	0.85
chr16	65081966	65082202	CpG: 21	236	21	144	17.8	61.0	0.98
chr16	65260538	65260766	CpG: 21	228	21	142	18.4	62.3	0.98
chr16	65357060	65357287	CpG: 17	227	17	132	15.0	58.1	0.89
chr16	65547113	65547393	CpG: 19	280	19	168	13.6	60.0	0.75
chr16	65790047	65790326	CpG: 24	279	24	175	17.2	62.7	0.89
chr16	66053532	66053746	CpG: 17	214	17	129	15.9	60.3	0.89
chr16	66248511	66248751	CpG: 22	240	22	148	18.3	61.7	0.99
chr16	66314480	66314796	CpG: 24	316	24	190	15.2	60.1	0.86
chr16	66490131	66490417	CpG: 22	286	22	177	15.4	61.9	0.82
chr16	66806480	66806777	CpG: 23	297	23	177	15.5	59.6	0.89
chr16	66846167	66846450	CpG: 24	283	24	176	17.0	62.2	0.89
chr16	66916891	66917442	CpG: 50	551	50	405	18.1	73.5	0.68
chr16	66956146	66956424	CpG: 25	278	25	175	18.0	62.9	0.92
chr16	67009697	67009936	CpG: 21	239	21	149	17.6	62.3	0.92
chr16	67064842	67065127	CpG: 26	285	26	179	18.2	62.8	0.94
chr16	67082630	67082905	CpG: 20	275	20	166	14.5	60.4	0.82
chr16	67110671	67110945	CpG: 24	274	24	172	17.5	62.8	0.90
chr16	67255091	67255368	CpG: 22	277	22	169	15.9	61.0	0.86
chr16	67279563	67279789	CpG: 19	226	19	143	16.8	63.3	0.86
chr16	67299753	67300034	CpG: 23	281	23	173	16.4	61.6	0.88
chr16	67494393	67494643	CpG: 25	250	25	155	20.0	62.0	1.06
chr16	67570156	67570515	CpG: 29	359	29	214	16.2	59.6	0.91
chr16	67589533	67589960	CpG: 30	427	30	256	14.1	60.0	0.79
chr16	67706376	67706728	CpG: 26	352	26	206	14.8	58.5	0.87
chr16	67770352	67770618	CpG: 24	266	24	164	18.0	61.7	0.96
chr16	67790884	67791117	CpG: 16	233	16	133	13.7	57.1	0.86
chr16	67822984	67824497	CpG: 121	1513	121	968	16.0	64.0	0.78
chr16	67885973	67886210	CpG: 17	237	17	142	14.3	59.9	0.83
chr16	68008652	68009198	CpG: 37	546	37	322	13.6	59.0	0.78
chr16	68136735	68136979	CpG: 19	244	19	147	15.6	60.2	0.87
chr16	68173251	68173547	CpG: 27	296	27	180	18.2	60.8	1.00
chr16	68196659	68196872	CpG: 18	213	18	136	16.9	63.8	0.83
chr16	68372200	68372437	CpG: 18	237	18	141	15.2	59.5	0.87
chr16	68512523	68513030	CpG: 46	507	46	374	18.1	73.8	0.67
chr16	68524134	68524370	CpG: 18	236	18	144	15.3	61.0	0.84
chr16	68532633	68532906	CpG: 21	273	21	170	15.4	62.3	0.81
chr16	68692413	68692653	CpG: 21	240	21	148	17.5	61.7	0.94
chr16	68743793	68744144	CpG: 23	351	23	194	13.1	55.3	0.86
chr16	68745839	68746097	CpG: 19	258	19	161	14.7	62.4	0.77
chr16	68908027	68908275	CpG: 21	248	21	151	16.9	60.9	0.91
chr16	68917209	68917951	CpG: 54	742	54	498	14.6	67.1	0.65
chr16	69176166	69176510	CpG: 25	344	25	203	14.5	59.0	0.84
chr16	69196613	69196887	CpG: 26	274	26	171	19.0	62.4	0.98
chr16	69405214	69405609	CpG: 45	395	45	297	22.8	75.2	0.82
chr16	69481314	69481598	CpG: 26	284	26	179	18.3	63.0	0.93
chr16	69534261	69534491	CpG: 19	230	19	139	16.5	60.4	0.92
chr16	69559446	69559720	CpG: 23	274	23	169	16.8	61.7	0.89
chr16	69571634	69571864	CpG: 20	230	20	140	17.4	60.9	0.95
chr16	69586924	69587159	CpG: 20	235	20	142	17.0	60.4	0.95
chr16	69648643	69648919	CpG: 20	276	20	166	14.5	60.1	0.81
chr16	69662308	69662532	CpG: 17	224	17	133	15.2	59.4	0.86
chr16	69763106	69763346	CpG: 18	240	18	145	15.0	60.4	0.85
chr16	69790103	69790343	CpG: 19	240	19	143	15.8	59.6	0.90
chr16	70031955	70032190	CpG: 19	235	19	141	16.2	60.0	0.91
chr16	70132248	70132788	CpG: 51	540	51	395	18.9	73.1	0.71
chr16	70596101	70596345	CpG: 18	244	18	146	14.8	59.8	0.84
chr16	70739355	70739582	CpG: 19	227	19	142	16.7	62.6	0.86
chr16	70909388	70912396	CpG: 239	3008	239	2015	15.9	67.0	0.71
chr16	71242488	71242762	CpG: 23	274	23	169	16.8	61.7	0.89
chr16	71280461	71280742	CpG: 23	281	23	175	16.4	62.3	0.86
chr16	71281226	71281455	CpG: 18	229	18	139	15.7	60.7	0.89
chr16	71457205	71457478	CpG: 21	273	21	168	15.4	61.5	0.82
chr16	71484334	71484693	CpG: 25	359	25	212	13.9	59.1	0.80
chr16	71752992	71753228	CpG: 22	236	22	144	18.6	61.0	1.02
chr16	72064797	72065143	CpG: 40	346	40	263	23.1	76.0	0.80
chr16	72196875	72197377	CpG: 58	502	58	344	23.1	68.5	0.98
chr16	72200802	72201258	CpG: 30	456	30	291	13.2	63.8	0.65
chr16	72220804	72222527	CpG: 196	1723	196	1265	22.8	73.4	0.84
chr16	72270104	72270336	CpG: 17	232	17	142	14.7	61.2	0.81
chr16	72298774	72299011	CpG: 21	237	21	145	17.7	61.2	0.97
chr16	72343628	72344527	CpG: 90	899	90	621	20.0	69.1	0.84
chr16	72346660	72347111	CpG: 47	451	47	287	20.8	63.6	1.05
chr16	72360416	72361011	CpG: 46	595	46	384	15.5	64.5	0.75
chr16	72373141	72373804	CpG: 70	663	70	439	21.1	66.2	0.97
chr16	72398422	72399953	CpG: 166	1531	166	1138	21.7	74.3	0.80
chr16	72424777	72425668	CpG: 70	891	70	635	15.7	71.3	0.62
chr16	72490216	72491653	CpG: 170	1437	170	1082	23.7	75.3	0.84
chr16	72545427	72546262	CpG: 110	835	110	641	26.3	76.8	0.90
chr16	72560177	72560462	CpG: 25	285	25	179	17.5	62.8	0.90
chr16	72583592	72583870	CpG: 25	278	25	175	18.0	62.9	0.92
chr16	72595662	72596181	CpG: 48	519	48	326	18.5	62.8	0.94
chr16	72607058	72607278	CpG: 16	220	16	135	14.5	61.4	0.79
chr16	72624798	72625382	CpG: 78	584	78	441	26.7	75.5	0.95
chr16	72638564	72639464	CpG: 95	900	95	663	21.1	73.7	0.78
chr16	72667429	72667684	CpG: 25	255	25	178	19.6	69.8	0.81
chr16	72673292	72673566	CpG: 24	274	24	172	17.5	62.8	0.90
chr16	72674572	72675584	CpG: 79	1012	79	683	15.6	67.5	0.69
chr16	72716340	72716648	CpG: 27	308	27	186	17.5	60.4	0.96
chr16	72719130	72720052	CpG: 101	922	101	673	21.9	73.0	0.84
chr16	72728426	72729321	CpG: 91	895	91	597	20.3	66.7	0.92
chr16	72729896	72730275	CpG: 32	379	32	262	16.9	69.1	0.72
chr16	72742176	72743342	CpG: 78	1166	78	738	13.4	63.3	0.67
chr16	72794766	72795730	CpG: 93	964	93	672	19.3	69.7	0.80
chr16	72807995	72808860	CpG: 83	865	83	625	19.2	72.3	0.74
chr16	72823003	72824402	CpG: 196	1399	196	1011	28.0	72.3	1.11
chr16	72901138	72901424	CpG: 21	286	21	177	14.7	61.9	0.77
chr16	72903671	72904724	CpG: 86	1053	86	686	16.3	65.1	0.77
chr16	72943597	72945357	CpG: 195	1760	195	1237	22.2	70.3	0.90
chr16	72949002	72950041	CpG: 117	1039	117	742	22.5	71.4	0.89
chr16	72953394	72953608	CpG: 16	214	16	135	15.0	63.1	0.75
chr16	72953935	72954960	CpG: 86	1025	86	656	16.8	64.0	0.82
chr16	72955255	72955562	CpG: 22	307	22	190	14.3	61.9	0.75
chr16	72955989	72956216	CpG: 17	227	17	158	15.0	69.6	0.62
chr16	72957181	72960378	CpG: 298	3197	298	2184	18.6	68.3	0.80
chr16	72964598	72965027	CpG: 37	429	37	315	17.2	73.4	0.64
chr16	72968458	72969302	CpG: 76	844	76	583	18.0	69.1	0.76
chr16	72972314	72972890	CpG: 66	576	66	414	22.9	71.9	0.89
chr16	72978097	72979600	CpG: 159	1503	159	1054	21.2	70.1	0.86
chr16	72986367	72986860	CpG: 48	493	48	348	19.5	70.6	0.79
chr16	72993294	72994407	CpG: 82	1113	82	778	14.7	69.9	0.62
chr16	73021125	73021536	CpG: 34	411	34	267	16.5	65.0	0.79
chr16	73031240	73031676	CpG: 37	436	37	282	17.0	64.7	0.81
chr16	73040405	73043534	CpG: 224	3129	224	2068	14.3	66.1	0.66
chr16	73073290	73074125	CpG: 113	835	113	645	27.1	77.2	0.91
chr16	73120945	73121244	CpG: 42	299	42	229	28.1	76.6	1.01
chr16	73121513	73121778	CpG: 18	265	18	159	13.6	60.0	0.77
chr16	73122535	73122768	CpG: 18	233	18	138	15.5	59.2	0.90
chr16	73150166	73150440	CpG: 22	274	22	169	16.1	61.7	0.85
chr16	73188152	73189818	CpG: 151	1666	151	1126	18.1	67.6	0.80
chr16	73193996	73194422	CpG: 40	426	40	297	18.8	69.7	0.77
chr16	73210803	73211345	CpG: 62	542	62	412	22.9	76.0	0.79
chr16	73225261	73226335	CpG: 133	1074	133	808	24.8	75.2	0.88
chr16	73267356	73267599	CpG: 16	243	16	141	13.2	58.0	0.80
chr16	73274683	73274966	CpG: 26	283	26	179	18.4	63.3	0.93
chr16	73275267	73276214	CpG: 78	947	78	610	16.5	64.4	0.79
chr16	73323440	73325197	CpG: 145	1757	145	1233	16.5	70.2	0.67
chr16	73331725	73331932	CpG: 16	207	16	120	15.5	58.0	0.92
chr16	73332116	73333592	CpG: 145	1476	145	1083	19.6	73.4	0.73
chr16	73356732	73358418	CpG: 227	1686	227	1270	26.9	75.3	0.95
chr16	73439458	73440062	CpG: 63	604	63	454	20.9	75.2	0.74
chr16	73442841	73444790	CpG: 146	1949	146	1312	15.0	67.3	0.67
chr16	73447484	73448540	CpG: 125	1056	125	822	23.7	77.8	0.78
chr16	73454316	73456425	CpG: 188	2109	188	1413	17.8	67.0	0.80
chr16	73460874	73462219	CpG: 125	1345	125	959	18.6	71.3	0.73
chr16	73507178	73507705	CpG: 41	527	41	348	15.6	66.0	0.71
chr16	73513715	73514312	CpG: 59	597	59	417	19.8	69.8	0.81
chr16	73594369	73594605	CpG: 18	236	18	141	15.3	59.7	0.87
chr16	73601395	73602226	CpG: 69	831	69	556	16.6	66.9	0.75
chr16	73602555	73602806	CpG: 16	251	16	140	12.7	55.8	0.85
chr16	73604653	73604928	CpG: 24	275	24	171	17.5	62.2	0.91
chr16	73612990	73613411	CpG: 36	421	36	244	17.1	58.0	1.03
chr16	73615747	73616034	CpG: 19	287	19	153	13.2	53.3	0.94
chr16	73629537	73629842	CpG: 35	305	35	204	23.0	66.9	1.03
chr16	73637588	73638955	CpG: 144	1367	144	932	21.1	68.2	0.91
chr16	73642549	73643387	CpG: 89	838	89	616	21.2	73.5	0.79
chr16	73668679	73669181	CpG: 65	502	65	368	25.9	73.3	0.99
chr16	73680549	73680779	CpG: 18	230	18	166	15.7	72.2	0.61
chr16	73688788	73689566	CpG: 92	778	92	547	23.7	70.3	0.96
chr16	73704838	73705143	CpG: 23	305	23	190	15.1	62.3	0.81
chr16	73731161	73732289	CpG: 93	1128	93	731	16.5	64.8	0.79
chr16	73734463	73734748	CpG: 25	285	25	181	17.5	63.5	0.89
chr16	73763786	73764909	CpG: 117	1123	117	798	20.8	71.1	0.82
chr16	73765277	73765629	CpG: 29	352	29	249	16.5	70.7	0.71
chr16	73775837	73776415	CpG: 62	578	62	411	21.5	71.1	0.85
chr16	73777913	73778433	CpG: 43	520	43	374	16.5	71.9	0.64
chr16	73788959	73789281	CpG: 33	322	33	235	20.5	73.0	0.78
chr16	73794009	73794398	CpG: 34	389	34	289	17.5	74.3	0.63
chr16	73818459	73819230	CpG: 89	771	89	514	23.1	66.7	1.05
chr16	73880414	73881837	CpG: 146	1423	146	961	20.5	67.5	0.91
chr16	73959060	73960035	CpG: 76	975	76	686	15.6	70.4	0.63
chr16	74030854	74033987	CpG: 267	3133	267	2080	17.0	66.4	0.77
chr16	74035389	74035928	CpG: 43	539	43	353	16.0	65.5	0.75
chr16	74040714	74041472	CpG: 73	758	73	522	19.3	68.9	0.82
chr16	74059862	74060829	CpG: 125	967	125	717	25.9	74.1	0.99
chr16	74106181	74107121	CpG: 88	940	88	633	18.7	67.3	0.83
chr16	74163254	74163501	CpG: 17	247	17	157	13.8	63.6	0.68
chr16	74166831	74168197	CpG: 88	1366	88	889	12.9	65.1	0.61
chr16	74205486	74205717	CpG: 18	231	18	136	15.6	58.9	0.92
chr16	74242783	74244741	CpG: 163	1958	163	1324	16.6	67.6	0.73
chr16	74305842	74306332	CpG: 44	490	44	308	18.0	62.9	0.91
chr16	74322423	74322927	CpG: 41	504	41	364	16.3	72.2	0.63
chr16	74325686	74326208	CpG: 48	522	48	354	18.4	67.8	0.80
chr16	74329052	74329275	CpG: 18	223	18	132	16.1	59.2	0.95
chr16	74334810	74335659	CpG: 81	849	81	597	19.1	70.3	0.78
chr16	74384895	74385187	CpG: 24	292	24	177	16.4	60.6	0.90
chr16	74431123	74431479	CpG: 24	356	24	201	13.5	56.5	0.88
chr16	74438837	74439230	CpG: 43	393	43	267	21.9	67.9	0.95
chr16	74440890	74442537	CpG: 123	1647	123	1080	14.9	65.6	0.69
chr16	74494371	74494619	CpG: 21	248	21	154	16.9	62.1	0.89
chr16	74500222	74500497	CpG: 22	275	22	168	16.0	61.1	0.87
chr16	74519990	74520322	CpG: 24	332	24	196	14.5	59.0	0.85
chr16	74533306	74534629	CpG: 116	1323	116	916	17.5	69.2	0.74
chr16	74614824	74615074	CpG: 22	250	22	148	17.6	59.2	1.02
chr16	74639718	74640177	CpG: 44	459	44	307	19.2	66.9	0.86
chr16	74662603	74662888	CpG: 23	285	23	177	16.1	62.1	0.85
chr16	74814516	74814753	CpG: 17	237	17	143	14.3	60.3	0.81
chr16	74859419	74859812	CpG: 28	393	28	232	14.2	59.0	0.82
chr16	74902035	74904307	CpG: 205	2272	205	1595	18.0	70.2	0.74
chr16	74905906	74906326	CpG: 33	420	33	278	15.7	66.2	0.72
chr16	74928328	74929312	CpG: 120	984	120	731	24.4	74.3	0.91
chr16	74942999	74943271	CpG: 19	272	19	158	14.0	58.1	0.84
chr16	74954265	74954502	CpG: 21	237	21	145	17.7	61.2	0.97
chr16	74983627	74984854	CpG: 134	1227	134	856	21.8	69.8	0.91
chr16	75052824	75053098	CpG: 23	274	23	169	16.8	61.7	0.89
chr16	75112810	75113756	CpG: 109	946	109	696	23.0	73.6	0.88
chr16	75122718	75123042	CpG: 25	324	25	189	15.4	58.3	0.92
chr16	75127123	75127384	CpG: 20	261	20	151	15.3	57.9	0.94
chr16	75131391	75132629	CpG: 151	1238	151	909	24.4	73.4	0.91
chr16	75140852	75141673	CpG: 92	821	92	540	22.4	65.8	1.04
chr16	75163708	75163946	CpG: 21	238	21	146	17.6	61.3	0.96
chr16	75187547	75188584	CpG: 105	1037	105	698	20.3	67.3	0.91
chr16	75226537	75226899	CpG: 26	362	26	203	14.4	56.1	0.96
chr16	75306659	75306920	CpG: 20	261	20	157	15.3	60.2	0.86
chr16	75332372	75332608	CpG: 18	236	18	141	15.3	59.7	0.87
chr16	75367738	75369037	CpG: 145	1299	145	970	22.3	74.7	0.81
chr16	75490099	75490382	CpG: 24	283	24	175	17.0	61.8	0.90
chr16	75525121	75525339	CpG: 19	218	19	133	17.4	61.0	0.95
chr16	75528549	75528762	CpG: 19	213	19	140	17.8	65.7	0.83
chr16	75544713	75545019	CpG: 24	306	24	186	15.7	60.8	0.85
chr16	75554316	75554559	CpG: 17	243	17	140	14.0	57.6	0.84
chr16	75557100	75557615	CpG: 51	515	51	346	19.8	67.2	0.89
chr16	75560546	75560906	CpG: 27	360	27	209	15.0	58.1	0.91
chr16	75564792	75565197	CpG: 60	405	60	324	29.6	80.0	0.97
chr16	75773953	75775306	CpG: 115	1353	115	921	17.0	68.1	0.73
chr16	75874830	75875087	CpG: 18	257	18	159	14.0	61.9	0.73
chr16	75875216	75876169	CpG: 96	953	96	669	20.1	70.2	0.82
chr16	75877855	75878120	CpG: 21	265	21	162	15.8	61.1	0.86
chr16	75888007	75888238	CpG: 16	231	16	140	13.9	60.6	0.78
chr16	75895736	75896017	CpG: 23	281	23	174	16.4	61.9	0.87
chr16	75907057	75907293	CpG: 21	236	21	145	17.8	61.4	0.96
chr16	75923494	75924587	CpG: 106	1093	106	736	19.4	67.3	0.86
chr16	75998483	75999836	CpG: 117	1353	117	925	17.3	68.4	0.74
chr16	76035742	76036351	CpG: 43	609	43	411	14.1	67.5	0.62
chr16	76061982	76063046	CpG: 153	1064	153	807	28.8	75.8	1.00
chr16	76097963	76098241	CpG: 25	278	25	174	18.0	62.6	0.93
chr16	76099114	76099399	CpG: 21	285	21	177	14.7	62.1	0.77
chr16	76099640	76099848	CpG: 19	208	19	126	18.3	60.6	1.00
chr16	76100213	76100795	CpG: 51	582	51	398	17.5	68.4	0.79
chr16	76104639	76104920	CpG: 22	281	22	173	15.7	61.6	0.84
chr16	76105154	76105394	CpG: 18	240	18	144	15.0	60.0	0.85
chr16	76157513	76158140	CpG: 54	627	54	360	17.2	57.4	1.07
chr16	76158794	76159034	CpG: 19	240	19	145	15.8	60.4	0.89
chr16	76191554	76192990	CpG: 117	1436	117	968	16.3	67.4	0.72
chr16	76249713	76250774	CpG: 120	1061	120	782	22.6	73.7	0.83
chr16	76261810	76262351	CpG: 48	541	48	390	17.7	72.1	0.68
chr16	76265483	76265939	CpG: 54	456	54	332	23.7	72.8	0.89
chr16	76284154	76284374	CpG: 20	220	20	165	18.2	75.0	0.65
chr16	76287095	76287330	CpG: 19	235	19	143	16.2	60.9	0.89
chr16	76310866	76311132	CpG: 19	266	19	161	14.3	60.5	0.79
chr16	76330319	76330601	CpG: 23	282	23	174	16.3	61.7	0.87
chr16	76334367	76334764	CpG: 30	397	30	239	15.1	60.2	0.87
chr16	76335754	76336019	CpG: 24	265	24	162	18.1	61.1	0.99
chr16	76398543	76398757	CpG: 16	214	16	124	15.0	57.9	0.91
chr16	76474849	76475638	CpG: 67	789	67	563	17.0	71.4	0.69
chr16	76490727	76491645	CpG: 91	918	91	668	19.8	72.8	0.75
chr16	76496382	76497709	CpG: 172	1327	172	989	25.9	74.5	0.95
chr16	76611958	76612567	CpG: 63	609	63	406	20.7	66.7	0.94
chr16	76941632	76941926	CpG: 25	294	25	181	17.0	61.6	0.91
chr16	76974337	76974553	CpG: 17	216	17	132	15.7	61.1	0.85
chr16	77035713	77035987	CpG: 24	274	24	171	17.5	62.4	0.91
chr16	77041587	77041886	CpG: 29	299	29	198	19.4	66.2	0.93
chr16	77100335	77100734	CpG: 45	399	45	285	22.6	71.4	0.89
chr16	77101607	77101842	CpG: 18	235	18	139	15.3	59.1	0.88
chr16	77174426	77174760	CpG: 44	334	44	251	26.3	75.1	0.93
chr16	77222716	77222990	CpG: 21	274	21	168	15.3	61.3	0.82
chr16	77243133	77243690	CpG: 50	557	50	396	18.0	71.1	0.74
chr16	77258566	77259271	CpG: 73	705	73	520	20.7	73.8	0.76
chr16	77279094	77279581	CpG: 41	487	41	330	16.8	67.8	0.74
chr16	77333560	77334052	CpG: 38	492	38	307	15.4	62.4	0.81
chr16	77382101	77382672	CpG: 45	571	45	336	15.8	58.8	0.91
chr16	77406131	77406857	CpG: 50	726	50	490	13.8	67.5	0.61
chr16	77417053	77417255	CpG: 17	202	17	123	16.8	60.9	0.95
chr16	77443091	77444009	CpG: 105	918	105	669	22.9	72.9	0.86
chr16	77524156	77524394	CpG: 19	238	19	147	16.0	61.8	0.85
chr16	77540192	77541409	CpG: 159	1217	159	929	26.1	76.3	0.90
chr16	77553886	77554094	CpG: 15	208	15	120	14.4	57.7	0.89
chr16	77625214	77626396	CpG: 91	1182	91	694	15.4	58.7	0.89
chr16	77658259	77658533	CpG: 20	274	20	167	14.6	60.9	0.80
chr16	77663005	77663538	CpG: 54	533	54	392	20.3	73.5	0.76
chr16	77677353	77677640	CpG: 29	287	29	190	20.2	66.2	0.96
chr16	77700671	77701790	CpG: 121	1119	121	834	21.6	74.5	0.78
chr16	77712092	77713184	CpG: 101	1092	101	723	18.5	66.2	0.85
chr16	77776168	77776446	CpG: 23	278	23	173	16.5	62.2	0.86
chr16	77822042	77822247	CpG: 15	205	15	119	14.6	58.0	0.89
chr16	77826507	77827564	CpG: 81	1057	81	665	15.3	62.9	0.80
chr16	77909544	77909756	CpG: 15	212	15	114	14.2	53.8	1.02
chr16	78089286	78089560	CpG: 23	274	23	171	16.8	62.4	0.88
chr16	78168092	78168366	CpG: 23	274	23	171	16.8	62.4	0.87
chr16	78371214	78371451	CpG: 19	237	19	141	16.0	59.5	0.94
chr16	78417790	78418075	CpG: 23	285	23	176	16.1	61.8	0.86
chr16	78434531	78434805	CpG: 24	274	24	171	17.5	62.4	0.91
chr16	78443788	78444215	CpG: 31	427	31	256	14.5	60.0	0.81
chr16	78481119	78481707	CpG: 51	588	51	360	17.3	61.2	0.93
chr16	78564433	78564656	CpG: 16	223	16	133	14.3	59.6	0.85
chr16	78605049	78605685	CpG: 59	636	59	411	18.6	64.6	0.90
chr16	78692065	78692285	CpG: 16	220	16	132	14.5	60.0	0.82
chr16	78777005	78777769	CpG: 55	764	55	474	14.4	62.0	0.75
chr16	78865473	78866448	CpG: 113	975	113	724	23.2	74.3	0.84
chr16	78875389	78876773	CpG: 216	1384	216	1102	31.2	79.6	1.01
chr16	78880757	78880984	CpG: 29	227	29	167	25.6	73.6	0.94
chr16	78883667	78884646	CpG: 80	979	80	657	16.3	67.1	0.73
chr16	78965127	78965401	CpG: 26	274	26	173	19.0	63.1	0.96
chr16	79234521	79234815	CpG: 23	294	23	179	15.6	60.9	0.86
chr16	79380267	79380504	CpG: 17	237	17	140	14.3	59.1	0.84
chr16	79441008	79441270	CpG: 20	262	20	159	15.3	60.7	0.85
chr16	79647946	79648255	CpG: 25	309	25	183	16.2	59.2	0.93
chr16	79859578	79859806	CpG: 17	228	17	140	14.9	61.4	0.81
chr16	80073316	80073597	CpG: 22	281	22	173	15.7	61.6	0.84
chr16	80114419	80115200	CpG: 74	781	74	503	19.0	64.4	0.92
chr16	80185427	80186520	CpG: 110	1093	110	743	20.1	68.0	0.87
chr16	80224716	80226069	CpG: 115	1353	115	923	17.0	68.2	0.73
chr16	80299799	80300893	CpG: 109	1094	109	743	19.9	67.9	0.87
chr16	80306530	80306805	CpG: 21	275	21	168	15.3	61.1	0.83
chr16	80339106	80340459	CpG: 115	1353	115	923	17.0	68.2	0.73
chr16	80414175	80415269	CpG: 109	1094	109	743	19.9	67.9	0.87
chr16	80420896	80421171	CpG: 21	275	21	168	15.3	61.1	0.83
chr16	80453427	80454780	CpG: 115	1353	115	925	17.0	68.4	0.73
chr16	80538344	80538566	CpG: 16	222	16	129	14.4	58.1	0.88
chr16	80544099	80544373	CpG: 21	274	21	167	15.3	60.9	0.84
chr16	80556249	80556481	CpG: 17	232	17	136	14.7	58.6	0.87
chr16	80614311	80614592	CpG: 24	281	24	174	17.1	61.9	0.91
chr16	80653303	80654032	CpG: 76	729	76	521	20.9	71.5	0.82
chr16	80713149	80713849	CpG: 63	700	63	472	18.0	67.4	0.80
chr16	80740432	80740648	CpG: 17	216	17	135	15.7	62.5	0.83
chr16	80746999	80747419	CpG: 35	420	35	273	16.7	65.0	0.82
chr16	80765539	80765752	CpG: 15	213	15	146	14.1	68.5	0.62
chr16	80821145	80821924	CpG: 93	779	93	586	23.9	75.2	0.85
chr16	80885651	80885917	CpG: 23	266	23	166	17.3	62.4	0.90
chr16	80952736	80952951	CpG: 16	215	16	130	14.9	60.5	0.83
chr16	81031128	81032484	CpG: 106	1356	106	839	15.6	61.9	0.82
chr16	81032816	81033057	CpG: 21	241	21	142	17.4	58.9	1.02
chr16	81045630	81047080	CpG: 170	1450	170	1058	23.4	73.0	0.88
chr16	81161197	81161663	CpG: 41	466	41	320	17.6	68.7	0.75
chr16	81187407	81187641	CpG: 18	234	18	138	15.4	59.0	0.90
chr16	81192911	81193204	CpG: 21	293	21	174	14.3	59.4	0.83
chr16	81195070	81195779	CpG: 87	709	87	516	24.5	72.8	0.93
chr16	81276346	81276736	CpG: 29	390	29	258	14.9	66.2	0.70
chr16	81281879	81282730	CpG: 64	851	64	588	15.0	69.1	0.63
chr16	81297531	81298672	CpG: 140	1141	140	876	24.5	76.8	0.86
chr16	81311827	81313037	CpG: 123	1210	123	898	20.3	74.2	0.74
chr16	81433911	81434187	CpG: 22	276	22	172	15.9	62.3	0.83
chr16	81478821	81479503	CpG: 81	682	81	472	23.8	69.2	0.99
chr16	81480812	81481085	CpG: 19	273	19	162	13.9	59.3	0.80
chr16	81509824	81510777	CpG: 111	953	111	705	23.3	74.0	0.85
chr16	81526834	81528005	CpG: 121	1171	121	793	20.7	67.7	0.91
chr16	81542922	81543735	CpG: 65	813	65	547	16.0	67.3	0.71
chr16	81544189	81544521	CpG: 24	332	24	195	14.5	58.7	0.84
chr16	81564911	81565795	CpG: 87	884	87	638	19.7	72.2	0.76
chr16	81577468	81578467	CpG: 106	999	106	672	21.2	67.3	0.94
chr16	81603909	81604708	CpG: 84	799	84	542	21.0	67.8	0.92
chr16	81614355	81615209	CpG: 90	854	90	602	21.1	70.5	0.85
chr16	81671300	81671765	CpG: 51	465	51	304	21.9	65.4	1.03
chr16	81672135	81672404	CpG: 20	269	20	159	14.9	59.1	0.86
chr16	81695663	81697321	CpG: 151	1658	151	1073	18.2	64.7	0.87
chr16	81738109	81738383	CpG: 25	274	25	172	18.2	62.8	0.94
chr16	81810538	81810776	CpG: 18	238	18	147	15.1	61.8	0.81
chr16	81838808	81839051	CpG: 20	243	20	149	16.5	61.3	0.89
chr16	81875947	81876173	CpG: 20	226	20	133	17.7	58.8	1.02
chr16	81911367	81911644	CpG: 23	277	23	167	16.6	60.3	0.93
chr16	81930027	81930308	CpG: 23	281	23	176	16.4	62.6	0.85
chr16	81982550	81982796	CpG: 18	246	18	141	14.6	57.3	0.92
chr16	82003016	82003230	CpG: 18	214	18	129	16.8	60.3	0.93
chr16	82291222	82291438	CpG: 18	216	18	143	16.7	66.2	0.77
chr16	82557981	82558258	CpG: 24	277	24	174	17.3	62.8	0.89
chr16	82627543	82627788	CpG: 18	245	18	150	14.7	61.2	0.80
chr16	82675384	82675660	CpG: 21	276	21	172	15.2	62.3	0.79
chr16	82689360	82689622	CpG: 20	262	20	158	15.3	60.3	0.85
chr16	82691113	82691430	CpG: 34	317	34	226	21.5	71.3	0.84
chr16	82902871	82903149	CpG: 24	278	24	175	17.3	62.9	0.88
chr16	83246445	83247420	CpG: 80	975	80	599	16.4	61.4	0.88
chr16	83250615	83250927	CpG: 26	312	26	201	16.7	64.4	0.80
chr16	83268221	83269290	CpG: 110	1069	110	778	20.6	72.8	0.79
chr16	83456618	83456836	CpG: 16	218	16	130	14.7	59.6	0.85
chr16	83490545	83491494	CpG: 110	949	110	682	23.2	71.9	0.90
chr16	83751585	83751810	CpG: 19	225	19	136	16.9	60.4	0.94
chr16	83778437	83778906	CpG: 41	469	41	323	17.5	68.9	0.78
chr16	83839686	83839900	CpG: 17	214	17	116	15.9	54.2	1.09
chr16	83844596	83845355	CpG: 75	759	75	524	19.8	69.0	0.84
chr16	84064410	84064647	CpG: 17	237	17	138	14.3	58.2	0.86
chr16	84101656	84102070	CpG: 40	414	40	297	19.3	71.7	0.77
chr16	84115596	84116032	CpG: 31	436	31	257	14.2	58.9	0.83
chr16	84155022	84155914	CpG: 91	892	91	603	20.4	67.6	0.90
chr16	84156814	84157298	CpG: 38	484	38	276	15.7	57.0	0.98
chr16	84176047	84176328	CpG: 20	281	20	170	14.2	60.5	0.79
chr16	84207720	84207990	CpG: 22	270	22	168	16.3	62.2	0.86
chr16	84250114	84250345	CpG: 17	231	17	139	14.7	60.2	0.82
chr16	84490068	84490342	CpG: 23	274	23	169	16.8	61.7	0.89
chr16	84597548	84597830	CpG: 25	282	25	177	17.7	62.8	0.91
chr16	84984470	84984744	CpG: 24	274	24	171	17.5	62.4	0.91
chr16	85395369	85395631	CpG: 18	262	18	160	13.7	61.1	0.76
chr16	85469523	85469755	CpG: 19	232	19	141	16.4	60.8	0.93
chr16	85600037	85600267	CpG: 17	230	17	136	14.8	59.1	0.86
chr16	85645931	85646397	CpG: 44	466	44	322	18.9	69.1	0.79
chr16	85655059	85657974	CpG: 289	2915	289	1947	19.8	66.8	0.89
chr16	85826885	85827350	CpG: 47	465	47	281	20.2	60.4	1.11
chr16	85852697	85852971	CpG: 20	274	20	167	14.6	60.9	0.80
chr16	85888473	85891531	CpG: 294	3058	294	2434	19.2	79.6	0.61
chr16	85933931	85934207	CpG: 23	276	23	162	16.7	58.7	0.98
chr16	85974191	85974422	CpG: 17	231	17	134	14.7	58.0	0.88
chr16	86037798	86038071	CpG: 23	273	23	173	16.8	63.4	0.85
chr16	86244395	86244673	CpG: 23	278	23	172	16.5	61.9	0.87
chr16	86299162	86299430	CpG: 21	268	21	164	15.7	61.2	0.84
chr16	86602509	86602858	CpG: 42	349	42	242	24.1	69.3	1.00
chr16	86788901	86789126	CpG: 19	225	19	135	16.9	60.0	0.94
chr16	86865285	86866821	CpG: 221	1536	221	1217	28.8	79.2	0.92
chr16	86923305	86923537	CpG: 19	232	19	138	16.4	59.5	0.95
chr16	86993897	86994821	CpG: 79	924	79	592	17.1	64.1	0.83
chr16	87025282	87025556	CpG: 24	274	24	172	17.5	62.8	0.89
chr16	87029220	87029449	CpG: 20	229	20	140	17.5	61.1	0.95
chr16	87067946	87069643	CpG: 146	1697	146	1089	17.2	64.2	0.84
chr16	87097217	87098088	CpG: 122	871	122	676	28.0	77.6	0.93
chr16	87138421	87139179	CpG: 64	758	64	497	16.9	65.6	0.79
chr16	87141000	87141232	CpG: 18	232	18	140	15.5	60.3	0.88
chr16	87156605	87157803	CpG: 118	1198	118	803	19.7	67.0	0.88
chr16	87243055	87243304	CpG: 17	249	17	150	13.7	60.2	0.76
chr16	87251947	87252232	CpG: 24	285	24	176	16.8	61.8	0.90
chr16	87375469	87376687	CpG: 156	1218	156	896	25.6	73.6	0.94
chr16	87377684	87377922	CpG: 18	238	18	140	15.1	58.8	0.90
chr16	87413759	87414047	CpG: 25	288	25	182	17.4	63.2	0.89
chr16	87464366	87464704	CpG: 25	338	25	230	14.8	68.0	0.64
chr16	87487739	87487949	CpG: 15	210	15	125	14.3	59.5	0.83
chr16	87505007	87506580	CpG: 199	1573	199	1229	25.3	78.1	0.84
chr16	87664800	87665039	CpG: 17	239	17	139	14.2	58.2	0.86
chr16	87739825	87740297	CpG: 39	472	39	319	16.5	67.6	0.73
chr16	87808546	87808867	CpG: 23	321	23	200	14.3	62.3	0.74
chr16	87822530	87822766	CpG: 17	236	17	143	14.4	60.6	0.81
chr16	87833292	87833572	CpG: 24	280	24	171	17.1	61.1	0.93
chr16	87842731	87843954	CpG: 132	1223	132	862	21.6	70.5	0.88
chr16	87865981	87866254	CpG: 20	273	20	163	14.7	59.7	0.84
chr16	88042185	88042466	CpG: 24	281	24	175	17.1	62.3	0.90
chr16	88074998	88075418	CpG: 35	420	35	285	16.7	67.9	0.73
chr16	88107116	88107352	CpG: 19	236	19	144	16.1	61.0	0.89
chr16	88203185	88203495	CpG: 26	310	26	187	16.8	60.3	0.93
chr16	88233848	88234602	CpG: 82	754	82	528	21.8	70.0	0.89
chr16	88432039	88432304	CpG: 21	265	21	165	15.8	62.3	0.83
chr16	88513249	88513531	CpG: 25	282	25	168	17.7	59.6	1.01
chr16	88691353	88692511	CpG: 102	1158	102	785	17.6	67.8	0.77
chr16	88701779	88702030	CpG: 20	251	20	148	15.9	59.0	0.93
chr16	89697892	89698173	CpG: 23	281	23	174	16.4	61.9	0.87
chr16	89702715	89703065	CpG: 28	350	28	207	16.0	59.1	0.92
chr16	89873536	89874112	CpG: 67	576	67	411	23.3	71.4	0.92
chr16	89964450	89965479	CpG: 132	1029	132	770	25.7	74.8	0.92
chr16	89975527	89975784	CpG: 19	257	19	143	14.8	55.6	0.96
chr16	89982073	89983247	CpG: 96	1174	96	684	16.4	58.3	0.98
chr16	89992381	89992668	CpG: 24	287	24	176	16.7	61.3	0.89
chr16	90031335	90031590	CpG: 25	255	25	181	19.6	71.0	0.79
chr16	90034158	90035311	CpG: 159	1153	159	932	27.6	80.8	0.84
chr16	90050136	90050350	CpG: 16	214	16	126	15.0	58.9	0.87
chr16	90061906	90062160	CpG: 19	254	19	171	15.0	67.3	0.66
chr16	90111518	90111741	CpG: 17	223	17	159	15.2	71.3	0.60
chr16	90118387	90118636	CpG: 18	249	18	156	14.5	62.7	0.74
chr16	90182401	90183599	CpG: 143	1198	143	839	23.9	70.0	0.97
chr16	90206909	90207171	CpG: 25	262	25	165	19.1	63.0	0.98
chr16	90210478	90211702	CpG: 123	1224	123	854	20.1	69.8	0.85
chr16	90247302	90247503	CpG: 20	201	20	140	19.9	69.7	0.83
chr16	90251694	90251930	CpG: 19	236	19	141	16.1	59.7	0.94
chr16	90252663	90253246	CpG: 58	583	58	395	19.9	67.8	0.87
chr16	90257199	90257553	CpG: 43	354	43	257	24.3	72.6	0.92
chr16	90288657	90288930	CpG: 26	273	26	186	19.0	68.1	0.82
chr16	90292807	90293088	CpG: 24	281	24	175	17.1	62.3	0.89
chr16	90303238	90303674	CpG: 32	436	32	286	14.7	65.6	0.69
chr16	90361313	90361514	CpG: 14	201	14	129	13.9	64.2	0.68
chr16	90379277	90379732	CpG: 51	455	51	342	22.4	75.2	0.79
chr16	90434749	90435289	CpG: 62	540	62	391	23.0	72.4	0.88
chr16	90571617	90571848	CpG: 17	231	17	144	14.7	62.3	0.80
chr16	90659827	90660081	CpG: 22	254	22	158	17.3	62.2	0.92
chr16	90683647	90684540	CpG: 120	893	120	642	26.9	71.9	1.04
chr16	90714367	90715418	CpG: 151	1051	151	836	28.7	79.5	0.91
chr16	90723101	90724168	CpG: 86	1067	86	680	16.1	63.7	0.79
chr16	90727836	90728348	CpG: 49	512	49	338	19.1	66.0	0.88
chr16	90765819	90766759	CpG: 121	940	121	732	25.7	77.9	0.85
chr16	90803063	90803329	CpG: 19	266	19	167	14.3	62.8	0.73
chr16	90885948	90886378	CpG: 48	430	48	314	22.3	73.0	0.84
chr16	90903706	90903981	CpG: 22	275	22	167	16.0	60.7	0.88
chr16	90944189	90944410	CpG: 17	221	17	124	15.4	56.1	0.99
chr16	91032442	91032806	CpG: 32	364	32	184	17.6	50.5	2.06
chr16	91077744	91078450	CpG: 81	706	81	503	22.9	71.2	0.92
chr16	91088499	91088769	CpG: 20	270	20	163	14.8	60.4	0.83
chr16	91094201	91094821	CpG: 80	620	80	479	25.8	77.3	0.89
chr16	91190276	91190494	CpG: 19	218	19	158	17.4	72.5	0.67
chr16	91203486	91203790	CpG: 22	304	22	208	14.5	68.4	0.62
chr16	91229234	91229552	CpG: 28	318	28	197	17.6	61.9	0.92
chr16	91234955	91236503	CpG: 236	1548	236	1214	30.5	78.4	0.99
chr16	91237160	91237593	CpG: 30	433	30	297	13.9	68.6	0.61
chr16	91274888	91275192	CpG: 23	304	23	187	15.1	61.5	0.93
chr16	91300894	91301122	CpG: 21	228	21	163	18.4	71.5	0.73
chr16	91301741	91302129	CpG: 43	388	43	294	22.2	75.8	0.77
chr16	91324817	91325061	CpG: 18	244	18	168	14.8	68.9	0.64
chr16	91350302	91350556	CpG: 22	254	22	165	17.3	65.0	0.89
chr16	91353127	91353328	CpG: 18	201	18	142	17.9	70.6	0.72
chr16	91369562	91370123	CpG: 42	561	42	384	15.0	68.4	0.64
chr16	91395666	91395910	CpG: 16	244	16	162	13.1	66.4	0.61
chr16	91403496	91403770	CpG: 23	274	23	171	16.8	62.4	0.88
chr16	91426763	91426965	CpG: 17	202	17	135	16.8	66.8	0.76
chr16	91439885	91440162	CpG: 21	277	21	194	15.2	70.0	0.62
chr16	91496238	91496493	CpG: 19	255	19	155	14.9	60.8	0.82
chr16	91527323	91528056	CpG: 86	733	86	562	23.5	76.7	0.80
chr16	91550250	91550498	CpG: 26	248	26	162	21.0	65.3	0.99
chr16	91560978	91561267	CpG: 26	289	26	186	18.0	64.4	0.88
chr16	91581588	91581862	CpG: 20	274	20	164	14.6	59.9	0.83
chr16	91582545	91582872	CpG: 27	327	27	220	16.5	67.3	0.73
chr16	91599699	91599983	CpG: 22	284	22	163	15.5	57.4	0.95
chr16	91610949	91611184	CpG: 17	235	17	138	14.5	58.7	0.85
chr16	91617321	91617731	CpG: 31	410	31	236	15.1	57.6	0.92
chr16	91618210	91622119	CpG: 319	3909	319	2478	16.3	63.4	0.81
chr16	91651436	91651759	CpG: 25	323	25	220	15.5	68.1	0.68
chr16	91675698	91675932	CpG: 24	234	24	159	20.5	67.9	0.89
chr16	91676556	91680636	CpG: 354	4080	354	2844	17.4	69.7	0.72
chr16	91690351	91690607	CpG: 23	256	23	173	18.0	67.6	0.85
chr16	91698229	91698757	CpG: 35	528	35	343	13.3	65.0	0.63
chr16	91699173	91699458	CpG: 34	285	34	214	23.9	75.1	0.87
chr16	91701742	91701956	CpG: 16	214	16	146	15.0	68.2	0.65
chr16	91705801	91706107	CpG: 29	306	29	208	19.0	68.0	0.82
chr16	91706443	91706694	CpG: 19	251	19	165	15.1	65.7	0.71
chr16	91707893	91708194	CpG: 21	301	21	204	14.0	67.8	0.61
chr16	91715674	91716058	CpG: 34	384	34	260	17.7	67.7	0.77
chr16	91721858	91722255	CpG: 43	397	43	282	21.7	71.0	0.90
chr16	91736727	91736948	CpG: 17	221	17	131	15.4	59.3	0.89
chr16	91753467	91754848	CpG: 135	1381	135	918	19.6	66.5	0.88
chr16	91775410	91776003	CpG: 47	593	47	391	15.9	65.9	0.73
chr16	91780392	91780629	CpG: 17	237	17	141	14.3	59.5	0.83
chr16	91805942	91806198	CpG: 18	256	18	154	14.1	60.2	0.80
chr16	91815776	91817045	CpG: 140	1269	140	931	22.1	73.4	0.82
chr16	91849580	91849812	CpG: 16	232	16	136	13.8	58.6	0.81
chr16	91864334	91865756	CpG: 145	1422	145	997	20.4	70.1	0.83
chr16	91873700	91874343	CpG: 50	643	50	433	15.6	67.3	0.69
chr16	91877494	91877700	CpG: 16	206	16	134	15.5	65.0	0.74
chr16	91895251	91895471	CpG: 16	220	16	151	14.5	68.6	0.62
chr16	91911768	91911975	CpG: 18	207	18	128	17.4	61.8	0.92
chr16	91912109	91912342	CpG: 18	233	18	138	15.5	59.2	0.90
chr16	91965014	91965835	CpG: 100	821	100	581	24.4	70.8	0.97
chr16	92014546	92014859	CpG: 24	313	24	202	15.3	64.5	0.74
chr16	92039104	92041100	CpG: 138	1996	138	1074	13.8	53.8	1.02
chr16	92301223	92301543	CpG: 26	320	26	186	16.2	58.1	0.96
chr16	92329787	92330102	CpG: 25	315	25	185	15.9	58.7	0.93
chr16	92354057	92355204	CpG: 91	1147	91	796	15.9	69.4	0.67
chr16	92445378	92445681	CpG: 22	303	22	191	14.5	63.0	0.73
chr16	92503160	92503390	CpG: 16	230	16	132	13.9	57.4	0.86
chr16	92562883	92563625	CpG: 57	742	57	483	15.4	65.1	0.73
chr16	92565364	92567611	CpG: 192	2247	192	1443	17.1	64.2	0.83
chr16	92573734	92574102	CpG: 55	368	55	286	29.9	77.7	0.99
chr16	92576045	92579839	CpG: 410	3794	410	2622	21.6	69.1	0.91
chr16	92580970	92581243	CpG: 21	273	21	180	15.4	65.9	0.71
chr16	92583680	92585123	CpG: 118	1443	118	937	16.4	64.9	0.78
chr16	92600051	92600555	CpG: 41	504	41	341	16.3	67.7	0.71
chr16	92621590	92621835	CpG: 18	245	18	171	14.7	69.8	0.60
chr16	92623145	92624223	CpG: 90	1078	90	691	16.7	64.1	0.83
chr16	92632285	92632514	CpG: 24	229	24	141	21.0	61.6	1.11
chr16	92634066	92637360	CpG: 323	3294	323	2144	19.6	65.1	0.93
chr16	92644096	92645170	CpG: 79	1074	79	661	14.7	61.5	0.78
chr16	92646893	92648526	CpG: 154	1633	154	1122	18.9	68.7	0.80
chr16	92749478	92749805	CpG: 23	327	23	212	14.1	64.8	0.69
chr16	92769482	92769751	CpG: 19	269	19	164	14.1	61.0	0.76
chr16	92806630	92806842	CpG: 27	212	27	141	25.5	66.5	1.23
chr16	92904408	92904691	CpG: 22	283	22	175	15.5	61.8	0.84
chr16	92946950	92947217	CpG: 25	267	25	171	18.7	64.0	0.91
chr16	92985632	92985847	CpG: 23	215	23	141	21.4	65.6	1.03
chr16	92999826	93000051	CpG: 18	225	18	143	16.0	63.6	0.80
chr16	93049771	93050009	CpG: 17	238	17	133	14.3	55.9	0.92
chr16	93210659	93210895	CpG: 18	236	18	143	15.3	60.6	0.83
chr16	93228296	93228570	CpG: 24	274	24	171	17.5	62.4	0.91
chr16	93251973	93252248	CpG: 23	275	23	172	16.7	62.5	0.86
chr16	93287127	93287584	CpG: 39	457	39	313	17.1	68.5	0.73
chr16	93387912	93388850	CpG: 77	938	77	605	16.4	64.5	0.79
chr16	93404815	93405132	CpG: 26	317	26	227	16.4	71.6	0.65
chr16	93424333	93424614	CpG: 19	281	19	181	13.5	64.4	0.67
chr16	93453668	93455613	CpG: 212	1945	212	1371	21.8	70.5	0.89
chr16	93462423	93463963	CpG: 187	1540	187	1166	24.3	75.7	0.85
chr16	93478664	93478948	CpG: 23	284	23	169	16.2	59.5	0.92
chr16	93482638	93482995	CpG: 29	357	29	236	16.2	66.1	0.79
chr16	93483909	93484238	CpG: 24	329	24	218	14.6	66.3	0.67
chr16	93484976	93485449	CpG: 33	473	33	309	14.0	65.3	0.68
chr16	93548674	93548943	CpG: 20	269	20	181	14.9	67.3	0.84
chr16	93561752	93564505	CpG: 332	2753	332	1982	24.1	72.0	0.94
chr16	93622298	93622649	CpG: 28	351	28	245	16.0	69.8	0.66
chr16	93673184	93675119	CpG: 243	1935	243	1444	25.1	74.6	0.90
chr16	93686364	93686723	CpG: 40	359	40	243	22.3	67.7	0.99
chr16	93708368	93708690	CpG: 22	322	22	201	13.7	62.4	0.70
chr16	93715913	93716688	CpG: 83	775	83	524	21.4	67.6	0.94
chr16	93726507	93726919	CpG: 28	412	28	269	13.6	65.3	0.64
chr16	93740533	93740744	CpG: 18	211	18	134	17.1	63.5	0.85
chr16	93745705	93745974	CpG: 20	269	20	160	14.9	59.5	0.85
chr16	93752639	93753354	CpG: 77	715	77	469	21.5	65.6	1.12
chr16	93757128	93757346	CpG: 16	218	16	147	14.7	67.4	0.68
chr16	93761210	93762139	CpG: 85	929	85	652	18.3	70.2	0.74
chr16	93774691	93774946	CpG: 25	255	25	154	19.6	60.4	1.09
chr16	93776656	93776893	CpG: 23	237	23	171	19.4	72.2	0.75
chr16	93779950	93780192	CpG: 22	242	22	159	18.2	65.7	0.90
chr16	93780596	93781149	CpG: 41	553	41	374	14.8	67.6	0.65
chr16	93790161	93790803	CpG: 50	642	50	454	15.6	70.7	0.62
chr16	93792048	93792325	CpG: 25	277	25	182	18.1	65.7	0.85
chr16	93796803	93797104	CpG: 22	301	22	181	14.6	60.1	0.81
chr16	93797807	93798627	CpG: 146	820	146	659	35.6	80.4	1.49
chr16	93838180	93839386	CpG: 108	1206	108	772	17.9	64.0	0.88
chr16	93849995	93850227	CpG: 18	232	18	144	15.5	62.1	0.81
chr16	93851874	93852111	CpG: 21	237	21	155	17.7	65.4	0.83
chr16	93933522	93933729	CpG: 15	207	15	139	14.5	67.1	0.65
chr16	93941627	93942633	CpG: 126	1006	126	742	25.0	73.8	0.94
chr16	93964405	93964631	CpG: 21	226	21	151	18.6	66.8	0.84
chr16	93987554	93987801	CpG: 23	247	23	153	18.6	61.9	0.98
chr16	94022536	94022772	CpG: 22	236	22	148	18.6	62.7	0.97
chr16	94023064	94024728	CpG: 172	1664	172	1137	20.7	68.3	0.89
chr16	94030283	94030592	CpG: 21	309	21	190	13.6	61.5	0.73
chr16	94057591	94057914	CpG: 25	323	25	214	15.5	66.3	0.75
chr16	94062123	94062373	CpG: 27	250	27	184	21.6	73.6	0.84
chr16	94070896	94072498	CpG: 139	1602	139	969	17.4	60.5	1.02
chr16	94077145	94077433	CpG: 25	288	25	181	17.4	62.8	0.89
chr16	94081825	94082031	CpG: 17	206	17	117	16.5	56.8	1.03
chr16	94089601	94090017	CpG: 32	416	32	263	15.4	63.2	0.77
chr16	94090633	94090865	CpG: 35	232	35	177	30.2	76.3	1.16
chr16	94098686	94099119	CpG: 37	433	37	307	17.1	70.9	0.68
chr16	94139000	94139438	CpG: 30	438	30	282	13.7	64.4	0.66
chr16	94143168	94143436	CpG: 27	268	27	194	20.1	72.4	0.77
chr16	94144302	94144865	CpG: 40	563	40	368	14.2	65.4	0.67
chr16	94147449	94148077	CpG: 58	628	58	426	18.5	67.8	0.80
chr16	94169199	94169508	CpG: 26	309	26	202	16.8	65.4	0.81
chr16	94171903	94172256	CpG: 23	353	23	215	13.0	60.9	0.76
chr16	94188654	94189217	CpG: 51	563	51	379	18.1	67.3	0.81
chr16	94190252	94190768	CpG: 38	516	38	320	14.7	62.0	0.84
chr16	94198344	94198612	CpG: 20	268	20	161	14.9	60.1	0.83
chr16	94199009	94199327	CpG: 36	318	36	221	22.6	69.5	0.97
chr16	94200182	94200656	CpG: 36	474	36	324	15.2	68.4	0.66
chr16	94219482	94219727	CpG: 21	245	21	151	17.1	61.6	0.90
chr16	94252750	94253079	CpG: 30	329	30	213	18.2	64.7	0.87
chr16	94254620	94255140	CpG: 45	520	45	344	17.3	66.2	0.80
chr16	94268655	94268857	CpG: 16	202	16	138	15.8	68.3	0.70
chr16	94272342	94272566	CpG: 20	224	20	155	17.9	69.2	0.75
chr16	94294660	94294875	CpG: 34	215	34	165	31.6	76.7	1.16
chr16	94297267	94297484	CpG: 22	217	22	124	20.3	57.1	1.36
chr16	94302145	94302399	CpG: 19	254	19	179	15.0	70.5	0.61
chr16	94326349	94326607	CpG: 24	258	24	177	18.6	68.6	0.80
chr16	94332723	94332980	CpG: 19	257	19	168	14.8	65.4	0.69
chr16	94344532	94345041	CpG: 37	509	37	278	14.5	54.6	0.97
chr16	94345400	94345634	CpG: 19	234	19	132	16.2	56.4	1.02
chr16	94388028	94388353	CpG: 23	325	23	224	14.2	68.9	0.60
chr16	94442854	94443570	CpG: 50	716	50	454	14.0	63.4	0.70
chr16	94449691	94450891	CpG: 166	1200	166	962	27.7	80.2	0.87
chr16	94453950	94454370	CpG: 31	420	31	290	14.8	69.0	0.62
chr16	94459917	94460145	CpG: 21	228	21	154	18.4	67.5	0.81
chr16	94475246	94475502	CpG: 20	256	20	151	15.6	59.0	0.90
chr16	94497755	94499317	CpG: 146	1562	146	1122	18.7	71.8	0.73
chr16	94499654	94500379	CpG: 48	725	48	454	13.2	62.6	0.68
chr16	94504029	94504238	CpG: 17	209	17	142	16.3	67.9	0.71
chr16	94504368	94505894	CpG: 132	1526	132	1079	17.3	70.7	0.69
chr16	94513234	94514396	CpG: 76	1162	76	743	13.1	63.9	0.64
chr16	94514853	94515094	CpG: 23	241	23	160	19.1	66.4	0.89
chr16	94520309	94524088	CpG: 395	3779	395	2702	20.9	71.5	0.82
chr16	94536077	94536369	CpG: 40	292	40	232	27.4	79.5	1.09
chr16	94538616	94539055	CpG: 30	439	30	290	13.7	66.1	0.85
chr16	94541540	94542212	CpG: 49	672	49	458	14.6	68.2	0.63
chr16	94556034	94556527	CpG: 40	493	40	340	16.2	69.0	0.69
chr16	94558329	94558601	CpG: 22	272	22	172	16.2	63.2	0.82
chr16	94559731	94560009	CpG: 22	278	22	188	15.8	67.6	0.70
chr16	94561500	94561749	CpG: 19	249	19	185	15.3	74.3	0.64
chr16	94565712	94566054	CpG: 29	342	29	237	17.0	69.3	0.71
chr16	94570220	94570444	CpG: 21	224	21	152	18.8	67.9	0.81
chr16	94570927	94571151	CpG: 17	224	17	156	15.2	69.6	0.63
chr16	94574946	94575150	CpG: 19	204	19	134	18.6	65.7	0.88
chr16	94591834	94592040	CpG: 23	206	23	154	22.3	74.8	0.80
chr16	94600082	94600800	CpG: 52	718	52	496	14.5	69.1	0.61
chr16	94601248	94603162	CpG: 276	1914	276	1495	28.8	78.1	0.96
chr16	94615143	94615460	CpG: 22	317	22	227	13.9	71.6	1.04
chr16	94626028	94626238	CpG: 26	210	26	164	24.8	78.1	0.81
chr16	94635172	94635610	CpG: 36	438	36	271	16.4	61.9	0.86
chr16	94637374	94638531	CpG: 143	1157	143	811	24.7	70.1	1.01
chr16	94642457	94642731	CpG: 20	274	20	167	14.6	60.9	0.80
chr16	94678880	94679135	CpG: 36	255	36	185	28.2	72.5	1.19
chr16	94690883	94691099	CpG: 26	216	26	148	24.1	68.5	1.03
chr16	94700788	94701022	CpG: 17	234	17	139	14.5	59.4	0.84
chr16	94701915	94703033	CpG: 102	1118	102	802	18.2	71.7	0.71
chr16	94707682	94707963	CpG: 30	281	30	195	21.4	69.4	0.89
chr16	94709600	94709834	CpG: 17	234	17	141	14.5	60.3	0.82
chr16	94710997	94711491	CpG: 51	494	51	352	20.6	71.3	0.82
chr16	94718511	94719128	CpG: 55	617	55	452	17.8	73.3	0.68
chr16	94723039	94723588	CpG: 46	549	46	374	16.8	68.1	0.73
chr16	94723846	94724220	CpG: 26	374	26	252	13.9	67.4	0.63
chr16	94727106	94727359	CpG: 22	253	22	160	17.4	63.2	0.87
chr16	94730360	94731957	CpG: 173	1597	173	1139	21.7	71.3	0.86
chr16	94747214	94747713	CpG: 35	499	35	336	14.0	67.3	0.62
chr16	94750475	94750746	CpG: 21	271	21	190	15.5	70.1	0.64
chr16	94755248	94756006	CpG: 80	758	80	546	21.1	72.0	0.81
chr16	94766275	94766696	CpG: 41	421	41	304	19.5	72.2	0.75
chr16	94767769	94768127	CpG: 27	358	27	250	15.1	69.8	0.62
chr16	94774988	94776042	CpG: 140	1054	140	804	26.6	76.3	0.91
chr16	94785370	94785739	CpG: 25	369	25	247	13.6	66.9	0.61
chr16	94785866	94786577	CpG: 51	711	51	469	14.3	66.0	0.66
chr16	94791624	94791842	CpG: 17	218	17	141	15.6	64.7	0.77
chr16	94792093	94793500	CpG: 101	1407	101	961	14.4	68.3	0.62
chr16	94797131	94797937	CpG: 58	806	58	553	14.4	68.6	0.61
chr16	94808969	94809280	CpG: 30	311	30	229	19.3	73.6	0.71
chr16	94816396	94816602	CpG: 16	206	16	146	15.5	70.9	0.64
chr16	94820606	94821335	CpG: 52	729	52	456	14.3	62.6	0.73
chr16	94826328	94826851	CpG: 41	523	41	361	15.7	69.0	0.66
chr16	94837669	94838042	CpG: 27	373	27	224	14.5	60.1	0.81
chr16	94843340	94843567	CpG: 20	227	20	165	17.6	72.7	0.77
chr16	94850054	94850278	CpG: 19	224	19	152	17.0	67.9	0.74
chr16	94855312	94855645	CpG: 24	333	24	216	14.4	64.9	0.69
chr16	94855852	94857382	CpG: 206	1530	206	1167	26.9	76.3	0.93
chr16	94872821	94874704	CpG: 184	1883	184	1205	19.5	64.0	0.96
chr16	94875962	94876315	CpG: 26	353	26	237	14.7	67.1	0.65
chr16	94881824	94883048	CpG: 144	1224	144	891	23.5	72.8	0.89
chr16	94887169	94887574	CpG: 31	405	31	278	15.3	68.6	0.65
chr16	94888281	94888636	CpG: 29	355	29	248	16.3	69.9	0.67
chr16	94893973	94894479	CpG: 62	506	62	381	24.5	75.3	0.87
chr16	94900566	94900769	CpG: 17	203	17	136	16.7	67.0	0.76
chr16	94901930	94902494	CpG: 63	564	63	420	22.3	74.5	1.10
chr16	94906158	94906580	CpG: 39	422	39	290	18.5	68.7	0.78
chr16	94909492	94909733	CpG: 31	241	31	176	25.7	73.0	1.00
chr16	94912416	94912681	CpG: 21	265	21	176	15.8	66.4	0.74
chr16	94926657	94927990	CpG: 135	1333	135	970	20.3	72.8	0.77
chr16	94941005	94941337	CpG: 26	332	26	211	15.7	63.6	0.79
chr16	94947377	94947619	CpG: 21	242	21	175	17.4	72.3	0.66
chr16	94949567	94949811	CpG: 26	244	26	168	21.3	68.9	0.90
chr16	94951663	94951965	CpG: 34	302	34	222	22.5	73.5	0.83
chr16	94953632	94954197	CpG: 46	565	46	364	16.3	64.4	0.79
chr16	94955369	94955615	CpG: 25	246	25	176	20.3	71.5	0.82
chr16	94957169	94957395	CpG: 24	226	24	158	21.2	69.9	0.87
chr16	94960655	94961082	CpG: 41	427	41	273	19.2	63.9	1.05
chr16	94962807	94963105	CpG: 20	298	20	188	13.4	63.1	0.69
chr16	94966295	94966512	CpG: 16	217	16	145	14.7	66.8	0.67
chr16	94967217	94967998	CpG: 54	781	54	510	13.8	65.3	0.66
chr16	94970749	94971139	CpG: 29	390	29	254	14.9	65.1	0.70
chr16	94974911	94975146	CpG: 19	235	19	156	16.2	66.4	0.73
chr16	94980397	94980716	CpG: 26	319	26	206	16.3	64.6	0.79
chr16	94986357	94986696	CpG: 28	339	28	251	16.5	74.0	1.29
chr16	95005085	95005390	CpG: 23	305	23	212	15.1	69.5	0.63
chr16	95010610	95011678	CpG: 86	1068	86	642	16.1	60.1	0.97
chr16	95012101	95012406	CpG: 23	305	23	181	15.1	59.3	0.87
chr16	95017345	95019611	CpG: 273	2266	273	1718	24.1	75.8	0.84
chr16	95041005	95041207	CpG: 15	202	15	129	14.9	63.9	0.74
chr16	95044441	95045258	CpG: 55	817	55	544	13.5	66.6	0.61
chr16	95077284	95077559	CpG: 21	275	21	228	15.3	82.9	1.03
chr16	95079859	95081423	CpG: 96	1564	96	1146	12.3	73.3	0.61
chr16	95081661	95081945	CpG: 21	284	21	180	14.8	63.4	0.74
chr16	95082507	95082765	CpG: 23	258	23	155	17.8	60.1	0.99
chr16	95113675	95113974	CpG: 20	299	20	187	13.4	62.5	0.70
chr16	95119512	95119732	CpG: 17	220	17	135	15.5	61.4	0.84
chr16	95121852	95122261	CpG: 36	409	36	318	17.6	77.8	0.66
chr16	95128340	95128674	CpG: 29	334	29	228	17.4	68.3	0.75
chr16	95132612	95132963	CpG: 33	351	33	249	18.8	70.9	0.76
chr16	95133117	95133475	CpG: 24	358	24	232	13.4	64.8	0.67
chr16	95141415	95141626	CpG: 17	211	17	140	16.1	66.4	0.75
chr16	95151033	95151269	CpG: 24	236	24	184	20.3	78.0	1.23
chr16	95154320	95154936	CpG: 37	616	37	357	12.0	58.0	0.72
chr16	95157655	95158322	CpG: 55	667	55	452	16.5	67.8	0.72
chr16	95160747	95160987	CpG: 19	240	19	164	15.8	68.3	0.69
chr16	95173569	95174257	CpG: 118	688	118	543	34.3	78.9	1.11
chr16	95180667	95181033	CpG: 30	366	30	246	16.4	67.2	0.73
chr16	95181314	95181542	CpG: 17	228	17	146	14.9	64.0	0.73
chr16	95187255	95187456	CpG: 18	201	18	131	17.9	65.2	1.01
chr16	95191333	95191556	CpG: 18	223	18	141	16.1	63.2	0.81
chr16	95199183	95199469	CpG: 23	286	23	192	16.1	67.1	0.72
chr16	95199750	95200103	CpG: 26	353	26	230	14.7	65.2	0.70
chr16	95232948	95233266	CpG: 23	318	23	201	14.5	63.2	0.73
chr16	95239305	95239813	CpG: 38	508	38	348	15.0	68.5	0.64
chr16	95251381	95252045	CpG: 69	664	69	499	20.8	75.2	0.83
chr16	95259333	95259674	CpG: 26	341	26	233	15.2	68.3	0.66
chr16	95271435	95274334	CpG: 198	2899	198	2035	13.7	70.2	0.61
chr16	95281108	95282906	CpG: 210	1798	210	1307	23.4	72.7	0.90
chr16	95285641	95285878	CpG: 18	237	18	143	15.2	60.3	0.85
chr16	95293065	95293339	CpG: 23	274	23	170	16.8	62.0	0.88
chr16	95297595	95298449	CpG: 96	854	96	582	22.5	68.1	0.97
chr16	95298753	95299027	CpG: 20	274	20	170	14.6	62.0	0.77
chr16	95305219	95305499	CpG: 25	280	25	172	17.9	61.4	0.95
chr16	95313448	95313979	CpG: 46	531	46	297	17.3	55.9	1.18
chr16	95320835	95321076	CpG: 21	241	21	148	17.4	61.4	0.94
chr16	95321392	95321757	CpG: 33	365	33	255	18.1	69.9	0.85
chr16	95327386	95329244	CpG: 192	1858	192	1284	20.7	69.1	0.87
chr16	95335575	95335854	CpG: 22	279	22	172	15.8	61.6	0.84
chr16	95337199	95338024	CpG: 96	825	96	584	23.3	70.8	0.93
chr16	95338912	95339178	CpG: 24	266	24	169	18.0	63.5	0.90
chr16	95348493	95349007	CpG: 47	514	47	347	18.3	67.5	0.80
chr16	95359378	95362452	CpG: 235	3074	235	2032	15.3	66.1	0.71
chr16	95365414	95365660	CpG: 19	246	19	128	15.4	52.0	1.18
chr16	95366443	95366740	CpG: 21	297	21	197	14.1	66.3	0.64
chr16	95385375	95385598	CpG: 18	223	18	159	16.1	71.3	0.64
chr16	95385869	95387414	CpG: 153	1545	153	1069	19.8	69.2	1.05
chr16	95422148	95422376	CpG: 19	228	19	169	16.7	74.1	0.63
chr16	95452407	95452754	CpG: 28	347	28	238	16.1	68.6	0.69
chr16	95466066	95466366	CpG: 21	300	21	199	14.0	66.3	0.65
chr16	95470064	95470687	CpG: 49	623	49	388	15.7	62.3	0.90
chr16	95501905	95502303	CpG: 27	398	27	254	13.6	63.8	0.78
chr16	95514206	95514407	CpG: 16	201	16	129	15.9	64.2	0.81
chr16	95537631	95537909	CpG: 25	278	25	173	18.0	62.2	0.94
chr16	95538934	95539176	CpG: 19	242	19	148	15.7	61.2	0.86
chr16	95550407	95550718	CpG: 23	311	23	187	14.8	60.1	0.82
chr16	95569878	95571998	CpG: 255	2120	255	1552	24.1	73.2	0.91
chr16	95581369	95581643	CpG: 23	274	23	171	16.8	62.4	0.87
chr16	95587213	95587435	CpG: 21	222	21	141	18.9	63.5	0.95
chr16	95588187	95589601	CpG: 161	1414	161	1031	22.8	72.9	0.86
chr16	95603047	95603289	CpG: 28	242	28	160	23.1	66.1	1.09
chr16	95607401	95607627	CpG: 24	226	24	144	21.2	63.7	1.05
chr16	95608706	95608964	CpG: 21	258	21	156	16.3	60.5	0.93
chr16	95617750	95618084	CpG: 28	334	28	216	16.8	64.7	0.81
chr16	95622437	95622677	CpG: 19	240	19	173	15.8	72.1	0.61
chr16	95640593	95642011	CpG: 154	1418	154	944	21.7	66.6	0.98
chr16	95646784	95646991	CpG: 19	207	19	132	18.4	63.8	0.91
chr16	95651337	95651790	CpG: 44	453	44	341	19.4	75.3	1.10
chr16	95655073	95657435	CpG: 249	2362	249	1746	21.1	73.9	0.77
chr16	95660195	95661459	CpG: 82	1264	82	709	13.0	56.1	1.11
chr16	95664006	95664286	CpG: 27	280	27	188	19.3	67.1	0.86
chr16	95664381	95664647	CpG: 20	266	20	181	15.0	68.0	0.71
chr16	95667007	95668529	CpG: 132	1522	132	1065	17.3	70.0	0.80
chr16	95673660	95673896	CpG: 18	236	18	141	15.3	59.7	0.88
chr16	95675631	95675875	CpG: 29	244	29	165	23.8	67.6	1.04
chr16	95696055	95696290	CpG: 18	235	18	141	15.3	60.0	0.89
chr16	95699104	95699424	CpG: 31	320	31	220	19.4	68.8	0.82
chr16	95731292	95733340	CpG: 283	2048	283	1477	27.6	72.1	1.16
chr16	95740970	95741241	CpG: 20	271	20	165	14.8	60.9	0.80
chr16	95741596	95743039	CpG: 154	1443	154	1033	21.3	71.6	0.87
chr16	95753392	95753596	CpG: 16	204	16	138	15.7	67.6	0.72
chr16	95771236	95772042	CpG: 92	806	92	574	22.8	71.2	0.91
chr16	95779374	95779674	CpG: 29	300	29	218	19.3	72.7	0.75
chr16	95784923	95785153	CpG: 22	230	22	156	19.1	67.8	0.84
chr16	95785607	95787236	CpG: 172	1629	172	1179	21.1	72.4	0.81
chr16	95798042	95798320	CpG: 20	278	20	166	14.4	59.7	0.82
chr16	95805195	95807447	CpG: 283	2252	283	1671	25.1	74.2	0.91
chr16	95884288	95884540	CpG: 20	252	20	153	15.9	60.7	0.87
chr16	95900285	95902335	CpG: 203	2050	203	1365	19.8	66.6	0.89
chr16	95912489	95913656	CpG: 141	1167	141	914	24.2	78.3	0.80
chr16	95918671	95919849	CpG: 99	1178	99	684	16.8	58.1	1.00
chr16	95925279	95925513	CpG: 16	234	16	137	13.7	58.5	0.82
chr16	95934963	95935677	CpG: 70	714	70	503	19.6	70.4	0.79
chr16	95937246	95938015	CpG: 54	769	54	525	14.0	68.3	0.95
chr16	95939105	95939348	CpG: 21	243	21	153	17.3	63.0	0.87
chr16	95939526	95939729	CpG: 16	203	16	133	15.8	65.5	0.75
chr16	95947080	95947361	CpG: 19	281	19	169	13.5	60.1	0.79
chr16	95957851	95959443	CpG: 177	1592	177	1113	22.2	69.9	0.93
chr16	95964145	95964996	CpG: 62	851	62	519	14.6	61.0	0.79
chr16	95979257	95979541	CpG: 26	284	26	217	18.3	76.4	0.68
chr16	95997399	95997688	CpG: 24	289	24	173	16.6	59.9	0.93
chr16	96005750	96006193	CpG: 38	443	38	295	17.2	66.6	0.78
chr16	96008667	96010344	CpG: 155	1677	155	1187	18.5	70.8	0.74
chr16	96011972	96012944	CpG: 97	972	97	705	20.0	72.5	0.76
chr16	96020184	96020567	CpG: 35	383	35	269	18.3	70.2	0.74
chr16	96021104	96022089	CpG: 80	985	80	636	16.2	64.6	0.78
chr16	96023451	96023678	CpG: 17	227	17	145	15.0	63.9	0.74
chr16	96034084	96035954	CpG: 203	1870	203	1345	21.7	71.9	0.85
chr16	96050343	96050574	CpG: 18	231	18	155	15.6	67.1	0.69
chr16	96058364	96059465	CpG: 119	1101	119	756	21.6	68.7	0.92
chr16	96076010	96076286	CpG: 22	276	22	168	15.9	60.9	0.87
chr16	96086199	96086525	CpG: 23	326	23	213	14.1	65.3	0.67
chr16	96089639	96090380	CpG: 53	741	53	491	14.3	66.3	0.66
chr16	96104870	96106186	CpG: 158	1316	158	1019	24.0	77.4	0.80
chr16	96108682	96109180	CpG: 48	498	48	350	19.3	70.3	0.79
chr16	96133787	96134469	CpG: 83	682	83	544	24.3	79.8	0.92
chr16	96138720	96139391	CpG: 40	671	40	402	11.9	59.9	0.67
chr16	96163554	96163952	CpG: 30	398	30	259	15.1	65.1	0.72
chr16	96168354	96168977	CpG: 54	623	54	392	17.3	62.9	0.91
chr16	96180215	96180958	CpG: 69	743	69	532	18.6	71.6	0.73
chr16	96192349	96192808	CpG: 45	459	45	287	19.6	62.5	1.01
chr16	96259439	96259922	CpG: 34	483	34	332	14.1	68.7	0.62
chr16	96326175	96327783	CpG: 216	1608	216	1143	26.9	71.1	1.07
chr17	1677	2144	CpG: 45	467	45	304	19.3	65.1	1.80
chr17	39416	39934	CpG: 61	518	61	375	23.6	72.4	0.91
chr17	49126	49382	CpG: 36	256	36	187	28.1	73.0	1.11
chr17	49576	49820	CpG: 16	244	16	142	13.1	58.2	0.78
chr17	83432	85306	CpG: 255	1874	255	1437	27.2	76.7	0.93
chr17	94766	96353	CpG: 257	1587	257	1262	32.4	79.5	1.32
chr17	102257	103258	CpG: 70	1001	70	651	14.0	65.0	0.67
chr17	111270	112383	CpG: 78	1113	78	617	14.0	55.4	0.98
chr17	141333	141868	CpG: 37	535	37	325	13.8	60.7	0.77
chr17	156178	156493	CpG: 23	315	23	193	14.6	61.3	0.80
chr17	159619	164218	CpG: 302	4599	302	2557	13.1	55.6	0.87
chr17	170153	170370	CpG: 17	217	17	129	15.7	59.4	0.92
chr17	175058	175365	CpG: 23	307	23	181	15.0	59.0	0.87
chr17	179162	185336	CpG: 610	6174	610	4328	19.8	70.1	0.84
chr17	212007	212328	CpG: 22	321	22	206	13.7	64.2	0.67
chr17	214629	215503	CpG: 56	874	56	679	12.8	77.7	0.73
chr17	240765	241126	CpG: 29	361	29	250	16.1	69.3	0.69
chr17	254861	255082	CpG: 17	221	17	146	15.4	66.1	0.71
chr17	276529	279100	CpG: 256	2571	256	1697	19.9	66.0	1.12
chr17	280902	281196	CpG: 21	294	21	199	14.3	67.7	0.66
chr17	283482	283873	CpG: 37	391	37	285	18.9	72.9	0.71
chr17	289188	289419	CpG: 17	231	17	140	14.7	60.6	0.81
chr17	306874	308715	CpG: 192	1841	192	1377	20.9	74.8	0.75
chr17	324938	326468	CpG: 155	1530	155	938	20.3	61.3	1.18
chr17	331867	332494	CpG: 80	627	80	433	25.5	69.1	1.07
chr17	335196	335525	CpG: 25	329	25	207	15.2	62.9	0.80
chr17	363124	363372	CpG: 22	248	22	165	17.7	66.5	0.80
chr17	364922	365439	CpG: 39	517	39	335	15.1	64.8	0.73
chr17	372804	374949	CpG: 242	2145	242	1624	22.6	75.7	0.79
chr17	386248	386553	CpG: 30	305	30	209	19.7	68.5	0.84
chr17	448894	449173	CpG: 24	279	24	174	17.2	62.4	0.89
chr17	454661	455520	CpG: 70	859	70	596	16.3	69.4	0.68
chr17	487770	488025	CpG: 17	255	17	131	13.3	51.4	1.04
chr17	493479	493755	CpG: 20	276	20	164	14.5	59.4	0.84
chr17	501410	501874	CpG: 39	464	39	290	16.8	62.5	0.88
chr17	502731	503499	CpG: 54	768	54	467	14.1	60.8	0.79
chr17	538964	539199	CpG: 17	235	17	141	14.5	60.0	0.82
chr17	598232	598512	CpG: 23	280	23	166	16.4	59.3	0.94
chr17	598987	600160	CpG: 109	1173	109	775	18.6	66.1	0.86
chr17	612724	613061	CpG: 22	337	22	212	13.1	62.9	0.66
chr17	616764	618327	CpG: 196	1563	196	1164	25.1	74.5	0.90
chr17	636935	638753	CpG: 188	1818	188	1227	20.7	67.5	0.91
chr17	668293	669179	CpG: 89	886	89	566	20.1	63.9	0.99
chr17	679386	679730	CpG: 26	344	26	215	15.1	62.5	0.78
chr17	683637	683840	CpG: 15	203	15	130	14.8	64.0	0.75
chr17	691341	691620	CpG: 24	279	24	202	17.2	72.4	0.66
chr17	693603	693934	CpG: 25	331	25	229	15.1	69.2	0.64
chr17	695999	696621	CpG: 69	622	69	357	22.2	57.4	1.46
chr17	698211	698483	CpG: 22	272	22	165	16.2	60.7	0.89
chr17	727317	727799	CpG: 50	482	50	338	20.7	70.1	0.89
chr17	750134	750435	CpG: 30	301	30	179	19.9	59.5	1.14
chr17	754755	755030	CpG: 20	275	20	166	14.5	60.4	0.82
chr17	757224	757432	CpG: 15	208	15	113	14.4	54.3	0.98
chr17	772014	772239	CpG: 18	225	18	131	16.0	58.2	0.95
chr17	817100	817375	CpG: 19	275	19	156	13.8	56.7	0.87
chr17	831748	832041	CpG: 20	293	20	174	13.7	59.4	0.78
chr17	841969	842243	CpG: 22	274	22	168	16.1	61.3	0.86
chr17	850191	850427	CpG: 20	236	20	145	16.9	61.4	0.93
chr17	864887	866534	CpG: 198	1647	198	1267	24.0	76.9	0.81
chr17	883160	884211	CpG: 96	1051	96	675	18.3	64.2	0.89
chr17	893484	893825	CpG: 36	341	36	249	21.1	73.0	0.80
chr17	898934	899328	CpG: 33	394	33	262	16.8	66.5	0.76
chr17	900745	901025	CpG: 20	280	20	170	14.3	60.7	0.78
chr17	904691	904932	CpG: 17	241	17	147	14.1	61.0	0.78
chr17	906589	907240	CpG: 42	651	42	391	12.9	60.1	0.72
chr17	909583	909788	CpG: 20	205	20	153	19.5	74.6	0.83
chr17	910796	911038	CpG: 23	242	23	162	19.0	66.9	0.85
chr17	911569	911842	CpG: 20	273	20	168	14.7	61.5	0.79
chr17	916374	916645	CpG: 25	271	25	177	18.5	65.3	0.93
chr17	917826	919350	CpG: 122	1524	122	1068	16.0	70.1	0.66
chr17	930948	931188	CpG: 20	240	20	127	16.7	52.9	1.19
chr17	934986	935221	CpG: 18	235	18	142	15.3	60.4	0.85
chr17	937299	937818	CpG: 50	519	50	346	19.3	66.7	0.88
chr17	958632	959047	CpG: 35	415	35	284	16.9	68.4	0.78
chr17	964654	965650	CpG: 72	996	72	660	14.5	66.3	0.67
chr17	988140	988365	CpG: 19	225	19	138	16.9	61.3	0.92
chr17	994989	996113	CpG: 133	1124	133	861	23.7	76.6	0.81
chr17	1011689	1012117	CpG: 36	428	36	305	16.8	71.3	0.66
chr17	1034808	1035422	CpG: 44	614	44	347	14.3	56.5	0.90
chr17	1048627	1048989	CpG: 26	362	26	218	14.4	60.2	0.80
chr17	1068180	1069638	CpG: 161	1458	161	1092	22.1	74.9	0.79
chr17	1084128	1084360	CpG: 21	232	21	142	18.1	61.2	0.99
chr17	1085850	1086097	CpG: 18	247	18	150	14.6	60.7	0.81
chr17	1092173	1093548	CpG: 125	1375	125	950	18.2	69.1	0.77
chr17	1104361	1104622	CpG: 23	261	23	169	17.6	64.8	0.84
chr17	1119471	1121780	CpG: 262	2309	262	1656	22.7	71.7	0.88
chr17	1124175	1124412	CpG: 19	237	19	145	16.0	61.2	0.88
chr17	1138132	1138824	CpG: 52	692	52	475	15.0	68.6	0.64
chr17	1144891	1145449	CpG: 38	558	38	332	13.6	59.5	0.78
chr17	1150064	1151442	CpG: 103	1378	103	853	14.9	61.9	0.78
chr17	1158745	1162404	CpG: 279	3659	279	2320	15.3	63.4	0.76
chr17	1165697	1165898	CpG: 15	201	15	118	14.9	58.7	0.89
chr17	1212252	1212488	CpG: 19	236	19	143	16.1	60.6	0.88
chr17	1212880	1213174	CpG: 26	294	26	205	17.7	69.7	0.81
chr17	1230502	1230769	CpG: 23	267	23	165	17.2	61.8	0.92
chr17	1245845	1246170	CpG: 23	325	23	184	14.2	56.6	0.89
chr17	1246982	1247212	CpG: 17	230	17	138	14.8	60.0	0.84
chr17	1288036	1289319	CpG: 116	1283	116	853	18.1	66.5	0.84
chr17	1291897	1292637	CpG: 56	740	56	510	15.1	68.9	0.64
chr17	1298373	1298602	CpG: 20	229	20	142	17.5	62.0	0.93
chr17	1335335	1335615	CpG: 22	280	22	173	15.7	61.8	0.84
chr17	1344316	1345663	CpG: 139	1347	139	942	20.6	69.9	0.85
chr17	1346020	1346289	CpG: 19	269	19	168	14.1	62.5	0.73
chr17	1360645	1360889	CpG: 22	244	22	164	18.0	67.2	0.81
chr17	1367169	1367466	CpG: 26	297	26	203	17.5	68.4	0.75
chr17	1372876	1373225	CpG: 27	349	27	232	15.5	66.5	0.71
chr17	1374035	1377227	CpG: 317	3192	317	2247	19.9	70.4	0.80
chr17	1379741	1380835	CpG: 132	1094	132	833	24.1	76.1	0.85
chr17	1397588	1397913	CpG: 24	325	24	231	14.8	71.1	0.66
chr17	1404904	1406430	CpG: 138	1526	138	990	18.1	64.9	0.86
chr17	1410840	1411125	CpG: 24	285	24	179	16.8	62.8	0.87
chr17	1450568	1452038	CpG: 181	1470	181	1089	24.6	74.1	0.92
chr17	1455761	1455962	CpG: 15	201	15	117	14.9	58.2	0.89
chr17	1459210	1459561	CpG: 27	351	27	213	15.4	60.7	0.85
chr17	1463455	1463667	CpG: 16	212	16	139	15.1	65.6	0.72
chr17	1463992	1464622	CpG: 44	630	44	428	14.0	67.9	0.61
chr17	1477523	1477759	CpG: 23	236	23	162	19.5	68.6	0.83
chr17	1483341	1483572	CpG: 19	231	19	141	16.5	61.0	0.90
chr17	1495349	1495568	CpG: 19	219	19	145	17.4	66.2	0.80
chr17	1511079	1511321	CpG: 19	242	19	148	15.7	61.2	0.88
chr17	1516617	1518796	CpG: 228	2179	228	1560	20.9	71.6	0.84
chr17	1523925	1524361	CpG: 37	436	37	297	17.0	68.1	0.74
chr17	1531862	1532820	CpG: 121	958	121	752	25.3	78.5	0.85
chr17	1537226	1538745	CpG: 157	1519	157	1116	20.7	73.5	0.77
chr17	1562864	1563112	CpG: 18	248	18	151	14.5	60.9	0.80
chr17	1573180	1573896	CpG: 69	716	69	481	19.3	67.2	0.86
chr17	1574121	1574358	CpG: 18	237	18	146	15.2	61.6	0.82
chr17	1585359	1585583	CpG: 16	224	16	128	14.3	57.1	0.89
chr17	1598857	1599741	CpG: 88	884	88	646	19.9	73.1	0.76
chr17	1604611	1605697	CpG: 98	1086	98	748	18.0	68.9	0.78
chr17	1613010	1615528	CpG: 193	2518	193	1677	15.3	66.6	0.69
chr17	1622511	1623132	CpG: 54	621	54	424	17.4	68.3	0.75
chr17	1642848	1643078	CpG: 18	230	18	152	15.7	66.1	0.73
chr17	1646675	1646891	CpG: 18	216	18	130	16.7	60.2	0.92
chr17	1679563	1679796	CpG: 16	233	16	139	13.7	59.7	0.79
chr17	1694674	1694906	CpG: 20	232	20	141	17.2	60.8	0.94
chr17	1698350	1698563	CpG: 18	213	18	136	16.9	63.8	0.84
chr17	1718265	1719043	CpG: 91	778	91	562	23.4	72.2	0.90
chr17	1785042	1785257	CpG: 15	215	15	122	14.0	56.7	0.87
chr17	1794074	1794275	CpG: 17	201	17	124	16.9	61.7	0.89
chr17	1796975	1797599	CpG: 52	624	52	408	16.7	65.4	0.78
chr17	1801648	1801861	CpG: 15	213	15	126	14.1	59.2	0.84
chr17	1814899	1815173	CpG: 20	274	20	170	14.6	62.0	0.77
chr17	1823078	1823350	CpG: 19	272	19	179	14.0	65.8	0.65
chr17	1825476	1826696	CpG: 82	1220	82	813	13.4	66.6	0.61
chr17	1866289	1866912	CpG: 55	623	55	448	17.7	71.9	0.69
chr17	1886624	1888199	CpG: 149	1575	149	1099	18.9	69.8	0.78
chr17	1891148	1891384	CpG: 18	236	18	143	15.3	60.6	0.86
chr17	1892885	1893121	CpG: 17	236	17	138	14.4	58.5	0.87
chr17	1911639	1914049	CpG: 254	2410	254	1726	21.1	71.6	0.83
chr17	1914500	1914735	CpG: 18	235	18	143	15.3	60.9	0.85
chr17	1917782	1918496	CpG: 60	714	60	463	16.8	64.8	0.80
chr17	1929469	1930199	CpG: 89	730	89	525	24.4	71.9	0.94
chr17	1937529	1946609	CpG: 905	9080	905	6438	19.9	70.9	0.79
chr17	1999498	1999740	CpG: 18	242	18	143	14.9	59.1	0.88
chr17	2007153	2007415	CpG: 19	262	19	153	14.5	58.4	0.87
chr17	2104992	2105199	CpG: 15	207	15	121	14.5	58.5	0.85
chr17	2142368	2142646	CpG: 25	278	25	176	18.0	63.3	0.91
chr17	2164447	2164694	CpG: 19	247	19	144	15.4	58.3	0.92
chr17	2178314	2178544	CpG: 20	230	20	140	17.4	60.9	0.95
chr17	2188640	2188880	CpG: 21	240	21	146	17.5	60.8	0.97
chr17	2190304	2192096	CpG: 157	1792	157	1158	17.5	64.6	0.84
chr17	2204572	2204842	CpG: 23	270	23	165	17.0	61.1	0.92
chr17	2223673	2225590	CpG: 211	1917	211	1351	22.0	70.5	0.89
chr17	2232658	2232890	CpG: 16	232	16	139	13.8	59.9	0.80
chr17	2250862	2251246	CpG: 30	384	30	240	15.6	62.5	0.87
chr17	2260925	2261153	CpG: 22	228	22	172	19.3	75.4	0.68
chr17	2281327	2282978	CpG: 209	1651	209	1251	25.3	75.8	0.88
chr17	2287654	2291117	CpG: 307	3463	307	2320	17.7	67.0	0.79
chr17	2297429	2297654	CpG: 21	225	21	138	18.7	61.3	1.01
chr17	2312820	2313094	CpG: 24	274	24	171	17.5	62.4	0.91
chr17	2319118	2319390	CpG: 20	272	20	164	14.7	60.3	0.81
chr17	2400575	2400876	CpG: 25	301	25	173	16.6	57.5	1.01
chr17	2421136	2421620	CpG: 39	484	39	353	16.1	72.9	0.61
chr17	2481534	2481751	CpG: 15	217	15	132	13.8	60.8	0.77
chr17	2482386	2483916	CpG: 166	1530	166	1112	21.7	72.7	0.82
chr17	2506018	2506258	CpG: 16	240	16	133	13.3	55.4	0.87
chr17	2562547	2562821	CpG: 22	274	22	170	16.1	62.0	0.85
chr17	2578864	2582098	CpG: 235	3234	235	2183	14.5	67.5	0.64
chr17	2584075	2584624	CpG: 37	549	37	361	13.5	65.8	0.62
chr17	2586799	2587804	CpG: 88	1005	88	674	17.5	67.1	0.78
chr17	2593558	2593828	CpG: 23	270	23	180	17.0	66.7	0.77
chr17	2600142	2601452	CpG: 157	1310	157	941	24.0	71.8	0.93
chr17	2613151	2614711	CpG: 166	1560	166	1117	21.3	71.6	0.83
chr17	2617572	2617798	CpG: 17	226	17	138	15.0	61.1	0.82
chr17	2638361	2639279	CpG: 108	918	108	717	23.5	78.1	0.78
chr17	2644276	2645289	CpG: 116	1013	116	729	22.9	72.0	0.89
chr17	2665625	2666375	CpG: 95	750	95	565	25.3	75.3	0.91
chr17	2741164	2743001	CpG: 211	1837	211	1334	23.0	72.6	0.88
chr17	2815552	2815822	CpG: 23	270	23	166	17.0	61.5	0.92
chr17	2892593	2892816	CpG: 18	223	18	155	16.1	69.5	0.67
chr17	2936949	2937345	CpG: 36	396	36	255	18.2	64.4	0.88
chr17	3000659	3001732	CpG: 79	1073	79	736	14.7	68.6	0.63
chr17	3064819	3065246	CpG: 31	427	31	258	14.5	60.4	0.80
chr17	3141871	3142160	CpG: 23	289	23	178	15.9	61.6	0.86
chr17	3221250	3221482	CpG: 18	232	18	138	15.5	59.5	0.88
chr17	3275007	3275717	CpG: 81	710	81	484	22.8	68.2	1.00
chr17	3353005	3354123	CpG: 87	1118	87	797	15.6	71.3	0.61
chr17	3360615	3360846	CpG: 33	231	33	161	28.6	69.7	1.21
chr17	3421537	3421748	CpG: 18	211	18	128	17.1	60.7	0.93
chr17	3424464	3424936	CpG: 45	472	45	312	19.1	66.1	0.87
chr17	3453307	3453945	CpG: 49	638	49	436	15.4	68.3	0.66
chr17	3457078	3457282	CpG: 17	204	17	123	16.7	60.3	0.93
chr17	3478747	3479072	CpG: 24	325	24	207	14.8	63.7	0.75
chr17	3512986	3513238	CpG: 17	252	17	154	13.5	61.1	0.72
chr17	3524357	3524596	CpG: 24	239	24	150	20.1	62.8	1.05
chr17	3525089	3526255	CpG: 114	1166	114	819	19.6	70.2	0.79
chr17	3556985	3558379	CpG: 149	1394	149	970	21.4	69.6	0.88
chr17	3563081	3563367	CpG: 23	286	23	174	16.1	60.8	0.87
chr17	3575356	3575576	CpG: 17	220	17	167	15.5	75.9	0.62
chr17	3584352	3584996	CpG: 66	644	66	449	20.5	69.7	0.85
chr17	3612218	3613133	CpG: 111	915	111	651	24.3	71.1	0.97
chr17	3665596	3665871	CpG: 19	275	19	167	13.8	60.7	0.76
chr17	3672595	3672846	CpG: 22	251	22	156	17.5	62.2	0.92
chr17	3734519	3735159	CpG: 76	640	76	479	23.8	74.8	0.87
chr17	3742446	3743217	CpG: 65	771	65	532	16.9	69.0	0.71
chr17	3746806	3747037	CpG: 18	231	18	140	15.6	60.6	0.87
chr17	3755039	3755250	CpG: 17	211	17	144	16.1	68.2	0.69
chr17	3756660	3757012	CpG: 27	352	27	218	15.3	61.9	0.86
chr17	3757480	3757895	CpG: 32	415	32	245	15.4	59.0	0.91
chr17	3777126	3777485	CpG: 36	359	36	244	20.1	68.0	0.89
chr17	3780851	3782199	CpG: 164	1348	164	1027	24.3	76.2	0.85
chr17	3787852	3788075	CpG: 17	223	17	134	15.2	60.1	0.85
chr17	3813749	3814091	CpG: 28	342	28	228	16.4	66.7	0.74
chr17	3830254	3830551	CpG: 30	297	30	202	20.2	68.0	0.87
chr17	3833951	3834522	CpG: 60	571	60	431	21.0	75.5	0.75
chr17	3836666	3837085	CpG: 43	419	43	286	20.5	68.3	0.88
chr17	3853010	3854046	CpG: 138	1036	138	805	26.6	77.7	0.88
chr17	3874363	3874688	CpG: 22	325	22	209	13.5	64.3	1.04
chr17	3893288	3893613	CpG: 27	325	27	227	16.6	69.8	0.70
chr17	3893903	3894287	CpG: 36	384	36	261	18.8	68.0	0.83
chr17	3965400	3965685	CpG: 23	285	23	176	16.1	61.8	0.86
chr17	4012238	4012473	CpG: 18	235	18	138	15.3	58.7	0.92
chr17	4031748	4033322	CpG: 157	1574	157	1026	19.9	65.2	0.94
chr17	4062156	4062389	CpG: 21	233	21	140	18.0	60.1	1.02
chr17	4091664	4091937	CpG: 21	273	21	163	15.4	59.7	0.87
chr17	4111219	4111521	CpG: 39	302	39	240	25.8	79.5	0.82
chr17	4152651	4153299	CpG: 75	648	75	458	23.1	70.7	0.94
chr17	4204706	4204942	CpG: 20	236	20	144	16.9	61.0	0.93
chr17	4237538	4237812	CpG: 23	274	23	169	16.8	61.7	0.89
chr17	4253582	4254141	CpG: 39	559	39	335	14.0	59.9	0.79
chr17	4254593	4256123	CpG: 189	1530	189	1158	24.7	75.7	0.87
chr17	4388555	4389919	CpG: 159	1364	159	1026	23.3	75.2	0.82
chr17	4408131	4408409	CpG: 21	278	21	172	15.1	61.9	0.80
chr17	4425906	4426311	CpG: 32	405	32	277	15.8	68.4	0.68
chr17	4434572	4435207	CpG: 45	635	45	433	14.2	68.2	0.65
chr17	4444784	4445585	CpG: 73	801	73	518	18.2	64.7	0.89
chr17	4468271	4468811	CpG: 43	540	43	376	15.9	69.6	0.66
chr17	4473980	4475064	CpG: 136	1084	136	835	25.1	77.0	0.85
chr17	4484982	4485220	CpG: 22	238	22	162	18.5	68.1	0.80
chr17	4486568	4486774	CpG: 18	206	18	143	17.5	69.4	0.73
chr17	4496994	4497217	CpG: 17	223	17	140	15.2	62.8	0.78
chr17	4529161	4531377	CpG: 151	2216	151	1401	13.6	63.2	0.69
chr17	4545416	4545654	CpG: 17	238	17	131	14.3	55.0	0.97
chr17	4546210	4546782	CpG: 52	572	52	415	18.2	72.6	0.69
chr17	4547022	4547292	CpG: 21	270	21	160	15.6	59.3	0.89
chr17	4593421	4594356	CpG: 84	935	84	605	18.0	64.7	0.86
chr17	4598868	4599282	CpG: 37	414	37	299	17.9	72.2	0.69
chr17	4599844	4600867	CpG: 100	1023	100	724	19.6	70.8	0.82
chr17	4620930	4621593	CpG: 51	663	51	411	15.4	62.0	0.81
chr17	4628413	4629785	CpG: 133	1372	133	948	19.4	69.1	0.82
chr17	4635368	4635653	CpG: 26	285	26	215	18.2	75.4	0.67
chr17	4672020	4672673	CpG: 49	653	49	403	15.0	61.7	0.79
chr17	4674981	4676008	CpG: 81	1027	81	658	15.8	64.1	0.77
chr17	4676707	4676985	CpG: 23	278	23	169	16.5	60.8	0.90
chr17	4678597	4680325	CpG: 173	1728	173	1192	20.0	69.0	0.84
chr17	4684501	4684784	CpG: 24	283	24	175	17.0	61.8	0.90
chr17	4695516	4695766	CpG: 18	250	18	145	14.4	58.0	0.88
chr17	4696575	4697520	CpG: 123	945	123	736	26.0	77.9	0.87
chr17	4710494	4710855	CpG: 25	361	25	204	13.9	56.5	0.88
chr17	4722695	4723363	CpG: 95	668	95	516	28.4	77.2	0.96
chr17	4756974	4757217	CpG: 21	243	21	153	17.3	63.0	0.89
chr17	4770853	4771125	CpG: 20	272	20	167	14.7	61.4	0.80
chr17	4779838	4780071	CpG: 22	233	22	167	18.9	71.7	0.74
chr17	4789222	4792355	CpG: 238	3133	238	2074	15.2	66.2	0.69
chr17	4797527	4797773	CpG: 21	246	21	151	17.1	61.4	0.94
chr17	4829911	4830689	CpG: 80	778	80	502	20.6	64.5	0.99
chr17	4837995	4840959	CpG: 267	2964	267	2007	18.0	67.7	0.79
chr17	4857218	4858739	CpG: 105	1521	105	938	13.8	61.7	0.74
chr17	4877317	4878027	CpG: 76	710	76	527	21.4	74.2	0.80
chr17	4887386	4888827	CpG: 167	1441	167	1088	23.2	75.5	0.82
chr17	4921919	4922203	CpG: 37	284	37	215	26.1	75.7	1.04
chr17	4951226	4951506	CpG: 24	280	24	171	17.1	61.1	0.93
chr17	4970771	4971065	CpG: 22	294	22	166	15.0	56.5	0.96
chr17	4971449	4972071	CpG: 70	622	70	414	22.5	66.6	1.05
chr17	4977673	4977947	CpG: 24	274	24	171	17.5	62.4	0.91
chr17	4990444	4991280	CpG: 77	836	77	561	18.4	67.1	0.82
chr17	5004782	5005433	CpG: 65	651	65	449	20.0	69.0	0.85
chr17	5005883	5006112	CpG: 19	229	19	139	16.6	60.7	0.92
chr17	5009135	5010102	CpG: 92	967	92	661	19.0	68.4	0.81
chr17	5015883	5017315	CpG: 132	1432	132	997	18.4	69.6	0.76
chr17	5084893	5085619	CpG: 75	726	75	497	20.7	68.5	0.89
chr17	5143011	5143287	CpG: 20	276	20	163	14.5	59.1	0.84
chr17	5171771	5172001	CpG: 17	230	17	138	14.8	60.0	0.84
chr17	5175771	5176612	CpG: 125	841	125	667	29.7	79.3	0.95
chr17	5238226	5238460	CpG: 17	234	17	138	14.5	59.0	0.87
chr17	5312923	5314132	CpG: 95	1209	95	737	15.7	61.0	0.84
chr17	5332545	5333049	CpG: 67	504	67	369	26.6	73.2	0.99
chr17	5338067	5338292	CpG: 17	225	17	141	15.1	62.7	0.80
chr17	5362271	5362741	CpG: 45	470	45	335	19.1	71.3	0.76
chr17	5379813	5380707	CpG: 83	894	83	583	18.6	65.2	0.88
chr17	5393548	5395019	CpG: 118	1471	118	959	16.0	65.2	0.76
chr17	5455219	5455500	CpG: 23	281	23	174	16.4	61.9	0.87
chr17	5539804	5540082	CpG: 21	278	21	170	15.1	61.2	0.81
chr17	5615624	5616045	CpG: 38	421	38	281	18.1	66.7	0.81
chr17	5665317	5665868	CpG: 56	551	56	411	20.3	74.6	0.73
chr17	5666634	5666911	CpG: 21	277	21	155	15.2	56.0	1.02
chr17	5804891	5805172	CpG: 21	281	21	170	14.9	60.5	0.83
chr17	5964393	5965330	CpG: 137	937	137	747	29.2	79.7	0.93
chr17	5974967	5975293	CpG: 28	326	28	241	17.2	73.9	0.63
chr17	6014516	6014947	CpG: 38	431	38	287	17.6	66.6	0.80
chr17	6083088	6083324	CpG: 19	236	19	144	16.1	61.0	0.89
chr17	6125331	6126026	CpG: 49	695	49	466	14.1	67.1	0.63
chr17	6325349	6325567	CpG: 17	218	17	147	15.6	67.4	0.71
chr17	6343871	6344517	CpG: 63	646	63	436	19.5	67.5	0.94
chr17	6354819	6355373	CpG: 51	554	51	392	18.4	70.8	0.74
chr17	6455664	6456837	CpG: 152	1173	152	910	25.9	77.6	0.86
chr17	6540665	6541874	CpG: 99	1209	99	802	16.4	66.3	0.76
chr17	6552141	6552895	CpG: 76	754	76	518	20.2	68.7	0.86
chr17	6555531	6555751	CpG: 23	220	23	153	20.9	69.5	0.87
chr17	6556622	6558042	CpG: 98	1420	98	912	13.8	64.2	0.68
chr17	6613737	6614786	CpG: 99	1049	99	734	18.9	70.0	0.77
chr17	6676529	6677034	CpG: 50	505	50	355	19.8	70.3	0.81
chr17	6732597	6732807	CpG: 21	210	21	144	20.0	68.6	0.85
chr17	6794809	6795104	CpG: 21	295	21	194	14.2	65.8	0.66
chr17	6852466	6852709	CpG: 20	243	20	149	16.5	61.3	0.91
chr17	6872109	6872381	CpG: 24	272	24	172	17.6	63.2	0.89
chr17	6896195	6897802	CpG: 129	1607	129	1096	16.1	68.2	0.69
chr17	6909703	6909973	CpG: 19	270	19	168	14.1	62.2	0.74
chr17	6913130	6913707	CpG: 44	577	44	376	15.3	65.2	0.72
chr17	6914875	6915820	CpG: 102	945	102	660	21.6	69.8	0.89
chr17	6922681	6924808	CpG: 141	2127	141	1349	13.3	63.4	0.66
chr17	6936469	6937422	CpG: 77	953	77	639	16.2	67.1	0.72
chr17	6942744	6944876	CpG: 169	2132	169	1467	15.9	68.8	0.67
chr17	6957483	6957758	CpG: 25	275	25	172	18.2	62.5	0.94
chr17	6963233	6963457	CpG: 17	224	17	131	15.2	58.5	0.91
chr17	7001254	7001732	CpG: 46	478	46	350	19.2	73.2	0.72
chr17	7034172	7034433	CpG: 20	261	20	146	15.3	55.9	1.01
chr17	7061273	7061534	CpG: 20	261	20	157	15.3	60.2	0.86
chr17	7074616	7075483	CpG: 68	867	68	587	15.7	67.7	0.68
chr17	7105895	7106245	CpG: 24	350	24	227	13.7	64.9	0.66
chr17	7112419	7112783	CpG: 31	364	31	252	17.0	69.2	0.79
chr17	7115188	7115677	CpG: 41	489	41	335	16.8	68.5	0.77
chr17	7120630	7121310	CpG: 66	680	66	478	19.4	70.3	0.80
chr17	7134966	7135741	CpG: 76	775	76	515	19.6	66.5	0.92
chr17	7138729	7140677	CpG: 173	1948	173	1373	17.8	70.5	0.84
chr17	7143115	7144312	CpG: 101	1197	101	713	16.9	59.6	0.95
chr17	7152028	7153730	CpG: 138	1702	138	1156	16.2	67.9	0.72
chr17	7161889	7163849	CpG: 180	1960	180	1343	18.4	68.5	0.78
chr17	7181649	7183312	CpG: 126	1663	126	1089	15.2	65.5	0.71
chr17	7191221	7191437	CpG: 18	216	18	146	16.7	67.6	0.74
chr17	7195055	7197629	CpG: 217	2574	217	1681	16.9	65.3	0.81
chr17	7198418	7198664	CpG: 18	246	18	136	14.6	55.3	1.00
chr17	7202367	7202606	CpG: 18	239	18	145	15.1	60.7	0.84
chr17	7210143	7210376	CpG: 16	233	16	139	13.7	59.7	0.79
chr17	7210467	7210697	CpG: 18	230	18	139	15.7	60.4	0.87
chr17	7210889	7212405	CpG: 163	1516	163	1034	21.5	68.2	1.00
chr17	7218840	7219625	CpG: 98	785	98	582	25.0	74.1	0.91
chr17	7228081	7228363	CpG: 22	282	22	190	15.6	67.4	0.69
chr17	7232995	7233817	CpG: 84	822	84	564	20.4	68.6	0.87
chr17	7253965	7256474	CpG: 214	2509	214	1706	17.1	68.0	0.74
chr17	7284941	7285405	CpG: 46	464	46	340	19.8	73.3	0.74
chr17	7287918	7288660	CpG: 69	742	69	523	18.6	70.5	0.75
chr17	7297227	7299189	CpG: 151	1962	151	1340	15.4	68.3	0.66
chr17	7307930	7309799	CpG: 153	1869	153	1273	16.4	68.1	0.72
chr17	7312333	7312788	CpG: 59	455	59	339	25.9	74.5	0.94
chr17	7321100	7321674	CpG: 55	574	55	420	19.2	73.2	0.73
chr17	7339830	7342599	CpG: 221	2769	221	1811	16.0	65.4	0.75
chr17	7343565	7344763	CpG: 93	1198	93	811	15.5	67.7	0.68
chr17	7349014	7349570	CpG: 46	556	46	392	16.5	70.5	0.68
chr17	7350919	7351185	CpG: 27	266	27	172	20.3	64.7	0.98
chr17	7359876	7360402	CpG: 38	526	38	306	14.4	58.2	0.85
chr17	7366643	7366950	CpG: 25	307	25	218	16.3	71.0	0.65
chr17	7369719	7369962	CpG: 20	243	20	154	16.5	63.4	0.87
chr17	7382993	7383930	CpG: 108	937	108	724	23.1	77.3	0.80
chr17	7384490	7384723	CpG: 17	233	17	141	14.6	60.5	0.82
chr17	7388259	7389054	CpG: 66	795	66	503	16.6	63.3	0.83
chr17	7453114	7453609	CpG: 58	495	58	383	23.4	77.4	0.79
chr17	7465610	7466767	CpG: 124	1157	124	799	21.4	69.1	0.90
chr17	7476845	7478259	CpG: 142	1414	142	964	20.1	68.2	0.89
chr17	7487217	7488363	CpG: 95	1146	95	719	16.6	62.7	0.84
chr17	7488962	7489198	CpG: 17	236	17	139	14.4	58.9	0.84
chr17	7493246	7493877	CpG: 60	631	60	444	19.0	70.4	0.77
chr17	7518593	7519651	CpG: 112	1058	112	751	21.2	71.0	0.86
chr17	7520591	7520886	CpG: 20	295	20	163	13.6	55.3	0.90
chr17	7530164	7530375	CpG: 16	211	16	127	15.2	60.2	0.85
chr17	7531588	7532134	CpG: 43	546	43	356	15.8	65.2	0.74
chr17	7544931	7545166	CpG: 23	235	23	170	19.6	72.3	0.75
chr17	7554977	7556178	CpG: 113	1201	113	827	18.8	68.9	0.80
chr17	7586398	7586615	CpG: 17	217	17	128	15.7	59.0	0.92
chr17	7590076	7590289	CpG: 23	213	23	135	21.6	63.4	1.08
chr17	7592280	7592625	CpG: 36	345	36	217	20.9	62.9	1.06
chr17	7600462	7600698	CpG: 16	236	16	142	13.6	60.2	0.76
chr17	7608864	7609758	CpG: 76	894	76	637	17.0	71.3	0.68
chr17	7621060	7621927	CpG: 68	867	68	591	15.7	68.2	0.69
chr17	7644631	7645145	CpG: 43	514	43	327	16.7	63.6	0.83
chr17	7671921	7672190	CpG: 18	269	18	162	13.4	60.2	0.76
chr17	7690921	7691187	CpG: 23	266	23	166	17.3	62.4	0.89
chr17	7737923	7740722	CpG: 203	2799	203	1867	14.5	66.7	0.65
chr17	7742632	7742884	CpG: 21	252	21	169	16.7	67.1	0.83
chr17	7746961	7750419	CpG: 264	3458	264	2268	15.3	65.6	0.72
chr17	7756924	7757590	CpG: 56	666	56	428	16.8	64.3	0.81
chr17	7758578	7759659	CpG: 83	1081	83	678	15.4	62.7	0.80
chr17	7760615	7760988	CpG: 36	373	36	254	19.3	68.1	0.84
chr17	7762289	7763688	CpG: 105	1399	105	824	15.0	58.9	0.87
chr17	7789935	7791156	CpG: 163	1221	163	956	26.7	78.3	0.89
chr17	7814589	7814811	CpG: 27	222	27	164	24.3	73.9	0.90
chr17	7821028	7821853	CpG: 105	825	105	587	25.5	71.2	1.01
chr17	7828237	7828524	CpG: 30	287	30	190	20.9	66.2	0.99
chr17	7834642	7835274	CpG: 60	632	60	453	19.0	71.7	0.78
chr17	7837281	7837679	CpG: 40	398	40	273	20.1	68.6	0.85
chr17	7895423	7896320	CpG: 72	897	72	584	16.1	65.1	0.76
chr17	7908022	7909538	CpG: 142	1516	142	1104	18.7	72.8	0.71
chr17	7911802	7912134	CpG: 29	332	29	223	17.5	67.2	0.78
chr17	7921115	7921961	CpG: 65	846	65	586	15.4	69.3	0.65
chr17	7969372	7969594	CpG: 19	222	19	169	17.1	76.1	0.72
chr17	7984486	7985687	CpG: 110	1201	110	797	18.3	66.4	0.84
chr17	8014533	8015843	CpG: 95	1310	95	884	14.5	67.5	0.66
chr17	8024107	8024363	CpG: 23	256	23	173	18.0	67.6	0.79
chr17	8026017	8026323	CpG: 23	306	23	194	15.0	63.4	0.82
chr17	8026815	8028919	CpG: 179	2104	179	1420	17.0	67.5	0.75
chr17	8030838	8032147	CpG: 101	1309	101	818	15.4	62.5	0.82
chr17	8042533	8042767	CpG: 18	234	18	143	15.4	61.1	0.84
chr17	8044050	8044486	CpG: 39	436	39	253	17.9	58.0	1.07
chr17	8045199	8045428	CpG: 17	229	17	137	14.8	59.8	0.83
chr17	8056647	8057932	CpG: 88	1285	88	837	13.7	65.1	0.65
chr17	8061652	8062359	CpG: 62	707	62	451	17.5	63.8	0.87
chr17	8062923	8063152	CpG: 20	229	20	138	17.5	60.3	0.98
chr17	8067864	8068678	CpG: 112	814	112	630	27.5	77.4	0.93
chr17	8078183	8078419	CpG: 20	236	20	144	16.9	61.0	0.93
chr17	8082332	8082967	CpG: 55	635	55	417	17.3	65.7	0.81
chr17	8084150	8084390	CpG: 17	240	17	143	14.2	59.6	0.81
chr17	8091099	8091370	CpG: 20	271	20	165	14.8	60.9	0.81
chr17	8092252	8093111	CpG: 64	859	64	510	14.9	59.4	0.85
chr17	8095264	8096552	CpG: 135	1288	135	891	21.0	69.2	0.88
chr17	8107025	8107262	CpG: 19	237	19	139	16.0	58.6	0.99
chr17	8116504	8116838	CpG: 27	334	27	222	16.2	66.5	0.77
chr17	8117080	8117285	CpG: 15	205	15	116	14.6	56.6	0.92
chr17	8127614	8128098	CpG: 43	484	43	288	17.8	59.5	1.01
chr17	8129065	8129396	CpG: 34	331	34	218	20.5	65.9	0.95
chr17	8154029	8154548	CpG: 39	519	39	319	15.0	61.5	0.80
chr17	8154807	8155125	CpG: 25	318	25	199	15.7	62.6	0.83
chr17	8155424	8155743	CpG: 37	319	37	203	23.2	63.6	1.15
chr17	8166872	8167146	CpG: 21	274	21	171	15.3	62.4	0.80
chr17	8194629	8195419	CpG: 65	790	65	512	16.5	64.8	0.78
chr17	8201361	8202091	CpG: 64	730	64	486	17.5	66.6	0.80
chr17	8233113	8233859	CpG: 62	746	62	507	16.6	68.0	0.73
chr17	8240020	8240231	CpG: 16	211	16	126	15.2	59.7	0.87
chr17	8253340	8253732	CpG: 38	392	38	289	19.4	73.7	0.72
chr17	8282656	8283012	CpG: 32	356	32	244	18.0	68.5	0.78
chr17	8289271	8290231	CpG: 83	960	83	633	17.3	65.9	0.80
chr17	8290444	8290724	CpG: 21	280	21	168	15.0	60.0	0.83
chr17	8298764	8299185	CpG: 37	421	37	311	17.6	73.9	0.65
chr17	8341853	8342811	CpG: 97	958	97	682	20.3	71.2	0.80
chr17	8383014	8383381	CpG: 28	367	28	226	15.3	61.6	0.81
chr17	8508093	8508317	CpG: 18	224	18	127	16.1	56.7	1.03
chr17	8535783	8537712	CpG: 188	1929	188	1387	19.5	71.9	0.78
chr17	8588161	8588410	CpG: 21	249	21	152	16.9	61.0	0.91
chr17	8624187	8624545	CpG: 32	358	32	266	17.9	74.3	0.65
chr17	8637959	8638250	CpG: 21	291	21	164	14.4	56.4	0.91
chr17	8651244	8652257	CpG: 86	1013	86	660	17.0	65.2	0.80
chr17	8705224	8705706	CpG: 52	482	52	374	21.6	77.6	0.72
chr17	8795313	8795847	CpG: 35	534	35	350	13.1	65.5	0.61
chr17	8872317	8873632	CpG: 110	1315	110	881	16.7	67.0	0.75
chr17	8910095	8911939	CpG: 206	1844	206	1280	22.3	69.4	0.93
chr17	8928014	8930768	CpG: 354	2754	354	1997	25.7	72.5	0.98
chr17	9022844	9023055	CpG: 23	211	23	149	21.8	70.6	0.92
chr17	9069883	9070119	CpG: 19	236	19	157	16.1	66.5	0.73
chr17	9146673	9147532	CpG: 96	859	96	622	22.4	72.4	0.86
chr17	9195386	9195623	CpG: 20	237	20	143	16.9	60.3	0.95
chr17	9208541	9208785	CpG: 18	244	18	137	14.8	56.1	0.94
chr17	9259498	9259739	CpG: 19	241	19	145	15.8	60.2	0.90
chr17	9356937	9357163	CpG: 20	226	20	142	17.7	62.8	0.90
chr17	9401715	9401951	CpG: 20	236	20	147	16.9	62.3	0.90
chr17	9466245	9466511	CpG: 24	266	24	169	18.0	63.5	0.91
chr17	9483386	9483604	CpG: 26	218	26	154	23.9	70.6	1.00
chr17	9523715	9524142	CpG: 32	427	32	256	15.0	60.0	0.84
chr17	9538193	9538441	CpG: 21	248	21	155	16.9	62.5	0.88
chr17	9552802	9554029	CpG: 127	1227	127	856	20.7	69.8	0.85
chr17	9679261	9679672	CpG: 32	411	32	260	15.6	63.3	0.78
chr17	9785401	9785619	CpG: 16	218	16	128	14.7	58.7	0.86
chr17	9789134	9789364	CpG: 20	230	20	141	17.4	61.3	0.94
chr17	9812485	9812757	CpG: 21	272	21	169	15.4	62.1	0.82
chr17	9835879	9836111	CpG: 17	232	17	131	14.7	56.5	0.94
chr17	9916767	9917042	CpG: 24	275	24	170	17.5	61.8	0.92
chr17	9965063	9965394	CpG: 30	331	30	254	18.1	76.7	0.62
chr17	10054408	10054673	CpG: 20	265	20	154	15.1	58.1	0.91
chr17	10105468	10106875	CpG: 172	1407	172	1061	24.4	75.4	0.86
chr17	10185205	10185477	CpG: 20	272	20	165	14.7	60.7	0.81
chr17	10234538	10234816	CpG: 24	278	24	174	17.3	62.6	0.89
chr17	10246237	10246512	CpG: 20	275	20	166	14.5	60.4	0.81
chr17	10290233	10290477	CpG: 24	244	24	144	19.7	59.0	1.14
chr17	10297034	10297274	CpG: 20	240	20	149	16.7	62.1	0.88
chr17	10307431	10307667	CpG: 17	236	17	142	14.4	60.2	0.83
chr17	10348225	10348463	CpG: 18	238	18	143	15.1	60.1	0.86
chr17	10373288	10373562	CpG: 23	274	23	170	16.8	62.0	0.88
chr17	10402968	10403242	CpG: 21	274	21	168	15.3	61.3	0.83
chr17	10479898	10480137	CpG: 19	239	19	144	15.9	60.3	0.90
chr17	10526386	10526769	CpG: 28	383	28	227	14.6	59.3	0.84
chr17	10545814	10546047	CpG: 20	233	20	152	17.2	65.2	0.84
chr17	10596387	10596661	CpG: 24	274	24	171	17.5	62.4	0.91
chr17	10604660	10605435	CpG: 79	775	79	537	20.4	69.3	0.85
chr17	10637022	10637724	CpG: 77	702	77	492	21.9	70.1	0.89
chr17	10892795	10893070	CpG: 24	275	24	170	17.5	61.8	0.92
chr17	10939029	10939303	CpG: 24	274	24	171	17.5	62.4	0.91
chr17	11097764	11098006	CpG: 19	242	19	144	15.7	59.5	0.92
chr17	11148387	11150304	CpG: 267	1917	267	1445	27.9	75.4	0.98
chr17	11358169	11358408	CpG: 17	239	17	142	14.2	59.4	0.82
chr17	11410347	11410617	CpG: 23	270	23	167	17.0	61.9	0.90
chr17	11465870	11466472	CpG: 46	602	46	397	15.3	65.9	0.71
chr17	11506713	11507410	CpG: 77	697	77	504	22.1	72.3	0.86
chr17	11570852	11571138	CpG: 25	286	25	179	17.5	62.6	0.90
chr17	11780566	11780788	CpG: 19	222	19	133	17.1	59.9	0.99
chr17	11905130	11905672	CpG: 68	542	68	404	25.1	74.5	0.90
chr17	11928616	11929536	CpG: 124	920	124	720	27.0	78.3	0.89
chr17	11974709	11974971	CpG: 25	262	25	166	19.1	63.4	0.96
chr17	12057207	12057437	CpG: 19	230	19	140	16.5	60.9	0.91
chr17	12098186	12098462	CpG: 21	276	21	167	15.2	60.5	0.85
chr17	12128721	12129233	CpG: 57	512	57	388	22.3	75.8	0.78
chr17	12288420	12288693	CpG: 20	273	20	171	14.7	62.6	0.76
chr17	12363088	12363330	CpG: 22	242	22	148	18.2	61.2	0.97
chr17	12572822	12573490	CpG: 70	668	70	453	21.0	67.8	0.92
chr17	12606291	12606502	CpG: 17	211	17	126	16.1	59.7	0.93
chr17	12657369	12657631	CpG: 20	262	20	159	15.3	60.7	0.84
chr17	12696907	12697860	CpG: 105	953	105	692	22.0	72.6	0.84
chr17	12881414	12881917	CpG: 44	503	44	345	17.5	68.6	0.75
chr17	12882981	12883217	CpG: 16	236	16	144	13.6	61.0	0.75
chr17	12907141	12907410	CpG: 21	269	21	164	15.6	61.0	0.85
chr17	12925100	12925710	CpG: 74	610	74	405	24.3	66.4	1.10
chr17	13308430	13308667	CpG: 18	237	18	144	15.2	60.8	0.84
chr17	13403613	13403943	CpG: 36	330	36	219	21.8	66.4	1.00
chr17	13507698	13509427	CpG: 196	1729	196	1262	22.7	73.0	0.85
chr17	13626858	13627137	CpG: 25	279	25	174	17.9	62.4	0.93
chr17	13803895	13804169	CpG: 25	274	25	173	18.2	63.1	0.92
chr17	13884402	13884667	CpG: 25	265	25	167	18.9	63.0	0.97
chr17	13976772	13977578	CpG: 62	806	62	514	15.4	63.8	0.76
chr17	14114675	14115052	CpG: 30	377	30	256	15.9	67.9	0.71
chr17	14203373	14204846	CpG: 109	1473	109	927	14.8	62.9	0.75
chr17	14205426	14206052	CpG: 48	626	48	389	15.3	62.1	0.80
chr17	14206965	14210499	CpG: 298	3534	298	2272	16.9	64.3	0.82
chr17	14215159	14215685	CpG: 58	526	58	388	22.1	73.8	0.81
chr17	14251252	14251582	CpG: 36	330	36	219	21.8	66.4	1.00
chr17	14321130	14321355	CpG: 17	225	17	132	15.1	58.7	0.89
chr17	14336586	14336871	CpG: 24	285	24	179	16.8	62.8	0.87
chr17	14455859	14456099	CpG: 22	240	22	149	18.3	62.1	0.97
chr17	14642217	14642453	CpG: 18	236	18	142	15.3	60.2	0.87
chr17	14750238	14750508	CpG: 22	270	22	166	16.3	61.5	0.87
chr17	14941285	14941518	CpG: 17	233	17	137	14.6	58.8	0.88
chr17	14965663	14965944	CpG: 24	281	24	175	17.1	62.3	0.90
chr17	15031435	15031683	CpG: 23	248	23	150	18.5	60.5	1.04
chr17	15048809	15049037	CpG: 17	228	17	137	14.9	60.1	0.84
chr17	15065864	15066103	CpG: 19	239	19	143	15.9	59.8	0.91
chr17	15166620	15167500	CpG: 77	880	77	581	17.5	66.0	0.80
chr17	15168486	15169196	CpG: 55	710	55	460	15.5	64.8	0.74
chr17	15205335	15205617	CpG: 24	282	24	174	17.0	61.7	0.91
chr17	15247418	15247839	CpG: 36	421	36	286	17.1	67.9	0.75
chr17	15323077	15323300	CpG: 19	223	19	132	17.0	59.2	1.00
chr17	15384039	15384324	CpG: 25	285	25	178	17.5	62.5	0.92
chr17	15411934	15412313	CpG: 33	379	33	276	17.4	72.8	0.66
chr17	15445563	15445799	CpG: 20	236	20	145	16.9	61.4	0.91
chr17	15469278	15469960	CpG: 68	682	68	487	19.9	71.4	0.78
chr17	15508871	15509153	CpG: 25	282	25	181	17.7	64.2	0.87
chr17	15520430	15520714	CpG: 21	284	21	170	14.8	59.9	0.83
chr17	15533671	15533949	CpG: 23	278	23	174	16.5	62.6	0.86
chr17	15590511	15590779	CpG: 24	268	24	145	17.9	54.1	1.23
chr17	15605704	15606241	CpG: 53	537	53	354	19.7	65.9	0.91
chr17	15610477	15611324	CpG: 70	847	70	578	16.5	68.2	0.71
chr17	15613400	15613636	CpG: 18	236	18	145	15.3	61.4	0.83
chr17	15655551	15656161	CpG: 57	610	57	432	18.7	70.8	0.75
chr17	15689313	15689572	CpG: 32	259	32	186	24.7	71.8	0.98
chr17	15692607	15693325	CpG: 79	718	79	548	22.0	76.3	0.76
chr17	15701191	15701441	CpG: 22	250	22	153	17.6	61.2	0.96
chr17	15706008	15706368	CpG: 26	360	26	200	14.4	55.6	0.94
chr17	15706573	15706839	CpG: 20	266	20	159	15.0	59.8	0.85
chr17	15746535	15746809	CpG: 23	274	23	170	16.8	62.0	0.88
chr17	15773332	15774238	CpG: 68	906	68	632	15.0	69.8	0.62
chr17	15819548	15820283	CpG: 57	735	57	521	15.5	70.9	0.62
chr17	15846622	15848378	CpG: 184	1756	184	1257	21.0	71.6	0.82
chr17	15862454	15862779	CpG: 28	325	28	189	17.2	58.2	1.03
chr17	15901402	15902590	CpG: 140	1188	140	842	23.6	70.9	0.94
chr17	16047723	16048153	CpG: 35	430	35	314	16.3	73.0	0.61
chr17	16117272	16119061	CpG: 165	1789	165	1193	18.4	66.7	0.83
chr17	16130756	16130999	CpG: 19	243	19	143	15.6	58.8	0.93
chr17	16149013	16149298	CpG: 23	285	23	174	16.1	61.1	0.88
chr17	16214351	16215140	CpG: 62	789	62	554	15.7	70.2	0.64
chr17	16236454	16236685	CpG: 17	231	17	138	14.7	59.7	0.84
chr17	16254629	16256168	CpG: 169	1539	169	1060	22.0	68.9	0.93
chr17	16282485	16283772	CpG: 103	1287	103	761	16.0	59.1	0.93
chr17	16288588	16288860	CpG: 20	272	20	153	14.7	56.2	0.94
chr17	16289081	16289678	CpG: 48	597	48	352	16.1	59.0	0.93
chr17	16308280	16308508	CpG: 20	228	20	140	17.5	61.4	0.94
chr17	16309155	16309948	CpG: 64	793	64	544	16.1	68.6	0.73
chr17	16341086	16341886	CpG: 56	800	56	479	14.0	59.9	0.80
chr17	16354077	16354342	CpG: 20	265	20	159	15.1	60.0	0.85
chr17	16393808	16394818	CpG: 149	1010	149	818	29.5	81.0	0.92
chr17	16437801	16438745	CpG: 68	944	68	567	14.4	60.1	0.80
chr17	16471047	16471773	CpG: 77	726	77	505	21.2	69.6	0.88
chr17	16482917	16483122	CpG: 16	205	16	123	15.6	60.0	0.88
chr17	16486602	16486836	CpG: 22	234	22	156	18.8	66.7	0.85
chr17	16491298	16491789	CpG: 51	491	51	346	20.8	70.5	0.84
chr17	16512612	16512852	CpG: 18	240	18	146	15.0	60.8	0.83
chr17	16519868	16520247	CpG: 49	379	49	250	25.9	66.0	1.20
chr17	16555615	16556105	CpG: 50	490	50	354	20.4	72.2	0.79
chr17	16559011	16559297	CpG: 21	286	21	172	14.7	60.1	0.82
chr17	16568834	16569786	CpG: 83	952	83	680	17.4	71.4	0.71
chr17	16585626	16586155	CpG: 40	529	40	310	15.1	58.6	0.90
chr17	16591682	16593038	CpG: 96	1356	96	898	14.2	66.2	0.65
chr17	16595544	16595815	CpG: 19	271	19	166	14.0	61.3	0.75
chr17	16601601	16601875	CpG: 22	274	22	170	16.1	62.0	0.85
chr17	16605859	16606098	CpG: 19	239	19	144	15.9	60.3	0.90
chr17	16628449	16628730	CpG: 21	281	21	170	14.9	60.5	0.82
chr17	16639561	16639835	CpG: 24	274	24	170	17.5	62.0	0.92
chr17	16672250	16672534	CpG: 24	284	24	177	16.9	62.3	0.89
chr17	16763683	16763892	CpG: 16	209	16	126	15.3	60.3	0.87
chr17	16788342	16788620	CpG: 23	278	23	173	16.5	62.2	0.86
chr17	16986689	16986963	CpG: 23	274	23	170	16.8	62.0	0.88
chr17	16988150	16989191	CpG: 149	1041	149	793	28.6	76.2	0.99
chr17	17104594	17104982	CpG: 35	388	35	269	18.0	69.3	0.76
chr17	17110315	17110679	CpG: 28	364	28	248	15.4	68.1	0.68
chr17	17129289	17129564	CpG: 20	275	20	166	14.5	60.4	0.81
chr17	17151494	17153019	CpG: 152	1525	152	1096	19.9	71.9	0.81
chr17	17167426	17167659	CpG: 17	233	17	152	14.6	65.2	0.70
chr17	17182843	17184022	CpG: 84	1179	84	702	14.2	59.5	0.81
chr17	17226344	17227463	CpG: 101	1119	101	720	18.1	64.3	0.87
chr17	17249280	17250059	CpG: 116	779	116	598	29.8	76.8	1.01
chr17	17328727	17329135	CpG: 44	408	44	277	21.6	67.9	0.94
chr17	17423437	17423788	CpG: 41	351	41	254	23.4	72.4	0.93
chr17	17432937	17433195	CpG: 23	258	23	186	17.8	72.1	0.69
chr17	17441543	17443641	CpG: 226	2098	226	1448	21.5	69.0	0.91
chr17	17508406	17508668	CpG: 19	262	19	176	14.5	67.2	0.65
chr17	17537877	17538784	CpG: 92	907	92	616	20.3	67.9	0.90
chr17	17598160	17598434	CpG: 24	274	24	171	17.5	62.4	0.91
chr17	17627780	17629659	CpG: 243	1879	243	1430	25.9	76.1	0.91
chr17	17641126	17641700	CpG: 77	574	77	434	26.8	75.6	0.94
chr17	17646885	17647449	CpG: 81	564	81	410	28.7	72.7	1.09
chr17	17668887	17671986	CpG: 272	3099	272	2070	17.6	66.8	0.79
chr17	17698739	17699163	CpG: 46	424	46	310	21.7	73.1	0.82
chr17	17728308	17730540	CpG: 228	2232	228	1558	20.4	69.8	0.85
chr17	17741005	17741358	CpG: 30	353	30	232	17.0	65.7	0.80
chr17	17744165	17744375	CpG: 18	210	18	136	17.1	64.8	0.82
chr17	17756190	17757735	CpG: 141	1545	141	1057	18.3	68.4	0.78
chr17	17758972	17759495	CpG: 49	523	49	361	18.7	69.0	0.79
chr17	17770227	17770654	CpG: 59	427	59	331	27.6	77.5	0.94
chr17	17782831	17783920	CpG: 130	1089	130	786	23.9	72.2	0.92
chr17	17786781	17787357	CpG: 57	576	57	419	19.8	72.7	0.75
chr17	17850037	17850259	CpG: 17	222	17	132	15.3	59.5	0.90
chr17	17858916	17859948	CpG: 76	1032	76	703	14.7	68.1	0.64
chr17	17903195	17903694	CpG: 39	499	39	354	15.6	70.9	0.62
chr17	17918530	17919296	CpG: 74	766	74	552	19.3	72.1	0.75
chr17	17953512	17953965	CpG: 35	453	35	310	15.5	68.4	0.72
chr17	17985687	17986984	CpG: 145	1297	145	935	22.4	72.1	0.87
chr17	18032161	18032505	CpG: 25	344	25	202	14.5	58.7	0.86
chr17	18034085	18034322	CpG: 18	237	18	141	15.2	59.5	0.89
chr17	18034596	18035097	CpG: 44	501	44	330	17.6	65.9	0.81
chr17	18065435	18068367	CpG: 294	2932	294	2044	20.1	69.7	0.84
chr17	18129626	18131859	CpG: 236	2233	236	1489	21.1	66.7	0.95
chr17	18172062	18172802	CpG: 110	740	110	582	29.7	78.6	0.96
chr17	18193769	18194663	CpG: 69	894	69	598	15.4	66.9	0.69
chr17	18204993	18208164	CpG: 215	3171	215	1998	13.6	63.0	0.68
chr17	18210666	18211269	CpG: 43	603	43	416	14.3	69.0	0.60
chr17	18244262	18245298	CpG: 74	1036	74	711	14.3	68.6	0.61
chr17	18261313	18262548	CpG: 117	1235	117	794	18.9	64.3	0.92
chr17	18296854	18297131	CpG: 20	277	20	166	14.4	59.9	0.82
chr17	18298974	18299247	CpG: 20	273	20	168	14.7	61.5	0.78
chr17	18309914	18310499	CpG: 72	585	72	427	24.6	73.0	0.94
chr17	18329728	18330296	CpG: 51	568	51	413	18.0	72.7	0.69
chr17	18358537	18359189	CpG: 47	652	47	414	14.4	63.5	0.89
chr17	18401429	18401638	CpG: 16	209	16	127	15.3	60.8	0.85
chr17	18519556	18519840	CpG: 26	284	26	183	18.3	64.4	0.88
chr17	18535860	18536141	CpG: 20	281	20	170	14.2	60.5	0.79
chr17	18558509	18558748	CpG: 19	239	19	145	15.9	60.7	0.89
chr17	18562733	18562983	CpG: 22	250	22	158	17.6	63.2	0.89
chr17	18571037	18571315	CpG: 26	278	26	176	18.7	63.3	0.94
chr17	18571892	18572497	CpG: 44	605	44	385	14.5	63.6	0.75
chr17	18581557	18582329	CpG: 68	772	68	555	17.6	71.9	0.70
chr17	18618645	18618862	CpG: 17	217	17	130	15.7	59.9	0.88
chr17	18619177	18619986	CpG: 105	809	105	595	26.0	73.5	0.96
chr17	18624168	18624574	CpG: 33	406	33	270	16.3	66.5	0.74
chr17	18628746	18629336	CpG: 54	590	54	385	18.3	65.3	0.86
chr17	18644176	18644486	CpG: 27	310	27	171	17.4	55.2	1.15
chr17	18675811	18676158	CpG: 27	347	27	204	15.6	58.8	0.91
chr17	18695408	18695693	CpG: 23	285	23	171	16.1	60.0	0.90
chr17	18727238	18727845	CpG: 54	607	54	416	17.8	68.5	0.77
chr17	18775982	18776256	CpG: 22	274	22	171	16.1	62.4	0.83
chr17	18804114	18804694	CpG: 58	580	58	431	20.0	74.3	0.73
chr17	18878173	18878447	CpG: 21	274	21	168	15.3	61.3	0.82
chr17	18917862	18918068	CpG: 15	206	15	132	14.6	64.1	0.73
chr17	18950102	18951436	CpG: 132	1334	132	950	19.8	71.2	0.79
chr17	18962830	18963148	CpG: 25	318	25	222	15.7	69.8	0.66
chr17	18973563	18973805	CpG: 17	242	17	145	14.0	59.9	0.82
chr17	19009867	19010731	CpG: 62	864	62	498	14.4	57.6	0.86
chr17	19011108	19011969	CpG: 63	861	63	498	14.6	57.8	0.88
chr17	19012319	19012541	CpG: 16	222	16	139	14.4	62.6	0.75
chr17	19018306	19018626	CpG: 25	320	25	214	15.6	66.9	0.70
chr17	19019533	19019807	CpG: 22	274	22	167	16.1	60.9	0.87
chr17	19036085	19036415	CpG: 25	330	25	182	15.2	55.2	1.00
chr17	19036680	19037665	CpG: 86	985	86	701	17.5	71.2	0.69
chr17	19046541	19046811	CpG: 19	270	19	161	14.1	59.6	0.80
chr17	19051212	19051454	CpG: 17	242	17	145	14.0	59.9	0.82
chr17	19087500	19088355	CpG: 64	855	64	500	15.0	58.5	0.88
chr17	19088734	19089248	CpG: 65	514	65	380	25.3	73.9	1.00
chr17	19096252	19096459	CpG: 16	207	16	122	15.5	58.9	0.90
chr17	19101261	19101531	CpG: 19	270	19	161	14.1	59.6	0.80
chr17	19110407	19111392	CpG: 86	985	86	702	17.5	71.3	0.69
chr17	19111656	19111986	CpG: 25	330	25	182	15.2	55.2	1.00
chr17	19128254	19128528	CpG: 22	274	22	167	16.1	60.9	0.87
chr17	19129435	19129755	CpG: 25	320	25	213	15.6	66.6	0.71
chr17	19136073	19136943	CpG: 63	870	63	495	14.5	56.9	0.90
chr17	19137320	19138168	CpG: 63	848	63	496	14.9	58.5	0.87
chr17	19144485	19144805	CpG: 25	320	25	214	15.6	66.9	0.70
chr17	19145711	19145985	CpG: 22	274	22	167	16.1	60.9	0.87
chr17	19162256	19163834	CpG: 119	1578	119	1018	15.1	64.5	0.72
chr17	19172704	19172974	CpG: 19	270	19	161	14.1	59.6	0.80
chr17	19177774	19177981	CpG: 16	207	16	122	15.5	58.9	0.90
chr17	19184981	19186322	CpG: 120	1341	120	959	17.9	71.5	0.70
chr17	19292519	19292803	CpG: 31	284	31	211	21.8	74.3	0.81
chr17	19310139	19311180	CpG: 97	1041	97	688	18.6	66.1	0.86
chr17	19325722	19327263	CpG: 131	1541	131	1034	17.0	67.1	0.76
chr17	19423614	19424266	CpG: 51	652	51	449	15.6	68.9	0.66
chr17	19455416	19456663	CpG: 118	1247	118	831	18.9	66.6	0.90
chr17	19481632	19482536	CpG: 98	904	98	649	21.7	71.8	0.84
chr17	19527931	19528582	CpG: 81	651	81	480	24.9	73.7	0.92
chr17	19541648	19541926	CpG: 26	278	26	176	18.7	63.3	0.94
chr17	19596653	19597792	CpG: 101	1139	101	782	17.7	68.7	0.75
chr17	19662389	19662730	CpG: 32	341	32	241	18.8	70.7	0.75
chr17	19672186	19672471	CpG: 25	285	25	179	17.5	62.8	0.90
chr17	19673182	19673603	CpG: 46	421	46	307	21.9	72.9	0.83
chr17	19693346	19693797	CpG: 46	451	46	334	20.4	74.1	0.74
chr17	19721340	19721548	CpG: 17	208	17	128	16.3	61.5	0.87
chr17	19809922	19810195	CpG: 19	273	19	158	13.9	57.9	0.84
chr17	19815648	19816850	CpG: 159	1202	159	902	26.5	75.0	0.94
chr17	19816951	19817156	CpG: 15	205	15	121	14.6	59.0	0.84
chr17	19831344	19831577	CpG: 18	233	18	141	15.5	60.5	0.86
chr17	19831708	19832157	CpG: 35	449	35	263	15.6	58.6	0.93
chr17	19899113	19900042	CpG: 74	929	74	668	15.9	71.9	0.62
chr17	19926071	19927028	CpG: 84	957	84	667	17.6	69.7	0.73
chr17	19928720	19929005	CpG: 27	285	27	193	18.9	67.7	0.83
chr17	19931433	19931634	CpG: 16	201	16	118	15.9	58.7	0.93
chr17	19957476	19958810	CpG: 134	1334	134	951	20.1	71.3	0.80
chr17	19965192	19965541	CpG: 31	349	31	260	17.8	74.5	0.64
chr17	19966017	19966232	CpG: 15	215	15	116	14.0	54.0	1.00
chr17	20104379	20105412	CpG: 118	1033	118	740	22.8	71.6	0.89
chr17	20214968	20215205	CpG: 18	237	18	143	15.2	60.3	0.86
chr17	20235803	20236084	CpG: 25	281	25	175	17.8	62.3	0.93
chr17	20269063	20270848	CpG: 125	1785	125	1121	14.0	62.8	0.72
chr17	20279263	20279537	CpG: 21	274	21	169	15.3	61.7	0.82
chr17	20437659	20437998	CpG: 23	339	23	196	13.6	57.8	0.82
chr17	20438241	20438453	CpG: 17	212	17	127	16.0	59.9	0.91
chr17	20480761	20481413	CpG: 47	652	47	414	14.4	63.5	0.89
chr17	20505551	20506152	CpG: 45	601	45	400	15.0	66.6	0.68
chr17	20537506	20538032	CpG: 65	526	65	420	24.7	79.8	0.78
chr17	20544414	20544655	CpG: 18	241	18	143	14.9	59.3	0.87
chr17	20546064	20546314	CpG: 21	250	21	152	16.8	60.8	0.92
chr17	20550902	20551148	CpG: 21	246	21	134	17.1	54.5	1.15
chr17	20551463	20551729	CpG: 18	266	18	156	13.5	58.6	0.80
chr17	20633349	20634354	CpG: 78	1005	78	721	15.5	71.7	0.60
chr17	20656593	20656807	CpG: 18	214	18	133	16.8	62.1	0.89
chr17	20669032	20669306	CpG: 21	274	21	164	15.3	59.9	0.87
chr17	20704147	20704393	CpG: 19	246	19	145	15.4	58.9	0.92
chr17	20733044	20733388	CpG: 43	344	43	239	25.0	69.5	1.06
chr17	20751955	20752282	CpG: 25	327	25	187	15.3	57.2	0.94
chr17	20789507	20790347	CpG: 82	840	82	614	19.5	73.1	0.73
chr17	20792284	20793190	CpG: 100	906	100	656	22.1	72.4	0.84
chr17	20801266	20801636	CpG: 27	370	27	220	14.6	59.5	0.83
chr17	20841689	20841908	CpG: 16	219	16	132	14.6	60.3	0.81
chr17	20844450	20845652	CpG: 85	1202	85	789	14.1	65.6	0.66
chr17	20857253	20857663	CpG: 34	410	34	288	16.6	70.2	0.67
chr17	20987818	20988090	CpG: 19	272	19	162	14.0	59.6	0.80
chr17	20990729	20992632	CpG: 174	1903	174	1340	18.3	70.4	0.74
chr17	21034645	21034875	CpG: 29	230	29	174	25.2	75.7	0.90
chr17	21050562	21050784	CpG: 19	222	19	140	17.1	63.1	0.87
chr17	21075607	21076368	CpG: 65	761	65	484	17.1	63.6	0.86
chr17	21077289	21077526	CpG: 17	237	17	141	14.3	59.5	0.82
chr17	21162428	21163609	CpG: 118	1181	118	834	20.0	70.6	0.80
chr17	21201801	21202548	CpG: 112	747	112	567	30.0	75.9	1.04
chr17	21224405	21225276	CpG: 72	871	72	594	16.5	68.2	0.72
chr17	21232695	21234031	CpG: 130	1336	130	925	19.5	69.2	0.81
chr17	21265598	21266019	CpG: 47	421	47	310	22.3	73.6	0.83
chr17	21271941	21272166	CpG: 18	225	18	137	16.0	60.9	0.86
chr17	21324973	21327187	CpG: 210	2214	210	1501	19.0	67.8	0.83
chr17	21333740	21333979	CpG: 18	239	18	141	15.1	59.0	0.89
chr17	21335979	21336336	CpG: 24	357	24	207	13.4	58.0	0.81
chr17	21364262	21365653	CpG: 101	1391	101	879	14.5	63.2	0.73
chr17	21401573	21402037	CpG: 39	464	39	294	16.8	63.4	0.84
chr17	21412733	21413211	CpG: 44	478	44	329	18.4	68.8	0.81
chr17	21460330	21461153	CpG: 80	823	80	541	19.4	65.7	0.91
chr17	21461856	21462098	CpG: 24	242	24	164	19.8	67.8	0.86
chr17	21499990	21500689	CpG: 72	699	72	482	20.6	69.0	0.90
chr17	21502506	21502741	CpG: 18	235	18	140	15.3	59.6	0.89
chr17	21522647	21523557	CpG: 64	910	64	561	14.1	61.6	0.74
chr17	21541143	21541395	CpG: 25	252	25	155	19.8	61.5	1.06
chr17	21541709	21541933	CpG: 20	224	20	158	17.9	70.5	0.73
chr17	21605671	21606271	CpG: 46	600	46	424	15.3	70.7	0.62
chr17	21623118	21623597	CpG: 44	479	44	317	18.4	66.2	0.84
chr17	21627340	21627880	CpG: 40	540	40	350	14.8	64.8	0.71
chr17	21628202	21634864	CpG: 407	6662	407	4077	12.2	61.2	0.65
chr17	21651646	21652536	CpG: 71	890	71	559	16.0	62.8	0.81
chr17	21652805	21653009	CpG: 16	204	16	142	15.7	69.6	0.65
chr17	21713649	21713960	CpG: 23	311	23	180	14.8	57.9	0.88
chr17	21719699	21720120	CpG: 47	421	47	309	22.3	73.4	0.84
chr17	21744383	21744620	CpG: 18	237	18	144	15.2	60.8	0.83
chr17	21812774	21815389	CpG: 350	2615	350	1789	26.8	68.4	1.21
chr17	22423037	22425048	CpG: 252	2011	252	1367	25.1	68.0	1.17
chr17	22545476	22545757	CpG: 23	281	23	173	16.4	61.6	0.88
chr17	22556930	22558241	CpG: 151	1311	151	884	23.0	67.4	1.06
chr17	22559258	22559532	CpG: 21	274	21	168	15.3	61.3	0.82
chr17	22579268	22580068	CpG: 102	800	102	522	25.5	65.2	1.26
chr17	22605317	22605624	CpG: 22	307	22	176	14.3	57.3	0.87
chr17	22666703	22667593	CpG: 57	890	57	541	12.8	60.8	0.69
chr17	22684351	22685980	CpG: 105	1629	105	1020	12.9	62.6	0.66
chr17	22686653	22687118	CpG: 37	465	37	309	15.9	66.5	0.72
chr17	22687816	22689514	CpG: 117	1698	117	1078	13.8	63.5	0.68
chr17	22693235	22693698	CpG: 45	463	45	311	19.4	67.2	0.86
chr17	22710545	22711145	CpG: 45	600	45	422	15.0	70.3	0.61
chr17	22815291	22815530	CpG: 19	239	19	146	15.9	61.1	0.86
chr17	22837716	22837989	CpG: 22	273	22	164	16.1	60.1	0.91
chr17	22864823	22865263	CpG: 32	440	32	263	14.5	59.8	0.86
chr17	22878245	22878655	CpG: 29	410	29	230	14.1	56.1	0.90
chr17	22878915	22879189	CpG: 24	274	24	161	17.5	58.8	1.01
chr17	22960167	22960710	CpG: 42	543	42	346	15.5	63.7	0.77
chr17	22962398	22962932	CpG: 47	534	47	350	17.6	65.5	0.82
chr17	23038381	23095600	CpG: 3286	57219	3286	35361	11.5	61.8	0.60
chr17	23097299	23097965	CpG: 59	666	59	444	17.7	66.7	0.80
chr17	23099552	23100007	CpG: 33	455	33	294	14.5	64.6	0.70
chr17	23123345	23123894	CpG: 52	549	52	392	18.9	71.4	0.81
chr17	23142247	23143169	CpG: 85	922	85	590	18.4	64.0	0.91
chr17	23205649	23206069	CpG: 30	420	30	256	14.3	61.0	0.77
chr17	23240782	23241072	CpG: 22	290	22	175	15.2	60.3	0.83
chr17	23380666	23380933	CpG: 21	267	21	164	15.7	61.4	0.84
chr17	27421254	27421670	CpG: 32	416	32	250	15.4	60.1	0.85
chr17	27671266	27672499	CpG: 117	1233	117	822	19.0	66.7	0.86
chr17	27705523	27706727	CpG: 154	1204	154	837	25.6	69.5	1.19
chr17	27712929	27715504	CpG: 337	2575	337	1756	26.2	68.2	1.19
chr17	27903044	27903989	CpG: 114	945	114	650	24.1	68.8	1.07
chr17	27922568	27922862	CpG: 25	294	25	198	17.0	67.3	0.75
chr17	28045436	28045795	CpG: 26	359	26	212	14.5	59.1	0.83
chr17	28209167	28209441	CpG: 24	274	24	170	17.5	62.0	0.92
chr17	28235379	28236110	CpG: 67	731	67	487	18.3	66.6	0.83
chr17	28274182	28274562	CpG: 35	380	35	263	18.4	69.2	0.77
chr17	28290358	28291129	CpG: 89	771	89	581	23.1	75.4	0.81
chr17	28294953	28295473	CpG: 55	520	55	391	21.2	75.2	0.77
chr17	28322479	28322692	CpG: 17	213	17	150	16.0	70.4	0.65
chr17	28397549	28398808	CpG: 142	1259	142	938	22.6	74.5	0.81
chr17	28546945	28547160	CpG: 20	215	20	152	18.6	70.7	0.75
chr17	28734737	28735312	CpG: 61	575	61	410	21.2	71.3	0.85
chr17	28787946	28788208	CpG: 20	262	20	162	15.3	61.8	0.81
chr17	28834306	28834843	CpG: 67	537	67	403	25.0	75.0	0.90
chr17	28982963	28983510	CpG: 60	547	60	402	21.9	73.5	0.82
chr17	29041001	29041282	CpG: 23	281	23	174	16.4	61.9	0.87
chr17	29052274	29052499	CpG: 18	225	18	136	16.0	60.4	0.89
chr17	29149577	29149854	CpG: 24	277	24	174	17.3	62.8	0.89
chr17	29169046	29169820	CpG: 74	774	74	526	19.1	68.0	0.84
chr17	29192311	29193501	CpG: 99	1190	99	763	16.6	64.1	0.81
chr17	29230353	29230593	CpG: 22	240	22	149	18.3	62.1	0.97
chr17	29248714	29249290	CpG: 53	576	53	406	18.4	70.5	0.74
chr17	29260112	29261428	CpG: 105	1316	105	829	16.0	63.0	0.82
chr17	29276893	29277870	CpG: 79	977	79	651	16.2	66.6	0.73
chr17	29298989	29299701	CpG: 78	712	78	514	21.9	72.2	0.84
chr17	29313189	29314435	CpG: 127	1246	127	905	20.4	72.6	0.77
chr17	29323058	29323638	CpG: 71	580	71	404	24.5	69.7	1.02
chr17	29326215	29327151	CpG: 79	936	79	621	16.9	66.3	0.77
chr17	29347010	29347226	CpG: 18	216	18	142	16.7	65.7	0.77
chr17	29347647	29348231	CpG: 64	584	64	429	21.9	73.5	0.81
chr17	29401323	29402224	CpG: 74	901	74	625	16.4	69.4	0.68
chr17	29494844	29495392	CpG: 64	548	64	428	23.4	78.1	0.77
chr17	29513712	29514388	CpG: 64	676	64	469	18.9	69.4	0.79
chr17	29541349	29542119	CpG: 65	770	65	501	16.9	65.1	0.80
chr17	29587488	29588187	CpG: 88	699	88	517	25.2	74.0	0.94
chr17	29604467	29605137	CpG: 58	670	58	397	17.3	59.3	0.99
chr17	29653875	29654710	CpG: 86	835	86	590	20.6	70.7	0.86
chr17	29654879	29655258	CpG: 28	379	28	248	14.8	65.4	0.73
chr17	29659959	29660840	CpG: 101	881	101	634	22.9	72.0	0.89
chr17	29662358	29663064	CpG: 53	706	53	408	15.0	57.8	0.90
chr17	29663881	29664118	CpG: 19	237	19	143	16.0	60.3	0.94
chr17	29668730	29671845	CpG: 242	3115	242	2003	15.5	64.3	0.75
chr17	29674108	29674314	CpG: 16	206	16	121	15.5	58.7	0.91
chr17	29686305	29687459	CpG: 113	1154	113	825	19.6	71.5	0.77
chr17	29743919	29744141	CpG: 17	222	17	123	15.3	55.4	1.00
chr17	29754955	29755441	CpG: 42	486	42	346	17.3	71.2	0.69
chr17	29785278	29785653	CpG: 37	375	37	263	19.7	70.1	0.90
chr17	29787200	29787429	CpG: 17	229	17	137	14.8	59.8	0.84
chr17	29790413	29790687	CpG: 22	274	22	166	16.1	60.6	0.89
chr17	29791755	29791995	CpG: 18	240	18	142	15.0	59.2	0.89
chr17	29797734	29798074	CpG: 29	340	29	216	17.1	63.5	0.85
chr17	29839762	29840630	CpG: 80	868	80	612	18.4	70.5	0.75
chr17	29845179	29845935	CpG: 104	756	104	580	27.5	76.7	0.95
chr17	29891962	29894620	CpG: 205	2658	205	1754	15.4	66.0	0.71
chr17	29895078	29895412	CpG: 22	334	22	196	13.2	58.7	0.77
chr17	29928697	29929016	CpG: 23	319	23	208	14.4	65.2	0.70
chr17	29947989	29948909	CpG: 106	920	106	680	23.0	73.9	0.85
chr17	29962562	29962931	CpG: 34	369	34	253	18.4	68.6	0.78
chr17	30022453	30023759	CpG: 107	1306	107	883	16.4	67.6	0.72
chr17	30030797	30031074	CpG: 22	277	22	175	15.9	63.2	0.80
chr17	30084661	30084874	CpG: 16	213	16	129	15.0	60.6	0.83
chr17	30108879	30109556	CpG: 42	677	42	431	12.4	63.7	0.62
chr17	30116167	30116385	CpG: 18	218	18	134	16.5	61.5	0.90
chr17	30119275	30119756	CpG: 50	481	50	350	20.8	72.8	0.80
chr17	30122566	30123284	CpG: 83	718	83	559	23.1	77.9	0.78
chr17	30166815	30167036	CpG: 19	221	19	133	17.2	60.2	0.97
chr17	30167367	30167641	CpG: 21	274	21	167	15.3	60.9	0.84
chr17	30208090	30208364	CpG: 25	274	25	172	18.2	62.8	0.94
chr17	30235205	30236109	CpG: 104	904	104	675	23.0	74.7	0.83
chr17	30236885	30237171	CpG: 23	286	23	176	16.1	61.5	0.93
chr17	30245302	30245532	CpG: 17	230	17	139	14.8	60.4	0.83
chr17	30320821	30321061	CpG: 18	240	18	142	15.0	59.2	0.87
chr17	30332106	30332348	CpG: 20	242	20	147	16.5	60.7	0.94
chr17	30332853	30333755	CpG: 98	902	98	660	21.7	73.2	0.81
chr17	30334677	30334947	CpG: 19	270	19	162	14.1	60.0	0.79
chr17	30353853	30354127	CpG: 24	274	24	169	17.5	61.7	0.93
chr17	30475667	30476586	CpG: 71	919	71	643	15.5	70.0	0.63
chr17	30508937	30511936	CpG: 310	2999	310	2129	20.7	71.0	0.82
chr17	30515369	30515925	CpG: 61	556	61	415	21.9	74.6	0.80
chr17	30531578	30536985	CpG: 412	5407	412	3601	15.2	66.6	0.69
chr17	30542799	30543029	CpG: 18	230	18	138	15.7	60.0	0.90
chr17	30555181	30556653	CpG: 150	1472	150	1055	20.4	71.7	0.79
chr17	30558415	30561271	CpG: 204	2856	204	1865	14.3	65.3	0.67
chr17	30565312	30566161	CpG: 77	849	77	588	18.1	69.3	0.76
chr17	30649765	30650039	CpG: 22	274	22	168	16.1	61.3	0.86
chr17	30703877	30704457	CpG: 73	580	73	413	25.2	71.2	1.00
chr17	30726673	30726947	CpG: 24	274	24	171	17.5	62.4	0.91
chr17	30728611	30729001	CpG: 27	390	27	228	13.8	58.5	0.82
chr17	30873135	30873717	CpG: 67	582	67	416	23.0	71.5	0.93
chr17	30930004	30930281	CpG: 22	277	22	175	15.9	63.2	0.81
chr17	30976462	30976740	CpG: 22	278	22	173	15.8	62.2	0.83
chr17	31060577	31060812	CpG: 19	235	19	141	16.2	60.0	0.91
chr17	31061288	31061553	CpG: 27	265	27	156	20.4	58.9	1.25
chr17	31179903	31180702	CpG: 81	799	81	556	20.3	69.6	0.84
chr17	31235903	31236809	CpG: 102	906	102	644	22.5	71.1	0.89
chr17	31322976	31324431	CpG: 152	1455	152	969	20.9	66.6	0.95
chr17	31421948	31422305	CpG: 28	357	28	236	15.7	66.1	0.74
chr17	31445539	31445813	CpG: 24	274	24	171	17.5	62.4	0.91
chr17	31467597	31468297	CpG: 59	700	59	504	16.9	72.0	0.65
chr17	31521060	31521435	CpG: 27	375	27	242	14.4	64.5	0.71
chr17	31544723	31546085	CpG: 127	1362	127	923	18.6	67.8	0.81
chr17	31589889	31590124	CpG: 19	235	19	139	16.2	59.1	0.96
chr17	31599602	31599877	CpG: 22	275	22	169	16.0	61.5	0.86
chr17	31632817	31633083	CpG: 20	266	20	157	15.0	59.0	0.87
chr17	31650975	31651317	CpG: 43	342	43	246	25.1	71.9	0.99
chr17	31653167	31655487	CpG: 254	2320	254	1659	21.9	71.5	0.86
chr17	31669926	31670166	CpG: 18	240	18	147	15.0	61.2	0.82
chr17	31676378	31677087	CpG: 82	709	82	504	23.1	71.1	0.92
chr17	31737856	31738126	CpG: 22	270	22	165	16.3	61.1	0.88
chr17	31770172	31770592	CpG: 60	420	60	325	28.6	77.4	1.00
chr17	31777569	31778114	CpG: 53	545	53	361	19.4	66.2	0.89
chr17	31810902	31811172	CpG: 20	270	20	163	14.8	60.4	0.83
chr17	31850950	31851225	CpG: 20	275	20	161	14.5	58.5	0.85
chr17	31851950	31852229	CpG: 29	279	29	192	20.8	68.8	0.88
chr17	31857647	31857883	CpG: 21	236	21	142	17.8	60.2	1.00
chr17	31867537	31868616	CpG: 117	1079	117	806	21.7	74.7	0.80
chr17	31916626	31917292	CpG: 68	666	68	476	20.4	71.5	0.80
chr17	31917885	31918114	CpG: 16	229	16	127	14.0	55.5	0.92
chr17	31954100	31955155	CpG: 96	1055	96	684	18.2	64.8	0.88
chr17	32040311	32041194	CpG: 75	883	75	625	17.0	70.8	0.68
chr17	32130085	32130358	CpG: 22	273	22	172	16.1	63.0	0.82
chr17	32290689	32290966	CpG: 29	277	29	195	20.9	70.4	0.85
chr17	32336437	32337631	CpG: 151	1194	151	913	25.3	76.5	0.87
chr17	32392347	32392551	CpG: 15	204	15	122	14.7	59.8	0.83
chr17	32432942	32434326	CpG: 154	1384	154	1023	22.3	73.9	0.82
chr17	32460955	32461229	CpG: 24	274	24	171	17.5	62.4	0.91
chr17	32495196	32496274	CpG: 126	1078	126	772	23.4	71.6	0.91
chr17	32504546	32506137	CpG: 198	1591	198	1190	24.9	74.8	0.90
chr17	32562030	32562258	CpG: 20	228	20	142	17.5	62.3	0.91
chr17	32600385	32600608	CpG: 18	223	18	134	16.1	60.1	0.93
chr17	32804584	32805417	CpG: 109	833	109	635	26.2	76.2	0.91
chr17	32847449	32847807	CpG: 32	358	32	226	17.9	63.1	0.90
chr17	32862705	32863409	CpG: 75	704	75	523	21.3	74.3	0.77
chr17	32882616	32883370	CpG: 89	754	89	545	23.6	72.3	0.91
chr17	32896668	32896943	CpG: 20	275	20	167	14.5	60.7	0.80
chr17	32952821	32953984	CpG: 126	1163	126	827	21.7	71.1	0.86
chr17	33007120	33007355	CpG: 18	235	18	140	15.3	59.6	0.90
chr17	33055548	33055832	CpG: 23	284	23	180	16.2	63.4	0.82
chr17	33086691	33086974	CpG: 21	283	21	165	14.8	58.3	0.88
chr17	33088101	33088687	CpG: 71	586	71	435	24.2	74.2	0.88
chr17	33193868	33194146	CpG: 26	278	26	175	18.7	62.9	0.95
chr17	33201428	33201710	CpG: 20	282	20	168	14.2	59.6	0.81
chr17	33211345	33212784	CpG: 202	1439	202	1134	28.1	78.8	0.90
chr17	33287578	33288039	CpG: 44	461	44	323	19.1	70.1	0.78
chr17	33295074	33295312	CpG: 18	238	18	144	15.1	60.5	0.84
chr17	33295753	33296212	CpG: 32	459	32	266	13.9	58.0	0.84
chr17	33379518	33379754	CpG: 16	236	16	138	13.6	58.5	0.83
chr17	33389714	33390891	CpG: 107	1177	107	787	18.2	66.9	0.81
chr17	33431926	33433988	CpG: 267	2062	267	1540	25.9	74.7	0.93
chr17	33441666	33441959	CpG: 22	293	22	192	15.0	65.5	0.70
chr17	33464646	33465445	CpG: 82	799	82	568	20.5	71.1	0.81
chr17	33512650	33512923	CpG: 25	273	25	169	18.3	61.9	0.97
chr17	33629888	33630197	CpG: 26	309	26	193	16.8	62.5	0.87
chr17	33723728	33723957	CpG: 18	229	18	138	15.7	60.3	0.88
chr17	33763923	33764197	CpG: 24	274	24	171	17.5	62.4	0.91
chr17	33768500	33768968	CpG: 79	468	79	379	33.8	81.0	1.03
chr17	33822512	33823486	CpG: 135	974	135	761	27.7	78.1	0.91
chr17	33833368	33833592	CpG: 19	224	19	132	17.0	58.9	0.98
chr17	33873903	33874573	CpG: 95	670	95	541	28.4	80.7	0.88
chr17	34072972	34073259	CpG: 24	287	24	178	16.7	62.0	0.88
chr17	34161775	34162003	CpG: 20	228	20	140	17.5	61.4	0.94
chr17	34237251	34239371	CpG: 234	2120	234	1541	22.1	72.7	0.84
chr17	34382915	34383189	CpG: 22	274	22	169	16.1	61.7	0.85
chr17	34389463	34389744	CpG: 25	281	25	174	17.8	61.9	0.94
chr17	34464905	34465145	CpG: 19	240	19	147	15.8	61.2	0.86
chr17	34658767	34659003	CpG: 21	236	21	145	17.8	61.4	0.96
chr17	34711163	34711443	CpG: 22	280	22	169	15.7	60.4	0.88
chr17	34986384	34986899	CpG: 67	515	67	395	26.0	76.7	0.89
chr17	35103377	35103650	CpG: 29	273	29	185	21.2	67.8	0.93
chr17	35244381	35244623	CpG: 21	242	21	149	17.4	61.6	0.92
chr17	35248576	35248854	CpG: 26	278	26	176	18.7	63.3	0.94
chr17	35525973	35528959	CpG: 301	2986	301	2072	20.2	69.4	0.84
chr17	35529015	35529301	CpG: 19	286	19	187	13.3	65.4	0.67
chr17	35573166	35573928	CpG: 77	762	77	560	20.2	73.5	0.75
chr17	35584370	35585430	CpG: 88	1060	88	722	16.6	68.1	0.72
chr17	35908169	35908908	CpG: 64	739	64	434	17.3	58.7	1.00
chr17	35911208	35911483	CpG: 20	275	20	164	14.5	59.6	0.83
chr17	35928248	35929141	CpG: 107	893	107	654	24.0	73.2	0.89
chr17	36036936	36037473	CpG: 77	537	77	433	28.7	80.6	0.89
chr17	36067321	36068045	CpG: 71	724	71	505	19.6	69.8	0.81
chr17	36089789	36090311	CpG: 56	522	56	370	21.5	70.9	0.86
chr17	36099005	36099256	CpG: 28	251	28	160	22.3	63.7	1.10
chr17	36142984	36143832	CpG: 61	848	61	585	14.4	69.0	0.61
chr17	36190057	36191443	CpG: 90	1386	90	827	13.0	59.7	0.73
chr17	36198319	36198552	CpG: 19	233	19	139	16.3	59.7	0.94
chr17	36226841	36227220	CpG: 30	379	30	275	15.8	72.6	0.60
chr17	36293563	36293929	CpG: 27	366	27	222	14.8	60.7	0.80
chr17	36294380	36294595	CpG: 17	215	17	141	15.8	65.6	0.84
chr17	36321424	36321697	CpG: 24	273	24	174	17.6	63.7	0.87
chr17	36321926	36322594	CpG: 45	668	45	418	13.5	62.6	0.69
chr17	36396270	36397861	CpG: 101	1591	101	961	12.7	60.4	0.70
chr17	36408373	36408817	CpG: 44	444	44	318	19.8	71.6	0.78
chr17	36435165	36435899	CpG: 55	734	55	420	15.0	57.2	0.92
chr17	36515772	36516053	CpG: 30	281	30	183	21.4	65.1	1.01
chr17	36526424	36526648	CpG: 21	224	21	140	18.8	62.5	0.98
chr17	36535143	36535493	CpG: 32	350	32	218	18.3	62.3	0.94
chr17	36544491	36545047	CpG: 53	556	53	394	19.1	70.9	0.76
chr17	36679467	36680253	CpG: 74	786	74	582	18.8	74.0	0.70
chr17	36683086	36683331	CpG: 23	245	23	160	18.8	65.3	0.88
chr17	36688961	36689586	CpG: 62	625	62	435	19.8	69.6	0.82
chr17	36711974	36712838	CpG: 81	864	81	610	18.8	70.6	0.75
chr17	36714490	36714755	CpG: 20	265	20	176	15.1	66.4	0.70
chr17	36718019	36718318	CpG: 41	299	41	221	27.4	73.9	1.01
chr17	36742732	36743707	CpG: 100	975	100	696	20.5	71.4	0.81
chr17	36751691	36751953	CpG: 23	262	23	157	17.6	59.9	0.98
chr17	36756785	36757914	CpG: 93	1129	93	691	16.5	61.2	0.88
chr17	36766036	36766252	CpG: 18	216	18	128	16.7	59.3	0.95
chr17	36827259	36827530	CpG: 19	271	19	164	14.0	60.5	0.78
chr17	36829828	36830210	CpG: 28	382	28	224	14.7	58.6	0.86
chr17	36830569	36830809	CpG: 19	240	19	143	15.8	59.6	0.92
chr17	36842830	36843111	CpG: 22	281	22	173	15.7	61.6	0.84
chr17	36878549	36878751	CpG: 21	202	21	130	20.8	64.4	1.01
chr17	36915458	36915732	CpG: 19	274	19	157	13.9	57.3	0.86
chr17	36989113	36989344	CpG: 18	231	18	137	15.6	59.3	0.89
chr17	37114304	37114658	CpG: 26	354	26	244	14.7	68.9	0.62
chr17	37127770	37127997	CpG: 16	227	16	120	14.1	52.9	1.04
chr17	37130515	37131489	CpG: 102	974	102	704	20.9	72.3	0.80
chr17	37176568	37176833	CpG: 23	265	23	165	17.4	62.3	0.91
chr17	37195329	37195606	CpG: 23	277	23	174	16.6	62.8	0.86
chr17	37202293	37202577	CpG: 21	284	21	196	14.8	69.0	0.62
chr17	37223481	37223722	CpG: 20	241	20	146	16.6	60.6	0.92
chr17	37281701	37281986	CpG: 21	285	21	196	14.7	68.8	0.62
chr17	37300484	37300749	CpG: 23	265	23	165	17.4	62.3	0.91
chr17	37319261	37319538	CpG: 23	277	23	174	16.6	62.8	0.86
chr17	37342472	37343446	CpG: 103	974	103	704	21.1	72.3	0.81
chr17	37356012	37356986	CpG: 103	974	103	704	21.1	72.3	0.81
chr17	37402063	37402328	CpG: 23	265	23	165	17.4	62.3	0.91
chr17	37420825	37421102	CpG: 23	277	23	174	16.6	62.8	0.86
chr17	37427788	37428072	CpG: 21	284	21	194	14.8	68.3	0.63
chr17	37441261	37441488	CpG: 16	227	16	120	14.1	52.9	1.04
chr17	37449751	37450661	CpG: 71	910	71	602	15.6	66.2	0.72
chr17	37468425	37469076	CpG: 70	651	70	452	21.5	69.4	0.89
chr17	37472222	37472844	CpG: 62	622	62	410	19.9	65.9	0.93
chr17	37473272	37473504	CpG: 17	232	17	139	14.7	59.9	0.83
chr17	37520392	37521557	CpG: 113	1165	113	768	19.4	65.9	0.90
chr17	37530054	37531653	CpG: 157	1599	157	1135	19.6	71.0	0.78
chr17	37577967	37578816	CpG: 95	849	95	623	22.4	73.4	0.84
chr17	37587748	37588705	CpG: 84	957	84	649	17.6	67.8	0.77
chr17	37627751	37628668	CpG: 93	917	93	647	20.3	70.6	0.83
chr17	37643748	37644480	CpG: 66	732	66	485	18.0	66.3	0.82
chr17	37690286	37690570	CpG: 32	284	32	202	22.5	71.1	0.89
chr17	37708551	37708892	CpG: 38	341	38	258	22.3	75.7	0.78
chr17	37773325	37773599	CpG: 23	274	23	170	16.8	62.0	0.88
chr17	37795102	37795793	CpG: 80	691	80	502	23.2	72.6	0.89
chr17	37919145	37919380	CpG: 23	235	23	149	19.6	63.4	1.07
chr17	37919608	37919817	CpG: 17	209	17	147	16.3	70.3	0.74
chr17	37920160	37920420	CpG: 20	260	20	168	15.4	64.6	0.74
chr17	37921656	37930632	CpG: 622	8976	622	5592	13.9	62.3	0.72
chr17	37933041	37933329	CpG: 22	288	22	177	15.3	61.5	0.81
chr17	37935515	37936514	CpG: 109	999	109	665	21.8	66.6	0.98
chr17	37996599	37996880	CpG: 23	281	23	175	16.4	62.3	0.86
chr17	38345860	38346691	CpG: 88	831	88	620	21.2	74.6	0.77
chr17	38349695	38349976	CpG: 24	281	24	173	17.1	61.6	0.91
chr17	38396733	38397404	CpG: 96	671	96	526	28.6	78.4	0.95
chr17	38475884	38477072	CpG: 152	1188	152	890	25.6	74.9	0.91
chr17	38499303	38499607	CpG: 21	304	21	176	13.8	57.9	0.82
chr17	38548613	38548898	CpG: 25	285	25	177	17.5	62.1	0.93
chr17	38594672	38594889	CpG: 17	217	17	130	15.7	59.9	0.88
chr17	38596011	38596683	CpG: 69	672	69	479	20.5	71.3	0.83
chr17	38630180	38630619	CpG: 38	439	38	258	17.3	58.8	1.00
chr17	38710028	38710270	CpG: 19	242	19	143	15.7	59.1	0.93
chr17	38729016	38731748	CpG: 237	2732	237	1776	17.3	65.0	0.82
chr17	38732316	38732565	CpG: 19	249	19	160	15.3	64.3	0.80
chr17	38796399	38796639	CpG: 23	240	23	149	19.2	62.1	1.02
chr17	38865709	38866026	CpG: 24	317	24	185	15.1	58.4	0.91
chr17	38877197	38877478	CpG: 23	281	23	172	16.4	61.2	0.89
chr17	38887222	38887446	CpG: 21	224	21	140	18.8	62.5	0.99
chr17	38897300	38897574	CpG: 24	274	24	171	17.5	62.4	0.91
chr17	38907910	38908137	CpG: 16	227	16	119	14.1	52.4	1.07
chr17	38921263	38921618	CpG: 25	355	25	243	14.1	68.5	0.61
chr17	38928304	38928581	CpG: 24	277	24	175	17.3	63.2	0.89
chr17	38947103	38947368	CpG: 22	265	22	164	16.6	61.9	0.88
chr17	38965838	38966193	CpG: 25	355	25	243	14.1	68.5	0.61
chr17	39000841	39001196	CpG: 25	355	25	243	14.1	68.5	0.61
chr17	39019696	39019961	CpG: 23	265	23	165	17.4	62.3	0.91
chr17	39038492	39038769	CpG: 23	277	23	173	16.6	62.5	0.87
chr17	39045455	39045810	CpG: 25	355	25	243	14.1	68.5	0.61
chr17	39103672	39103913	CpG: 20	241	20	146	16.6	60.6	0.92
chr17	39119574	39120552	CpG: 113	978	113	756	23.1	77.3	0.79
chr17	39120812	39121048	CpG: 22	236	22	146	18.6	61.9	1.00
chr17	39127528	39127803	CpG: 23	275	23	170	16.7	61.8	0.88
chr17	39150833	39151113	CpG: 24	280	24	170	17.1	60.7	0.94
chr17	39159429	39160154	CpG: 59	725	59	428	16.3	59.0	0.97
chr17	39182730	39182967	CpG: 19	237	19	146	16.0	61.6	0.87
chr17	39214645	39215962	CpG: 146	1317	146	992	22.2	75.3	0.78
chr17	39272707	39272946	CpG: 18	239	18	145	15.1	60.7	0.84
chr17	39281987	39282583	CpG: 73	596	73	449	24.5	75.3	0.93
chr17	39291214	39292251	CpG: 99	1037	99	780	19.1	75.2	0.68
chr17	39316440	39317216	CpG: 114	776	114	619	29.4	79.8	0.95
chr17	39327925	39328193	CpG: 22	268	22	200	16.4	74.6	0.61
chr17	39340610	39340980	CpG: 43	370	43	267	23.2	72.2	0.91
chr17	39372784	39374030	CpG: 168	1246	168	949	27.0	76.2	0.93
chr17	39421233	39421650	CpG: 42	417	42	296	20.1	71.0	0.80
chr17	39422516	39422820	CpG: 27	304	27	214	17.8	70.4	0.77
chr17	39424552	39425418	CpG: 121	866	121	644	27.9	74.4	1.01
chr17	39426369	39426763	CpG: 41	394	41	266	20.8	67.5	0.91
chr17	39435463	39436114	CpG: 82	651	82	499	25.2	76.7	0.86
chr17	39441489	39442070	CpG: 56	581	56	425	19.3	73.1	0.72
chr17	39468552	39469940	CpG: 170	1388	170	1035	24.5	74.6	0.88
chr17	39536509	39538317	CpG: 228	1808	228	1356	25.2	75.0	0.90
chr17	39544609	39544834	CpG: 17	225	17	135	15.1	60.0	0.89
chr17	39565108	39569243	CpG: 358	4135	358	2663	17.3	64.4	0.84
chr17	39592940	39593606	CpG: 95	666	95	534	28.5	80.2	0.89
chr17	39610592	39613158	CpG: 223	2566	223	1745	17.4	68.0	0.76
chr17	39614867	39616408	CpG: 107	1541	107	903	13.9	58.6	0.81
chr17	39662088	39663212	CpG: 122	1124	122	832	21.7	74.0	0.79
chr17	39663890	39664113	CpG: 17	223	17	132	15.2	59.2	0.88
chr17	39688203	39688580	CpG: 37	377	37	231	19.6	61.3	1.05
chr17	39704253	39704466	CpG: 21	213	21	136	19.7	63.8	0.97
chr17	39705207	39705441	CpG: 18	234	18	140	15.4	59.8	0.88
chr17	39716269	39716916	CpG: 46	647	46	347	14.2	53.6	1.04
chr17	39718082	39718448	CpG: 32	366	32	214	17.5	58.5	1.02
chr17	39723900	39724102	CpG: 16	202	16	120	15.8	59.4	0.92
chr17	39732534	39733901	CpG: 126	1367	126	960	18.4	70.2	0.76
chr17	39781683	39781920	CpG: 30	237	30	157	25.3	66.2	1.15
chr17	39793661	39794347	CpG: 59	686	59	517	17.2	75.4	0.61
chr17	39830115	39830351	CpG: 17	236	17	143	14.4	60.6	0.81
chr17	39839538	39839749	CpG: 16	211	16	129	15.2	61.1	0.82
chr17	40004225	40004465	CpG: 18	240	18	143	15.0	59.6	0.88
chr17	40015103	40015771	CpG: 65	668	65	514	19.5	76.9	0.66
chr17	40019223	40019493	CpG: 22	270	22	163	16.3	60.4	0.90
chr17	40029106	40029723	CpG: 51	617	51	408	16.5	66.1	0.76
chr17	40039049	40039253	CpG: 16	204	16	133	15.7	65.2	0.77
chr17	40060829	40061826	CpG: 85	997	85	722	17.1	72.4	0.67
chr17	40064110	40064569	CpG: 43	459	43	301	18.7	65.6	0.89
chr17	40069436	40069717	CpG: 23	281	23	174	16.4	61.9	0.87
chr17	40073610	40074163	CpG: 54	553	54	396	19.5	71.6	0.76
chr17	40088578	40089988	CpG: 160	1410	160	1031	22.7	73.1	0.85
chr17	40197198	40197930	CpG: 56	732	56	486	15.3	66.4	0.70
chr17	40201037	40201888	CpG: 64	851	64	599	15.0	70.4	0.61
chr17	40234415	40234698	CpG: 23	283	23	170	16.3	60.1	0.91
chr17	40265024	40266641	CpG: 167	1617	167	1159	20.7	71.7	0.80
chr17	40315047	40315372	CpG: 29	325	29	193	17.8	59.4	1.01
chr17	40325184	40325698	CpG: 41	514	41	318	16.0	61.9	0.85
chr17	40436779	40437631	CpG: 77	852	77	567	18.1	66.5	0.82
chr17	40460136	40460560	CpG: 38	424	38	300	17.9	70.8	0.72
chr17	40467774	40468146	CpG: 34	372	34	253	18.3	68.0	0.79
chr17	40468870	40470862	CpG: 204	1992	204	1394	20.5	70.0	0.84
chr17	40471403	40471615	CpG: 21	212	21	146	19.8	68.9	0.84
chr17	40481239	40481907	CpG: 85	668	85	521	25.4	78.0	0.85
chr17	40490444	40491236	CpG: 83	792	83	578	21.0	73.0	0.79
chr17	40500582	40501039	CpG: 58	457	58	333	25.4	72.9	0.96
chr17	40531005	40532301	CpG: 128	1296	128	933	19.8	72.0	0.78
chr17	40551425	40551794	CpG: 32	369	32	228	17.3	61.8	0.91
chr17	40563660	40564198	CpG: 56	538	56	388	20.8	72.1	0.80
chr17	40586960	40587166	CpG: 17	206	17	138	16.5	67.0	0.74
chr17	40593762	40594317	CpG: 59	555	59	407	21.3	73.3	0.79
chr17	40617398	40618713	CpG: 153	1315	153	965	23.3	73.4	0.86
chr17	40727851	40728115	CpG: 37	264	37	197	28.0	74.6	1.01
chr17	40731615	40732107	CpG: 60	492	60	335	24.4	68.1	1.05
chr17	40790687	40791513	CpG: 78	826	78	574	18.9	69.5	0.80
chr17	40816438	40817135	CpG: 56	697	56	515	16.1	73.9	0.81
chr17	40844260	40845100	CpG: 90	840	90	558	21.4	66.4	0.97
chr17	40874824	40875203	CpG: 37	379	37	282	19.5	74.4	0.71
chr17	40877944	40878195	CpG: 18	251	18	150	14.3	59.8	0.82
chr17	40910350	40910625	CpG: 23	275	23	170	16.7	61.8	0.89
chr17	40918399	40918607	CpG: 19	208	19	121	18.3	58.2	1.09
chr17	40926567	40927512	CpG: 109	945	109	734	23.1	77.7	0.77
chr17	40953052	40953293	CpG: 18	241	18	152	14.9	63.1	0.78
chr17	40956892	40957235	CpG: 26	343	26	218	15.2	63.6	0.76
chr17	40962908	40963530	CpG: 54	622	54	424	17.4	68.2	0.75
chr17	40964269	40964716	CpG: 35	447	35	282	15.7	63.1	0.79
chr17	40985391	40987135	CpG: 194	1744	194	1329	22.2	76.2	0.77
chr17	41002441	41002674	CpG: 19	233	19	137	16.3	58.8	0.97
chr17	41004104	41004719	CpG: 70	615	70	428	22.8	69.6	0.94
chr17	41041231	41042422	CpG: 118	1191	118	884	19.8	74.2	0.72
chr17	41050168	41050449	CpG: 24	281	24	175	17.1	62.3	0.90
chr17	41055157	41055696	CpG: 54	539	54	382	20.0	70.9	0.80
chr17	41083082	41083490	CpG: 49	408	49	289	24.0	70.8	0.99
chr17	41091454	41091728	CpG: 24	274	24	171	17.5	62.4	0.91
chr17	41151058	41151395	CpG: 31	337	31	208	18.4	61.7	0.97
chr17	41152058	41152492	CpG: 33	434	33	254	15.2	58.5	0.89
chr17	41180214	41180457	CpG: 23	243	23	170	18.9	70.0	0.83
chr17	41181453	41182236	CpG: 68	783	68	529	17.4	67.6	0.76
chr17	41204787	41206223	CpG: 130	1436	130	1011	18.1	70.4	0.73
chr17	41208656	41209099	CpG: 39	443	39	317	17.6	71.6	0.69
chr17	41226225	41227524	CpG: 161	1299	161	953	24.8	73.4	0.93
chr17	41280963	41281490	CpG: 47	527	47	334	17.8	63.4	0.92
chr17	41284658	41284939	CpG: 22	281	22	173	15.7	61.6	0.84
chr17	41306519	41307555	CpG: 116	1036	116	776	22.4	74.9	0.80
chr17	41512070	41513006	CpG: 83	936	83	584	17.7	62.4	0.91
chr17	41643857	41644151	CpG: 32	294	32	190	21.8	64.6	1.04
chr17	41644891	41645154	CpG: 22	263	22	161	16.7	61.2	0.91
chr17	41650335	41650563	CpG: 19	228	19	137	16.7	60.1	0.96
chr17	41661281	41661581	CpG: 27	300	27	195	18.0	65.0	0.85
chr17	41683128	41683528	CpG: 69	400	69	302	34.5	75.5	1.24
chr17	41727450	41728164	CpG: 48	714	48	417	13.4	58.4	0.79
chr17	42054380	42054687	CpG: 28	307	28	185	18.2	60.3	1.01
chr17	42381572	42381818	CpG: 19	246	19	150	15.4	61.0	0.86
chr17	42383217	42383908	CpG: 83	691	83	487	24.0	70.5	0.97
chr17	42404369	42404656	CpG: 21	287	21	198	14.6	69.0	0.62
chr17	42504928	42505186	CpG: 20	258	20	169	15.5	65.5	0.72
chr17	42522407	42522628	CpG: 25	221	25	168	22.6	76.0	0.82
chr17	42545036	42546153	CpG: 104	1117	104	755	18.6	67.6	0.82
chr17	42590229	42591762	CpG: 130	1533	130	1046	17.0	68.2	0.73
chr17	42614009	42614319	CpG: 22	310	22	204	14.2	65.8	0.66
chr17	42642456	42643457	CpG: 99	1001	99	710	19.8	70.9	0.79
chr17	42667715	42668912	CpG: 135	1197	135	857	22.6	71.6	0.88
chr17	42675250	42675473	CpG: 17	223	17	131	15.2	58.7	0.92
chr17	42692325	42692931	CpG: 71	606	71	459	23.4	75.7	0.82
chr17	42721170	42722975	CpG: 162	1805	162	1128	18.0	62.5	0.93
chr17	42732074	42732865	CpG: 60	791	60	541	15.2	68.4	0.65
chr17	42774547	42775930	CpG: 123	1383	123	945	17.8	68.3	0.77
chr17	42787009	42787499	CpG: 37	490	37	269	15.1	54.9	1.01
chr17	42823065	42823780	CpG: 85	715	85	528	23.8	73.8	0.88
chr17	42824290	42824526	CpG: 17	236	17	150	14.4	63.6	0.71
chr17	42824712	42824950	CpG: 22	238	22	146	18.5	61.3	0.98
chr17	42873512	42874207	CpG: 66	695	66	472	19.0	67.9	0.82
chr17	42876444	42876794	CpG: 39	350	39	261	22.3	74.6	0.80
chr17	42896291	42896954	CpG: 73	663	73	477	22.0	71.9	0.85
chr17	42901586	42901864	CpG: 23	278	23	156	16.5	56.1	1.05
chr17	42906890	42907398	CpG: 61	508	61	394	24.0	77.6	0.80
chr17	42928870	42929387	CpG: 61	517	61	389	23.6	75.2	0.83
chr17	42954759	42955077	CpG: 35	318	35	236	22.0	74.2	0.81
chr17	42964007	42964463	CpG: 34	456	34	313	14.9	68.6	0.66
chr17	42973885	42974098	CpG: 21	213	21	137	19.7	64.3	0.95
chr17	42977509	42977926	CpG: 40	417	40	315	19.2	75.5	0.68
chr17	42979008	42979845	CpG: 64	837	64	541	15.3	64.6	0.74
chr17	42980236	42980467	CpG: 18	231	18	137	15.6	59.3	0.90
chr17	43011376	43012113	CpG: 67	737	67	474	18.2	64.3	0.88
chr17	43037067	43037941	CpG: 81	874	81	615	18.5	70.4	0.77
chr17	43040225	43041110	CpG: 82	885	82	606	18.5	68.5	0.79
chr17	43132420	43133505	CpG: 149	1085	149	833	27.5	76.8	0.95
chr17	43137342	43137616	CpG: 20	274	20	170	14.6	62.0	0.77
chr17	43144657	43145483	CpG: 95	826	95	609	23.0	73.7	0.85
chr17	43168762	43169416	CpG: 49	654	49	465	15.0	71.1	0.60
chr17	43240361	43240645	CpG: 25	284	25	176	17.6	62.0	0.92
chr17	43244029	43244967	CpG: 87	938	87	651	18.6	69.4	0.78
chr17	43261880	43263526	CpG: 147	1646	147	1002	17.9	60.9	0.97
chr17	43278999	43280785	CpG: 156	1786	156	1248	17.5	69.9	0.71
chr17	43307858	43308138	CpG: 20	280	20	171	14.3	61.1	0.78
chr17	43315926	43316212	CpG: 32	286	32	201	22.4	70.3	0.95
chr17	43389202	43389524	CpG: 50	322	50	236	31.1	73.3	1.16
chr17	43393202	43393958	CpG: 100	756	100	577	26.5	76.3	0.91
chr17	43405242	43406052	CpG: 81	810	81	560	20.0	69.1	0.84
chr17	43410347	43412332	CpG: 152	1985	152	1318	15.3	66.4	0.70
chr17	43419257	43420452	CpG: 80	1195	80	741	13.4	62.0	0.71
chr17	43423805	43424803	CpG: 100	998	100	704	20.0	70.5	0.81
chr17	43425270	43425538	CpG: 21	268	21	167	15.7	62.3	0.82
chr17	43434580	43435101	CpG: 48	521	48	342	18.4	65.6	0.86
chr17	43460846	43461120	CpG: 21	274	21	167	15.3	60.9	0.84
chr17	43466186	43466888	CpG: 73	702	73	481	20.8	68.5	0.89
chr17	43509133	43509410	CpG: 21	277	21	170	15.2	61.4	0.81
chr17	43510792	43511075	CpG: 20	283	20	166	14.1	58.7	0.87
chr17	43516351	43516716	CpG: 41	365	41	258	22.5	70.7	0.90
chr17	43527058	43528696	CpG: 144	1638	144	1115	17.6	68.1	0.76
chr17	43532679	43532904	CpG: 20	225	20	166	17.8	73.8	0.65
chr17	43533095	43537571	CpG: 290	4476	290	2838	13.0	63.4	0.65
chr17	43539910	43540221	CpG: 31	311	31	222	19.9	71.4	0.78
chr17	43540850	43541386	CpG: 39	536	39	334	14.6	62.3	0.75
chr17	43541918	43542644	CpG: 61	726	61	454	16.8	62.5	0.86
chr17	43543969	43545133	CpG: 80	1164	80	702	13.7	60.3	0.76
chr17	43587656	43587930	CpG: 24	274	24	171	17.5	62.4	0.91
chr17	43601780	43602356	CpG: 61	576	61	421	21.2	73.1	0.85
chr17	43617939	43618676	CpG: 89	737	89	557	24.2	75.6	0.85
chr17	43637451	43638421	CpG: 94	970	94	684	19.4	70.5	0.78
chr17	43641086	43641302	CpG: 17	216	17	132	15.7	61.1	0.85
chr17	43641567	43641790	CpG: 19	223	19	136	17.0	61.0	0.92
chr17	43642304	43642601	CpG: 36	297	36	209	24.2	70.4	0.99
chr17	43655596	43656024	CpG: 42	428	42	282	19.6	65.9	0.91
chr17	43681280	43681706	CpG: 40	426	40	282	18.8	66.2	0.86
chr17	43690129	43691044	CpG: 82	915	82	596	17.9	65.1	0.85
chr17	43813837	43814107	CpG: 24	270	24	169	17.8	62.6	0.92
chr17	43821473	43822553	CpG: 75	1080	75	613	13.9	56.8	0.87
chr17	43837717	43838622	CpG: 102	905	102	641	22.5	70.8	0.95
chr17	43879679	43880330	CpG: 77	651	77	474	23.7	72.8	0.89
chr17	43882547	43883012	CpG: 32	465	32	257	13.8	55.3	0.90
chr17	43883208	43884131	CpG: 78	923	78	637	16.9	69.0	0.72
chr17	43916106	43916343	CpG: 17	237	17	140	14.3	59.1	0.85
chr17	43979114	43979565	CpG: 31	451	31	257	13.7	57.0	0.85
chr17	43984752	43985862	CpG: 82	1110	82	726	14.8	65.4	0.69
chr17	43988261	43988488	CpG: 17	227	17	134	15.0	59.0	0.88
chr17	44004110	44004376	CpG: 20	266	20	162	15.0	60.9	0.82
chr17	44018088	44018366	CpG: 25	278	25	210	18.0	75.5	0.63
chr17	44029712	44030103	CpG: 27	391	27	234	13.8	59.8	0.77
chr17	44070486	44071032	CpG: 40	546	40	347	14.7	63.6	0.73
chr17	44089091	44089310	CpG: 18	219	18	127	16.4	58.0	0.99
chr17	44090287	44090969	CpG: 49	682	49	439	14.4	64.4	0.69
chr17	44100399	44100841	CpG: 44	442	44	302	19.9	68.3	0.86
chr17	44104624	44104835	CpG: 16	211	16	126	15.2	59.7	0.87
chr17	44110963	44111182	CpG: 18	219	18	127	16.4	58.0	0.99
chr17	44114995	44116567	CpG: 125	1572	125	971	15.9	61.8	0.83
chr17	44118616	44119131	CpG: 41	515	41	302	15.9	58.6	0.93
chr17	44121182	44122754	CpG: 125	1572	125	971	15.9	61.8	0.83
chr17	44124783	44125298	CpG: 41	515	41	302	15.9	58.6	0.93
chr17	44127353	44128925	CpG: 125	1572	125	971	15.9	61.8	0.83
chr17	44130942	44131457	CpG: 41	515	41	302	15.9	58.6	0.93
chr17	44133512	44135084	CpG: 124	1572	124	970	15.8	61.7	0.83
chr17	44137118	44137633	CpG: 41	515	41	302	15.9	58.6	0.93
chr17	44139685	44141257	CpG: 125	1572	125	971	15.9	61.8	0.83
chr17	44143276	44143791	CpG: 41	515	41	302	15.9	58.6	0.93
chr17	44145847	44147419	CpG: 125	1572	125	971	15.9	61.8	0.83
chr17	44149433	44149948	CpG: 41	515	41	302	15.9	58.6	0.93
chr17	44151992	44153564	CpG: 125	1572	125	971	15.9	61.8	0.83
chr17	44155580	44156095	CpG: 41	515	41	302	15.9	58.6	0.93
chr17	44158139	44159711	CpG: 126	1572	126	973	16.0	61.9	0.84
chr17	44161728	44162243	CpG: 41	515	41	302	15.9	58.6	0.93
chr17	44164287	44165859	CpG: 126	1572	126	971	16.0	61.8	0.84
chr17	44167870	44168385	CpG: 41	515	41	302	15.9	58.6	0.93
chr17	44210622	44211149	CpG: 50	527	50	273	19.0	51.8	1.42
chr17	44218570	44219003	CpG: 40	433	40	308	18.5	71.1	0.77
chr17	44228546	44228777	CpG: 19	231	19	151	16.5	65.4	0.81
chr17	44238512	44238725	CpG: 17	213	17	139	16.0	65.3	0.75
chr17	44248616	44249111	CpG: 56	495	56	344	22.6	69.5	0.96
chr17	44249666	44249878	CpG: 19	212	19	139	17.9	65.6	0.87
chr17	44336142	44336472	CpG: 28	330	28	197	17.0	59.7	0.95
chr17	44346899	44347113	CpG: 17	214	17	123	15.9	57.5	0.96
chr17	44397713	44399374	CpG: 143	1661	143	1095	17.2	65.9	0.79
chr17	44403661	44404053	CpG: 27	392	27	227	13.8	57.9	0.83
chr17	44438192	44438455	CpG: 18	263	18	156	13.7	59.3	0.79
chr17	44497740	44498007	CpG: 20	267	20	159	15.0	59.6	0.86
chr17	44498385	44498992	CpG: 72	607	72	460	23.7	75.8	0.83
chr17	44521133	44521524	CpG: 26	391	26	226	13.3	57.8	0.80
chr17	44566298	44566664	CpG: 41	366	41	261	22.4	71.3	0.88
chr17	44573049	44573772	CpG: 74	723	74	489	20.5	67.6	0.90
chr17	44607824	44608385	CpG: 75	561	75	415	26.7	74.0	0.99
chr17	44630810	44631909	CpG: 122	1099	122	780	22.2	71.0	0.88
chr17	44685218	44686244	CpG: 125	1026	125	764	24.4	74.5	0.88
chr17	44694916	44695388	CpG: 43	472	43	322	18.2	68.2	1.69
chr17	44753099	44753307	CpG: 20	208	20	147	19.2	70.7	0.77
chr17	44759325	44760189	CpG: 64	864	64	577	14.8	66.8	0.66
chr17	44769970	44770529	CpG: 39	559	39	351	14.0	62.8	0.71
chr17	44790363	44791238	CpG: 66	875	66	567	15.1	64.8	0.72
chr17	44805354	44806122	CpG: 78	768	78	524	20.3	68.2	0.90
chr17	44836235	44836832	CpG: 75	597	75	429	25.1	71.9	0.98
chr17	44843368	44843592	CpG: 18	224	18	132	16.1	58.9	0.97
chr17	44847086	44847589	CpG: 43	503	43	345	17.1	68.6	0.73
chr17	44857170	44860115	CpG: 224	2945	224	1988	15.2	67.5	0.67
chr17	44866852	44867088	CpG: 21	236	21	148	17.8	62.7	0.91
chr17	44867283	44867572	CpG: 23	289	23	180	15.9	62.3	0.83
chr17	44917368	44917939	CpG: 38	571	38	316	13.3	55.3	0.87
chr17	44918798	44919240	CpG: 59	442	59	327	26.7	74.0	0.98
chr17	44923066	44923642	CpG: 49	576	49	390	17.0	67.7	0.75
chr17	44975658	44976679	CpG: 103	1021	103	719	20.2	70.4	0.81
chr17	44978164	44978441	CpG: 21	277	21	149	15.2	53.8	1.07
chr17	44994636	44995414	CpG: 64	778	64	497	16.5	63.9	0.81
chr17	45021992	45022266	CpG: 22	274	22	157	16.1	57.3	1.00
chr17	45029865	45030334	CpG: 50	469	50	341	21.3	72.7	0.81
chr17	45032700	45034370	CpG: 153	1670	153	1254	18.3	75.1	0.65
chr17	45039138	45039380	CpG: 20	242	20	147	16.5	60.7	0.91
chr17	45039679	45040538	CpG: 62	859	62	533	14.4	62.0	0.77
chr17	45052026	45053878	CpG: 213	1852	213	1400	23.0	75.6	0.81
chr17	45063427	45064127	CpG: 64	700	64	506	18.3	72.3	0.70
chr17	45071596	45075447	CpG: 431	3851	431	2742	22.4	71.2	0.89
chr17	45090632	45092121	CpG: 125	1489	125	1111	16.8	74.6	0.60
chr17	45161235	45162104	CpG: 63	869	63	613	14.5	70.5	0.61
chr17	45168034	45168790	CpG: 85	756	85	536	22.5	70.9	0.90
chr17	45177110	45180092	CpG: 266	2982	266	1926	17.8	64.6	0.86
chr17	45198619	45198852	CpG: 16	233	16	135	13.7	57.9	0.84
chr17	45207645	45209186	CpG: 208	1541	208	1174	27.0	76.2	0.93
chr17	45217174	45218049	CpG: 102	875	102	657	23.3	75.1	0.84
chr17	45223942	45224149	CpG: 17	207	17	119	16.4	57.5	1.01
chr17	45238722	45240192	CpG: 108	1470	108	983	14.7	66.9	0.67
chr17	45276534	45276761	CpG: 18	227	18	137	15.9	60.4	0.90
chr17	45316733	45316954	CpG: 17	221	17	132	15.4	59.7	0.89
chr17	45357017	45357808	CpG: 79	791	79	519	20.0	65.6	0.93
chr17	45358773	45359009	CpG: 19	236	19	142	16.1	60.2	0.92
chr17	45369392	45369662	CpG: 19	270	19	165	14.1	61.1	0.76
chr17	45378189	45379142	CpG: 70	953	70	664	14.7	69.7	0.61
chr17	45381872	45382271	CpG: 31	399	31	287	15.5	71.9	0.60
chr17	45411367	45413389	CpG: 203	2022	203	1339	20.1	66.2	0.92
chr17	45509079	45509329	CpG: 20	250	20	148	16.0	59.2	0.93
chr17	45510032	45511210	CpG: 122	1178	122	814	20.7	69.1	0.87
chr17	45543597	45544164	CpG: 50	567	50	355	17.6	62.6	0.91
chr17	45551008	45551258	CpG: 20	250	20	149	16.0	59.6	0.93
chr17	45562492	45562870	CpG: 32	378	32	213	16.9	56.3	1.20
chr17	45612354	45613510	CpG: 126	1156	126	870	21.8	75.3	0.77
chr17	45628885	45630231	CpG: 99	1346	99	919	14.7	68.3	0.65
chr17	45633176	45633427	CpG: 19	251	19	172	15.1	68.5	0.65
chr17	45683384	45684635	CpG: 178	1251	178	941	28.5	75.2	1.02
chr17	45752995	45753634	CpG: 53	639	53	393	16.6	61.5	0.88
chr17	45765287	45765694	CpG: 44	407	44	298	21.6	73.2	0.82
chr17	45801185	45801871	CpG: 61	686	61	444	17.8	64.7	0.85
chr17	45813716	45814315	CpG: 56	599	56	415	18.7	69.3	0.81
chr17	45820923	45822978	CpG: 208	2055	208	1463	20.2	71.2	0.80
chr17	45824101	45824508	CpG: 49	407	49	304	24.1	74.7	0.88
chr17	45838118	45838912	CpG: 87	794	87	532	21.9	67.0	1.66
chr17	45872981	45873676	CpG: 78	695	78	479	22.4	68.9	0.97
chr17	45875792	45876231	CpG: 50	439	50	323	22.8	73.6	0.84
chr17	45888181	45888388	CpG: 15	207	15	126	14.5	60.9	0.79
chr17	45905399	45906081	CpG: 100	682	100	522	29.3	76.5	1.04
chr17	45914733	45915361	CpG: 45	628	45	371	14.3	59.1	0.83
chr17	45924352	45924584	CpG: 17	232	17	137	14.7	59.1	0.85
chr17	45926519	45926726	CpG: 17	207	17	125	16.4	60.4	0.91
chr17	45972597	45972900	CpG: 23	303	23	202	15.2	66.7	0.70
chr17	45974788	45975284	CpG: 65	496	65	367	26.2	74.0	0.96
chr17	45985864	45987740	CpG: 167	1876	167	1283	17.8	68.4	0.76
chr17	45988378	45988615	CpG: 19	237	19	138	16.0	58.2	0.98
chr17	45998278	45998901	CpG: 60	623	60	462	19.3	74.2	0.70
chr17	45999361	45999599	CpG: 18	238	18	140	15.1	58.8	0.89
chr17	46001283	46004127	CpG: 196	2844	196	1655	13.8	58.2	0.82
chr17	46014778	46015751	CpG: 83	973	83	628	17.1	64.5	0.82
chr17	46023369	46023697	CpG: 25	328	25	217	15.2	66.2	0.72
chr17	46075077	46076089	CpG: 136	1012	136	792	26.9	78.3	0.88
chr17	46094799	46095862	CpG: 94	1063	94	757	17.7	71.2	0.70
chr17	46101056	46102108	CpG: 99	1052	99	741	18.8	70.4	0.76
chr17	46115502	46116210	CpG: 65	708	65	496	18.4	70.1	0.75
chr17	46170289	46171336	CpG: 125	1047	125	754	23.9	72.0	0.92
chr17	46225419	46225651	CpG: 33	232	33	182	28.4	78.4	0.93
chr17	46248894	46250710	CpG: 141	1816	141	1228	15.5	67.6	0.68
chr17	46259459	46259816	CpG: 33	357	33	248	18.5	69.5	0.77
chr17	46283157	46286726	CpG: 320	3569	320	2455	17.9	68.8	0.76
chr17	46343963	46344721	CpG: 75	758	75	543	19.8	71.6	0.79
chr17	46345291	46345569	CpG: 20	278	20	170	14.4	61.2	0.77
chr17	46354738	46355043	CpG: 24	305	24	196	15.7	64.3	0.77
chr17	46431667	46431904	CpG: 20	237	20	141	16.9	59.5	0.97
chr17	46446346	46448122	CpG: 165	1776	165	1213	18.6	68.3	0.81
chr17	46452232	46452442	CpG: 17	210	17	129	16.2	61.4	0.87
chr17	46463171	46464019	CpG: 72	848	72	554	17.0	65.3	0.80
chr17	46482158	46482654	CpG: 62	496	62	394	25.0	79.4	0.83
chr17	46644946	46647190	CpG: 235	2244	235	1616	20.9	72.0	0.81
chr17	46755667	46759297	CpG: 321	3630	321	2389	17.7	65.8	0.82
chr17	46810817	46811028	CpG: 27	211	27	156	25.6	73.9	0.94
chr17	46844513	46844797	CpG: 21	284	21	196	14.8	69.0	0.62
chr17	46868307	46868508	CpG: 15	201	15	115	14.9	57.2	0.94
chr17	46960667	46960946	CpG: 24	279	24	172	17.2	61.6	0.91
chr17	47008161	47008435	CpG: 23	274	23	169	16.8	61.7	0.89
chr17	47054414	47055798	CpG: 172	1384	172	1023	24.9	73.9	0.91
chr17	47086403	47086899	CpG: 62	496	62	394	25.0	79.4	0.82
chr17	47092731	47092996	CpG: 19	265	19	158	14.3	59.6	0.82
chr17	47099816	47100224	CpG: 42	408	42	337	20.6	82.6	0.60
chr17	47105641	47105904	CpG: 38	263	38	204	28.9	77.6	0.97
chr17	47106131	47106459	CpG: 23	328	23	197	14.0	60.1	0.80
chr17	47114926	47115661	CpG: 63	735	63	508	17.1	69.1	0.72
chr17	47122064	47122578	CpG: 55	514	55	363	21.4	70.6	0.86
chr17	47128328	47128556	CpG: 17	228	17	129	14.9	56.6	0.93
chr17	47128672	47129468	CpG: 114	796	114	574	28.6	72.1	1.10
chr17	47203349	47203933	CpG: 40	584	40	365	13.7	62.5	0.70
chr17	47223181	47224185	CpG: 71	1004	71	597	14.1	59.5	0.80
chr17	47234502	47235229	CpG: 88	727	88	533	24.2	73.3	0.90
chr17	47420860	47421444	CpG: 40	584	40	365	13.7	62.5	0.70
chr17	47440695	47441699	CpG: 71	1004	71	598	14.1	59.6	0.80
chr17	47452030	47452757	CpG: 88	727	88	533	24.2	73.3	0.90
chr17	47631242	47631566	CpG: 42	324	42	228	25.9	70.4	1.05
chr17	47632411	47634010	CpG: 212	1599	212	1182	26.5	73.9	0.97
chr17	47679913	47681138	CpG: 112	1225	112	828	18.3	67.6	0.80
chr17	47703271	47703494	CpG: 28	223	28	164	25.1	73.5	0.93
chr17	47712388	47713791	CpG: 144	1403	144	1005	20.5	71.6	0.81
chr17	47784294	47784778	CpG: 41	484	41	311	16.9	64.3	0.82
chr17	47835881	47836088	CpG: 16	207	16	126	15.5	60.9	0.85
chr17	47837417	47837656	CpG: 16	239	16	138	13.4	57.7	0.82
chr17	47839382	47840903	CpG: 162	1521	162	1054	21.3	69.3	0.90
chr17	47917934	47918181	CpG: 17	247	17	141	13.8	57.1	0.88
chr17	47918767	47919119	CpG: 30	352	30	255	17.0	72.4	0.65
chr17	47961356	47961853	CpG: 45	497	45	367	18.1	73.8	0.69
chr17	48009457	48009730	CpG: 25	273	25	168	18.3	61.5	0.98
chr17	48051230	48051953	CpG: 64	723	64	454	17.7	62.8	0.90
chr17	48115916	48116754	CpG: 112	838	112	629	26.7	75.1	0.96
chr17	48185887	48186453	CpG: 64	566	64	410	22.6	72.4	0.90
chr17	48187450	48187671	CpG: 18	221	18	133	16.3	60.2	0.91
chr17	48286068	48286995	CpG: 120	927	120	698	25.9	75.3	0.91
chr17	48287559	48287841	CpG: 25	282	25	178	17.7	63.1	0.90
chr17	48320669	48320908	CpG: 21	239	21	150	17.6	62.8	0.91
chr17	48355162	48355862	CpG: 59	700	59	420	16.9	60.0	0.98
chr17	48363786	48364058	CpG: 22	272	22	164	16.2	60.3	0.90
chr17	48392643	48393609	CpG: 113	966	113	750	23.4	77.6	0.80
chr17	48409478	48409756	CpG: 23	278	23	174	16.5	62.6	0.86
chr17	48510240	48510510	CpG: 20	270	20	160	14.8	59.3	0.85
chr17	48511091	48512640	CpG: 151	1549	151	1097	19.5	70.8	0.80
chr17	48551183	48551415	CpG: 18	232	18	138	15.5	59.5	0.90
chr17	48555529	48557414	CpG: 170	1885	170	1353	18.0	71.8	0.70
chr17	48557872	48558116	CpG: 18	244	18	161	14.8	66.0	0.68
chr17	48570512	48571364	CpG: 106	852	106	655	24.9	76.9	0.89
chr17	48594853	48595832	CpG: 120	979	120	707	24.5	72.2	0.94
chr17	48639996	48640466	CpG: 52	470	52	349	22.1	74.3	0.82
chr17	48651354	48652152	CpG: 72	798	72	552	18.0	69.2	0.77
chr17	48675358	48675567	CpG: 18	209	18	139	17.2	66.5	0.78
chr17	48693191	48693474	CpG: 29	283	29	191	20.5	67.5	0.90
chr17	48702501	48703181	CpG: 55	680	55	466	16.2	68.5	0.70
chr17	48709005	48710214	CpG: 100	1209	100	834	16.5	69.0	0.70
chr17	48712618	48713118	CpG: 57	500	57	362	22.8	72.4	0.87
chr17	48734086	48734295	CpG: 20	209	20	150	19.1	71.8	0.81
chr17	48757144	48757374	CpG: 17	230	17	127	14.8	55.2	0.99
chr17	48757889	48758678	CpG: 78	789	78	554	19.8	70.2	0.82
chr17	48795692	48795966	CpG: 26	274	26	172	19.0	62.8	0.98
chr17	48831075	48831350	CpG: 19	275	19	163	13.8	59.3	0.80
chr17	48832498	48833304	CpG: 67	806	67	541	16.6	67.1	0.74
chr17	48874083	48874298	CpG: 30	215	30	160	27.9	74.4	1.01
chr17	48885244	48887351	CpG: 153	2107	153	1323	14.5	62.8	0.74
chr17	48899019	48899719	CpG: 80	700	80	522	22.9	74.6	0.85
chr17	48909446	48910684	CpG: 102	1238	102	820	16.5	66.2	0.76
chr17	48921101	48921421	CpG: 28	320	28	206	17.5	64.4	0.85
chr17	48964121	48964915	CpG: 91	794	91	557	22.9	70.2	0.96
chr17	48970835	48971173	CpG: 38	338	38	238	22.5	70.4	0.91
chr17	49022049	49022320	CpG: 21	271	21	165	15.5	60.9	0.85
chr17	49061555	49061791	CpG: 19	236	19	140	16.1	59.3	0.95
chr17	49293452	49293886	CpG: 54	434	54	326	24.9	75.1	0.91
chr17	49356041	49356572	CpG: 46	531	46	344	17.3	64.8	0.84
chr17	49390436	49390955	CpG: 51	519	51	366	19.7	70.5	0.82
chr17	49393870	49394456	CpG: 41	586	41	378	14.0	64.5	0.68
chr17	49405305	49405531	CpG: 24	226	24	167	21.2	73.9	0.84
chr17	49406584	49407590	CpG: 93	1006	93	664	18.5	66.0	0.85
chr17	49414005	49414944	CpG: 88	939	88	634	18.7	67.5	0.82
chr17	49415771	49416034	CpG: 21	263	21	180	16.0	68.4	0.71
chr17	49418020	49418432	CpG: 36	412	36	268	17.5	65.0	0.84
chr17	49419237	49419447	CpG: 22	210	22	151	21.0	71.9	0.81
chr17	49427763	49428339	CpG: 70	576	70	430	24.3	74.7	0.87
chr17	49440281	49440597	CpG: 32	316	32	212	20.3	67.1	0.90
chr17	49441442	49441831	CpG: 51	389	51	298	26.2	76.6	0.93
chr17	49445176	49446231	CpG: 90	1055	90	668	17.1	63.3	0.85
chr17	49455662	49456039	CpG: 31	377	31	243	16.4	64.5	0.81
chr17	49456750	49457688	CpG: 73	938	73	562	15.6	59.9	0.91
chr17	49459762	49460411	CpG: 54	649	54	424	16.6	65.3	0.79
chr17	49461274	49461819	CpG: 65	545	65	367	23.9	67.3	1.06
chr17	49471475	49471813	CpG: 31	338	31	198	18.3	58.6	1.08
chr17	49473760	49478342	CpG: 295	4582	295	2726	12.9	59.5	0.73
chr17	49481567	49481795	CpG: 23	228	23	158	20.2	69.3	0.87
chr17	49482795	49483160	CpG: 29	365	29	239	15.9	65.5	0.74
chr17	49483647	49483935	CpG: 24	288	24	188	16.7	65.3	0.78
chr17	49485114	49485317	CpG: 23	203	23	143	22.7	70.4	0.92
chr17	49488514	49490400	CpG: 170	1886	170	1262	18.0	66.9	0.81
chr17	49497046	49497947	CpG: 84	901	84	579	18.6	64.3	0.91
chr17	49500162	49500367	CpG: 24	205	24	147	23.4	71.7	0.92
chr17	49505295	49506468	CpG: 86	1173	86	741	14.7	63.2	0.73
chr17	49509965	49510617	CpG: 71	652	71	477	21.8	73.2	0.82
chr17	49541803	49542244	CpG: 35	441	35	302	15.9	68.5	0.68
chr17	49582473	49583531	CpG: 98	1058	98	636	18.5	60.1	1.03
chr17	49586772	49586985	CpG: 16	213	16	114	15.0	53.5	1.05
chr17	49587184	49587527	CpG: 30	343	30	198	17.5	57.7	1.06
chr17	49588023	49588310	CpG: 23	287	23	189	16.0	65.9	0.74
chr17	49589029	49589315	CpG: 29	286	29	195	20.3	68.2	0.88
chr17	49590442	49590654	CpG: 21	212	21	134	19.8	63.2	0.99
chr17	49591792	49592387	CpG: 46	595	46	395	15.5	66.4	0.70
chr17	49596803	49597176	CpG: 39	373	39	248	20.9	66.5	0.95
chr17	49611017	49611604	CpG: 52	587	52	392	17.7	66.8	0.80
chr17	49613667	49613873	CpG: 16	206	16	123	15.5	59.7	0.88
chr17	49618334	49618864	CpG: 46	530	46	335	17.4	63.2	0.87
chr17	49671451	49671725	CpG: 19	274	19	169	13.9	61.7	0.74
chr17	49680496	49681012	CpG: 54	516	54	365	20.9	70.7	0.86
chr17	49690122	49690338	CpG: 17	216	17	133	15.7	61.6	0.85
chr17	49694525	49695068	CpG: 44	543	44	374	16.2	68.9	0.70
chr17	49754756	49755029	CpG: 24	273	24	168	17.6	61.5	0.94
chr17	49756074	49756503	CpG: 35	429	35	252	16.3	58.7	0.95
chr17	49762523	49763033	CpG: 38	510	38	296	14.9	58.0	0.89
chr17	49771943	49772891	CpG: 104	948	104	692	21.9	73.0	0.83
chr17	49807731	49807976	CpG: 19	245	19	148	15.5	60.4	0.87
chr17	49808417	49808699	CpG: 39	282	39	204	27.7	72.3	1.08
chr17	49819463	49819700	CpG: 18	237	18	139	15.2	58.6	0.90
chr17	49832607	49832873	CpG: 19	266	19	163	14.3	61.3	0.77
chr17	49851685	49851973	CpG: 21	288	21	177	14.6	61.5	0.78
chr17	49858803	49862025	CpG: 262	3222	262	2081	16.3	64.6	0.79
chr17	49877023	49877748	CpG: 60	725	60	525	16.6	72.4	0.64
chr17	49877959	49878197	CpG: 18	238	18	158	15.1	66.4	0.69
chr17	49890930	49891196	CpG: 19	266	19	161	14.3	60.5	0.80
chr17	49899250	49899484	CpG: 17	234	17	148	14.5	63.2	0.74
chr17	49920553	49920834	CpG: 23	281	23	174	16.4	61.9	0.87
chr17	49963397	49963679	CpG: 26	282	26	176	18.4	62.4	0.96
chr17	49988951	49989389	CpG: 44	438	44	345	20.1	78.8	0.65
chr17	49995852	49996781	CpG: 87	929	87	627	18.7	67.5	0.88
chr17	50055058	50056161	CpG: 83	1103	83	670	15.0	60.7	0.82
chr17	50082691	50083036	CpG: 28	345	28	248	16.2	71.9	0.72
chr17	50083649	50083885	CpG: 19	236	19	140	16.1	59.3	0.94
chr17	50087267	50088199	CpG: 105	932	105	645	22.5	69.2	0.95
chr17	50093462	50093998	CpG: 50	536	50	375	18.7	70.0	0.76
chr17	50098250	50098485	CpG: 20	235	20	143	17.0	60.9	0.94
chr17	50123295	50123707	CpG: 62	412	62	319	30.1	77.4	1.02
chr17	50224550	50225582	CpG: 139	1032	139	806	26.9	78.1	0.88
chr17	50283226	50283427	CpG: 15	201	15	131	14.9	65.2	0.71
chr17	50333017	50333530	CpG: 42	513	42	344	16.4	67.1	0.73
chr17	50357990	50360961	CpG: 276	2971	276	2056	18.6	69.2	0.80
chr17	50369258	50369710	CpG: 61	452	61	317	27.0	70.1	1.11
chr17	50375800	50376073	CpG: 23	273	23	193	16.8	70.7	0.69
chr17	50398423	50398704	CpG: 20	281	20	170	14.2	60.5	0.78
chr17	50419345	50419553	CpG: 18	208	18	147	17.3	70.7	0.70
chr17	50431047	50431515	CpG: 33	468	33	289	14.1	61.8	0.74
chr17	50432795	50433431	CpG: 62	636	62	402	19.5	63.2	0.98
chr17	50438560	50440140	CpG: 159	1580	159	1152	20.1	72.9	0.76
chr17	50518395	50518620	CpG: 18	225	18	136	16.0	60.4	0.89
chr17	50540619	50541521	CpG: 72	902	72	585	16.0	64.9	0.76
chr17	50541964	50542222	CpG: 21	258	21	146	16.3	56.6	1.03
chr17	50626563	50627274	CpG: 61	711	61	519	17.2	73.0	0.74
chr17	50651702	50652452	CpG: 67	750	67	477	17.9	63.6	0.88
chr17	50714002	50715093	CpG: 103	1091	103	759	18.9	69.6	0.80
chr17	50743355	50743898	CpG: 40	543	40	371	14.7	68.3	0.67
chr17	50753626	50754162	CpG: 45	536	45	376	16.8	70.1	0.69
chr17	50765136	50765503	CpG: 39	367	39	271	21.3	73.8	0.78
chr17	50769108	50769382	CpG: 22	274	22	168	16.1	61.3	0.86
chr17	50773292	50773869	CpG: 65	577	65	425	22.5	73.7	0.84
chr17	50823228	50823494	CpG: 23	266	23	170	17.3	63.9	0.86
chr17	50826945	50828843	CpG: 135	1898	135	1131	14.2	59.6	0.80
chr17	50831563	50832983	CpG: 116	1420	116	961	16.3	67.7	0.72
chr17	50834729	50836392	CpG: 135	1663	135	1119	16.2	67.3	0.72
chr17	50856370	50858430	CpG: 167	2060	167	1327	16.2	64.4	0.79
chr17	50859834	50860398	CpG: 54	564	54	403	19.1	71.5	0.75
chr17	50919931	50920162	CpG: 17	231	17	139	14.7	60.2	0.82
chr17	50921095	50922185	CpG: 114	1090	114	765	20.9	70.2	0.86
chr17	50962193	50962728	CpG: 57	535	57	375	21.3	70.1	0.91
chr17	50966612	50966823	CpG: 17	211	17	127	16.1	60.2	0.91
chr17	50972991	50973212	CpG: 18	221	18	144	16.3	65.2	0.77
chr17	50984348	50984821	CpG: 60	473	60	353	25.4	74.6	0.92
chr17	50996402	50997602	CpG: 119	1200	119	884	19.8	73.7	0.75
chr17	51015917	51018324	CpG: 260	2407	260	1733	21.6	72.0	0.84
chr17	51028476	51028777	CpG: 36	301	36	210	23.9	69.8	0.99
chr17	51066586	51068696	CpG: 146	2110	146	1325	13.8	62.8	0.71
chr17	51140143	51140553	CpG: 41	410	41	306	20.0	74.6	0.73
chr17	51171358	51171597	CpG: 18	239	18	143	15.1	59.8	0.87
chr17	51212972	51214094	CpG: 127	1122	127	843	22.6	75.1	0.81
chr17	51240080	51240289	CpG: 19	209	19	128	18.2	61.2	0.98
chr17	51264143	51264722	CpG: 68	579	68	406	23.5	70.1	0.96
chr17	51292692	51293518	CpG: 73	826	73	579	17.7	70.1	0.72
chr17	51335209	51336539	CpG: 116	1330	116	892	17.4	67.1	0.78
chr17	51343081	51343467	CpG: 43	386	43	290	22.3	75.1	1.02
chr17	51345739	51346244	CpG: 66	505	66	374	26.1	74.1	0.95
chr17	51375122	51375904	CpG: 83	782	83	548	21.2	70.1	0.87
chr17	51403650	51404238	CpG: 46	588	46	377	15.6	64.1	0.76
chr17	51408883	51409566	CpG: 76	683	76	489	22.3	71.6	0.88
chr17	51414188	51414496	CpG: 39	308	39	237	25.3	76.9	0.87
chr17	51425865	51429054	CpG: 274	3189	274	2184	17.2	68.5	0.73
chr17	51438963	51439173	CpG: 16	210	16	138	15.2	65.7	0.71
chr17	51470138	51470357	CpG: 17	219	17	147	15.5	67.1	0.71
chr17	51501854	51502509	CpG: 77	655	77	500	23.5	76.3	0.81
chr17	51574409	51575179	CpG: 79	770	79	562	20.5	73.0	0.79
chr17	51586588	51587156	CpG: 71	568	71	408	25.0	71.8	0.99
chr17	51648442	51648745	CpG: 35	303	35	204	23.1	67.3	1.02
chr17	51707562	51708096	CpG: 37	534	37	346	13.9	64.8	0.66
chr17	51732732	51734726	CpG: 204	1994	204	1380	20.5	69.2	0.86
chr17	51761522	51761796	CpG: 25	274	25	172	18.2	62.8	0.93
chr17	51798475	51799143	CpG: 65	668	65	436	19.5	65.3	0.91
chr17	51811845	51812268	CpG: 50	423	50	303	23.6	71.6	0.92
chr17	51971959	51972233	CpG: 23	274	23	169	16.8	61.7	0.89
chr17	51987483	51988436	CpG: 125	953	125	722	26.2	75.8	0.91
chr17	52017874	52018151	CpG: 25	277	25	172	18.1	62.1	0.94
chr17	52019259	52019871	CpG: 43	612	43	328	14.1	53.6	0.98
chr17	52020640	52021262	CpG: 52	622	52	372	16.7	59.8	0.99
chr17	52033565	52034592	CpG: 127	1027	127	764	24.7	74.4	0.90
chr17	52126969	52128450	CpG: 150	1481	150	1010	20.3	68.2	0.87
chr17	52946805	52947035	CpG: 18	230	18	139	15.7	60.4	0.86
chr17	52949273	52949551	CpG: 23	278	23	173	16.5	62.2	0.86
chr17	53014138	53014393	CpG: 19	255	19	157	14.9	61.6	0.79
chr17	53025538	53026829	CpG: 117	1291	117	868	18.1	67.2	0.80
chr17	53154555	53154792	CpG: 20	237	20	139	16.9	58.6	1.00
chr17	53601412	53601682	CpG: 21	270	21	164	15.6	60.7	0.85
chr17	53759199	53759721	CpG: 41	522	41	376	15.7	72.0	0.61
chr17	53828584	53828825	CpG: 18	241	18	144	14.9	59.8	0.86
chr17	54162672	54162946	CpG: 23	274	23	169	16.8	61.7	0.89
chr17	54172183	54172411	CpG: 18	228	18	136	15.8	59.6	0.91
chr17	54227357	54227633	CpG: 22	276	22	169	15.9	61.2	0.86
chr17	54380859	54381099	CpG: 18	240	18	143	15.0	59.6	0.85
chr17	54422287	54422557	CpG: 20	270	20	163	14.8	60.4	0.82
chr17	54440694	54440930	CpG: 16	236	16	141	13.6	59.7	0.78
chr17	54508126	54508362	CpG: 18	236	18	141	15.3	59.7	0.89
chr17	54577273	54577559	CpG: 23	286	23	177	16.1	61.9	0.86
chr17	54605279	54605515	CpG: 20	236	20	144	16.9	61.0	0.93
chr17	54632527	54632777	CpG: 17	250	17	160	13.6	64.0	0.66
chr17	54755027	54755305	CpG: 26	278	26	176	18.7	63.3	0.94
chr17	55662812	55663330	CpG: 38	518	38	305	14.7	58.9	0.85
chr17	55775411	55775852	CpG: 54	441	54	323	24.5	73.2	0.91
chr17	55843116	55843933	CpG: 69	817	69	514	16.9	62.9	0.86
chr17	56039419	56039702	CpG: 25	283	25	176	17.7	62.2	0.93
chr17	56113264	56113844	CpG: 66	580	66	398	22.8	68.6	0.97
chr17	56139840	56140966	CpG: 110	1126	110	713	19.5	63.3	0.97
chr17	56145689	56145998	CpG: 28	309	28	184	18.1	59.5	1.03
chr17	56276780	56277029	CpG: 21	249	21	149	16.9	59.8	0.97
chr17	56295856	56297159	CpG: 124	1303	124	921	19.0	70.7	0.76
chr17	56377834	56378256	CpG: 32	422	32	253	15.2	60.0	0.85
chr17	56413197	56413431	CpG: 21	234	21	142	17.9	60.7	1.00
chr17	56437413	56437715	CpG: 24	302	24	192	15.9	63.6	0.79
chr17	56627113	56627496	CpG: 36	383	36	280	18.8	73.1	0.71
chr17	56715775	56716041	CpG: 23	266	23	166	17.3	62.4	0.90
chr17	56721508	56721913	CpG: 34	405	34	268	16.8	66.2	0.77
chr17	56918648	56918849	CpG: 16	201	16	119	15.9	59.2	0.94
chr17	56949159	56949433	CpG: 23	274	23	169	16.8	61.7	0.89
chr17	57065342	57065616	CpG: 22	274	22	169	16.1	61.7	0.85
chr17	57386719	57387264	CpG: 40	545	40	360	14.7	66.1	0.68
chr17	57468711	57471108	CpG: 232	2397	232	1680	19.4	70.1	0.79
chr17	57472695	57473128	CpG: 34	433	34	289	15.7	66.7	0.85
chr17	57473635	57473994	CpG: 38	359	38	247	21.2	68.8	0.90
chr17	57547898	57548181	CpG: 23	283	23	171	16.3	60.4	0.90
chr17	57656490	57656712	CpG: 28	222	28	164	25.2	73.9	0.93
chr17	57710367	57712341	CpG: 236	1974	236	1437	23.9	72.8	0.90
chr17	57747527	57747752	CpG: 21	225	21	143	18.7	63.6	0.94
chr17	57791119	57792058	CpG: 94	939	94	651	20.0	69.3	0.84
chr17	57838336	57838809	CpG: 49	473	49	315	20.7	66.6	0.93
chr17	57855576	57855835	CpG: 28	259	28	193	21.6	74.5	0.79
chr17	57919918	57921141	CpG: 105	1223	105	817	17.2	66.8	0.78
chr17	57958291	57958525	CpG: 18	234	18	139	15.4	59.4	0.89
chr17	57959156	57960891	CpG: 200	1735	200	1232	23.1	71.0	0.92
chr17	58002510	58002787	CpG: 22	277	22	169	15.9	61.0	0.86
chr17	58098079	58098366	CpG: 22	287	22	177	15.3	61.7	0.82
chr17	58124064	58124339	CpG: 24	275	24	171	17.5	62.2	0.91
chr17	58130782	58132140	CpG: 133	1358	133	938	19.6	69.1	0.83
chr17	58723099	58723985	CpG: 60	886	60	544	13.5	61.4	0.72
chr17	58734987	58735490	CpG: 57	503	57	374	22.7	74.4	0.82
chr17	58747893	58748148	CpG: 21	255	21	165	16.5	64.7	0.81
chr17	58758481	58759137	CpG: 63	656	63	459	19.2	70.0	0.78
chr17	58827765	58829082	CpG: 160	1317	160	1006	24.3	76.4	0.84
chr17	58842522	58842793	CpG: 21	271	21	163	15.5	60.1	0.88
chr17	58842969	58843209	CpG: 17	240	17	144	14.2	60.0	0.82
chr17	58861205	58862692	CpG: 139	1487	139	1065	18.7	71.6	0.73
chr17	58880397	58882020	CpG: 146	1623	146	969	18.0	59.7	1.01
chr17	58957283	58958254	CpG: 128	971	128	760	26.4	78.3	0.87
chr17	59024857	59025363	CpG: 52	506	52	339	20.6	67.0	0.92
chr17	59035669	59035886	CpG: 20	217	20	131	18.4	60.4	1.05
chr17	59064918	59065124	CpG: 17	206	17	132	16.5	64.1	0.84
chr17	59071537	59071815	CpG: 25	278	25	175	18.0	62.9	0.92
chr17	59086055	59086291	CpG: 21	236	21	146	17.8	61.9	0.96
chr17	59087008	59087362	CpG: 47	354	47	241	26.6	68.1	1.15
chr17	59088364	59088642	CpG: 26	278	26	176	18.7	63.3	0.94
chr17	59117189	59117766	CpG: 49	577	49	405	17.0	70.2	0.69
chr17	59145725	59146020	CpG: 23	295	23	190	15.6	64.4	0.80
chr17	59146892	59147531	CpG: 60	639	60	437	18.8	68.4	0.80
chr17	59192247	59192862	CpG: 63	615	63	467	20.5	75.9	0.71
chr17	59219969	59220420	CpG: 47	451	47	317	20.8	70.3	0.85
chr17	59317610	59317850	CpG: 22	240	22	148	18.3	61.7	0.98
chr17	59355369	59356406	CpG: 126	1037	126	770	24.3	74.3	0.88
chr17	59382120	59382636	CpG: 56	516	56	394	21.7	76.4	0.75
chr17	59385590	59386129	CpG: 46	539	46	358	17.1	66.4	0.78
chr17	59387131	59387437	CpG: 25	306	25	186	16.3	60.8	0.89
chr17	59399533	59400091	CpG: 71	558	71	436	25.4	78.1	0.84
chr17	59527251	59527459	CpG: 17	208	17	105	16.3	50.5	1.42
chr17	59529344	59529659	CpG: 27	315	27	188	17.1	59.7	0.99
chr17	59560370	59560800	CpG: 40	430	40	272	18.6	63.3	0.93
chr17	59620543	59620773	CpG: 18	230	18	139	15.7	60.4	0.87
chr17	59623681	59624817	CpG: 131	1136	131	812	23.1	71.5	0.91
chr17	59630699	59630974	CpG: 23	275	23	169	16.7	61.5	0.89
chr17	59685851	59686097	CpG: 20	246	20	148	16.3	60.2	0.93
chr17	59704805	59705078	CpG: 24	273	24	170	17.6	62.3	0.91
chr17	59747607	59747876	CpG: 19	269	19	164	14.1	61.0	0.77
chr17	59751573	59751854	CpG: 26	281	26	179	18.5	63.7	0.92
chr17	59900346	59900627	CpG: 24	281	24	175	17.1	62.3	0.90
chr17	59908867	59909148	CpG: 24	281	24	174	17.1	61.9	0.91
chr17	59924534	59924787	CpG: 23	253	23	156	18.2	61.7	0.99
chr17	59974363	59975338	CpG: 100	975	100	656	20.5	67.3	0.91
chr17	60021896	60022172	CpG: 22	276	22	161	15.9	58.3	0.95
chr17	60022592	60023392	CpG: 54	800	54	463	13.5	57.9	0.83
chr17	60039076	60039358	CpG: 21	282	21	171	14.9	60.6	0.82
chr17	60040632	60040886	CpG: 21	254	21	185	16.5	72.8	0.63
chr17	60078096	60078533	CpG: 33	437	33	268	15.1	61.3	0.83
chr17	60088480	60089376	CpG: 67	896	67	566	15.0	63.2	0.77
chr17	60092478	60092703	CpG: 19	225	19	137	16.9	60.9	0.94
chr17	60101317	60101590	CpG: 19	273	19	165	13.9	60.4	0.78
chr17	60130037	60130270	CpG: 20	233	20	141	17.2	60.5	0.95
chr17	60149738	60149967	CpG: 16	229	16	137	14.0	59.8	0.79
chr17	60177043	60177401	CpG: 27	358	27	206	15.1	57.5	0.94
chr17	60199565	60200923	CpG: 161	1358	161	995	23.7	73.3	0.89
chr17	60205351	60205631	CpG: 23	280	23	173	16.4	61.8	0.87
chr17	60262227	60263113	CpG: 64	886	64	606	14.4	68.4	0.62
chr17	60340427	60340663	CpG: 19	236	19	143	16.1	60.6	0.90
chr17	60361680	60361961	CpG: 21	281	21	173	14.9	61.6	0.81
chr17	60367766	60368731	CpG: 75	965	75	665	15.5	68.9	0.66
chr17	60419252	60419475	CpG: 17	223	17	132	15.2	59.2	0.89
chr17	60419796	60420319	CpG: 39	523	39	299	14.9	57.2	0.91
chr17	60434118	60434692	CpG: 58	574	58	373	20.2	65.0	0.97
chr17	60488055	60488772	CpG: 68	717	68	463	19.0	64.6	0.91
chr17	60576142	60576496	CpG: 28	354	28	216	15.8	61.0	0.85
chr17	60578667	60578903	CpG: 18	236	18	137	15.3	58.1	0.93
chr17	60585748	60586022	CpG: 23	274	23	168	16.8	61.3	0.91
chr17	60678285	60678515	CpG: 20	230	20	140	17.4	60.9	0.95
chr17	60716934	60717198	CpG: 20	264	20	165	15.2	62.5	0.78
chr17	60761398	60762408	CpG: 79	1010	79	616	15.6	61.0	0.85
chr17	60769958	60770198	CpG: 18	240	18	146	15.0	60.8	0.83
chr17	60777399	60777669	CpG: 23	270	23	167	17.0	61.9	0.90
chr17	60833221	60833838	CpG: 62	617	62	400	20.1	64.8	0.97
chr17	60894140	60895763	CpG: 186	1623	186	1190	22.9	73.3	0.86
chr17	60911123	60912021	CpG: 79	898	79	590	17.6	65.7	0.82
chr17	60935941	60936219	CpG: 26	278	26	176	18.7	63.3	0.94
chr17	60947603	60948349	CpG: 59	746	59	463	15.8	62.1	0.83
chr17	60988468	60990091	CpG: 186	1623	186	1190	22.9	73.3	0.85
chr17	61004439	61004790	CpG: 35	351	35	223	19.9	63.5	1.02
chr17	61007895	61009114	CpG: 103	1219	103	795	16.9	65.2	0.80
chr17	61010225	61010525	CpG: 33	300	33	208	22.0	69.3	0.92
chr17	61018840	61019949	CpG: 101	1109	101	749	18.2	67.5	0.80
chr17	61205377	61205614	CpG: 21	237	21	144	17.7	60.8	0.98
chr17	61237955	61238229	CpG: 23	274	23	170	16.8	62.0	0.88
chr17	61258672	61258913	CpG: 18	241	18	149	14.9	61.8	0.80
chr17	61260558	61261481	CpG: 91	923	91	662	19.7	71.7	0.87
chr17	61290287	61290908	CpG: 63	621	63	444	20.3	71.5	0.80
chr17	61394578	61395272	CpG: 66	694	66	461	19.0	66.4	0.87
chr17	61468661	61469655	CpG: 124	994	124	686	24.9	69.0	1.05
chr17	61482367	61482628	CpG: 21	261	21	190	16.1	72.8	0.62
chr17	61541094	61541309	CpG: 18	215	18	123	16.7	57.2	1.03
chr17	61546079	61546934	CpG: 56	855	56	518	13.1	60.6	0.73
chr17	61572466	61572743	CpG: 21	277	21	167	15.2	60.3	0.85
chr17	61755794	61756093	CpG: 26	299	26	186	17.4	62.2	0.90
chr17	61790139	61790380	CpG: 20	241	20	148	16.6	61.4	0.89
chr17	61843786	61844067	CpG: 24	281	24	176	17.1	62.6	0.89
chr17	61845679	61845937	CpG: 22	258	22	193	17.1	74.8	0.61
chr17	61979146	61979456	CpG: 24	310	24	189	15.5	61.0	0.84
chr17	62264565	62274750	CpG: 824	10185	824	6651	16.2	65.3	0.76
chr17	62276962	62277263	CpG: 25	301	25	216	16.6	71.8	0.67
chr17	62278160	62281969	CpG: 323	3809	323	2602	17.0	68.3	0.73
chr17	62285475	62285869	CpG: 29	394	29	269	14.7	68.3	0.64
chr17	62320463	62321750	CpG: 128	1287	128	923	19.9	71.7	0.78
chr17	62323207	62326738	CpG: 238	3531	238	2309	13.5	65.4	0.64
chr17	62330846	62331318	CpG: 43	472	43	298	18.2	63.1	0.92
chr17	62374177	62374458	CpG: 24	281	24	176	17.1	62.6	0.89
chr17	62427508	62427744	CpG: 18	236	18	142	15.3	60.2	0.87
chr17	62484314	62484587	CpG: 21	273	21	164	15.4	60.1	0.86
chr17	62549309	62549579	CpG: 20	270	20	165	14.8	61.1	0.80
chr17	62651034	62651271	CpG: 17	237	17	140	14.3	59.1	0.84
chr17	62732405	62732647	CpG: 21	242	21	144	17.4	59.5	1.02
chr17	62796482	62797009	CpG: 48	527	48	324	18.2	61.5	0.96
chr17	62805887	62806128	CpG: 21	241	21	140	17.4	58.1	1.08
chr17	62817760	62818040	CpG: 24	280	24	174	17.1	62.1	0.90
chr17	62876524	62876798	CpG: 20	274	20	163	14.6	59.5	0.83
chr17	62933823	62935093	CpG: 127	1270	127	878	20.0	69.1	0.84
chr17	63006302	63009523	CpG: 244	3221	244	2168	15.2	67.3	0.67
chr17	63031247	63031513	CpG: 19	266	19	160	14.3	60.2	0.81
chr17	63052817	63053192	CpG: 25	375	25	215	13.3	57.3	0.82
chr17	63095543	63095808	CpG: 21	265	21	162	15.8	61.1	0.86
chr17	63105103	63105339	CpG: 20	236	20	144	16.9	61.0	0.93
chr17	63105769	63106035	CpG: 22	266	22	164	16.5	61.7	0.88
chr17	63106242	63106482	CpG: 19	240	19	150	15.8	62.5	0.83
chr17	63293676	63294321	CpG: 54	645	54	408	16.7	63.3	0.84
chr17	63347931	63349752	CpG: 210	1821	210	1386	23.1	76.1	0.80
chr17	63486690	63486925	CpG: 19	235	19	143	16.2	60.9	0.90
chr17	63497123	63498524	CpG: 134	1401	134	989	19.1	70.6	0.77
chr17	63522214	63522838	CpG: 56	624	56	429	17.9	68.8	0.80
chr17	63533906	63534180	CpG: 24	274	24	171	17.5	62.4	0.91
chr17	63537042	63537442	CpG: 27	400	27	269	13.5	67.2	0.61
chr17	63549736	63550852	CpG: 87	1116	87	762	15.6	68.3	0.67
chr17	63559451	63559689	CpG: 19	238	19	168	16.0	70.6	0.66
chr17	63573693	63574629	CpG: 103	936	103	676	22.0	72.2	0.85
chr17	63678110	63678559	CpG: 49	449	49	336	21.8	74.8	0.78
chr17	63836032	63837115	CpG: 145	1083	145	815	26.8	75.3	0.94
chr17	64053963	64054231	CpG: 20	268	20	162	14.9	60.4	0.82
chr17	64304500	64304733	CpG: 19	233	19	162	16.3	69.5	0.68
chr17	64307599	64308233	CpG: 50	634	50	440	15.8	69.4	0.68
chr17	64315846	64317316	CpG: 154	1470	154	1083	21.0	73.7	0.77
chr17	64326143	64327328	CpG: 94	1185	94	859	15.9	72.5	0.60
chr17	64341072	64341296	CpG: 18	224	18	135	16.1	60.3	0.90
chr17	64346681	64347910	CpG: 139	1229	139	927	22.6	75.4	0.80
chr17	64358766	64358996	CpG: 20	230	20	142	17.4	61.7	0.92
chr17	64393322	64393753	CpG: 51	431	51	341	23.7	79.1	0.77
chr17	64404226	64404552	CpG: 24	326	24	201	14.7	61.7	0.80
chr17	64406026	64406268	CpG: 20	242	20	157	16.5	64.9	0.79
chr17	64408360	64409004	CpG: 62	644	62	442	19.3	68.6	0.84
chr17	64420474	64421548	CpG: 91	1074	91	685	16.9	63.8	0.83
chr17	64471413	64471937	CpG: 52	524	52	360	19.8	68.7	0.84
chr17	64492258	64493979	CpG: 180	1721	180	1243	20.9	72.2	0.81
chr17	64524946	64525229	CpG: 25	283	25	177	17.7	62.5	0.91
chr17	64534869	64535148	CpG: 23	279	23	170	16.5	60.9	0.90
chr17	64570435	64572278	CpG: 233	1843	233	1415	25.3	76.8	0.86
chr17	64612239	64612952	CpG: 67	713	67	500	18.8	70.1	0.76
chr17	64613565	64613841	CpG: 22	276	22	165	15.9	59.8	0.90
chr17	64643207	64643437	CpG: 16	230	16	134	13.9	58.3	0.83
chr17	64644216	64645579	CpG: 131	1363	131	895	19.2	65.7	0.89
chr17	64698279	64698783	CpG: 52	504	52	333	20.6	66.1	0.98
chr17	64713146	64714257	CpG: 127	1111	127	782	22.9	70.4	0.94
chr17	64719716	64720428	CpG: 77	712	77	457	21.6	64.2	1.05
chr17	64812438	64812734	CpG: 26	296	26	177	17.6	59.8	0.99
chr17	65000239	65001420	CpG: 145	1181	145	872	24.6	73.8	0.90
chr17	65015626	65016526	CpG: 78	900	78	555	17.3	61.7	0.92
chr17	65132199	65133195	CpG: 117	996	117	704	23.5	70.7	0.95
chr17	65170647	65170854	CpG: 17	207	17	124	16.4	59.9	0.93
chr17	65171570	65171779	CpG: 15	209	15	125	14.4	59.8	0.83
chr17	65366520	65366961	CpG: 43	441	43	288	19.5	65.3	0.95
chr17	65375117	65377204	CpG: 188	2087	188	1304	18.0	62.5	0.93
chr17	65531049	65532498	CpG: 156	1449	156	1019	21.5	70.3	0.87
chr17	65585925	65586475	CpG: 43	550	43	367	15.6	66.7	0.71
chr17	65646543	65646819	CpG: 25	276	25	196	18.1	71.0	0.72
chr17	65648001	65651432	CpG: 299	3431	299	2343	17.4	68.3	0.75
chr17	65706409	65707168	CpG: 74	759	74	544	19.5	71.7	0.78
chr17	65707749	65708026	CpG: 21	277	21	171	15.2	61.7	0.80
chr17	65717250	65717789	CpG: 36	539	36	337	13.4	62.5	0.68
chr17	65744050	65744282	CpG: 25	232	25	179	21.6	77.2	0.73
chr17	65786923	65787160	CpG: 17	237	17	140	14.3	59.1	0.83
chr17	65788894	65789876	CpG: 114	982	114	724	23.2	73.7	0.87
chr17	65818547	65818809	CpG: 26	262	26	166	19.8	63.4	1.00
chr17	65835792	65836156	CpG: 38	364	38	256	20.9	70.3	0.84
chr17	65845366	65846144	CpG: 100	778	100	555	25.7	71.3	1.04
chr17	65925746	65927209	CpG: 163	1463	163	1061	22.3	72.5	0.85
chr17	65950615	65950830	CpG: 17	215	17	130	15.8	60.5	0.90
chr17	65970590	65970834	CpG: 32	244	32	187	26.2	76.6	0.90
chr17	65983171	65983442	CpG: 21	271	21	162	15.5	59.8	0.88
chr17	65993063	65993542	CpG: 41	479	41	303	17.1	63.3	0.86
chr17	66007186	66007448	CpG: 33	262	33	202	25.2	77.1	0.85
chr17	66353686	66354419	CpG: 51	733	51	493	13.9	67.3	0.62
chr17	66407426	66409155	CpG: 120	1729	120	1110	13.9	64.2	0.67
chr17	66430409	66432438	CpG: 255	2029	255	1514	25.1	74.6	0.91
chr17	66707525	66708154	CpG: 43	629	43	410	13.7	65.2	0.65
chr17	67062365	67063239	CpG: 91	874	91	604	20.8	69.1	0.88
chr17	67072352	67072589	CpG: 17	237	17	141	14.3	59.5	0.84
chr17	67073464	67073703	CpG: 19	239	19	139	15.9	58.2	0.98
chr17	67105032	67105235	CpG: 19	203	19	126	18.7	62.1	0.99
chr17	67106871	67107111	CpG: 19	240	19	146	15.8	60.8	0.88
chr17	67171664	67173225	CpG: 205	1561	205	1183	26.3	75.8	0.91
chr17	67173445	67173681	CpG: 18	236	18	143	15.3	60.6	0.84
chr17	67471677	67472104	CpG: 31	427	31	255	14.5	59.7	0.82
chr17	67510639	67511152	CpG: 38	513	38	304	14.8	59.3	0.85
chr17	67613182	67613432	CpG: 18	250	18	144	14.4	57.6	0.89
chr17	67710790	67711278	CpG: 58	488	58	375	23.8	76.8	0.81
chr17	67807503	67807790	CpG: 21	287	21	177	14.6	61.7	0.80
chr17	67810227	67810501	CpG: 23	274	23	170	16.8	62.0	0.88
chr17	67840203	67842008	CpG: 215	1805	215	1332	23.8	73.8	0.88
chr17	67920423	67920723	CpG: 22	300	22	199	14.7	66.3	0.69
chr17	67960159	67960434	CpG: 24	275	24	171	17.5	62.2	0.91
chr17	68120370	68122143	CpG: 187	1773	187	1275	21.1	71.9	0.82
chr17	68167118	68167355	CpG: 21	237	21	147	17.7	62.0	0.93
chr17	68170410	68170848	CpG: 36	438	36	319	16.4	72.8	0.62
chr17	68180304	68180531	CpG: 17	227	17	140	15.0	61.7	0.80
chr17	68183010	68183284	CpG: 22	274	22	170	16.1	62.0	0.84
chr17	68232213	68232443	CpG: 20	230	20	142	17.4	61.7	0.92
chr17	68242130	68242624	CpG: 47	494	47	355	19.0	71.9	0.75
chr17	68243192	68243431	CpG: 19	239	19	144	15.9	60.3	0.90
chr17	68252995	68254902	CpG: 211	1907	211	1356	22.1	71.1	0.88
chr17	68273746	68273976	CpG: 18	230	18	139	15.7	60.4	0.87
chr17	68284978	68285259	CpG: 24	281	24	175	17.1	62.3	0.90
chr17	68415144	68415417	CpG: 22	273	22	167	16.1	61.2	0.88
chr17	68593201	68593701	CpG: 43	500	43	310	17.2	62.0	0.89
chr17	68654053	68654327	CpG: 21	274	21	169	15.3	61.7	0.81
chr17	68656966	68657206	CpG: 22	240	22	147	18.3	61.2	0.99
chr17	68700240	68701524	CpG: 161	1284	161	944	25.1	73.5	0.93
chr17	68746023	68746303	CpG: 24	280	24	174	17.1	62.1	0.90
chr17	68831234	68831476	CpG: 21	242	21	148	17.4	61.2	0.95
chr17	68864540	68864814	CpG: 25	274	25	172	18.2	62.8	0.94
chr17	68868315	68869526	CpG: 168	1211	168	897	27.7	74.1	1.06
chr17	68870873	68871391	CpG: 41	518	41	332	15.8	64.1	0.81
chr17	68876895	68877560	CpG: 43	665	43	368	12.9	55.3	0.85
chr17	68895846	68896086	CpG: 36	240	36	180	30.0	75.0	1.09
chr17	68897253	68897565	CpG: 23	312	23	182	14.7	58.3	0.89
chr17	68911151	68911952	CpG: 83	801	83	528	20.7	65.9	0.96
chr17	68927651	68928006	CpG: 35	355	35	260	19.7	73.2	0.74
chr17	68957282	68957783	CpG: 44	501	44	363	17.6	72.5	0.67
chr17	68976104	68976434	CpG: 30	330	30	243	18.2	73.6	0.68
chr17	68977974	68979273	CpG: 120	1299	120	866	18.5	66.7	0.83
chr17	68992968	68993636	CpG: 51	668	51	462	15.3	69.2	0.64
chr17	69012044	69012558	CpG: 40	514	40	340	15.6	66.1	0.75
chr17	69046146	69046533	CpG: 36	387	36	273	18.6	70.5	0.75
chr17	69056515	69057085	CpG: 50	570	50	426	17.5	74.7	0.63
chr17	69066183	69066420	CpG: 19	237	19	142	16.0	59.9	0.92
chr17	69073022	69076539	CpG: 295	3517	295	2395	16.8	68.1	0.72
chr17	69077693	69077944	CpG: 20	251	20	171	15.9	68.1	0.69
chr17	69081839	69082965	CpG: 126	1126	126	798	22.4	70.9	0.89
chr17	69084511	69084760	CpG: 21	249	21	182	16.9	73.1	0.64
chr17	69124017	69124837	CpG: 108	820	108	594	26.3	72.4	1.02
chr17	69135627	69135991	CpG: 38	364	38	257	20.9	70.6	0.84
chr17	69159815	69160131	CpG: 23	316	23	181	14.6	57.3	0.89
chr17	69166978	69168965	CpG: 207	1987	207	1355	20.8	68.2	0.90
chr17	69290284	69290645	CpG: 27	361	27	212	15.0	58.7	0.87
chr17	69333899	69334635	CpG: 76	736	76	533	20.7	72.4	0.80
chr17	69388504	69389931	CpG: 140	1427	140	987	19.6	69.2	0.82
chr17	69468028	69468257	CpG: 19	229	19	136	16.6	59.4	0.96
chr17	69470997	69471259	CpG: 24	262	24	165	18.3	63.0	0.95
chr17	69476796	69478302	CpG: 165	1506	165	1096	21.9	72.8	0.83
chr17	69648485	69648714	CpG: 20	229	20	138	17.5	60.3	0.97
chr17	69704516	69704769	CpG: 19	253	19	141	15.0	55.7	0.97
chr17	69841757	69842031	CpG: 23	274	23	170	16.8	62.0	0.88
chr17	69881669	69881921	CpG: 22	252	22	150	17.5	59.5	0.99
chr17	70072763	70073554	CpG: 57	791	57	542	14.4	68.5	0.61
chr17	70086845	70087126	CpG: 24	281	24	173	17.1	61.6	0.91
chr17	70090838	70091116	CpG: 25	278	25	176	18.0	63.3	0.90
chr17	70203196	70204324	CpG: 115	1128	115	778	20.4	69.0	0.87
chr17	70258756	70259030	CpG: 19	274	19	166	13.9	60.6	0.76
chr17	70326590	70326863	CpG: 22	273	22	170	16.1	62.3	0.84
chr17	70352165	70352407	CpG: 22	242	22	147	18.2	60.7	1.01
chr17	70440726	70441002	CpG: 25	276	25	174	18.1	63.0	0.92
chr17	70685620	70685899	CpG: 24	279	24	175	17.2	62.7	0.88
chr17	70756578	70756856	CpG: 24	278	24	174	17.3	62.6	0.89
chr17	71032428	71032698	CpG: 24	270	24	168	17.8	62.2	0.93
chr17	71035103	71035314	CpG: 16	211	16	128	15.2	60.7	0.83
chr17	71042122	71042396	CpG: 25	274	25	172	18.2	62.8	0.94
chr17	71047093	71047900	CpG: 87	807	87	580	21.6	71.9	0.84
chr17	71150201	71150472	CpG: 19	271	19	167	14.0	61.6	0.75
chr17	71177821	71178046	CpG: 19	225	19	136	16.9	60.4	0.94
chr17	71209510	71209784	CpG: 25	274	25	172	18.2	62.8	0.94
chr17	71423005	71423399	CpG: 31	394	31	237	15.7	60.2	0.87
chr17	71450125	71450327	CpG: 17	202	17	129	16.8	63.9	0.84
chr17	71473860	71474079	CpG: 17	219	17	130	15.5	59.4	0.89
chr17	71491869	71492113	CpG: 17	244	17	146	13.9	59.8	0.80
chr17	71501135	71501401	CpG: 27	266	27	170	20.3	63.9	1.01
chr17	71633180	71633462	CpG: 21	282	21	172	14.9	61.0	0.81
chr17	71643539	71643776	CpG: 18	237	18	143	15.2	60.3	0.86
chr17	72190529	72190809	CpG: 20	280	20	168	14.3	60.0	0.81
chr17	72349393	72349633	CpG: 16	240	16	142	13.3	59.2	0.77
chr17	72577767	72578003	CpG: 20	236	20	144	16.9	61.0	0.93
chr17	72729104	72729385	CpG: 23	281	23	173	16.4	61.6	0.88
chr17	72989041	72989370	CpG: 26	329	26	213	15.8	64.7	0.75
chr17	72989886	72991333	CpG: 101	1447	101	865	14.0	59.8	0.78
chr17	72993333	72997622	CpG: 317	4289	317	2706	14.8	63.1	0.75
chr17	73413370	73413574	CpG: 36	204	36	166	35.3	81.4	1.07
chr17	73464630	73465939	CpG: 122	1309	122	850	18.6	64.9	0.88
chr17	73513405	73513843	CpG: 49	438	49	332	22.4	75.8	0.78
chr17	73835963	73836194	CpG: 24	231	24	139	20.8	60.2	1.50
chr17	74039805	74040079	CpG: 21	274	21	164	15.3	59.9	0.86
chr17	74054574	74056003	CpG: 113	1429	113	932	15.8	65.2	0.75
chr17	74082055	74083153	CpG: 134	1098	134	772	24.4	70.3	0.99
chr17	74121647	74122661	CpG: 87	1014	87	664	17.2	65.5	0.80
chr17	74175450	74176193	CpG: 55	743	55	487	14.8	65.5	0.69
chr17	74200642	74202349	CpG: 168	1707	168	1215	19.7	71.2	0.78
chr17	74218094	74218334	CpG: 22	240	22	148	18.3	61.7	0.99
chr17	74222174	74222448	CpG: 23	274	23	170	16.8	62.0	0.88
chr17	74259538	74259744	CpG: 15	206	15	123	14.6	59.7	0.83
chr17	74326430	74326687	CpG: 22	257	22	175	17.1	68.1	0.74
chr17	74533827	74536469	CpG: 271	2642	271	1908	20.5	72.2	0.79
chr17	74792558	74793008	CpG: 40	450	40	280	17.8	62.2	0.99
chr17	74826933	74827213	CpG: 21	280	21	165	15.0	58.9	0.87
chr17	74843066	74843967	CpG: 85	901	85	632	18.9	70.1	0.81
chr17	75004018	75004573	CpG: 56	555	56	410	20.2	73.9	0.74
chr17	75090589	75090799	CpG: 20	210	20	140	19.0	66.7	0.86
chr17	75094631	75095127	CpG: 43	496	43	321	17.3	64.7	0.84
chr17	75103173	75104989	CpG: 135	1816	135	1162	14.9	64.0	0.73
chr17	75164272	75164546	CpG: 21	274	21	166	15.3	60.6	0.85
chr17	75164962	75165173	CpG: 27	211	27	146	25.6	69.2	1.08
chr17	75216455	75216968	CpG: 72	513	72	391	28.1	76.2	0.98
chr17	75242419	75242817	CpG: 54	398	54	295	27.1	74.1	0.99
chr17	75244841	75245206	CpG: 31	365	31	255	17.0	69.9	0.70
chr17	75247322	75248293	CpG: 128	971	128	716	26.4	73.7	0.97
chr17	75250590	75250821	CpG: 18	231	18	152	15.6	65.8	0.73
chr17	75262511	75262712	CpG: 16	201	16	140	15.9	69.7	0.68
chr17	75263601	75263840	CpG: 18	239	18	145	15.1	60.7	0.85
chr17	75309605	75309841	CpG: 21	236	21	145	17.8	61.4	0.96
chr17	75321184	75323378	CpG: 199	2194	199	1509	18.1	68.8	0.77
chr17	75325524	75325754	CpG: 18	230	18	138	15.7	60.0	0.88
chr17	75337323	75337590	CpG: 21	267	21	170	15.7	63.7	0.78
chr17	75344381	75345071	CpG: 61	690	61	506	17.7	73.3	0.66
chr17	75561785	75562300	CpG: 52	515	52	343	20.2	66.6	0.91
chr17	75628587	75629284	CpG: 72	697	72	498	20.7	71.4	0.81
chr17	75639738	75641691	CpG: 196	1953	196	1348	20.1	69.0	0.84
chr17	75667995	75668554	CpG: 62	559	62	395	22.2	70.7	0.89
chr17	75727690	75728285	CpG: 43	595	43	378	14.5	63.5	0.74
chr17	75734448	75735396	CpG: 113	948	113	725	23.8	76.5	0.83
chr17	75743810	75744713	CpG: 92	903	92	657	20.4	72.8	0.77
chr17	75751285	75753725	CpG: 244	2440	244	1757	20.0	72.0	0.78
chr17	75764585	75765511	CpG: 74	926	74	591	16.0	63.8	0.81
chr17	75784990	75785953	CpG: 96	963	96	683	19.9	70.9	0.80
chr17	75798781	75799199	CpG: 37	418	37	309	17.7	73.9	0.65
chr17	75811260	75812202	CpG: 86	942	86	644	18.3	68.4	0.78
chr17	75814687	75816711	CpG: 163	2024	163	1366	16.1	67.5	0.71
chr17	75827437	75828313	CpG: 82	876	82	607	18.7	69.3	0.78
chr17	75863868	75864865	CpG: 108	997	108	732	21.7	73.4	0.81
chr17	75873924	75874321	CpG: 50	397	50	288	25.2	72.5	0.96
chr17	75879316	75880286	CpG: 118	970	118	724	24.3	74.6	0.87
chr17	75894906	75895680	CpG: 72	774	72	545	18.6	70.4	0.75
chr17	75904133	75904869	CpG: 65	736	65	503	17.7	68.3	0.77
chr17	75926249	75927537	CpG: 91	1288	91	748	14.1	58.1	0.84
chr17	75937536	75939081	CpG: 135	1545	135	1031	17.5	66.7	0.79
chr17	75950094	75950325	CpG: 17	231	17	136	14.7	58.9	0.89
chr17	75968660	75969312	CpG: 72	652	72	455	22.1	69.8	0.91
chr17	75979232	75979861	CpG: 62	629	62	468	19.7	74.4	0.72
chr17	76000601	76002039	CpG: 114	1438	114	925	15.9	64.3	0.77
chr17	76020283	76020522	CpG: 21	239	21	168	17.6	70.3	0.72
chr17	76022563	76023702	CpG: 113	1139	113	775	19.8	68.0	0.86
chr17	76045015	76046267	CpG: 114	1252	114	831	18.2	66.4	0.83
chr17	76073460	76074678	CpG: 143	1218	143	875	23.5	71.8	0.91
chr17	76086071	76086999	CpG: 66	928	66	545	14.2	58.7	0.83
chr17	76091290	76091523	CpG: 17	233	17	137	14.6	58.8	0.86
chr17	76097359	76098155	CpG: 70	796	70	510	17.6	64.1	0.86
chr17	76140262	76140540	CpG: 20	278	20	172	14.4	61.9	0.76
chr17	76153192	76154503	CpG: 111	1311	111	853	16.9	65.1	0.81
chr17	76162345	76164057	CpG: 162	1712	162	1214	18.9	70.9	0.75
chr17	76181191	76181865	CpG: 66	674	66	443	19.6	65.7	0.91
chr17	76293379	76293660	CpG: 24	281	24	175	17.1	62.3	0.89
chr17	76297356	76298127	CpG: 90	771	90	561	23.3	72.8	0.90
chr17	76319054	76319291	CpG: 16	237	16	139	13.5	58.6	0.79
chr17	76324037	76324248	CpG: 16	211	16	129	15.2	61.1	0.83
chr17	76349874	76350238	CpG: 28	364	28	239	15.4	65.7	0.72
chr17	76355065	76355290	CpG: 18	225	18	137	16.0	60.9	0.89
chr17	76360892	76361173	CpG: 25	281	25	176	17.8	62.6	0.92
chr17	76371376	76371655	CpG: 26	279	26	176	18.6	63.1	0.94
chr17	76398238	76398473	CpG: 18	235	18	168	15.3	71.5	0.64
chr17	76408301	76410468	CpG: 233	2167	233	1582	21.5	73.0	0.81
chr17	76415298	76415668	CpG: 32	370	32	253	17.3	68.4	0.74
chr17	76418241	76419835	CpG: 178	1594	178	1178	22.3	73.9	0.82
chr17	76451913	76452196	CpG: 24	283	24	203	17.0	71.7	0.96
chr17	76456433	76456643	CpG: 16	210	16	137	15.2	65.2	0.74
chr17	76466249	76466496	CpG: 21	247	21	167	17.0	67.6	0.74
chr17	76480935	76483434	CpG: 260	2499	260	1829	20.8	73.2	0.79
chr17	76493297	76493509	CpG: 16	212	16	125	15.1	59.0	0.88
chr17	76524649	76524969	CpG: 29	320	29	222	18.1	69.4	0.75
chr17	76560105	76560734	CpG: 51	629	51	375	16.2	59.6	0.91
chr17	76614155	76614979	CpG: 90	824	90	634	21.8	76.9	0.74
chr17	76623376	76623664	CpG: 22	288	22	190	15.3	66.0	0.72
chr17	76635719	76635950	CpG: 19	231	19	161	16.5	69.7	0.68
chr17	76646726	76647318	CpG: 69	592	69	451	23.3	76.2	0.81
chr17	76657821	76658593	CpG: 79	772	79	566	20.5	73.3	0.77
chr17	76671934	76673189	CpG: 133	1255	133	825	21.2	65.7	1.00
chr17	76678012	76678473	CpG: 55	461	55	331	23.9	71.8	0.93
chr17	76731976	76732230	CpG: 18	254	18	155	14.2	61.0	0.77
chr17	76748330	76749292	CpG: 78	962	78	606	16.2	63.0	0.82
chr17	76767791	76768026	CpG: 19	235	19	162	16.2	68.9	0.68
chr17	76770597	76771992	CpG: 160	1395	160	1034	22.9	74.1	0.84
chr17	76784266	76784640	CpG: 26	374	26	233	13.9	62.3	0.72
chr17	76788997	76790519	CpG: 155	1522	155	1059	20.4	69.6	0.84
chr17	76796937	76797176	CpG: 17	239	17	143	14.2	59.8	0.81
chr17	76797597	76798696	CpG: 106	1099	106	769	19.3	70.0	0.79
chr17	76807091	76807423	CpG: 25	332	25	233	15.1	70.2	0.64
chr17	76811077	76811447	CpG: 27	370	27	245	14.6	66.2	0.67
chr17	76833952	76834488	CpG: 58	536	58	384	21.6	71.6	0.85
chr17	76861331	76861561	CpG: 18	230	18	139	15.7	60.4	0.87
chr17	76867882	76868166	CpG: 20	284	20	168	14.1	59.2	0.82
chr17	76871283	76871518	CpG: 19	235	19	141	16.2	60.0	0.92
chr17	76872019	76872779	CpG: 74	760	74	512	19.5	67.4	0.86
chr17	76900229	76902544	CpG: 157	2315	157	1514	13.6	65.4	0.64
chr17	76908027	76908305	CpG: 26	278	26	194	18.7	69.8	0.77
chr17	76914545	76915691	CpG: 85	1146	85	810	14.8	70.7	0.60
chr17	76965225	76965807	CpG: 57	582	57	384	19.6	66.0	0.91
chr17	76969921	76970155	CpG: 19	234	19	142	16.2	60.7	0.90
chr17	76970740	76974014	CpG: 275	3274	275	2167	16.8	66.2	0.77
chr17	77000218	77000535	CpG: 33	317	33	210	20.8	66.2	0.95
chr17	77015507	77015780	CpG: 19	273	19	161	13.9	59.0	0.80
chr17	77017968	77018840	CpG: 81	872	81	642	18.6	73.6	0.70
chr17	77034101	77034576	CpG: 39	475	39	337	16.4	70.9	0.65
chr17	77036384	77038264	CpG: 152	1880	152	1260	16.2	67.0	0.72
chr17	77082040	77082318	CpG: 25	278	25	176	18.0	63.3	0.91
chr17	77087185	77087444	CpG: 19	259	19	158	14.7	61.0	0.79
chr17	77123354	77123606	CpG: 17	252	17	156	13.5	61.9	0.73
chr17	77136232	77137685	CpG: 211	1453	211	1119	29.0	77.0	0.98
chr17	77154188	77154624	CpG: 37	436	37	320	17.0	73.4	0.63
chr17	77161602	77162757	CpG: 163	1155	163	867	28.2	75.1	1.01
chr17	77200132	77200384	CpG: 21	252	21	155	16.7	61.5	0.90
chr17	77203952	77204902	CpG: 100	950	100	677	21.1	71.3	0.83
chr17	77247805	77248076	CpG: 19	271	19	164	14.0	60.5	0.78
chr17	77249638	77251143	CpG: 141	1505	141	1004	18.7	66.7	0.84
chr17	77252372	77252646	CpG: 21	274	21	168	15.3	61.3	0.83
chr17	77257448	77257676	CpG: 16	228	16	137	14.0	60.1	0.79
chr17	77279340	77283005	CpG: 383	3665	383	2584	20.9	70.5	0.84
chr17	77305603	77305835	CpG: 18	232	18	140	15.5	60.3	0.88
chr17	77346216	77346458	CpG: 18	242	18	148	14.9	61.2	0.81
chr17	77348887	77349923	CpG: 125	1036	125	758	24.1	73.2	0.90
chr17	77368321	77368650	CpG: 22	329	22	217	13.4	66.0	0.65
chr17	77375734	77375947	CpG: 17	213	17	145	16.0	68.1	0.69
chr17	77384111	77384316	CpG: 15	205	15	132	14.6	64.4	0.74
chr17	77385997	77386212	CpG: 15	215	15	133	14.0	61.9	0.75
chr17	77397511	77398151	CpG: 70	640	70	480	21.9	75.0	0.78
chr17	77433945	77435230	CpG: 157	1285	157	964	24.4	75.0	0.87
chr17	77453886	77455027	CpG: 80	1141	80	663	14.0	58.1	0.84
chr17	77459047	77459329	CpG: 22	282	22	173	15.6	61.3	0.84
chr17	77481624	77483046	CpG: 145	1422	145	1012	20.4	71.2	0.81
chr17	77524563	77524818	CpG: 18	255	18	152	14.1	59.6	0.81
chr17	77533369	77533599	CpG: 20	230	20	156	17.4	67.8	0.76
chr17	77551627	77551863	CpG: 19	236	19	142	16.1	60.2	0.91
chr17	77568430	77568833	CpG: 27	403	27	234	13.4	58.1	0.81
chr17	77603067	77603363	CpG: 23	296	23	203	15.5	68.6	0.71
chr17	77607342	77608069	CpG: 107	727	107	600	29.4	82.5	0.86
chr17	77622932	77624321	CpG: 152	1389	152	967	21.9	69.6	0.91
chr17	77625975	77626190	CpG: 16	215	16	126	14.9	58.6	0.88
chr17	77627855	77628081	CpG: 17	226	17	138	15.0	61.1	0.82
chr17	77633250	77635127	CpG: 236	1877	236	1312	25.1	69.9	1.03
chr17	77698132	77698463	CpG: 30	331	30	248	18.1	74.9	0.65
chr17	77760106	77762593	CpG: 261	2487	261	1828	21.0	73.5	0.78
chr17	77774182	77774392	CpG: 18	210	18	145	17.1	69.0	0.74
chr17	77825412	77825613	CpG: 18	201	18	133	17.9	66.2	0.82
chr17	77841476	77841702	CpG: 17	226	17	154	15.0	68.1	0.66
chr17	77861814	77862028	CpG: 23	214	23	145	21.5	67.8	0.99
chr17	77884287	77884567	CpG: 25	280	25	179	17.9	63.9	0.88
chr17	77948750	77949339	CpG: 41	589	41	393	13.9	66.7	0.65
chr17	77956293	77956530	CpG: 18	237	18	143	15.2	60.3	0.87
chr17	77981392	77981855	CpG: 36	463	36	292	15.6	63.1	0.78
chr17	78033059	78033405	CpG: 26	346	26	201	15.0	58.1	0.89
chr17	78033850	78035255	CpG: 161	1405	161	1030	22.9	73.3	0.88
chr17	78106991	78107204	CpG: 18	213	18	139	16.9	65.3	0.80
chr17	78139993	78140735	CpG: 75	742	75	546	20.2	73.6	0.75
chr17	78149119	78149341	CpG: 18	222	18	148	16.2	66.7	0.73
chr17	78170584	78170866	CpG: 22	282	22	168	15.6	59.6	0.89
chr17	78173936	78175337	CpG: 148	1401	148	1012	21.1	72.2	0.81
chr17	78248865	78249101	CpG: 16	236	16	140	13.6	59.3	0.79
chr17	78255390	78255656	CpG: 22	266	22	164	16.5	61.7	0.88
chr17	78266336	78268154	CpG: 171	1818	171	1298	18.8	71.4	0.74
chr17	78284269	78284551	CpG: 25	282	25	179	17.7	63.5	0.89
chr17	78295998	78296241	CpG: 24	243	24	169	19.8	69.5	0.82
chr17	78345196	78345540	CpG: 35	344	35	245	20.3	71.2	0.80
chr17	78392454	78392709	CpG: 21	255	21	180	16.5	70.6	0.69
chr17	78422478	78423041	CpG: 59	563	59	411	21.0	73.0	0.80
chr17	78518371	78518573	CpG: 16	202	16	122	15.8	60.4	0.88
chr17	78659390	78659664	CpG: 21	274	21	168	15.3	61.3	0.82
chr17	78686937	78687164	CpG: 21	227	21	143	18.5	63.0	0.94
chr17	78709933	78710195	CpG: 22	262	22	163	16.8	62.2	0.88
chr17	78781782	78782307	CpG: 36	525	36	313	13.7	59.6	0.77
chr17	78851843	78853905	CpG: 279	2062	279	1509	27.1	73.2	1.02
chr17	78855252	78855491	CpG: 18	239	18	143	15.1	59.8	0.85
chr17	78934604	78934942	CpG: 31	338	31	220	18.3	65.1	0.87
chr17	78998287	78998723	CpG: 33	436	33	305	15.1	70.0	0.62
chr17	79021836	79022662	CpG: 73	826	73	619	17.7	74.9	0.63
chr17	79025219	79026104	CpG: 86	885	86	657	19.4	74.2	0.71
chr17	79034210	79034910	CpG: 61	700	61	502	17.4	71.7	0.68
chr17	79050778	79051063	CpG: 25	285	25	179	17.5	62.8	0.90
chr17	79051427	79051767	CpG: 25	340	25	192	14.7	56.5	0.94
chr17	79062410	79063287	CpG: 113	877	113	673	25.8	76.7	0.88
chr17	79081090	79081462	CpG: 39	372	39	257	21.0	69.1	0.88
chr17	79108115	79108638	CpG: 53	523	53	372	20.3	71.1	0.81
chr17	79125798	79126390	CpG: 75	592	75	457	25.3	77.2	0.87
chr17	79148260	79148836	CpG: 74	576	74	416	25.7	72.2	0.99
chr17	79155489	79155761	CpG: 19	272	19	161	14.0	59.2	0.81
chr17	79206817	79207416	CpG: 72	599	72	466	24.0	77.8	0.80
chr17	79234601	79235458	CpG: 100	857	100	673	23.3	78.5	0.77
chr17	79244199	79244482	CpG: 25	283	25	175	17.7	61.8	0.94
chr17	79246240	79246899	CpG: 75	659	75	486	22.8	73.7	0.84
chr17	79252259	79254479	CpG: 235	2220	235	1603	21.2	72.2	0.81
chr17	79271893	79272651	CpG: 83	758	83	542	21.9	71.5	0.86
chr17	79292851	79293062	CpG: 16	211	16	126	15.2	59.7	0.89
chr17	79318874	79319199	CpG: 22	325	22	199	13.5	61.2	0.73
chr17	79345062	79345286	CpG: 17	224	17	145	15.2	64.7	0.73
chr17	79353400	79353736	CpG: 30	336	30	211	17.9	62.8	0.92
chr17	79359593	79360352	CpG: 57	759	57	531	15.0	70.0	0.61
chr17	79370693	79370930	CpG: 25	237	25	147	21.1	62.0	1.11
chr17	79379257	79379489	CpG: 22	232	22	158	19.0	68.1	0.85
chr17	79397197	79397465	CpG: 20	268	20	164	14.9	61.2	0.80
chr17	79435274	79435595	CpG: 22	321	22	257	13.7	80.1	1.37
chr17	79437768	79438049	CpG: 23	281	23	172	16.4	61.2	0.89
chr17	79493081	79493332	CpG: 19	251	19	149	15.1	59.4	0.88
chr17	79656263	79656495	CpG: 18	232	18	139	15.5	59.9	0.87
chr17	79676228	79677483	CpG: 177	1255	177	981	28.2	78.2	0.96
chr17	79696872	79697179	CpG: 29	307	29	226	18.9	73.6	0.82
chr17	79734780	79736158	CpG: 170	1378	170	1017	24.7	73.8	0.93
chr17	79750477	79750691	CpG: 18	214	18	137	16.8	64.0	0.84
chr17	79795804	79796024	CpG: 23	220	23	148	20.9	67.3	0.92
chr17	79819435	79820712	CpG: 150	1277	150	956	23.5	74.9	0.84
chr17	79884362	79884643	CpG: 19	281	19	169	13.5	60.1	0.76
chr17	79885270	79885549	CpG: 21	279	21	175	15.1	62.7	0.77
chr17	79888329	79888726	CpG: 39	397	39	253	19.6	63.7	0.97
chr17	79889776	79890157	CpG: 29	381	29	263	15.2	69.0	0.71
chr17	79892060	79892306	CpG: 18	246	18	162	14.6	65.9	0.71
chr17	79904451	79904953	CpG: 62	502	62	365	24.7	72.7	0.97
chr17	79918866	79919711	CpG: 78	845	78	590	18.5	69.8	0.76
chr17	79942592	79943340	CpG: 53	748	53	464	14.2	62.0	0.75
chr17	79969640	79970372	CpG: 106	732	106	567	29.0	77.5	0.97
chr17	79992144	79992658	CpG: 43	514	43	367	16.7	71.4	0.68
chr17	79998848	79999056	CpG: 21	208	21	130	20.2	62.5	1.04
chr17	80026280	80026481	CpG: 15	201	15	127	14.9	63.2	0.80
chr17	80032801	80033049	CpG: 19	248	19	153	15.3	61.7	0.83
chr17	80077494	80079248	CpG: 199	1754	199	1300	22.7	74.1	0.83
chr17	80093125	80093326	CpG: 16	201	16	122	15.9	60.7	0.90
chr17	80272730	80272943	CpG: 16	213	16	136	15.0	63.8	0.74
chr17	80358293	80358901	CpG: 40	608	40	414	13.2	68.1	1.01
chr17	80359400	80359801	CpG: 27	401	27	240	13.5	59.9	0.75
chr17	80409326	80409609	CpG: 26	283	26	182	18.4	64.3	0.90
chr17	80506504	80509181	CpG: 257	2677	257	1869	19.2	69.8	0.80
chr17	80517990	80518432	CpG: 38	442	38	251	17.2	56.8	1.27
chr17	80632871	80633216	CpG: 31	345	31	218	18.0	63.2	0.91
chr17	80639572	80640063	CpG: 41	491	41	346	16.7	70.5	0.68
chr17	80645235	80646486	CpG: 130	1251	130	918	20.8	73.4	0.78
chr17	80675384	80676799	CpG: 179	1415	179	1063	25.3	75.1	0.90
chr17	80682594	80682891	CpG: 24	297	24	192	16.2	64.6	0.80
chr17	80687390	80691382	CpG: 299	3992	299	2555	15.0	64.0	0.73
chr17	80692962	80693354	CpG: 33	392	33	270	16.8	68.9	0.71
chr17	80694346	80702494	CpG: 581	8148	581	5150	14.3	63.2	0.72
chr17	80707831	80713863	CpG: 513	6032	513	4084	17.0	67.7	0.74
chr17	80729876	80743091	CpG: 960	13215	960	8682	14.5	65.7	0.67
chr17	80758093	80758398	CpG: 26	305	26	206	17.0	67.5	0.76
chr17	80824995	80825263	CpG: 22	268	22	165	16.4	61.6	0.88
chr17	80828015	80828525	CpG: 53	510	53	354	20.8	69.4	0.86
chr17	80838771	80839014	CpG: 20	243	20	167	16.5	68.7	0.70
chr17	80840816	80841048	CpG: 19	232	19	153	16.4	65.9	0.76
chr17	80841719	80842017	CpG: 24	298	24	176	16.1	59.1	0.93
chr17	80846853	80847105	CpG: 19	252	19	169	15.1	67.1	0.67
chr17	80848212	80848555	CpG: 32	343	32	239	18.7	69.7	0.77
chr17	80875974	80876420	CpG: 33	446	33	282	14.8	63.2	0.74
chr17	80879620	80879849	CpG: 19	229	19	152	16.6	66.4	0.79
chr17	80893441	80893711	CpG: 19	270	19	164	14.1	60.7	0.77
chr17	80908119	80908621	CpG: 40	502	40	347	15.9	69.1	0.67
chr17	80921859	80922117	CpG: 26	258	26	182	20.2	70.5	0.81
chr17	80933933	80935941	CpG: 226	2008	226	1456	22.5	72.5	0.87
chr17	80950039	80950269	CpG: 20	230	20	139	17.4	60.4	0.96
chr17	80957104	80957399	CpG: 22	295	22	172	14.9	58.3	0.89
chr17	80964118	80964374	CpG: 20	256	20	176	15.6	68.8	0.66
chr17	80990605	80990881	CpG: 50	276	50	189	36.2	68.5	1.55
chr17	81001542	81002401	CpG: 116	859	116	648	27.0	75.4	0.95
chr17	81006208	81006491	CpG: 28	283	28	186	19.8	65.7	0.92
chr17	81008031	81008426	CpG: 35	395	35	270	17.7	68.4	0.76
chr17	81009132	81009414	CpG: 21	282	21	184	14.9	65.2	0.70
chr17	81046915	81048292	CpG: 158	1377	158	947	22.9	68.8	0.97
chr17	81081863	81082066	CpG: 15	203	15	139	14.8	68.5	0.63
chr17	81091628	81091844	CpG: 17	216	17	144	15.7	66.7	0.71
chr17	81098780	81099006	CpG: 21	226	21	155	18.6	68.6	0.79
chr17	81110929	81111590	CpG: 48	661	48	430	14.5	65.1	0.70
chr17	81114943	81115197	CpG: 21	254	21	163	16.5	64.2	0.80
chr17	81120602	81121576	CpG: 110	974	110	737	22.6	75.7	0.79
chr17	81139845	81140052	CpG: 16	207	16	124	15.5	59.9	0.87
chr17	81160389	81161776	CpG: 206	1387	206	1118	29.7	80.6	0.93
chr17	81194887	81195125	CpG: 18	238	18	143	15.1	60.1	0.86
chr17	81220835	81221109	CpG: 22	274	22	171	16.1	62.4	0.83
chr17	81249891	81250417	CpG: 38	526	38	305	14.4	58.0	0.86
chr17	81316491	81318079	CpG: 154	1588	154	1045	19.4	65.8	0.91
chr17	81345930	81346184	CpG: 22	254	22	177	17.3	69.7	0.73
chr17	81356339	81357382	CpG: 118	1043	118	755	22.6	72.4	0.87
chr17	81370659	81370926	CpG: 21	267	21	162	15.7	60.7	0.86
chr17	81372574	81372794	CpG: 19	220	19	141	17.3	64.1	0.86
chr17	81377597	81380873	CpG: 390	3276	390	2441	23.8	74.5	0.86
chr17	81438805	81439306	CpG: 41	501	41	345	16.4	68.9	0.69
chr17	81446408	81446741	CpG: 27	333	27	225	16.2	67.6	0.72
chr17	81475603	81475890	CpG: 24	287	24	178	16.7	62.0	0.89
chr17	81629094	81629391	CpG: 29	297	29	181	19.5	60.9	1.10
chr17	81658848	81659130	CpG: 25	282	25	173	17.7	61.3	0.95
chr17	81684887	81685194	CpG: 25	307	25	185	16.3	60.3	0.91
chr17	81705108	81705315	CpG: 16	207	16	135	15.5	65.2	0.79
chr17	81707302	81707526	CpG: 24	224	24	157	21.4	70.1	0.87
chr17	81721301	81721543	CpG: 23	242	23	158	19.0	65.3	0.89
chr17	81727789	81728103	CpG: 24	314	24	201	15.3	64.0	0.79
chr17	81730491	81730871	CpG: 27	380	27	260	14.2	68.4	0.61
chr17	81745813	81747595	CpG: 133	1782	133	1148	14.9	64.4	0.93
chr17	81750171	81750427	CpG: 19	256	19	167	14.8	65.2	0.70
chr17	81763235	81763594	CpG: 27	359	27	240	15.0	66.9	0.70
chr17	81781132	81782866	CpG: 139	1734	139	1177	16.0	67.9	0.70
chr17	81789602	81789838	CpG: 20	236	20	161	16.9	68.2	0.73
chr17	81802031	81802287	CpG: 35	256	35	195	27.3	76.2	1.11
chr17	81811873	81812121	CpG: 17	248	17	144	13.7	58.1	0.82
chr17	81828301	81828668	CpG: 30	367	30	260	16.3	70.8	0.71
chr17	81848464	81848784	CpG: 24	320	24	191	15.0	59.7	0.84
chr17	81854829	81855165	CpG: 25	336	25	225	14.9	67.0	0.67
chr17	81867970	81868234	CpG: 21	264	21	180	15.9	68.2	0.69
chr17	81869538	81869817	CpG: 20	279	20	179	14.3	64.2	0.70
chr17	81870109	81871530	CpG: 109	1421	109	1019	15.3	71.7	0.64
chr17	81873100	81873317	CpG: 18	217	18	110	16.6	50.7	1.29
chr17	81888052	81888488	CpG: 46	436	46	346	21.1	79.4	0.67
chr17	81895984	81896577	CpG: 42	593	42	396	14.2	66.8	0.64
chr17	81898534	81899603	CpG: 149	1069	149	815	27.9	76.2	0.96
chr17	81910692	81911526	CpG: 88	834	88	623	21.1	74.7	0.76
chr17	81941160	81941411	CpG: 19	251	19	164	15.1	65.3	0.71
chr17	81942897	81944338	CpG: 190	1441	190	1111	26.4	77.1	0.89
chr17	81960601	81960913	CpG: 22	312	22	207	14.1	66.3	0.64
chr17	81980043	81980285	CpG: 20	242	20	163	16.5	67.4	0.73
chr17	81982695	81983137	CpG: 31	442	31	250	14.0	56.6	1.00
chr17	81986488	81987085	CpG: 42	597	42	415	14.1	69.5	0.70
chr17	81997098	81997331	CpG: 16	233	16	148	13.7	63.5	0.68
chr17	82007616	82007835	CpG: 17	219	17	137	15.5	62.6	0.80
chr17	82011978	82012179	CpG: 17	201	17	142	16.9	70.6	0.70
chr17	82018996	82019221	CpG: 17	225	17	156	15.1	69.3	0.63
chr17	82020981	82021240	CpG: 21	259	21	154	16.2	59.5	0.92
chr17	82027636	82031314	CpG: 300	3678	300	2604	16.3	70.8	0.65
chr17	82037373	82037595	CpG: 17	222	17	157	15.3	70.7	0.61
chr17	82044323	82044536	CpG: 17	213	17	136	16.0	63.8	0.78
chr17	82046375	82046582	CpG: 18	207	18	129	17.4	62.3	1.18
chr17	82047124	82047436	CpG: 26	312	26	184	16.7	59.0	1.18
chr17	82049126	82049563	CpG: 43	437	43	334	19.7	76.4	0.80
chr17	82066420	82066625	CpG: 17	205	17	134	16.6	65.4	0.78
chr17	82067635	82067889	CpG: 23	254	23	175	18.1	68.9	0.78
chr17	82073997	82074909	CpG: 107	912	107	698	23.5	76.5	0.85
chr17	82098939	82099428	CpG: 38	489	38	343	15.5	70.1	0.66
chr17	82099479	82099735	CpG: 17	256	17	173	13.3	67.6	0.60
chr17	82110216	82110447	CpG: 17	231	17	139	14.7	60.2	0.83
chr17	82111609	82111825	CpG: 18	216	18	141	16.7	65.3	0.79
chr17	82118950	82119479	CpG: 56	529	56	322	21.2	60.9	1.19
chr17	82131665	82132739	CpG: 112	1074	112	775	20.9	72.2	0.80
chr17	82134170	82134436	CpG: 21	266	21	161	15.8	60.5	0.87
chr17	82140438	82140753	CpG: 25	315	25	214	15.9	67.9	0.69
chr17	82147706	82149094	CpG: 145	1388	145	960	20.9	69.2	0.87
chr17	82173584	82173849	CpG: 20	265	20	187	15.1	70.6	0.61
chr17	82187352	82187625	CpG: 23	273	23	167	16.8	61.2	0.91
chr17	82192505	82192706	CpG: 18	201	18	137	17.9	68.2	0.79
chr17	82194058	82194421	CpG: 33	363	33	245	18.2	67.5	0.80
chr17	82197380	82197635	CpG: 24	255	24	175	18.8	68.6	0.80
chr17	82206465	82207565	CpG: 105	1100	105	771	19.1	70.1	0.78
chr17	82222309	82222577	CpG: 22	268	22	198	16.4	73.9	0.60
chr17	82233478	82233722	CpG: 18	244	18	144	14.8	59.0	0.88
chr17	82253949	82259642	CpG: 500	5693	500	3655	17.6	64.2	0.85
chr17	82264008	82264222	CpG: 18	214	18	122	16.8	57.0	1.07
chr17	82264807	82265605	CpG: 66	798	66	556	16.5	69.7	0.69
chr17	82272116	82272355	CpG: 19	239	19	147	15.9	61.5	0.87
chr17	82301748	82303088	CpG: 157	1340	157	957	23.4	71.4	0.92
chr17	82308171	82316106	CpG: 685	7935	685	5007	17.3	63.1	0.87
chr17	82318893	82319234	CpG: 33	341	33	209	19.4	61.3	1.03
chr17	82321723	82322087	CpG: 31	364	31	236	17.0	64.8	0.83
chr17	82329806	82330299	CpG: 43	493	43	354	17.4	71.8	0.68
chr17	82334812	82335213	CpG: 30	401	30	261	15.0	65.1	0.71
chr17	82350752	82351044	CpG: 20	292	20	189	13.7	64.7	0.66
chr17	82362471	82362790	CpG: 24	319	24	229	15.0	71.8	0.63
chr17	82365475	82365766	CpG: 22	291	22	192	15.1	66.0	0.69
chr17	82370128	82370421	CpG: 27	293	27	181	18.4	61.8	0.97
chr17	82375830	82376611	CpG: 56	781	56	534	14.3	68.4	0.62
chr17	82377913	82379118	CpG: 93	1205	93	840	15.4	69.7	0.64
chr17	82380483	82381120	CpG: 50	637	50	431	15.7	67.7	0.69
chr17	82398204	82398813	CpG: 91	609	91	474	29.9	77.8	0.99
chr17	82400910	82401643	CpG: 80	733	80	535	21.8	73.0	0.82
chr17	82402485	82402720	CpG: 16	235	16	137	13.6	58.3	0.83
chr17	82404569	82405809	CpG: 139	1240	139	929	22.4	74.9	0.80
chr17	82415896	82416706	CpG: 75	810	75	599	18.5	74.0	0.68
chr17	82420448	82420670	CpG: 16	222	16	135	14.4	60.8	0.79
chr17	82428327	82432518	CpG: 410	4191	410	2921	19.6	69.7	0.81
chr17	82435709	82437023	CpG: 123	1314	123	947	18.7	72.1	0.72
chr17	82445142	82446428	CpG: 108	1286	108	891	16.8	69.3	0.70
chr17	82453872	82454467	CpG: 79	595	79	435	26.6	73.1	0.99
chr17	82458474	82458686	CpG: 16	212	16	148	15.1	69.8	0.64
chr17	82469067	82470216	CpG: 141	1149	141	853	24.5	74.2	0.89
chr17	82534748	82535594	CpG: 70	846	70	593	16.5	70.1	0.67
chr17	82540455	82540733	CpG: 22	278	22	173	15.8	62.2	0.83
chr17	82553536	82554137	CpG: 74	601	74	451	24.6	75.0	0.88
chr17	82556550	82556907	CpG: 26	357	26	217	14.6	60.8	0.79
chr17	82560144	82560532	CpG: 31	388	31	231	16.0	59.5	0.90
chr17	82564752	82565457	CpG: 87	705	87	521	24.7	73.9	0.91
chr17	82569018	82569507	CpG: 34	489	34	291	13.9	59.5	0.79
chr17	82583138	82584541	CpG: 131	1403	131	940	18.7	67.0	0.83
chr17	82600058	82601311	CpG: 153	1253	153	892	24.4	71.2	0.97
chr17	82605026	82605379	CpG: 29	353	29	246	16.4	69.7	0.68
chr17	82612714	82612919	CpG: 19	205	19	132	18.5	64.4	0.90
chr17	82619445	82620771	CpG: 138	1326	138	916	20.8	69.1	0.88
chr17	82624068	82624533	CpG: 38	465	38	327	16.3	70.3	0.68
chr17	82628722	82629691	CpG: 126	969	126	758	26.0	78.2	0.85
chr17	82632412	82632654	CpG: 23	242	23	165	19.0	68.2	0.85
chr17	82657546	82657837	CpG: 23	291	23	198	15.8	68.0	0.68
chr17	82670557	82672097	CpG: 177	1540	177	1167	23.0	75.8	0.80
chr17	82678502	82678842	CpG: 25	340	25	230	14.7	67.6	0.64
chr17	82679758	82680146	CpG: 34	388	34	271	17.5	69.8	0.72
chr17	82681685	82681983	CpG: 26	298	26	202	17.4	67.8	0.77
chr17	82691442	82691702	CpG: 18	260	18	175	13.8	67.3	0.61
chr17	82699819	82700978	CpG: 135	1159	135	858	23.3	74.0	0.85
chr17	82706858	82707140	CpG: 25	282	25	179	17.7	63.5	0.89
chr17	82708575	82708913	CpG: 25	338	25	233	14.8	68.9	0.64
chr17	82713548	82713777	CpG: 17	229	17	145	14.8	63.3	0.74
chr17	82725742	82725968	CpG: 18	226	18	141	15.9	62.4	0.82
chr17	82727158	82728994	CpG: 185	1836	185	1254	20.2	68.3	0.86
chr17	82735989	82736964	CpG: 64	975	64	648	13.1	66.5	0.60
chr17	82737925	82739424	CpG: 190	1499	190	1118	25.4	74.6	0.91
chr17	82740558	82740824	CpG: 21	266	21	160	15.8	60.2	0.90
chr17	82755490	82755772	CpG: 22	282	22	175	15.6	62.1	0.83
chr17	82757798	82759267	CpG: 192	1469	192	1059	26.1	72.1	1.01
chr17	82769092	82770247	CpG: 127	1155	127	860	22.0	74.5	0.79
chr17	82777971	82779095	CpG: 142	1124	142	851	25.3	75.7	0.90
chr17	82784709	82785408	CpG: 97	699	97	524	27.8	75.0	1.02
chr17	82789733	82790156	CpG: 43	423	43	291	20.3	68.8	0.86
chr17	82793962	82796367	CpG: 256	2405	256	1760	21.3	73.2	0.80
chr17	82802033	82802344	CpG: 25	311	25	209	16.1	67.2	0.72
chr17	82803444	82803684	CpG: 19	240	19	149	15.8	62.1	0.84
chr17	82803951	82804816	CpG: 96	865	96	636	22.2	73.5	0.83
chr17	82808302	82808774	CpG: 43	472	43	328	18.2	69.5	0.75
chr17	82822522	82822743	CpG: 21	221	21	156	19.0	70.6	0.77
chr17	82823788	82824105	CpG: 27	317	27	218	17.0	68.8	0.73
chr17	82826568	82829304	CpG: 369	2736	369	2115	27.0	77.3	0.90
chr17	82829811	82830038	CpG: 18	227	18	156	15.9	68.7	0.67
chr17	82844420	82845886	CpG: 161	1466	161	1023	22.0	69.8	0.92
chr17	82850245	82850666	CpG: 31	421	31	279	14.7	66.3	0.67
chr17	82853896	82854620	CpG: 53	724	53	478	14.6	66.0	0.71
chr17	82860394	82860668	CpG: 20	274	20	167	14.6	60.9	0.79
chr17	82861424	82861777	CpG: 26	353	26	244	14.7	69.1	0.62
chr17	82862111	82862387	CpG: 21	276	21	156	15.2	56.5	0.95
chr17	82864092	82864353	CpG: 19	261	19	162	14.6	62.1	0.79
chr17	82867371	82867652	CpG: 22	281	22	201	15.7	71.5	0.63
chr17	82876137	82876421	CpG: 25	284	25	202	17.6	71.1	0.70
chr17	82889482	82890831	CpG: 133	1349	133	969	19.7	71.8	0.78
chr17	82890965	82891246	CpG: 19	281	19	179	13.5	63.7	0.67
chr17	82897266	82899598	CpG: 269	2332	269	1763	23.1	75.6	0.81
chr17	82904062	82905091	CpG: 107	1029	107	733	20.8	71.2	0.82
chr17	82905475	82905711	CpG: 17	236	17	142	14.4	60.2	0.81
chr17	82907751	82908025	CpG: 21	274	21	171	15.3	62.4	0.80
chr17	82914552	82914885	CpG: 24	333	24	208	14.4	62.5	0.82
chr17	82917796	82919849	CpG: 219	2053	219	1503	21.3	73.2	0.80
chr17	82921628	82922062	CpG: 32	434	32	289	14.7	66.6	0.67
chr17	82931937	82933460	CpG: 169	1523	169	1097	22.2	72.0	0.86
chr17	82946002	82946753	CpG: 58	751	58	512	15.4	68.2	0.67
chr17	82948150	82948529	CpG: 34	379	34	259	17.9	68.3	0.77
chr17	82950330	82950745	CpG: 29	415	29	268	14.0	64.6	0.69
chr17	82950932	82951306	CpG: 38	374	38	269	20.3	71.9	0.79
chr17	82955333	82955609	CpG: 23	276	23	190	16.7	68.8	0.72
chr17	82958395	82958723	CpG: 29	328	29	232	17.7	70.7	0.71
chr17	82959902	82960158	CpG: 18	256	18	175	14.1	68.4	0.61
chr17	82963448	82963669	CpG: 18	221	18	146	16.3	66.1	0.79
chr17	82964456	82966553	CpG: 294	2097	294	1629	28.0	77.7	0.93
chr17	82967950	82968165	CpG: 18	215	18	132	16.7	61.4	0.89
chr17	83022894	83023194	CpG: 27	300	27	191	18.0	63.7	0.89
chr17	83080352	83081350	CpG: 135	998	135	764	27.1	76.6	0.93
chr17	83090758	83091095	CpG: 37	337	37	237	22.0	70.3	0.92
chr17	83097001	83100705	CpG: 317	3704	317	2685	17.1	72.5	0.65
chr17	83102623	83102867	CpG: 18	244	18	146	14.8	59.8	0.84
chr17	83105282	83105635	CpG: 26	353	26	249	14.7	70.5	0.60
chr17	83105901	83106724	CpG: 76	823	76	567	18.5	68.9	0.78
chr17	83111465	83111737	CpG: 27	272	27	170	19.9	62.5	1.02
chr17	83113660	83114150	CpG: 39	490	39	315	15.9	64.3	0.78
chr17	83117550	83117788	CpG: 22	238	22	161	18.5	67.6	0.82
chr17	83119057	83119300	CpG: 18	243	18	167	14.8	68.7	0.64
chr17	83122507	83124003	CpG: 139	1496	139	1043	18.6	69.7	0.77
chr17	83140816	83141038	CpG: 17	222	17	131	15.3	59.0	0.89
chr17	83141520	83142681	CpG: 122	1161	122	850	21.0	73.2	0.82
chr17	83161074	83162714	CpG: 139	1640	139	1122	17.0	68.4	0.77
chr17	83187094	83188722	CpG: 146	1628	146	996	17.9	61.2	1.13
chr17	83189752	83190454	CpG: 57	702	57	445	16.2	63.4	0.81
chr17	83201911	83203341	CpG: 132	1430	132	1015	18.5	71.0	0.73
chr17	83214391	83214753	CpG: 31	362	31	233	17.1	64.4	0.83
chr17	83240353	83244961	CpG: 329	4608	329	2986	14.3	64.8	0.68
chr17	83257832	83258231	CpG: 30	399	30	258	15.0	64.7	0.75
chr17	83261333	83261551	CpG: 20	218	20	146	18.3	67.0	0.84
chr17	83264552	83264835	CpG: 20	283	20	171	14.1	60.4	0.78
chr17	83272668	83273205	CpG: 55	537	55	366	20.5	68.2	0.90
chr17	83277830	83278151	CpG: 22	321	22	210	13.7	65.4	0.65
chr17	83284329	83284543	CpG: 19	214	19	149	17.8	69.6	0.75
chr17	83287133	83287815	CpG: 98	682	98	540	28.7	79.2	0.92
chr17	83304518	83304800	CpG: 24	282	24	194	17.0	68.8	0.72
chr17	83308479	83308690	CpG: 17	211	17	146	16.1	69.2	0.68
chr17	83312692	83312906	CpG: 18	214	18	152	16.8	71.0	0.69
chr17	83315998	83316368	CpG: 29	370	29	222	15.7	60.0	0.89
chr17	83319342	83319927	CpG: 86	585	86	424	29.4	72.5	1.13
chr17	83327051	83328306	CpG: 152	1255	152	891	24.2	71.0	0.96
chr17	83365699	83366679	CpG: 111	980	111	703	22.7	71.7	0.89
chr17	83366894	83367141	CpG: 21	247	21	155	17.0	62.8	0.87
chr17	83387971	83389634	CpG: 234	1663	234	1231	28.1	74.0	1.03
chr17	83444790	83445194	CpG: 56	404	56	291	27.7	72.0	1.09
chr17	83451959	83452571	CpG: 41	612	41	331	13.4	54.1	0.92
chr17	83452729	83452936	CpG: 16	207	16	142	15.5	68.6	0.66
chr17	83461529	83461754	CpG: 21	225	21	140	18.7	62.2	0.97
chr17	83470924	83471136	CpG: 17	212	17	144	16.0	67.9	0.70
chr17	83473562	83473802	CpG: 17	240	17	157	14.2	65.4	0.66
chr17	83475140	83475565	CpG: 37	425	37	261	17.4	61.4	0.93
chr17	83487530	83487836	CpG: 25	306	25	197	16.3	64.4	0.79
chr17	83505560	83505834	CpG: 23	274	23	169	16.8	61.7	0.89
chr17	83521730	83523334	CpG: 182	1604	182	1168	22.7	72.8	0.91
chr17	83532846	83533707	CpG: 54	861	54	530	12.5	61.6	0.67
chr17	83538312	83538531	CpG: 17	219	17	162	15.5	74.0	0.71
chr17	83566469	83566695	CpG: 18	226	18	164	15.9	72.6	0.65
chr17	83571891	83573791	CpG: 214	1900	214	1417	22.5	74.6	0.82
chr17	83587572	83587853	CpG: 27	281	27	187	19.2	66.5	0.87
chr17	83590848	83591845	CpG: 103	997	103	704	20.7	70.6	0.83
chr17	83603905	83604387	CpG: 35	482	35	330	14.5	68.5	0.66
chr17	83609353	83610357	CpG: 112	1004	112	714	22.3	71.1	0.88
chr17	83624918	83627614	CpG: 302	2696	302	1955	22.4	72.5	0.87
chr17	83654295	83654527	CpG: 17	232	17	151	14.7	65.1	0.71
chr17	83657264	83657686	CpG: 41	422	41	269	19.4	63.7	0.96
chr17	83676161	83676806	CpG: 72	645	72	441	22.3	68.4	1.14
chr17	83681496	83681712	CpG: 16	216	16	151	14.8	69.9	0.63
chr17	83682386	83682646	CpG: 19	260	19	171	14.6	65.8	0.68
chr17	83689663	83689874	CpG: 17	211	17	140	16.1	66.4	0.75
chr17	83707251	83707464	CpG: 18	213	18	127	16.9	59.6	0.96
chr17	83720873	83721114	CpG: 24	241	24	175	19.9	72.6	0.87
chr17	83731879	83732200	CpG: 49	321	49	237	30.5	73.8	1.13
chr17	83735891	83736096	CpG: 16	205	16	139	15.6	67.8	0.68
chr17	83736312	83736536	CpG: 16	224	16	154	14.3	68.8	0.60
chr17	83745209	83745555	CpG: 33	346	33	221	19.1	63.9	0.94
chr17	83746774	83747112	CpG: 27	338	27	233	16.0	68.9	0.67
chr17	83748006	83748217	CpG: 22	211	22	158	20.9	74.9	0.75
chr17	83774372	83774763	CpG: 48	391	48	258	24.6	66.0	1.13
chr17	83780738	83781018	CpG: 30	280	30	204	21.4	72.9	0.81
chr17	83788564	83788781	CpG: 23	217	23	137	21.2	63.1	1.11
chr17	83803972	83804499	CpG: 36	527	36	335	13.7	63.6	0.68
chr17	83805022	83805402	CpG: 38	380	38	254	20.0	66.8	0.90
chr17	83806154	83806512	CpG: 28	358	28	219	15.6	61.2	0.85
chr17	83816298	83816626	CpG: 23	328	23	211	14.0	64.3	0.68
chr17	83835700	83836740	CpG: 84	1040	84	697	16.2	67.0	0.72
chr17	83839744	83840192	CpG: 41	448	41	335	18.3	74.8	0.66
chr17	83845767	83847085	CpG: 112	1318	112	865	17.0	65.6	0.79
chr17	83879130	83881665	CpG: 211	2535	211	1729	16.6	68.2	0.75
chr17	83888368	83888636	CpG: 24	268	24	140	17.9	52.2	1.56
chr17	83894077	83894726	CpG: 48	649	48	371	14.8	57.2	0.93
chr17	83901561	83902332	CpG: 61	771	61	457	15.8	59.3	0.91
chr17	83905119	83905384	CpG: 22	265	22	168	16.6	63.4	0.84
chr17	83908057	83908390	CpG: 31	333	31	220	18.6	66.1	0.85
chr17	83908926	83909387	CpG: 37	461	37	302	16.1	65.5	0.75
chr17	83916140	83916533	CpG: 41	393	41	288	20.9	73.3	0.86
chr17	83932930	83933147	CpG: 23	217	23	137	21.2	63.1	1.11
chr17	83948396	83948923	CpG: 36	527	36	335	13.7	63.6	0.68
chr17	83949446	83949826	CpG: 38	380	38	254	20.0	66.8	0.90
chr17	83950578	83950936	CpG: 28	358	28	219	15.6	61.2	0.85
chr17	83960722	83961050	CpG: 23	328	23	211	14.0	64.3	0.68
chr17	83979981	83981023	CpG: 84	1042	84	697	16.1	66.9	0.72
chr17	83984129	83984577	CpG: 41	448	41	334	18.3	74.6	0.67
chr17	83990168	83991263	CpG: 101	1095	101	726	18.4	66.3	0.84
chr17	83997508	83997716	CpG: 17	208	17	127	16.3	61.1	0.88
chr17	84022418	84024515	CpG: 167	2097	167	1415	15.9	67.5	0.73
chr17	84031216	84031436	CpG: 20	220	20	115	18.2	52.3	1.57
chr17	84036870	84037519	CpG: 47	649	47	371	14.5	57.2	0.91
chr17	84044305	84045076	CpG: 61	771	61	457	15.8	59.3	0.91
chr17	84047863	84048128	CpG: 21	265	21	167	15.8	63.0	0.81
chr17	84050801	84051134	CpG: 31	333	31	220	18.6	66.1	0.85
chr17	84051670	84052115	CpG: 35	445	35	294	15.7	66.1	0.72
chr17	84053119	84053385	CpG: 19	266	19	164	14.3	61.7	0.77
chr17	84058827	84059256	CpG: 46	429	46	316	21.4	73.7	0.87
chr17	84070693	84071741	CpG: 127	1048	127	790	24.2	75.4	0.88
chr17	84074704	84075158	CpG: 33	454	33	295	14.5	65.0	0.75
chr17	84077786	84078037	CpG: 20	251	20	168	15.9	66.9	0.71
chr17	84080324	84080688	CpG: 25	364	25	215	13.7	59.1	0.79
chr17	84085872	84086110	CpG: 23	238	23	160	19.3	67.2	0.86
chr17	84087775	84089457	CpG: 216	1682	216	1357	25.7	80.7	0.91
chr17	84095091	84095468	CpG: 30	377	30	248	15.9	65.8	0.74
chr17	84098839	84101917	CpG: 421	3078	421	2410	27.4	78.3	0.89
chr17	84105136	84105754	CpG: 48	618	48	408	15.5	66.0	0.73
chr17	84108004	84108451	CpG: 36	447	36	296	16.1	66.2	0.73
chr17	84110027	84110477	CpG: 33	450	33	292	14.7	64.9	0.70
chr17	84113405	84113700	CpG: 21	295	21	182	14.2	61.7	0.75
chr17	84114707	84115714	CpG: 69	1007	69	593	13.7	58.9	0.79
chr17	84120239	84120595	CpG: 30	356	30	256	16.9	71.9	0.69
chr17	84123849	84124805	CpG: 93	956	93	704	19.5	73.6	0.86
chr17	84125818	84126204	CpG: 28	386	28	262	14.5	67.9	0.64
chr17	84129572	84130023	CpG: 33	451	33	257	14.6	57.0	1.05
chr17	84139943	84140187	CpG: 21	244	21	157	17.2	64.3	0.83
chr17	84142596	84143372	CpG: 51	776	51	413	13.1	53.2	0.93
chr17	84152879	84153126	CpG: 20	247	20	151	16.2	61.1	0.89
chr17	84156685	84158514	CpG: 186	1829	186	1275	20.3	69.7	0.87
chr17	84175232	84176207	CpG: 81	975	81	669	16.6	68.6	0.71
chr17	84240245	84241750	CpG: 151	1505	151	951	20.1	63.2	1.01
chr17	84271331	84271616	CpG: 23	285	23	174	16.1	61.1	0.88
chr17	84272476	84273527	CpG: 181	1051	181	807	34.4	76.8	1.18
chr18	2074	4150	CpG: 256	2076	256	1501	24.7	72.3	0.95
chr18	40713	41457	CpG: 60	744	60	519	16.1	69.8	0.66
chr18	56150	58168	CpG: 242	2018	242	1449	24.0	71.8	0.93
chr18	94729	95473	CpG: 60	744	60	520	16.1	69.9	0.66
chr18	110148	112224	CpG: 256	2076	256	1501	24.7	72.3	0.95
chr18	148775	149519	CpG: 60	744	60	520	16.1	69.9	0.66
chr18	164187	166118	CpG: 221	1931	221	1371	22.9	71.0	0.91
chr18	202697	203441	CpG: 60	744	60	520	16.1	69.9	0.66
chr18	226666	227349	CpG: 63	683	63	452	18.4	66.2	0.86
chr18	229186	229812	CpG: 61	626	61	409	19.5	65.3	0.92
chr18	265531	266319	CpG: 80	788	80	583	20.3	74.0	0.75
chr18	290746	290951	CpG: 15	205	15	119	14.6	58.0	0.89
chr18	300637	300914	CpG: 24	277	24	170	17.3	61.4	0.93
chr18	312025	313058	CpG: 101	1033	101	711	19.6	68.8	0.83
chr18	390318	390603	CpG: 26	285	26	175	18.2	61.4	0.98
chr18	421649	422321	CpG: 61	672	61	436	18.2	64.9	0.87
chr18	472116	472367	CpG: 26	251	26	159	20.7	63.3	1.05
chr18	653350	655050	CpG: 181	1700	181	1120	21.3	65.9	0.99
chr18	666236	666849	CpG: 52	613	52	416	17.0	67.9	0.74
chr18	668178	668415	CpG: 23	237	23	148	19.4	62.4	1.01
chr18	668775	669870	CpG: 111	1095	111	821	20.3	75.0	0.81
chr18	690109	690535	CpG: 33	426	33	256	15.5	60.1	0.86
chr18	714008	714244	CpG: 22	236	22	148	18.6	62.7	0.97
chr18	734574	735294	CpG: 60	720	60	439	16.7	61.0	0.94
chr18	751169	751620	CpG: 41	451	41	327	18.2	72.5	0.73
chr18	811733	813071	CpG: 140	1338	140	918	20.9	68.6	0.89
chr18	866527	868096	CpG: 164	1569	164	1036	20.9	66.0	0.96
chr18	875595	875870	CpG: 23	275	23	168	16.7	61.1	0.90
chr18	911548	911825	CpG: 20	277	20	171	14.4	61.7	0.77
chr18	965947	967000	CpG: 124	1053	124	779	23.6	74.0	0.86
chr18	982810	983084	CpG: 22	274	22	173	16.1	63.1	0.82
chr18	998129	998363	CpG: 19	234	19	142	16.2	60.7	0.90
chr18	1051394	1051653	CpG: 21	259	21	162	16.2	62.5	0.84
chr18	1058872	1063867	CpG: 356	4995	356	3087	14.3	61.8	0.75
chr18	1130740	1131155	CpG: 32	415	32	249	15.4	60.0	0.86
chr18	1252283	1252856	CpG: 50	573	50	419	17.5	73.1	0.65
chr18	1271146	1271376	CpG: 19	230	19	140	16.5	60.9	0.91
chr18	1389975	1390253	CpG: 23	278	23	169	16.5	60.8	0.91
chr18	1544905	1545137	CpG: 18	232	18	140	15.5	60.3	0.88
chr18	1561540	1561811	CpG: 23	271	23	167	17.0	61.6	0.90
chr18	1615963	1616230	CpG: 20	267	20	163	15.0	61.0	0.81
chr18	1695474	1695753	CpG: 27	279	27	179	19.4	64.2	0.95
chr18	1791105	1791384	CpG: 23	279	23	173	16.5	62.0	0.87
chr18	1910158	1910430	CpG: 22	272	22	171	16.2	62.9	0.83
chr18	1955619	1955893	CpG: 20	274	20	167	14.6	60.9	0.79
chr18	1973222	1973496	CpG: 24	274	24	172	17.5	62.8	0.90
chr18	2007086	2007360	CpG: 26	274	26	173	19.0	63.1	0.96
chr18	2188086	2188359	CpG: 22	273	22	169	16.1	61.9	0.85
chr18	2286876	2287150	CpG: 22	274	22	169	16.1	61.7	0.85
chr18	2403180	2403475	CpG: 23	295	23	181	15.6	61.4	0.83
chr18	2495583	2495801	CpG: 17	218	17	139	15.6	63.8	0.78
chr18	2507142	2507345	CpG: 18	203	18	131	17.7	64.5	0.87
chr18	2706638	2706912	CpG: 24	274	24	170	17.5	62.0	0.92
chr18	2727034	2727328	CpG: 33	294	33	184	22.4	62.6	1.15
chr18	2810501	2812400	CpG: 207	1899	207	1286	21.8	67.7	0.95
chr18	2867088	2867362	CpG: 24	274	24	171	17.5	62.4	0.91
chr18	3002210	3003820	CpG: 166	1610	166	1132	20.6	70.3	0.84
chr18	3029069	3029301	CpG: 18	232	18	138	15.5	59.5	0.89
chr18	3039510	3039743	CpG: 18	233	18	140	15.5	60.1	0.88
chr18	3061366	3062852	CpG: 161	1486	161	1058	21.7	71.2	0.86
chr18	3068564	3068812	CpG: 18	248	18	158	14.5	63.7	0.72
chr18	3168080	3169025	CpG: 142	945	142	752	30.1	79.6	0.95
chr18	3169558	3169779	CpG: 18	221	18	139	16.3	62.9	0.85
chr18	3192447	3192674	CpG: 17	227	17	133	15.0	58.6	0.88
chr18	3193880	3194156	CpG: 24	276	24	173	17.4	62.7	0.90
chr18	3198321	3198544	CpG: 16	223	16	135	14.3	60.5	0.80
chr18	3222831	3223067	CpG: 20	236	20	145	16.9	61.4	0.91
chr18	3307944	3308209	CpG: 22	265	22	162	16.6	61.1	0.90
chr18	3309465	3309690	CpG: 16	225	16	134	14.2	59.6	0.81
chr18	3406660	3407625	CpG: 79	965	79	610	16.4	63.2	0.82
chr18	3421071	3421961	CpG: 117	890	117	671	26.3	75.4	0.93
chr18	3471630	3471896	CpG: 24	266	24	168	18.0	63.2	0.92
chr18	3495515	3495749	CpG: 18	234	18	145	15.4	62.0	0.83
chr18	3607473	3611826	CpG: 332	4353	332	2673	15.3	61.4	0.81
chr18	3624439	3624669	CpG: 17	230	17	137	14.8	59.6	0.84
chr18	3658453	3658870	CpG: 52	417	52	305	24.9	73.1	0.99
chr18	3761901	3762175	CpG: 23	274	23	170	16.8	62.0	0.88
chr18	3800272	3800508	CpG: 17	236	17	141	14.4	59.7	0.83
chr18	3818120	3818358	CpG: 21	238	21	144	17.6	60.5	1.00
chr18	3889580	3889863	CpG: 29	283	29	186	20.5	65.7	0.95
chr18	3931815	3932032	CpG: 28	217	28	161	25.8	74.2	0.97
chr18	4039521	4040406	CpG: 73	885	73	601	16.5	67.9	0.73
chr18	4058129	4058414	CpG: 25	285	25	179	17.5	62.8	0.90
chr18	4249687	4249942	CpG: 19	255	19	156	14.9	61.2	0.80
chr18	4265692	4265968	CpG: 23	276	23	171	16.7	62.0	0.88
chr18	4614228	4615918	CpG: 181	1690	181	1190	21.4	70.4	0.87
chr18	4637620	4638046	CpG: 33	426	33	254	15.5	59.6	0.87
chr18	4658617	4658821	CpG: 16	204	16	117	15.7	57.4	0.96
chr18	5099937	5100174	CpG: 20	237	20	147	16.9	62.0	0.90
chr18	5166528	5166735	CpG: 18	207	18	127	17.4	61.4	0.93
chr18	5358522	5359668	CpG: 89	1146	89	720	15.5	62.8	0.79
chr18	5399969	5400920	CpG: 97	951	97	627	20.4	65.9	0.94
chr18	5457008	5457212	CpG: 17	204	17	129	16.7	63.2	0.83
chr18	5457343	5459369	CpG: 284	2026	284	1507	28.0	74.4	1.01
chr18	5601645	5601924	CpG: 26	279	26	175	18.6	62.7	0.96
chr18	5700965	5701242	CpG: 23	277	23	170	16.6	61.4	0.88
chr18	5703013	5704407	CpG: 173	1394	173	1061	24.8	76.1	0.86
chr18	5721170	5721432	CpG: 19	262	19	161	14.5	61.5	0.78
chr18	5788490	5790953	CpG: 248	2463	248	1729	20.1	70.2	0.82
chr18	5844844	5845271	CpG: 31	427	31	256	14.5	60.0	0.81
chr18	5956274	5956551	CpG: 22	277	22	170	15.9	61.4	0.86
chr18	6050408	6051798	CpG: 171	1390	171	1030	24.6	74.1	0.90
chr18	6054982	6056358	CpG: 166	1376	166	1029	24.1	74.8	0.87
chr18	6109684	6109963	CpG: 22	279	22	173	15.8	62.0	0.83
chr18	6399183	6399453	CpG: 22	270	22	165	16.3	61.1	0.88
chr18	6444842	6445083	CpG: 22	241	22	166	18.3	68.9	0.77
chr18	6574427	6575587	CpG: 147	1160	147	872	25.3	75.2	0.90
chr18	6889804	6890523	CpG: 85	719	85	508	23.6	70.7	0.96
chr18	6987728	6988809	CpG: 85	1081	85	780	15.7	72.2	0.60
chr18	7081134	7081417	CpG: 27	283	27	203	19.1	71.7	0.75
chr18	7089990	7090628	CpG: 42	638	42	429	13.2	67.2	0.66
chr18	7171809	7172030	CpG: 17	221	17	139	15.4	62.9	0.78
chr18	7258515	7259432	CpG: 68	917	68	643	14.8	70.1	0.60
chr18	7277379	7278768	CpG: 155	1389	155	1013	22.3	72.9	0.85
chr18	7280034	7280267	CpG: 16	233	16	144	13.7	61.8	0.73
chr18	7297152	7297413	CpG: 21	261	21	161	16.1	61.7	0.86
chr18	7299347	7299585	CpG: 17	238	17	137	14.3	57.6	0.86
chr18	7366762	7367221	CpG: 39	459	39	304	17.0	66.2	0.78
chr18	7514671	7514946	CpG: 25	275	25	171	18.2	62.2	0.96
chr18	7590282	7590557	CpG: 21	275	21	167	15.3	60.7	0.84
chr18	7598150	7598359	CpG: 17	209	17	128	16.3	61.2	0.89
chr18	7685294	7685529	CpG: 19	235	19	144	16.2	61.3	0.89
chr18	7729815	7732088	CpG: 295	2273	295	1712	26.0	75.3	0.92
chr18	7738003	7738282	CpG: 22	279	22	168	15.8	60.2	0.88
chr18	8129724	8130014	CpG: 26	290	26	182	17.9	62.8	0.91
chr18	8226166	8226584	CpG: 30	418	30	254	14.4	60.8	0.78
chr18	8530425	8530751	CpG: 38	326	38	225	23.3	69.0	0.98
chr18	8535236	8535520	CpG: 24	284	24	175	16.9	61.6	0.91
chr18	8771932	8773539	CpG: 177	1607	177	1122	22.0	69.8	0.92
chr18	8822501	8822730	CpG: 17	229	17	148	14.8	64.6	0.72
chr18	8822849	8823223	CpG: 27	374	27	236	14.4	63.1	0.73
chr18	8860772	8861046	CpG: 24	274	24	181	17.5	66.1	0.85
chr18	8867782	8870621	CpG: 340	2839	340	2087	24.0	73.5	0.89
chr18	8947116	8947581	CpG: 37	465	37	312	15.9	67.1	0.72
chr18	8948403	8948614	CpG: 18	211	18	137	17.1	64.9	0.81
chr18	9020000	9020254	CpG: 23	254	23	183	18.1	72.0	0.70
chr18	9068579	9068853	CpG: 21	274	21	168	15.3	61.3	0.82
chr18	9090264	9090542	CpG: 26	278	26	175	18.7	62.9	0.96
chr18	9098570	9098921	CpG: 31	351	31	256	17.7	72.9	0.67
chr18	9264657	9264930	CpG: 21	273	21	171	15.4	62.6	0.80
chr18	9265856	9266413	CpG: 58	557	58	406	20.8	72.9	0.79
chr18	9299539	9301045	CpG: 199	1506	199	1117	26.4	74.2	0.96
chr18	9301682	9301961	CpG: 19	279	19	163	13.6	58.4	0.80
chr18	9448131	9448404	CpG: 21	273	21	169	15.4	61.9	0.81
chr18	9460124	9460514	CpG: 29	390	29	276	14.9	70.8	0.61
chr18	9497112	9498575	CpG: 150	1463	150	1009	20.5	69.0	0.88
chr18	9548588	9548875	CpG: 25	287	25	179	17.4	62.4	0.91
chr18	9593599	9593800	CpG: 21	201	21	149	20.9	74.1	0.76
chr18	9638176	9639350	CpG: 126	1174	126	823	21.5	70.1	0.88
chr18	9641825	9642293	CpG: 37	468	37	296	15.8	63.2	0.79
chr18	9705538	9705783	CpG: 18	245	18	143	14.7	58.4	0.89
chr18	9706803	9707077	CpG: 20	274	20	169	14.6	61.7	0.78
chr18	9708993	9709228	CpG: 17	235	17	141	14.5	60.0	0.83
chr18	9743789	9744022	CpG: 16	233	16	138	13.7	59.2	0.80
chr18	9777117	9778686	CpG: 204	1569	204	1207	26.0	76.9	0.89
chr18	9871152	9872701	CpG: 162	1549	162	1077	20.9	69.5	0.87
chr18	9887404	9887634	CpG: 17	230	17	137	14.8	59.6	0.84
chr18	10059861	10060085	CpG: 18	224	18	136	16.1	60.7	0.89
chr18	10076918	10078618	CpG: 201	1700	201	1229	23.6	72.3	0.91
chr18	10195871	10196320	CpG: 39	449	39	325	17.4	72.4	0.67
chr18	10262230	10262511	CpG: 23	281	23	173	16.4	61.6	0.88
chr18	10295278	10295560	CpG: 31	282	31	210	22.0	74.5	0.81
chr18	10413356	10413637	CpG: 25	281	25	174	17.8	61.9	0.94
chr18	10576363	10576601	CpG: 20	238	20	158	16.8	66.4	0.80
chr18	10616078	10617264	CpG: 137	1186	137	899	23.1	75.8	0.81
chr18	10633804	10634015	CpG: 17	211	17	142	16.1	67.3	0.71
chr18	10668507	10668826	CpG: 25	319	25	227	15.7	71.2	0.62
chr18	10687972	10688583	CpG: 62	611	62	429	20.3	70.2	0.82
chr18	10689057	10689292	CpG: 18	235	18	141	15.3	60.0	0.86
chr18	10740477	10740718	CpG: 20	241	20	144	16.6	59.8	0.93
chr18	10750475	10750764	CpG: 21	289	21	176	14.5	60.9	0.80
chr18	10751334	10751561	CpG: 25	227	25	170	22.0	74.9	0.81
chr18	10769681	10769894	CpG: 24	213	24	159	22.5	74.6	0.94
chr18	10888370	10888790	CpG: 52	420	52	302	24.8	71.9	0.96
chr18	10903988	10904231	CpG: 17	243	17	145	14.0	59.7	0.81
chr18	10952850	10953115	CpG: 20	265	20	162	15.1	61.1	0.82
chr18	10973940	10974214	CpG: 22	274	22	168	16.1	61.3	0.86
chr18	11185763	11186348	CpG: 49	585	49	426	16.8	72.8	0.63
chr18	11196473	11196740	CpG: 20	267	20	161	15.0	60.3	0.83
chr18	11278592	11278868	CpG: 22	276	22	169	15.9	61.2	0.86
chr18	11310452	11312081	CpG: 169	1629	169	1165	20.7	71.5	0.82
chr18	11340401	11340637	CpG: 16	236	16	140	13.6	59.3	0.80
chr18	11355143	11355380	CpG: 20	237	20	138	16.9	58.2	1.02
chr18	11379694	11379924	CpG: 18	230	18	139	15.7	60.4	0.86
chr18	11394365	11394635	CpG: 20	270	20	154	14.8	57.0	0.92
chr18	11421213	11421494	CpG: 27	281	27	180	19.2	64.1	0.95
chr18	11490629	11490871	CpG: 17	242	17	133	14.0	55.0	0.94
chr18	11532395	11532626	CpG: 19	231	19	138	16.5	59.7	0.94
chr18	11594476	11594977	CpG: 41	501	41	350	16.4	69.9	0.67
chr18	11608746	11609023	CpG: 23	277	23	173	16.6	62.5	0.86
chr18	11646765	11647033	CpG: 20	268	20	163	14.9	60.8	0.82
chr18	11721825	11722053	CpG: 19	228	19	140	16.7	61.4	0.92
chr18	11851405	11852452	CpG: 135	1047	135	770	25.8	73.5	0.96
chr18	11913266	11915101	CpG: 167	1835	167	1218	18.2	66.4	0.83
chr18	11984218	11984557	CpG: 34	339	34	236	20.1	69.6	0.83
chr18	12013470	12014383	CpG: 73	913	73	540	16.0	59.1	0.92
chr18	12043664	12043882	CpG: 20	218	20	137	18.3	62.8	0.94
chr18	12070928	12071788	CpG: 109	860	109	642	25.3	74.7	0.91
chr18	12110542	12110870	CpG: 26	328	26	235	15.9	71.6	0.64
chr18	12121899	12122823	CpG: 69	924	69	634	14.9	68.6	0.63
chr18	12134652	12135400	CpG: 51	748	51	430	13.6	57.5	0.83
chr18	12143198	12144857	CpG: 181	1659	181	1208	21.8	72.8	0.85
chr18	12201149	12202095	CpG: 92	946	92	660	19.5	69.8	0.80
chr18	12229789	12231372	CpG: 126	1583	126	1107	15.9	69.9	0.65
chr18	12239207	12239563	CpG: 55	356	55	288	30.9	80.9	0.95
chr18	12256220	12256607	CpG: 39	387	39	261	20.2	67.4	0.91
chr18	12370980	12371407	CpG: 33	427	33	259	15.5	60.7	0.84
chr18	12383431	12383670	CpG: 17	239	17	142	14.2	59.4	0.82
chr18	12390849	12391073	CpG: 25	224	25	166	22.3	74.1	0.94
chr18	12405972	12406646	CpG: 46	674	46	452	13.6	67.1	0.61
chr18	12417138	12418097	CpG: 92	959	92	677	19.2	70.6	0.77
chr18	12427608	12427844	CpG: 20	236	20	148	16.9	62.7	0.89
chr18	12434653	12434916	CpG: 27	263	27	189	20.5	71.9	0.80
chr18	12450265	12451102	CpG: 60	837	60	559	14.3	66.8	0.64
chr18	12470573	12472097	CpG: 180	1524	180	1088	23.6	71.4	0.93
chr18	12488057	12489066	CpG: 79	1009	79	639	15.7	63.3	0.78
chr18	12538544	12539270	CpG: 45	726	45	417	12.4	57.4	0.76
chr18	12539516	12540715	CpG: 136	1199	136	870	22.7	72.6	0.88
chr18	12550416	12550628	CpG: 16	212	16	123	15.1	58.0	0.91
chr18	12570304	12571450	CpG: 122	1146	122	796	21.3	69.5	0.88
chr18	12583114	12583842	CpG: 73	728	73	527	20.1	72.4	0.78
chr18	12594178	12594648	CpG: 43	470	43	339	18.3	72.1	0.71
chr18	12595879	12597475	CpG: 107	1596	107	998	13.4	62.5	0.69
chr18	12796999	12797229	CpG: 17	230	17	142	14.8	61.7	0.79
chr18	12820024	12821712	CpG: 233	1688	233	1281	27.6	75.9	0.96
chr18	12864854	12866246	CpG: 132	1392	132	905	19.0	65.0	0.91
chr18	12919263	12919530	CpG: 19	267	19	162	14.2	60.7	0.78
chr18	12939837	12941120	CpG: 110	1283	110	905	17.1	70.5	0.69
chr18	13045965	13047258	CpG: 161	1293	161	928	24.9	71.8	0.97
chr18	13052417	13052697	CpG: 22	280	22	175	15.7	62.5	0.82
chr18	13059305	13059834	CpG: 61	529	61	366	23.1	69.2	0.97
chr18	13073726	13075406	CpG: 150	1680	150	1169	17.9	69.6	0.74
chr18	13090417	13090647	CpG: 16	230	16	135	13.9	58.7	0.83
chr18	13110072	13111335	CpG: 132	1263	132	880	20.9	69.7	0.88
chr18	13153797	13154432	CpG: 68	635	68	440	21.4	69.3	0.89
chr18	13157818	13158095	CpG: 21	277	21	168	15.2	60.6	0.84
chr18	13297380	13297931	CpG: 49	551	49	400	17.8	72.6	0.67
chr18	13299333	13300301	CpG: 105	968	105	699	21.7	72.2	0.84
chr18	13358312	13358579	CpG: 20	267	20	165	15.0	61.8	0.80
chr18	13379829	13381801	CpG: 236	1972	236	1477	23.9	74.9	0.85
chr18	13425080	13426022	CpG: 94	942	94	655	20.0	69.5	0.86
chr18	13451423	13451705	CpG: 18	282	18	184	12.8	65.2	0.60
chr18	13550258	13550559	CpG: 32	301	32	224	21.3	74.4	0.77
chr18	13661787	13662191	CpG: 30	404	30	241	14.9	59.7	0.91
chr18	13804437	13805268	CpG: 83	831	83	586	20.0	70.5	0.80
chr18	13888296	13889687	CpG: 134	1391	134	911	19.3	65.5	0.90
chr18	13905335	13905612	CpG: 24	277	24	172	17.3	62.1	0.91
chr18	13963274	13963498	CpG: 23	224	23	167	20.5	74.6	0.74
chr18	13981413	13981686	CpG: 20	273	20	166	14.7	60.8	0.80
chr18	13986296	13986757	CpG: 53	461	53	318	23.0	69.0	0.97
chr18	13988565	13988902	CpG: 27	337	27	209	16.0	62.0	0.85
chr18	13999316	13999695	CpG: 27	379	27	222	14.2	58.6	0.85
chr18	14030887	14031595	CpG: 51	708	51	453	14.4	64.0	0.70
chr18	14143918	14144227	CpG: 25	309	25	184	16.2	59.5	0.92
chr18	14294800	14295331	CpG: 36	531	36	339	13.6	63.8	0.67
chr18	14309243	14309450	CpG: 15	207	15	137	14.5	66.2	0.67
chr18	14340457	14342581	CpG: 146	2124	146	1408	13.7	66.3	0.66
chr18	14537587	14537863	CpG: 24	276	24	173	17.4	62.7	0.89
chr18	14541417	14541684	CpG: 24	267	24	176	18.0	65.9	0.85
chr18	14545672	14546371	CpG: 50	699	50	474	14.3	67.8	0.62
chr18	14556154	14556938	CpG: 74	784	74	546	18.9	69.6	0.78
chr18	14593571	14594500	CpG: 83	929	83	664	17.9	71.5	0.71
chr18	14613031	14613900	CpG: 102	869	102	650	23.5	74.8	0.84
chr18	14620957	14621920	CpG: 69	963	69	631	14.3	65.5	0.67
chr18	14637482	14637903	CpG: 29	421	29	286	13.8	67.9	0.65
chr18	14649693	14650380	CpG: 51	687	51	461	14.8	67.1	0.66
chr18	14706439	14706671	CpG: 37	232	37	154	31.9	66.4	1.49
chr18	14803000	14803555	CpG: 42	555	42	389	15.1	70.1	1.15
chr18	14909446	14910419	CpG: 80	973	80	672	16.4	69.1	0.70
chr18	15093631	15093906	CpG: 22	275	22	167	16.0	60.7	0.88
chr18	15158646	15161808	CpG: 305	3162	305	2226	19.3	70.4	0.79
chr18	15326330	15326563	CpG: 29	233	29	159	24.9	68.2	1.12
chr18	15358875	15359534	CpG: 78	659	78	460	23.7	69.8	0.98
chr18	15491541	15492407	CpG: 62	866	62	585	14.3	67.6	0.63
chr18	15500631	15500857	CpG: 16	226	16	136	14.2	60.2	0.81
chr18	21212858	21213132	CpG: 24	274	24	171	17.5	62.4	0.91
chr18	21262053	21262334	CpG: 23	281	23	174	16.4	61.9	0.87
chr18	21296050	21297169	CpG: 118	1119	118	794	21.1	71.0	0.85
chr18	21329953	21330233	CpG: 26	280	26	177	18.6	63.2	0.94
chr18	21426481	21428447	CpG: 202	1966	202	1372	20.5	69.8	0.85
chr18	21596829	21597110	CpG: 22	281	22	172	15.7	61.2	0.85
chr18	21612975	21613256	CpG: 24	281	24	175	17.1	62.3	0.90
chr18	21785181	21786158	CpG: 105	977	105	670	21.5	68.6	0.91
chr18	21795870	21796318	CpG: 33	448	33	254	14.7	56.7	0.93
chr18	21797277	21797728	CpG: 49	451	49	310	21.7	68.7	0.92
chr18	21834755	21835028	CpG: 21	273	21	170	15.4	62.3	0.80
chr18	21888906	21890198	CpG: 135	1292	135	875	20.9	67.7	0.91
chr18	21916590	21916819	CpG: 17	229	17	138	14.8	60.3	0.82
chr18	21925705	21927055	CpG: 160	1350	160	990	23.7	73.3	0.88
chr18	22040992	22041273	CpG: 23	281	23	173	16.4	61.6	0.88
chr18	22081930	22082181	CpG: 20	251	20	157	15.9	62.5	0.82
chr18	22237069	22237342	CpG: 23	273	23	169	16.8	61.9	0.89
chr18	22350041	22357468	CpG: 615	7427	615	4605	16.6	62.0	0.86
chr18	22361899	22362461	CpG: 59	562	59	409	21.0	72.8	0.79
chr18	22363087	22363327	CpG: 19	240	19	144	15.8	60.0	0.90
chr18	22385717	22385997	CpG: 27	280	27	184	19.3	65.7	0.89
chr18	22534797	22535710	CpG: 95	913	95	603	20.8	66.0	0.96
chr18	22573375	22573638	CpG: 18	263	18	153	13.7	58.2	0.82
chr18	22624690	22624964	CpG: 21	274	21	170	15.3	62.0	0.80
chr18	22716945	22717188	CpG: 23	243	23	150	18.9	61.7	1.00
chr18	22752371	22753133	CpG: 63	762	63	495	16.5	65.0	0.78
chr18	22907371	22907656	CpG: 24	285	24	175	16.8	61.4	0.91
chr18	23126280	23127018	CpG: 85	738	85	507	23.0	68.7	0.98
chr18	23328336	23330430	CpG: 263	2094	263	1520	25.1	72.6	0.96
chr18	23557514	23557725	CpG: 17	211	17	127	16.1	60.2	0.91
chr18	23566028	23566259	CpG: 21	231	21	142	18.2	61.5	0.97
chr18	23631782	23632122	CpG: 34	340	34	228	20.0	67.1	0.92
chr18	23637758	23638041	CpG: 21	283	21	166	14.8	58.7	0.87
chr18	23647177	23647763	CpG: 53	586	53	395	18.1	67.4	0.80
chr18	23697286	23698278	CpG: 121	992	121	692	24.4	69.8	1.00
chr18	23770683	23770930	CpG: 18	247	18	142	14.6	57.5	0.90
chr18	23771875	23772086	CpG: 19	211	19	155	18.0	73.5	0.70
chr18	23780455	23781363	CpG: 99	908	99	644	21.8	70.9	0.87
chr18	23813738	23814105	CpG: 41	367	41	249	22.3	67.8	0.97
chr18	23850074	23850348	CpG: 24	274	24	171	17.5	62.4	0.91
chr18	23856661	23857269	CpG: 79	608	79	463	26.0	76.2	0.92
chr18	23883574	23884654	CpG: 123	1080	123	795	22.8	73.6	0.84
chr18	24208308	24209794	CpG: 170	1486	170	1080	22.9	72.7	0.87
chr18	24333225	24333913	CpG: 56	688	56	440	16.3	64.0	0.80
chr18	24334316	24334550	CpG: 21	234	21	147	17.9	62.8	0.94
chr18	24465760	24466530	CpG: 93	770	93	579	24.2	75.2	0.87
chr18	24525750	24526019	CpG: 24	269	24	170	17.8	63.2	0.91
chr18	24571068	24571285	CpG: 22	217	22	161	20.3	74.2	0.75
chr18	24591622	24592457	CpG: 95	835	95	586	22.8	70.2	0.94
chr18	24620657	24621415	CpG: 81	758	81	539	21.4	71.1	0.85
chr18	24627525	24627806	CpG: 23	281	23	175	16.4	62.3	0.86
chr18	24633701	24633942	CpG: 22	241	22	149	18.3	61.8	0.97
chr18	24819033	24819275	CpG: 23	242	23	150	19.0	62.0	0.99
chr18	24910805	24911048	CpG: 19	243	19	144	15.6	59.3	0.89
chr18	25507168	25507448	CpG: 24	280	24	174	17.1	62.1	0.90
chr18	25543849	25547119	CpG: 325	3270	325	2090	19.9	63.9	0.98
chr18	25741734	25742015	CpG: 23	281	23	172	16.4	61.2	0.89
chr18	26284668	26285972	CpG: 129	1304	129	867	19.8	66.5	0.90
chr18	26327638	26327912	CpG: 19	274	19	167	13.9	60.9	0.76
chr18	26328414	26328639	CpG: 25	225	25	152	22.2	67.6	1.00
chr18	26392114	26392351	CpG: 18	237	18	142	15.2	59.9	0.89
chr18	26421120	26421930	CpG: 105	810	105	598	25.9	73.8	0.95
chr18	26455352	26455645	CpG: 23	293	23	181	15.7	61.8	0.83
chr18	26707165	26707397	CpG: 18	232	18	138	15.5	59.5	0.90
chr18	26740815	26745173	CpG: 393	4358	393	2902	18.0	66.6	0.81
chr18	26814894	26815157	CpG: 24	263	24	164	18.3	62.4	0.96
chr18	26849634	26851306	CpG: 172	1672	172	1147	20.6	68.6	0.88
chr18	27034404	27034682	CpG: 23	278	23	171	16.5	61.5	0.89
chr18	27057290	27057548	CpG: 29	258	29	194	22.5	75.2	0.80
chr18	27090360	27090577	CpG: 18	217	18	133	16.6	61.3	0.91
chr18	27128324	27128567	CpG: 20	243	20	149	16.5	61.3	0.90
chr18	27379037	27379593	CpG: 63	556	63	416	22.7	74.8	0.85
chr18	27411273	27411515	CpG: 22	242	22	150	18.2	62.0	0.97
chr18	27618979	27619256	CpG: 23	277	23	170	16.6	61.4	0.89
chr18	27633988	27634299	CpG: 27	311	27	195	17.4	62.7	0.90
chr18	27867075	27867282	CpG: 16	207	16	118	15.5	57.0	0.99
chr18	27937365	27937791	CpG: 32	426	32	252	15.0	59.2	0.87
chr18	28063003	28063239	CpG: 19	236	19	141	16.1	59.7	0.94
chr18	28242509	28242744	CpG: 18	235	18	141	15.3	60.0	0.88
chr18	28370450	28373211	CpG: 300	2761	300	1960	21.7	71.0	0.86
chr18	28435513	28435837	CpG: 25	324	25	190	15.4	58.6	0.90
chr18	28442979	28443260	CpG: 23	281	23	175	16.4	62.3	0.86
chr18	28457942	28458178	CpG: 17	236	17	141	14.4	59.7	0.82
chr18	28480498	28480775	CpG: 21	277	21	164	15.2	59.2	0.88
chr18	28617236	28617609	CpG: 29	373	29	221	15.5	59.2	0.89
chr18	28641902	28642115	CpG: 15	213	15	129	14.1	60.6	0.79
chr18	28745421	28745706	CpG: 23	285	23	177	16.1	62.1	0.85
chr18	28759416	28759652	CpG: 18	236	18	146	15.3	61.9	0.82
chr18	28817465	28817723	CpG: 22	258	22	149	17.1	57.8	1.05
chr18	28924768	28925046	CpG: 24	278	24	169	17.3	60.8	0.94
chr18	29049425	29049662	CpG: 17	237	17	141	14.3	59.5	0.83
chr18	29357671	29357907	CpG: 21	236	21	145	17.8	61.4	0.96
chr18	29436037	29436280	CpG: 19	243	19	144	15.6	59.3	0.91
chr18	29480751	29481030	CpG: 21	279	21	169	15.1	60.6	0.83
chr18	29667926	29668213	CpG: 24	287	24	173	16.7	60.3	0.93
chr18	30035214	30035487	CpG: 21	273	21	167	15.4	61.2	0.83
chr18	30054671	30054907	CpG: 17	236	17	136	14.4	57.6	0.88
chr18	30239112	30239386	CpG: 24	274	24	172	17.5	62.8	0.90
chr18	30364513	30365074	CpG: 61	561	61	416	21.7	74.2	0.79
chr18	30410358	30410643	CpG: 24	285	24	178	16.8	62.5	0.88
chr18	30482528	30482802	CpG: 23	274	23	170	16.8	62.0	0.89
chr18	30504652	30504888	CpG: 20	236	20	144	16.9	61.0	0.95
chr18	30785259	30785531	CpG: 19	272	19	164	14.0	60.3	0.78
chr18	30978703	30978914	CpG: 16	211	16	147	15.2	69.7	0.63
chr18	31059048	31059322	CpG: 24	274	24	171	17.5	62.4	0.91
chr18	31113437	31113658	CpG: 17	221	17	137	15.4	62.0	0.81
chr18	31142921	31143159	CpG: 21	238	21	146	17.6	61.3	0.96
chr18	31231789	31233417	CpG: 137	1628	137	1055	16.8	64.8	0.82
chr18	31291606	31292742	CpG: 108	1136	108	785	19.0	69.1	0.81
chr18	31302039	31302304	CpG: 18	265	18	163	13.6	61.5	0.73
chr18	31349689	31349954	CpG: 21	265	21	164	15.8	61.9	0.84
chr18	31457674	31457947	CpG: 19	273	19	165	13.9	60.4	0.78
chr18	31487037	31487271	CpG: 20	234	20	141	17.1	60.3	0.95
chr18	31497264	31497501	CpG: 18	237	18	140	15.2	59.1	0.89
chr18	31544165	31544392	CpG: 20	227	20	136	17.6	59.9	0.98
chr18	31688116	31689090	CpG: 103	974	103	699	21.1	71.8	0.82
chr18	31765338	31765565	CpG: 18	227	18	130	15.9	57.3	1.00
chr18	31875037	31876203	CpG: 173	1166	173	913	29.7	78.3	0.97
chr18	31914528	31914822	CpG: 26	294	26	191	17.7	65.0	0.87
chr18	31975657	31975869	CpG: 19	212	19	129	17.9	60.8	0.99
chr18	32018892	32019167	CpG: 22	275	22	169	16.0	61.5	0.87
chr18	32132967	32134142	CpG: 109	1175	109	781	18.6	66.5	0.84
chr18	32208994	32209888	CpG: 78	894	78	597	17.4	66.8	0.79
chr18	32211560	32211775	CpG: 16	215	16	130	14.9	60.5	0.82
chr18	32232057	32232323	CpG: 24	266	24	169	18.0	63.5	0.91
chr18	32271144	32271365	CpG: 16	221	16	133	14.5	60.2	0.84
chr18	32282188	32283737	CpG: 178	1549	178	1126	23.0	72.7	0.87
chr18	32660456	32661686	CpG: 155	1230	155	921	25.2	74.9	0.91
chr18	32746194	32746472	CpG: 24	278	24	177	17.3	63.7	0.86
chr18	32801054	32801328	CpG: 24	274	24	171	17.5	62.4	0.91
chr18	32961481	32964085	CpG: 187	2604	187	1708	14.4	65.6	0.67
chr18	32986379	32986850	CpG: 44	471	44	346	18.7	73.5	0.69
chr18	33024506	33024746	CpG: 19	240	19	147	15.8	61.2	0.87
chr18	33054013	33054304	CpG: 24	291	24	177	16.5	60.8	0.89
chr18	33127577	33127818	CpG: 21	241	21	149	17.4	61.8	0.93
chr18	33172109	33172375	CpG: 27	266	27	169	20.3	63.5	1.02
chr18	33277064	33277314	CpG: 20	250	20	149	16.0	59.6	0.94
chr18	33339729	33340091	CpG: 27	362	27	247	14.9	68.2	0.64
chr18	33393904	33394139	CpG: 18	235	18	137	15.3	58.3	0.93
chr18	33452902	33453168	CpG: 19	266	19	163	14.3	61.3	0.77
chr18	33505697	33505934	CpG: 21	237	21	144	17.7	60.8	0.98
chr18	33508010	33508316	CpG: 29	306	29	225	19.0	73.5	0.70
chr18	33535792	33536077	CpG: 26	285	26	180	18.2	63.2	0.93
chr18	33580267	33580497	CpG: 19	230	19	140	16.5	60.9	0.90
chr18	33607882	33608118	CpG: 18	236	18	141	15.3	59.7	0.87
chr18	33632216	33632650	CpG: 61	434	61	327	28.1	75.3	1.00
chr18	33755663	33755931	CpG: 20	268	20	165	14.9	61.6	0.79
chr18	33769599	33770721	CpG: 164	1122	164	837	29.2	74.6	1.05
chr18	34011909	34012320	CpG: 69	411	69	346	33.6	84.2	0.95
chr18	34144787	34145017	CpG: 19	230	19	140	16.5	60.9	0.90
chr18	34350924	34351399	CpG: 45	475	45	334	18.9	70.3	0.77
chr18	34358599	34358881	CpG: 21	282	21	173	14.9	61.3	0.81
chr18	34379280	34379525	CpG: 22	245	22	147	18.0	60.0	1.03
chr18	34414246	34415680	CpG: 116	1434	116	901	16.2	62.8	0.82
chr18	34416368	34416775	CpG: 44	407	44	277	21.6	68.1	0.94
chr18	34425664	34426092	CpG: 37	428	37	310	17.3	72.4	0.66
chr18	34592398	34592634	CpG: 21	236	21	145	17.8	61.4	0.96
chr18	34649054	34649328	CpG: 23	274	23	170	16.8	62.0	0.88
chr18	34685287	34686214	CpG: 116	927	116	683	25.0	73.7	0.94
chr18	34801153	34801385	CpG: 18	232	18	137	15.5	59.1	0.91
chr18	34923049	34923330	CpG: 23	281	23	173	16.4	61.6	0.88
chr18	34945249	34945523	CpG: 23	274	23	170	16.8	62.0	0.88
chr18	35016115	35016338	CpG: 18	223	18	131	16.1	58.7	0.96
chr18	35056181	35056420	CpG: 22	239	22	153	18.4	64.0	0.93
chr18	35168323	35169552	CpG: 105	1229	105	834	17.1	67.9	0.74
chr18	35196307	35196521	CpG: 16	214	16	130	15.0	60.7	0.82
chr18	35232867	35233341	CpG: 46	474	46	316	19.4	66.7	0.88
chr18	35387196	35387399	CpG: 17	203	17	127	16.7	62.6	0.87
chr18	35397196	35397438	CpG: 20	242	20	148	16.5	61.2	0.88
chr18	35431969	35432519	CpG: 51	550	51	367	18.5	66.7	0.84
chr18	35458605	35459437	CpG: 77	832	77	520	18.5	62.5	0.97
chr18	35462933	35463333	CpG: 37	400	37	295	18.5	73.8	0.68
chr18	35481542	35481879	CpG: 32	337	32	216	19.0	64.1	0.93
chr18	35535192	35535961	CpG: 69	769	69	520	17.9	67.6	0.80
chr18	35561886	35562161	CpG: 24	275	24	170	17.5	61.8	0.92
chr18	35568154	35568796	CpG: 70	642	70	463	21.8	72.1	0.85
chr18	35688999	35689517	CpG: 53	518	53	332	20.5	64.1	1.00
chr18	35689871	35690111	CpG: 17	240	17	146	14.2	60.8	0.78
chr18	35772411	35773782	CpG: 213	1371	213	1064	31.1	77.6	1.03
chr18	36141475	36142063	CpG: 53	588	53	397	18.0	67.5	0.80
chr18	36163688	36164489	CpG: 75	801	75	527	18.7	65.8	0.87
chr18	36206042	36206268	CpG: 16	226	16	132	14.2	58.4	0.83
chr18	36253570	36253851	CpG: 24	281	24	175	17.1	62.3	0.89
chr18	36255638	36255906	CpG: 22	268	22	189	16.4	70.5	0.66
chr18	36258634	36259234	CpG: 65	600	65	416	21.7	69.3	0.90
chr18	36320520	36321837	CpG: 126	1317	126	893	19.1	67.8	0.83
chr18	36377990	36379744	CpG: 141	1754	141	1156	16.1	65.9	0.74
chr18	36384596	36384877	CpG: 23	281	23	174	16.4	61.9	0.87
chr18	36464645	36464860	CpG: 16	215	16	130	14.9	60.5	0.84
chr18	36488352	36490269	CpG: 200	1917	200	1401	20.9	73.1	0.78
chr18	36526807	36527081	CpG: 23	274	23	170	16.8	62.0	0.88
chr18	36938861	36939079	CpG: 17	218	17	154	15.6	70.6	1.02
chr18	36953814	36954080	CpG: 27	266	27	184	20.3	69.2	0.85
chr18	37016599	37016873	CpG: 25	274	25	171	18.2	62.4	0.95
chr18	37021712	37022443	CpG: 89	731	89	535	24.4	73.2	0.91
chr18	37168377	37168651	CpG: 22	274	22	168	16.1	61.3	0.86
chr18	37393594	37393879	CpG: 24	285	24	178	16.8	62.5	0.88
chr18	37436904	37437123	CpG: 35	219	35	162	32.0	74.0	1.20
chr18	37446658	37447710	CpG: 123	1052	123	810	23.4	77.0	0.79
chr18	37467350	37468597	CpG: 112	1247	112	859	18.0	68.9	0.76
chr18	37530474	37530677	CpG: 16	203	16	130	15.8	64.0	0.77
chr18	37587661	37588136	CpG: 53	475	53	355	22.3	74.7	0.82
chr18	37678701	37679420	CpG: 94	719	94	534	26.1	74.3	0.96
chr18	37718184	37718593	CpG: 52	409	52	294	25.4	71.9	0.99
chr18	37758560	37761278	CpG: 240	2718	240	1699	17.7	62.5	0.91
chr18	37789439	37789675	CpG: 20	236	20	143	16.9	60.6	0.94
chr18	37929255	37929525	CpG: 22	270	22	165	16.3	61.1	0.88
chr18	38014029	38014321	CpG: 24	292	24	178	16.4	61.0	0.89
chr18	38272772	38273046	CpG: 24	274	24	171	17.5	62.4	0.91
chr18	38496600	38496873	CpG: 23	273	23	168	16.8	61.5	0.90
chr18	38937095	38937406	CpG: 21	311	21	180	13.5	57.9	0.81
chr18	39238319	39238545	CpG: 16	226	16	133	14.2	58.8	0.83
chr18	39269432	39269649	CpG: 17	217	17	133	15.7	61.3	0.85
chr18	39687420	39687650	CpG: 18	230	18	136	15.7	59.1	0.91
chr18	39813726	39813989	CpG: 19	263	19	182	14.4	69.2	0.61
chr18	39865239	39865475	CpG: 17	236	17	140	14.4	59.3	0.83
chr18	39887225	39887488	CpG: 23	263	23	161	17.5	61.2	0.94
chr18	39911032	39911305	CpG: 25	273	25	169	18.3	61.9	0.96
chr18	39973409	39973686	CpG: 24	277	24	170	17.3	61.4	0.93
chr18	39994773	39995042	CpG: 19	269	19	162	14.1	60.2	0.78
chr18	40036791	40037160	CpG: 33	369	33	247	17.9	66.9	0.80
chr18	40119698	40119975	CpG: 22	277	22	163	15.9	58.8	0.94
chr18	40387992	40388226	CpG: 19	234	19	143	16.2	61.1	0.87
chr18	40565713	40565948	CpG: 21	235	21	142	17.9	60.4	0.99
chr18	40825851	40826081	CpG: 19	230	19	140	16.5	60.9	0.90
chr18	41029547	41029825	CpG: 23	278	23	172	16.5	61.9	0.87
chr18	41120861	41121138	CpG: 23	277	23	170	16.6	61.4	0.89
chr18	41127608	41127889	CpG: 24	281	24	174	17.1	61.9	0.91
chr18	41132955	41133229	CpG: 21	274	21	169	15.3	61.7	0.81
chr18	41476103	41476340	CpG: 18	237	18	144	15.2	60.8	0.84
chr18	41585048	41585353	CpG: 24	305	24	187	15.7	61.3	0.85
chr18	41799666	41799947	CpG: 23	281	23	174	16.4	61.9	0.87
chr18	41823502	41823752	CpG: 20	250	20	149	16.0	59.6	0.90
chr18	41966676	41966985	CpG: 23	309	23	182	14.9	58.9	0.86
chr18	42057393	42057798	CpG: 33	405	33	288	16.3	71.1	0.64
chr18	42106794	42107065	CpG: 20	271	20	163	14.8	60.1	0.82
chr18	42269777	42270054	CpG: 22	277	22	172	15.9	62.1	0.84
chr18	42819962	42820237	CpG: 23	275	23	169	16.7	61.5	0.89
chr18	42821413	42821686	CpG: 23	273	23	169	16.8	61.9	0.90
chr18	42873197	42873437	CpG: 23	240	23	150	19.2	62.5	1.00
chr18	42987039	42987411	CpG: 30	372	30	263	16.1	70.7	0.65
chr18	43268558	43268836	CpG: 25	278	25	175	18.0	62.9	0.92
chr18	43979198	43979474	CpG: 24	276	24	172	17.4	62.3	0.91
chr18	44186801	44187076	CpG: 22	275	22	168	16.0	61.1	0.87
chr18	44390521	44390749	CpG: 17	228	17	140	14.9	61.4	0.81
chr18	44690175	44690454	CpG: 22	279	22	173	15.8	62.0	0.83
chr18	44771892	44772136	CpG: 28	244	28	182	23.0	74.6	0.83
chr18	44870171	44871996	CpG: 207	1825	207	1236	22.7	67.7	1.00
chr18	44935842	44936354	CpG: 40	512	40	312	15.6	60.9	0.84
chr18	44978933	44979214	CpG: 22	281	22	174	15.7	61.9	0.83
chr18	45128514	45128791	CpG: 24	277	24	171	17.3	61.7	0.92
chr18	45180985	45181215	CpG: 18	230	18	139	15.7	60.4	0.86
chr18	45240019	45240300	CpG: 24	281	24	174	17.1	61.9	0.91
chr18	45254716	45255304	CpG: 45	588	45	407	15.3	69.2	0.65
chr18	45691511	45691785	CpG: 25	274	25	172	18.2	62.8	0.94
chr18	45784286	45784560	CpG: 21	274	21	169	15.3	61.7	0.81
chr18	45966269	45966649	CpG: 37	380	37	245	19.5	64.5	0.94
chr18	45979000	45979234	CpG: 18	234	18	139	15.4	59.4	0.91
chr18	46028371	46030086	CpG: 153	1715	153	1158	17.8	67.5	0.79
chr18	46110488	46110710	CpG: 18	222	18	136	16.2	61.3	0.88
chr18	46134591	46134832	CpG: 18	241	18	146	14.9	60.6	0.84
chr18	46156923	46157312	CpG: 29	389	29	229	14.9	58.9	0.87
chr18	46158166	46158709	CpG: 49	543	49	345	18.0	63.5	0.91
chr18	46219040	46219510	CpG: 55	470	55	306	23.4	65.1	1.12
chr18	46262791	46263450	CpG: 80	659	80	483	24.3	73.3	0.91
chr18	46288951	46289347	CpG: 39	396	39	274	19.7	69.2	0.85
chr18	46295108	46295842	CpG: 57	734	57	453	15.5	61.7	0.82
chr18	46297152	46297385	CpG: 18	233	18	139	15.5	59.7	0.89
chr18	46363963	46365764	CpG: 175	1801	175	1214	19.4	67.4	0.86
chr18	46516868	46517100	CpG: 17	232	17	137	14.7	59.1	0.87
chr18	46523967	46525099	CpG: 142	1132	142	818	25.1	72.3	0.96
chr18	46623245	46623511	CpG: 25	266	25	168	18.8	63.2	0.96
chr18	46632325	46632719	CpG: 34	394	34	245	17.3	62.2	0.91
chr18	46736219	46736489	CpG: 23	270	23	167	17.0	61.9	0.90
chr18	46740851	46741141	CpG: 23	290	23	180	15.9	62.1	0.84
chr18	46750965	46751178	CpG: 20	213	20	152	18.8	71.4	0.78
chr18	46847431	46847648	CpG: 17	217	17	140	15.7	64.5	0.80
chr18	46870515	46871061	CpG: 47	546	47	351	17.2	64.3	0.85
chr18	46946858	46948775	CpG: 172	1917	172	1246	17.9	65.0	0.85
chr18	46949146	46949427	CpG: 24	281	24	175	17.1	62.3	0.90
chr18	46993395	46993704	CpG: 26	309	26	190	16.8	61.5	0.90
chr18	47107611	47108533	CpG: 128	922	128	692	27.8	75.1	1.02
chr18	47137571	47137842	CpG: 23	271	23	154	17.0	56.8	1.11
chr18	47147980	47148249	CpG: 21	269	21	165	15.6	61.3	0.84
chr18	47153551	47155571	CpG: 169	2020	169	1333	16.7	66.0	0.77
chr18	47157632	47157845	CpG: 18	213	18	131	16.9	61.5	0.89
chr18	47159303	47161487	CpG: 179	2184	179	1422	16.4	65.1	0.77
chr18	47163547	47163760	CpG: 18	213	18	131	16.9	61.5	0.89
chr18	47165218	47167402	CpG: 179	2184	179	1422	16.4	65.1	0.77
chr18	47169462	47169675	CpG: 18	213	18	131	16.9	61.5	0.89
chr18	47171261	47173281	CpG: 169	2020	169	1333	16.7	66.0	0.77
chr18	47175342	47175555	CpG: 18	213	18	131	16.9	61.5	0.89
chr18	47177013	47179197	CpG: 179	2184	179	1422	16.4	65.1	0.77
chr18	47181262	47181475	CpG: 18	213	18	131	16.9	61.5	0.89
chr18	47183061	47185081	CpG: 169	2020	169	1333	16.7	66.0	0.77
chr18	47187136	47187349	CpG: 18	213	18	131	16.9	61.5	0.89
chr18	47188807	47190991	CpG: 179	2184	179	1422	16.4	65.1	0.77
chr18	47193051	47193264	CpG: 18	213	18	131	16.9	61.5	0.89
chr18	47194722	47196906	CpG: 179	2184	179	1420	16.4	65.0	0.78
chr18	47198966	47199179	CpG: 18	213	18	131	16.9	61.5	0.89
chr18	47200637	47202821	CpG: 179	2184	179	1422	16.4	65.1	0.77
chr18	47204881	47205094	CpG: 18	213	18	131	16.9	61.5	0.89
chr18	47206552	47208736	CpG: 179	2184	179	1422	16.4	65.1	0.77
chr18	47210798	47211011	CpG: 18	213	18	131	16.9	61.5	0.89
chr18	47212469	47214653	CpG: 179	2184	179	1422	16.4	65.1	0.77
chr18	47216713	47216926	CpG: 18	213	18	131	16.9	61.5	0.89
chr18	47218384	47220568	CpG: 179	2184	179	1422	16.4	65.1	0.77
chr18	47224925	47225722	CpG: 62	797	62	521	15.6	65.4	0.73
chr18	47233212	47233493	CpG: 24	281	24	172	17.1	61.2	0.93
chr18	47340411	47340998	CpG: 63	587	63	400	21.5	68.1	0.94
chr18	47366357	47366775	CpG: 42	418	42	282	20.1	67.5	0.91
chr18	47436907	47439492	CpG: 305	2585	305	1887	23.6	73.0	0.89
chr18	47441547	47441999	CpG: 45	452	45	300	19.9	66.4	0.91
chr18	47451322	47451578	CpG: 41	256	41	199	32.0	77.7	1.15
chr18	47453662	47454598	CpG: 73	936	73	620	15.6	66.2	0.71
chr18	47544083	47544394	CpG: 25	311	25	192	16.1	61.7	0.84
chr18	47763597	47763870	CpG: 22	273	22	167	16.1	61.2	0.87
chr18	47851277	47851636	CpG: 26	359	26	211	14.5	58.8	0.84
chr18	47940027	47940434	CpG: 51	407	51	272	25.1	66.8	1.15
chr18	48018634	48019493	CpG: 65	859	65	598	15.1	69.6	0.62
chr18	48047863	48048093	CpG: 19	230	19	140	16.5	60.9	0.90
chr18	48121102	48122642	CpG: 208	1540	208	1180	27.0	76.6	0.92
chr18	48196375	48196692	CpG: 22	317	22	189	13.9	59.6	0.80
chr18	48199134	48199634	CpG: 58	500	58	377	23.2	75.4	0.84
chr18	48220305	48220874	CpG: 61	569	61	410	21.4	72.1	0.83
chr18	48326987	48328193	CpG: 115	1206	115	845	19.1	70.1	0.78
chr18	48352468	48353183	CpG: 78	715	78	539	21.8	75.4	0.81
chr18	48599190	48602002	CpG: 312	2812	312	1954	22.2	69.5	0.93
chr18	48729889	48730091	CpG: 18	202	18	130	17.8	64.4	0.87
chr18	48730361	48732654	CpG: 233	2293	233	1598	20.3	69.7	0.84
chr18	48784629	48784856	CpG: 17	227	17	135	15.0	59.5	0.86
chr18	48956819	48957053	CpG: 20	234	20	148	17.1	63.2	0.86
chr18	49055216	49055431	CpG: 20	215	20	139	18.6	64.7	0.89
chr18	49116607	49116972	CpG: 25	365	25	220	13.7	60.3	0.76
chr18	49143824	49148260	CpG: 394	4436	394	2914	17.8	65.7	0.82
chr18	49170235	49171877	CpG: 194	1642	194	1167	23.6	71.1	0.94
chr18	49537430	49537705	CpG: 19	275	19	164	13.8	59.6	0.79
chr18	49657872	49658648	CpG: 82	776	82	547	21.1	70.5	0.85
chr18	49684692	49685272	CpG: 65	580	65	399	22.4	68.8	0.96
chr18	49689805	49690319	CpG: 42	514	42	329	16.3	64.0	0.80
chr18	49691242	49691516	CpG: 25	274	25	172	18.2	62.8	0.93
chr18	49758519	49759972	CpG: 110	1453	110	911	15.1	62.7	0.77
chr18	50014815	50016360	CpG: 125	1545	125	993	16.2	64.3	0.79
chr18	50241122	50241361	CpG: 19	239	19	144	15.9	60.3	0.89
chr18	50395227	50397103	CpG: 196	1876	196	1309	20.9	69.8	0.86
chr18	50468114	50468408	CpG: 34	294	34	203	23.1	69.0	0.97
chr18	50469822	50470368	CpG: 50	546	50	358	18.3	65.6	0.85
chr18	50482965	50484736	CpG: 142	1771	142	1153	16.0	65.1	0.76
chr18	50488805	50489917	CpG: 96	1112	96	679	17.3	61.1	0.99
chr18	50500440	50500696	CpG: 30	256	30	188	23.4	73.4	0.87
chr18	50541896	50542114	CpG: 18	218	18	146	16.5	67.0	0.74
chr18	50551275	50551702	CpG: 30	427	30	252	14.1	59.0	0.81
chr18	50576621	50577046	CpG: 46	425	46	290	21.6	68.2	0.93
chr18	50619250	50619600	CpG: 31	350	31	258	17.7	73.7	0.65
chr18	50761231	50762982	CpG: 189	1751	189	1275	21.6	72.8	0.82
chr18	50791131	50791361	CpG: 21	230	21	143	18.3	62.2	0.96
chr18	50810950	50811185	CpG: 24	235	24	180	20.4	76.6	0.70
chr18	50865806	50866041	CpG: 21	235	21	144	17.9	61.3	0.96
chr18	50930917	50931732	CpG: 90	815	90	578	22.1	70.9	0.88
chr18	51010549	51010835	CpG: 21	286	21	174	14.7	60.8	0.81
chr18	51069309	51069557	CpG: 18	248	18	133	14.5	53.6	1.04
chr18	51080491	51081338	CpG: 110	847	110	650	26.0	76.7	0.88
chr18	51169617	51170044	CpG: 65	427	65	337	30.4	78.9	0.98
chr18	51231634	51232676	CpG: 136	1042	136	771	26.1	74.0	0.95
chr18	51397924	51399810	CpG: 198	1886	198	1341	21.0	71.1	0.83
chr18	51756526	51756778	CpG: 19	252	19	147	15.1	58.3	0.92
chr18	51792531	51792751	CpG: 15	220	15	129	13.6	58.6	0.82
chr18	51816159	51816395	CpG: 18	236	18	141	15.3	59.7	0.88
chr18	51943747	51944057	CpG: 23	310	23	190	14.8	61.3	0.79
chr18	52220004	52220285	CpG: 24	281	24	174	17.1	61.9	0.91
chr18	52544888	52545270	CpG: 33	382	33	250	17.3	65.4	0.81
chr18	52569769	52570160	CpG: 32	391	32	282	16.4	72.1	0.63
chr18	52648844	52649112	CpG: 21	268	21	164	15.7	61.2	0.85
chr18	52832978	52833214	CpG: 17	236	17	142	14.4	60.2	0.82
chr18	52867806	52868043	CpG: 19	237	19	144	16.0	60.8	0.89
chr18	52951162	52951455	CpG: 21	293	21	191	14.3	65.2	0.67
chr18	53059627	53059864	CpG: 19	237	19	141	16.0	59.5	0.93
chr18	53642891	53643170	CpG: 25	279	25	174	17.9	62.4	0.93
chr18	53714706	53715022	CpG: 25	316	25	194	15.8	61.4	0.85
chr18	53739329	53739604	CpG: 23	275	23	169	16.7	61.5	0.89
chr18	53765439	53765713	CpG: 24	274	24	171	17.5	62.4	0.91
chr18	53886651	53886927	CpG: 22	276	22	169	15.9	61.2	0.87
chr18	53965151	53965386	CpG: 17	235	17	144	14.5	61.3	0.79
chr18	54253065	54253340	CpG: 24	275	24	171	17.5	62.2	0.91
chr18	54413976	54414242	CpG: 23	266	23	165	17.3	62.0	0.91
chr18	54427162	54427896	CpG: 111	734	111	594	30.2	80.9	0.96
chr18	54429062	54429500	CpG: 29	438	29	254	13.2	58.0	0.79
chr18	54433573	54433851	CpG: 25	278	25	176	18.0	63.3	0.91
chr18	54472419	54473040	CpG: 60	621	60	424	19.3	68.3	0.84
chr18	54545553	54547096	CpG: 124	1543	124	1129	16.1	73.2	0.60
chr18	54560657	54561704	CpG: 82	1047	82	656	15.7	62.7	0.82
chr18	55031438	55031903	CpG: 34	465	34	303	14.6	65.2	0.69
chr18	55154029	55154303	CpG: 25	274	25	174	18.2	63.5	0.91
chr18	55162377	55162709	CpG: 39	332	39	259	23.5	78.0	0.78
chr18	55708624	55708903	CpG: 25	279	25	177	17.9	63.4	0.90
chr18	55790874	55791516	CpG: 82	642	82	464	25.5	72.3	0.98
chr18	55792838	55793129	CpG: 30	291	30	194	20.6	66.7	0.96
chr18	55830944	55831166	CpG: 16	222	16	130	14.4	58.6	0.85
chr18	55843155	55843374	CpG: 17	219	17	130	15.5	59.4	0.89
chr18	55867869	55868274	CpG: 39	405	39	298	19.3	73.6	0.71
chr18	55881795	55882055	CpG: 21	260	21	158	16.2	60.8	0.89
chr18	55982962	55983730	CpG: 85	768	85	523	22.1	68.1	0.96
chr18	56260576	56260813	CpG: 21	237	21	148	17.7	62.4	0.93
chr18	56495474	56495712	CpG: 17	238	17	139	14.3	58.4	0.85
chr18	56774855	56775396	CpG: 49	541	49	396	18.1	73.2	0.68
chr18	56776000	56776212	CpG: 17	212	17	120	16.0	56.6	1.03
chr18	56840160	56840828	CpG: 61	668	61	441	18.3	66.0	0.85
chr18	56853200	56853529	CpG: 30	329	30	206	18.2	62.6	0.93
chr18	56902549	56902779	CpG: 21	230	21	142	18.3	61.7	0.97
chr18	56945935	56946159	CpG: 20	224	20	138	17.9	61.6	0.98
chr18	57193094	57193318	CpG: 18	224	18	134	16.1	59.8	0.90
chr18	57241520	57241805	CpG: 25	285	25	179	17.5	62.8	0.90
chr18	57324589	57324824	CpG: 24	235	24	176	20.4	74.9	0.73
chr18	57349883	57350300	CpG: 42	417	42	289	20.1	69.3	0.87
chr18	57439329	57439618	CpG: 24	289	24	182	16.6	63.0	0.86
chr18	57528432	57529015	CpG: 47	583	47	354	16.1	60.7	0.88
chr18	57553361	57555261	CpG: 154	1900	154	1243	16.2	65.4	0.76
chr18	57628460	57629945	CpG: 173	1485	173	1072	23.3	72.2	0.90
chr18	57635604	57642493	CpG: 500	6889	500	4251	14.5	61.7	0.77
chr18	57786665	57787214	CpG: 73	549	73	420	26.6	76.5	0.93
chr18	57815576	57815787	CpG: 16	211	16	128	15.2	60.7	0.84
chr18	57821762	57823307	CpG: 115	1545	115	942	14.9	61.0	0.80
chr18	57830362	57830796	CpG: 40	434	40	280	18.4	64.5	0.89
chr18	57842761	57843470	CpG: 53	709	53	395	15.0	55.7	0.99
chr18	57844481	57844795	CpG: 28	314	28	225	17.8	71.7	0.70
chr18	57849102	57849304	CpG: 29	202	29	142	28.7	70.3	1.16
chr18	57919735	57919969	CpG: 20	234	20	143	17.1	61.1	0.92
chr18	57978511	57978790	CpG: 21	279	21	166	15.1	59.5	0.86
chr18	58002079	58004287	CpG: 178	2208	178	1482	16.1	67.1	0.72
chr18	58243496	58245200	CpG: 184	1704	184	1205	21.6	70.7	0.87
chr18	58395329	58395549	CpG: 19	220	19	155	17.3	70.5	0.70
chr18	58456502	58457583	CpG: 100	1081	100	735	18.5	68.0	0.80
chr18	58634236	58634510	CpG: 24	274	24	171	17.5	62.4	0.91
chr18	58659968	58660527	CpG: 54	559	54	418	19.3	74.8	0.69
chr18	58872118	58873184	CpG: 126	1066	126	803	23.6	75.3	0.84
chr18	58969569	58969862	CpG: 27	293	27	213	18.4	72.7	0.70
chr18	58998534	58998797	CpG: 19	263	19	162	14.4	61.6	0.77
chr18	59017815	59018029	CpG: 19	214	19	133	17.8	62.1	0.93
chr18	59064243	59065354	CpG: 163	1111	163	882	29.3	79.4	0.93
chr18	59077194	59077458	CpG: 18	264	18	159	13.6	60.2	0.76
chr18	59274701	59274911	CpG: 18	210	18	126	17.1	60.0	0.98
chr18	59315081	59315362	CpG: 24	281	24	173	17.1	61.6	0.91
chr18	59340656	59341473	CpG: 69	817	69	545	16.9	66.7	0.76
chr18	59421121	59421695	CpG: 57	574	57	389	19.9	67.8	0.87
chr18	59438709	59438948	CpG: 19	239	19	144	15.9	60.3	0.89
chr18	59466290	59467282	CpG: 75	992	75	615	15.1	62.0	0.79
chr18	59469121	59471115	CpG: 159	1994	159	1294	15.9	64.9	0.76
chr18	59473911	59475827	CpG: 174	1916	174	1312	18.2	68.5	0.78
chr18	59510113	59510431	CpG: 35	318	35	223	22.0	70.1	0.90
chr18	59560299	59561003	CpG: 71	704	71	500	20.2	71.0	0.80
chr18	59598856	59599130	CpG: 23	274	23	170	16.8	62.0	0.88
chr18	59610963	59611273	CpG: 26	310	26	191	16.8	61.6	0.89
chr18	59612032	59612319	CpG: 25	287	25	179	17.4	62.4	0.91
chr18	59635414	59635624	CpG: 16	210	16	130	15.2	61.9	0.82
chr18	59793636	59793912	CpG: 22	276	22	170	15.9	61.6	0.85
chr18	59899124	59900373	CpG: 116	1249	116	841	18.6	67.3	0.82
chr18	59911232	59911498	CpG: 20	266	20	165	15.0	62.0	0.79
chr18	59916877	59917134	CpG: 25	257	25	189	19.5	73.5	0.73
chr18	59992361	59992575	CpG: 17	214	17	123	15.9	57.5	0.98
chr18	59993120	59993506	CpG: 33	386	33	278	17.1	72.0	0.66
chr18	60078254	60078493	CpG: 19	239	19	142	15.9	59.4	0.93
chr18	60101351	60101591	CpG: 20	240	20	145	16.7	60.4	0.93
chr18	60102309	60103166	CpG: 95	857	95	596	22.2	69.5	0.92
chr18	60128226	60128504	CpG: 26	278	26	175	18.7	62.9	0.95
chr18	60172104	60172562	CpG: 59	458	59	345	25.8	75.3	0.92
chr18	60213715	60213932	CpG: 33	217	33	170	30.4	78.3	0.99
chr18	60218792	60219069	CpG: 26	277	26	176	18.8	63.5	0.94
chr18	60238212	60238507	CpG: 23	295	23	178	15.6	60.3	0.86
chr18	61069547	61069788	CpG: 18	241	18	144	14.9	59.8	0.86
chr18	61500344	61500628	CpG: 23	284	23	174	16.2	61.3	0.87
chr18	61536701	61537710	CpG: 102	1009	102	721	20.2	71.5	0.80
chr18	61718344	61718704	CpG: 27	360	27	210	15.0	58.3	0.89
chr18	61757440	61757975	CpG: 64	535	64	358	23.9	66.9	1.07
chr18	62097100	62098622	CpG: 169	1522	169	1099	22.2	72.2	0.86
chr18	62102035	62102309	CpG: 25	274	25	175	18.2	63.9	0.91
chr18	62268329	62268564	CpG: 17	235	17	138	14.5	58.7	0.87
chr18	62388883	62389159	CpG: 22	276	22	169	15.9	61.2	0.85
chr18	62389555	62390829	CpG: 101	1274	101	820	15.9	64.4	0.77
chr18	62527702	62529189	CpG: 146	1487	146	1035	19.6	69.6	0.81
chr18	62587502	62588020	CpG: 50	518	50	365	19.3	70.5	0.78
chr18	62725151	62727751	CpG: 329	2600	329	1953	25.3	75.1	0.90
chr18	62729456	62729847	CpG: 58	391	58	298	29.7	76.2	1.03
chr18	62797965	62798201	CpG: 18	236	18	140	15.3	59.3	0.89
chr18	62799023	62799891	CpG: 91	868	91	606	21.0	69.8	0.86
chr18	62859933	62860143	CpG: 16	210	16	125	15.2	59.5	0.90
chr18	62887566	62887847	CpG: 23	281	23	174	16.4	61.9	0.87
chr18	62917862	62919929	CpG: 279	2067	279	1561	27.0	75.5	0.95
chr18	62964144	62964419	CpG: 20	275	20	164	14.5	59.6	0.83
chr18	63109255	63109538	CpG: 22	283	22	170	15.5	60.1	0.86
chr18	63275876	63276161	CpG: 23	285	23	175	16.1	61.4	0.87
chr18	63277008	63277282	CpG: 22	274	22	169	16.1	61.7	0.86
chr18	63523331	63526110	CpG: 244	2779	244	1709	17.6	61.5	0.93
chr18	63571525	63572867	CpG: 144	1342	144	956	21.5	71.2	0.85
chr18	63627068	63628163	CpG: 89	1095	89	693	16.3	63.3	0.81
chr18	63655416	63655642	CpG: 24	226	24	184	21.2	81.4	0.64
chr18	63694980	63695220	CpG: 19	240	19	145	15.8	60.4	0.89
chr18	63959967	63960253	CpG: 24	286	24	173	16.8	60.5	0.93
chr18	63987920	63988210	CpG: 21	290	21	172	14.5	59.3	0.84
chr18	64080835	64081113	CpG: 25	278	25	175	18.0	62.9	0.92
chr18	64141225	64142069	CpG: 64	844	64	556	15.2	65.9	0.70
chr18	64175077	64175748	CpG: 60	671	60	463	17.9	69.0	0.80
chr18	64194706	64194972	CpG: 22	266	22	164	16.5	61.7	0.88
chr18	64207686	64208072	CpG: 44	386	44	286	22.8	74.1	0.83
chr18	64462422	64462703	CpG: 23	281	23	175	16.4	62.3	0.86
chr18	64492343	64492617	CpG: 22	274	22	169	16.1	61.7	0.86
chr18	64712028	64712306	CpG: 24	278	24	174	17.3	62.6	0.90
chr18	64733735	64734013	CpG: 26	278	26	176	18.7	63.3	0.94
chr18	64911679	64911915	CpG: 18	236	18	143	15.3	60.6	0.88
chr18	64924337	64924611	CpG: 24	274	24	171	17.5	62.4	0.91
chr18	64931395	64931774	CpG: 39	379	39	279	20.6	73.6	0.76
chr18	65083908	65084133	CpG: 17	225	17	134	15.1	59.6	0.87
chr18	65139089	65139317	CpG: 17	228	17	136	14.9	59.6	0.86
chr18	65268493	65268778	CpG: 22	285	22	175	15.4	61.4	0.84
chr18	65599342	65599616	CpG: 25	274	25	172	18.2	62.8	0.93
chr18	65811461	65811849	CpG: 40	388	40	292	20.6	75.3	0.73
chr18	65925591	65925828	CpG: 23	237	23	147	19.4	62.0	1.02
chr18	65930848	65931081	CpG: 17	233	17	142	14.6	60.9	0.81
chr18	65956747	65957612	CpG: 101	865	101	628	23.4	72.6	0.89
chr18	66026307	66026581	CpG: 25	274	25	172	18.2	62.8	0.94
chr18	66091717	66091996	CpG: 25	279	25	175	17.9	62.7	0.92
chr18	66187362	66187598	CpG: 20	236	20	144	16.9	61.0	0.94
chr18	66362872	66363112	CpG: 22	240	22	149	18.3	62.1	0.97
chr18	66456195	66456416	CpG: 19	221	19	139	17.2	62.9	0.88
chr18	66593753	66593964	CpG: 23	211	23	158	21.8	74.9	0.78
chr18	66594900	66595132	CpG: 18	232	18	139	15.5	59.9	0.89
chr18	66644318	66644578	CpG: 21	260	21	140	16.2	53.8	1.16
chr18	66745708	66745982	CpG: 24	274	24	171	17.5	62.4	0.91
chr18	66875449	66875727	CpG: 23	278	23	175	16.5	62.9	0.85
chr18	67064627	67064991	CpG: 39	364	39	273	21.4	75.0	0.77
chr18	67073806	67074080	CpG: 24	274	24	171	17.5	62.4	0.91
chr18	67227023	67227250	CpG: 18	227	18	138	15.9	60.8	0.87
chr18	67324872	67325662	CpG: 59	790	59	544	14.9	68.9	0.63
chr18	67413850	67414086	CpG: 21	236	21	170	17.8	72.0	0.69
chr18	67458532	67458802	CpG: 23	270	23	166	17.0	61.5	0.92
chr18	67523570	67523809	CpG: 19	239	19	143	15.9	59.8	0.91
chr18	67616544	67616854	CpG: 28	310	28	190	18.1	61.3	0.97
chr18	67734592	67735669	CpG: 125	1077	125	772	23.2	71.7	0.91
chr18	67761183	67761457	CpG: 22	274	22	172	16.1	62.8	0.83
chr18	67885610	67885875	CpG: 22	265	22	155	16.6	58.5	1.01
chr18	67958872	67959146	CpG: 24	274	24	171	17.5	62.4	0.91
chr18	68125114	68125348	CpG: 20	234	20	144	17.1	61.5	0.92
chr18	68449354	68449589	CpG: 17	235	17	139	14.5	59.1	0.85
chr18	68805472	68805707	CpG: 17	235	17	144	14.5	61.3	0.79
chr18	68824368	68824642	CpG: 24	274	24	167	17.5	60.9	0.95
chr18	68930818	68931459	CpG: 67	641	67	443	20.9	69.1	0.88
chr18	68948062	68948336	CpG: 25	274	25	172	18.2	62.8	0.94
chr18	69006822	69007132	CpG: 25	310	25	194	16.1	62.6	0.83
chr18	69024919	69025186	CpG: 20	267	20	161	15.0	60.3	0.84
chr18	69121571	69121856	CpG: 26	285	26	177	18.2	62.1	0.96
chr18	69128063	69128337	CpG: 25	274	25	172	18.2	62.8	0.94
chr18	69226622	69226861	CpG: 16	239	16	132	13.4	55.2	0.88
chr18	69616901	69618559	CpG: 193	1658	193	1162	23.3	70.1	0.95
chr18	69619324	69619562	CpG: 16	238	16	145	13.4	60.9	0.72
chr18	69686265	69686606	CpG: 25	341	25	218	14.7	63.9	0.72
chr18	69725954	69726194	CpG: 21	240	21	147	17.5	61.2	0.95
chr18	69765422	69765661	CpG: 19	239	19	144	15.9	60.3	0.89
chr18	69782775	69783010	CpG: 17	235	17	137	14.5	58.3	0.87
chr18	69820110	69820348	CpG: 19	238	19	145	16.0	60.9	0.89
chr18	69910414	69910689	CpG: 23	275	23	170	16.7	61.8	0.88
chr18	70073707	70073982	CpG: 21	275	21	168	15.3	61.1	0.83
chr18	70117507	70117788	CpG: 26	281	26	176	18.5	62.6	0.95
chr18	70140728	70141003	CpG: 23	275	23	169	16.7	61.5	0.89
chr18	70418372	70418648	CpG: 23	276	23	169	16.7	61.2	0.90
chr18	70422341	70423178	CpG: 80	837	80	516	19.1	61.6	1.01
chr18	70467583	70467819	CpG: 22	236	22	148	18.6	62.7	0.97
chr18	70503526	70504896	CpG: 202	1370	202	1089	29.5	79.5	0.94
chr18	70606975	70607211	CpG: 19	236	19	145	16.1	61.4	0.88
chr18	70645682	70645972	CpG: 21	290	21	185	14.5	63.8	0.71
chr18	70680386	70680905	CpG: 46	519	46	371	17.7	71.5	0.79
chr18	70791305	70791953	CpG: 47	648	47	450	14.5	69.4	0.60
chr18	70973964	70974323	CpG: 25	359	25	210	13.9	58.5	0.81
chr18	71253024	71253337	CpG: 25	313	25	224	16.0	71.6	0.63
chr18	71278841	71279114	CpG: 22	273	22	172	16.1	63.0	0.82
chr18	71286948	71287184	CpG: 20	236	20	143	16.9	60.6	0.98
chr18	71351353	71351597	CpG: 18	244	18	150	14.8	61.5	0.79
chr18	71352706	71352969	CpG: 22	263	22	161	16.7	61.2	0.91
chr18	71367313	71367682	CpG: 27	369	27	219	14.6	59.3	0.85
chr18	71401149	71401423	CpG: 24	274	24	171	17.5	62.4	0.91
chr18	71409853	71410122	CpG: 23	269	23	170	17.1	63.2	0.87
chr18	71417396	71417670	CpG: 22	274	22	166	16.1	60.6	0.88
chr18	71434131	71434586	CpG: 44	455	44	339	19.3	74.5	0.70
chr18	71448564	71448804	CpG: 20	240	20	149	16.7	62.1	0.89
chr18	71828939	71829209	CpG: 20	270	20	167	14.8	61.9	0.78
chr18	71858522	71858796	CpG: 22	274	22	172	16.1	62.8	0.83
chr18	71970118	71970335	CpG: 18	217	18	129	16.6	59.4	0.95
chr18	72005925	72006157	CpG: 17	232	17	137	14.7	59.1	0.87
chr18	72055316	72055680	CpG: 25	364	25	206	13.7	56.6	0.88
chr18	72430545	72431104	CpG: 59	559	59	414	21.1	74.1	0.77
chr18	72451137	72451411	CpG: 24	274	24	171	17.5	62.4	0.91
chr18	72508271	72508493	CpG: 18	222	18	136	16.2	61.3	0.88
chr18	72531997	72532259	CpG: 22	262	22	163	16.8	62.2	0.88
chr18	72627298	72627572	CpG: 21	274	21	167	15.3	60.9	0.83
chr18	72680943	72681253	CpG: 27	310	27	195	17.4	62.9	0.90
chr18	72706219	72706486	CpG: 21	267	21	167	15.7	62.5	0.82
chr18	72763238	72766049	CpG: 239	2811	239	1791	17.0	63.7	0.84
chr18	72928938	72929174	CpG: 18	236	18	144	15.3	61.0	0.84
chr18	73088188	73091095	CpG: 298	2907	298	2003	20.5	68.9	0.87
chr18	73110038	73110318	CpG: 23	280	23	172	16.4	61.4	0.88
chr18	73193572	73193861	CpG: 22	289	22	178	15.2	61.6	0.81
chr18	73251192	73251471	CpG: 22	279	22	175	15.8	62.7	0.80
chr18	73276339	73276625	CpG: 24	286	24	179	16.8	62.6	0.87
chr18	73416511	73416751	CpG: 21	240	21	149	17.5	62.1	0.93
chr18	73456064	73456338	CpG: 24	274	24	170	17.5	62.0	0.92
chr18	73485765	73486005	CpG: 19	240	19	147	15.8	61.2	0.85
chr18	73533086	73533360	CpG: 24	274	24	172	17.5	62.8	0.90
chr18	73558172	73558440	CpG: 21	268	21	165	15.7	61.6	0.83
chr18	73637976	73638205	CpG: 21	229	21	143	18.3	62.4	0.95
chr18	73998025	73998310	CpG: 25	285	25	179	17.5	62.8	0.90
chr18	74067163	74067437	CpG: 22	274	22	169	16.1	61.7	0.85
chr18	74368286	74369447	CpG: 97	1161	97	700	16.7	60.3	0.93
chr18	74375249	74375479	CpG: 20	230	20	138	17.4	60.0	0.98
chr18	74518457	74520085	CpG: 150	1628	150	1061	18.4	65.2	0.87
chr18	74543068	74544060	CpG: 68	992	68	613	13.7	61.8	0.72
chr18	74568529	74568810	CpG: 23	281	23	174	16.4	61.9	0.86
chr18	74684046	74685157	CpG: 137	1111	137	838	24.7	75.4	0.87
chr18	74723072	74724176	CpG: 103	1104	103	767	18.7	69.5	0.78
chr18	74824662	74826109	CpG: 135	1447	135	958	18.7	66.2	0.85
chr18	74905827	74906050	CpG: 17	223	17	136	15.2	61.0	0.82
chr18	74948826	74949050	CpG: 16	224	16	130	14.3	58.0	0.88
chr18	74993126	74993404	CpG: 24	278	24	171	17.3	61.5	0.92
chr18	75231924	75232163	CpG: 20	239	20	141	16.7	59.0	0.99
chr18	75263792	75264068	CpG: 22	276	22	169	15.9	61.2	0.86
chr18	75289988	75290269	CpG: 30	281	30	182	21.4	64.8	1.03
chr18	75317015	75317319	CpG: 23	304	23	182	15.1	59.9	0.85
chr18	75319199	75319486	CpG: 22	287	22	187	15.3	65.2	0.73
chr18	75334146	75334716	CpG: 42	570	42	332	14.7	58.2	0.88
chr18	75354912	75355129	CpG: 20	217	20	166	18.4	76.5	0.65
chr18	75433545	75434671	CpG: 111	1126	111	793	19.7	70.4	0.80
chr18	75437352	75441621	CpG: 389	4269	389	2694	18.2	63.1	0.92
chr18	75479873	75480117	CpG: 22	244	22	175	18.0	71.7	0.71
chr18	75515374	75515610	CpG: 21	236	21	148	17.8	62.7	0.91
chr18	75517078	75517516	CpG: 28	438	28	262	12.8	59.8	0.72
chr18	75684735	75685259	CpG: 70	524	70	394	26.7	75.2	0.95
chr18	75820442	75820716	CpG: 22	274	22	168	16.1	61.3	0.86
chr18	76076240	76076599	CpG: 29	359	29	213	16.2	59.3	0.92
chr18	76138209	76138445	CpG: 22	236	22	147	18.6	62.3	0.98
chr18	76145021	76145762	CpG: 87	741	87	526	23.5	71.0	0.94
chr18	76308928	76309170	CpG: 20	242	20	147	16.5	60.7	0.91
chr18	76490365	76490646	CpG: 24	281	24	175	17.1	62.3	0.90
chr18	76517580	76517820	CpG: 21	240	21	151	17.5	62.9	0.91
chr18	76580118	76580595	CpG: 40	477	40	324	16.8	67.9	0.74
chr18	76587015	76587367	CpG: 37	352	37	248	21.0	70.5	0.86
chr18	76609073	76609736	CpG: 47	663	47	428	14.2	64.6	0.68
chr18	76629819	76630785	CpG: 82	966	82	709	17.0	73.4	1.07
chr18	76631520	76631760	CpG: 19	240	19	132	15.8	55.0	1.06
chr18	76670093	76671927	CpG: 179	1834	179	1276	19.5	69.6	0.81
chr18	76687386	76687644	CpG: 33	258	33	176	25.6	68.2	1.10
chr18	76690549	76690762	CpG: 15	213	15	139	14.1	65.3	0.67
chr18	76719486	76725359	CpG: 453	5873	453	3612	15.4	61.5	0.82
chr18	76741618	76741892	CpG: 22	274	22	172	16.1	62.8	0.82
chr18	76742290	76742564	CpG: 19	274	19	164	13.9	59.9	0.78
chr18	76758514	76759039	CpG: 39	525	39	298	14.9	56.8	0.93
chr18	76768825	76769095	CpG: 20	270	20	167	14.8	61.9	0.78
chr18	76828377	76828693	CpG: 27	316	27	232	17.1	73.4	0.63
chr18	76839721	76840443	CpG: 64	722	64	489	17.7	67.7	0.88
chr18	76842221	76842495	CpG: 22	274	22	181	16.1	66.1	0.76
chr18	76873481	76874323	CpG: 59	842	59	555	14.0	65.9	0.65
chr18	76881862	76882136	CpG: 24	274	24	171	17.5	62.4	0.91
chr18	76938175	76938410	CpG: 18	235	18	141	15.3	60.0	0.86
chr18	76951860	76952137	CpG: 22	277	22	166	15.9	59.9	0.90
chr18	76972837	76973067	CpG: 18	230	18	139	15.7	60.4	0.87
chr18	76976756	76977009	CpG: 20	253	20	152	15.8	60.1	0.89
chr18	77005834	77006150	CpG: 28	316	28	234	17.7	74.1	0.65
chr18	77015946	77016358	CpG: 35	412	35	261	17.0	63.3	0.86
chr18	77022602	77022876	CpG: 22	274	22	171	16.1	62.4	0.83
chr18	77030912	77031164	CpG: 29	252	29	184	23.0	73.0	0.90
chr18	77049286	77049581	CpG: 22	295	22	170	14.9	57.6	0.91
chr18	77050625	77052721	CpG: 260	2096	260	1518	24.8	72.4	0.95
chr18	77123757	77123982	CpG: 23	225	23	146	20.4	64.9	1.00
chr18	77148646	77148850	CpG: 16	204	16	131	15.7	64.2	0.77
chr18	77209854	77210058	CpG: 18	204	18	131	17.6	64.2	0.86
chr18	77228153	77228522	CpG: 30	369	30	229	16.3	62.1	0.85
chr18	77259102	77259671	CpG: 46	569	46	377	16.2	66.3	0.74
chr18	77277530	77277764	CpG: 16	234	16	132	13.7	56.4	0.86
chr18	77288292	77289078	CpG: 59	786	59	517	15.0	65.8	0.70
chr18	77317617	77318567	CpG: 68	950	68	648	14.3	68.2	0.62
chr18	77322600	77322933	CpG: 27	333	27	216	16.2	64.9	0.78
chr18	77342579	77342912	CpG: 31	333	31	197	18.6	59.2	1.07
chr18	77351119	77351362	CpG: 17	243	17	138	14.0	56.8	0.87
chr18	77362108	77364497	CpG: 233	2389	233	1703	19.5	71.3	0.77
chr18	77480736	77483002	CpG: 220	2266	220	1573	19.4	69.4	0.81
chr18	77654371	77654612	CpG: 20	241	20	147	16.6	61.0	0.89
chr18	77826794	77827026	CpG: 18	232	18	139	15.5	59.9	0.87
chr18	77901202	77901538	CpG: 25	336	25	229	14.9	68.2	0.64
chr18	78028843	78029105	CpG: 25	262	25	165	19.1	63.0	0.98
chr18	78131572	78132025	CpG: 54	453	54	339	23.8	74.8	0.85
chr18	78137368	78137582	CpG: 18	214	18	156	16.8	72.9	0.65
chr18	78210375	78210782	CpG: 29	407	29	205	14.3	50.4	1.13
chr18	78244570	78244836	CpG: 21	266	21	164	15.8	61.7	0.85
chr18	78255165	78255438	CpG: 22	273	22	171	16.1	62.6	0.83
chr18	78268582	78268959	CpG: 28	377	28	227	14.9	60.2	0.83
chr18	78325021	78325299	CpG: 25	278	25	174	18.0	62.6	0.93
chr18	78359329	78359553	CpG: 18	224	18	129	16.1	57.6	0.97
chr18	78405835	78406116	CpG: 24	281	24	175	17.1	62.3	0.90
chr18	78471266	78471541	CpG: 22	275	22	168	16.0	61.1	0.87
chr18	78473748	78474228	CpG: 48	480	48	341	20.0	71.0	0.83
chr18	78544449	78544926	CpG: 48	477	48	328	20.1	68.8	0.86
chr18	78548502	78548786	CpG: 22	284	22	166	15.5	58.5	0.91
chr18	78598845	78599159	CpG: 29	314	29	212	18.5	67.5	0.81
chr18	78623693	78624826	CpG: 77	1133	77	739	13.6	65.2	0.64
chr18	78633486	78633757	CpG: 20	271	20	180	14.8	66.4	0.67
chr18	78662773	78663245	CpG: 44	472	44	347	18.6	73.5	0.69
chr18	78663653	78663867	CpG: 22	214	22	138	20.6	64.5	1.00
chr18	78734272	78735273	CpG: 98	1001	98	671	19.6	67.0	0.87
chr18	78736859	78737279	CpG: 27	420	27	271	12.9	64.5	0.64
chr18	78738402	78738625	CpG: 19	223	19	140	17.0	62.8	0.90
chr18	78751875	78752234	CpG: 40	359	40	268	22.3	74.7	0.80
chr18	78753294	78753577	CpG: 22	283	22	196	15.5	69.3	0.65
chr18	78772491	78772774	CpG: 22	283	22	174	15.5	61.5	0.83
chr18	78783097	78783446	CpG: 26	349	26	226	14.9	64.8	0.73
chr18	78797575	78797915	CpG: 39	340	39	237	22.9	69.7	0.94
chr18	78871534	78872429	CpG: 71	895	71	620	15.9	69.3	0.66
chr18	78937375	78937690	CpG: 24	315	24	201	15.2	63.8	0.76
chr18	78960369	78960920	CpG: 43	551	43	367	15.6	66.6	0.72
chr18	78969997	78970326	CpG: 31	329	31	204	18.8	62.0	0.98
chr18	79015376	79016259	CpG: 64	883	64	548	14.5	62.1	0.75
chr18	79027231	79027470	CpG: 18	239	18	161	15.1	67.4	1.00
chr18	79031172	79031765	CpG: 63	593	63	377	21.2	63.6	1.05
chr18	79076261	79076470	CpG: 23	209	23	140	22.0	67.0	0.98
chr18	79091097	79092000	CpG: 66	903	66	549	14.6	60.8	0.79
chr18	79113616	79114298	CpG: 80	682	80	446	23.5	65.4	1.10
chr18	79148762	79149350	CpG: 44	588	44	375	15.0	63.8	0.76
chr18	79152230	79152500	CpG: 19	270	19	163	14.1	60.4	0.78
chr18	79159740	79160748	CpG: 77	1008	77	626	15.3	62.1	0.79
chr18	79168470	79168748	CpG: 22	278	22	163	15.8	58.6	0.92
chr18	79176054	79176320	CpG: 19	266	19	167	14.3	62.8	0.74
chr18	79199375	79200150	CpG: 61	775	61	562	15.7	72.5	0.65
chr18	79207548	79215940	CpG: 736	8392	736	5144	17.5	61.3	0.93
chr18	79226514	79230124	CpG: 366	3610	366	2498	20.3	69.2	0.86
chr18	79240323	79241409	CpG: 100	1086	100	755	18.4	69.5	0.76
chr18	79269334	79269573	CpG: 20	239	20	173	16.7	72.4	0.64
chr18	79317778	79318936	CpG: 162	1158	162	857	28.0	74.0	1.02
chr18	79395291	79395557	CpG: 18	266	18	178	13.5	66.9	0.76
chr18	79421375	79421818	CpG: 38	443	38	294	17.2	66.4	0.80
chr18	79460198	79460464	CpG: 21	266	21	169	15.8	63.5	0.80
chr18	79477745	79478141	CpG: 30	396	30	249	15.2	62.9	0.77
chr18	79515916	79516153	CpG: 19	237	19	142	16.0	59.9	0.92
chr18	79579944	79580569	CpG: 55	625	55	364	17.6	58.2	1.04
chr18	79588451	79589176	CpG: 57	725	57	547	15.7	75.4	0.68
chr18	79598792	79599115	CpG: 27	323	27	194	16.7	60.1	0.98
chr18	79606210	79606430	CpG: 16	220	16	141	14.5	64.1	0.71
chr18	79617866	79618139	CpG: 23	273	23	165	16.8	60.4	0.93
chr18	79619555	79619764	CpG: 16	209	16	130	15.3	62.2	0.85
chr18	79623040	79623342	CpG: 22	302	22	176	14.6	58.3	0.87
chr18	79628098	79628583	CpG: 41	485	41	352	16.9	72.6	0.64
chr18	79632727	79633235	CpG: 43	508	43	312	16.9	61.4	0.90
chr18	79647307	79655160	CpG: 685	7853	685	5214	17.4	66.4	0.79
chr18	79655389	79655606	CpG: 16	217	16	119	14.7	54.8	1.00
chr18	79660880	79661219	CpG: 31	339	31	245	18.3	72.3	0.70
chr18	79664394	79666085	CpG: 138	1691	138	1157	16.3	68.4	0.71
chr18	79673846	79674505	CpG: 49	659	49	405	14.9	61.5	0.90
chr18	79679931	79680176	CpG: 19	245	19	160	15.5	65.3	0.73
chr18	79683554	79683805	CpG: 21	251	21	144	16.7	57.4	1.02
chr18	79687165	79687466	CpG: 27	301	27	206	17.9	68.4	0.77
chr18	79689830	79690277	CpG: 44	447	44	290	19.7	64.9	0.94
chr18	79695647	79696441	CpG: 56	794	56	529	14.1	66.6	0.64
chr18	79696978	79697441	CpG: 30	463	30	291	13.0	62.9	0.66
chr18	79700630	79701255	CpG: 41	625	41	401	13.1	64.2	0.64
chr18	79702400	79702744	CpG: 27	344	27	222	15.7	64.5	0.75
chr18	79704698	79704922	CpG: 22	224	22	137	19.6	61.2	1.06
chr18	79708668	79709201	CpG: 44	533	44	327	16.5	61.4	0.88
chr18	79711904	79712543	CpG: 47	639	47	419	14.7	65.6	0.69
chr18	79712916	79713193	CpG: 22	277	22	179	15.9	64.6	0.76
chr18	79715532	79715788	CpG: 20	256	20	167	15.6	65.2	0.74
chr18	79720950	79721404	CpG: 47	454	47	271	20.7	59.7	1.16
chr18	79724274	79724480	CpG: 18	206	18	141	17.5	68.4	0.75
chr18	79727003	79730078	CpG: 250	3075	250	1722	16.3	56.0	1.04
chr18	79734113	79734417	CpG: 25	304	25	206	16.4	67.8	0.72
chr18	79737045	79737317	CpG: 21	272	21	181	15.4	66.5	0.71
chr18	79740037	79741570	CpG: 124	1533	124	1026	16.2	66.9	0.72
chr18	79746860	79748681	CpG: 196	1821	196	1289	21.5	70.8	0.86
chr18	79749358	79749724	CpG: 34	366	34	213	18.6	58.2	1.15
chr18	79764468	79764835	CpG: 34	367	34	256	18.5	69.8	0.76
chr18	79766259	79767278	CpG: 66	1019	66	613	13.0	60.2	0.72
chr18	79773819	79774089	CpG: 23	270	23	180	17.0	66.7	0.77
chr18	79778043	79779164	CpG: 90	1121	90	761	16.1	67.9	0.75
chr18	79779671	79779897	CpG: 19	226	19	148	16.8	65.5	0.78
chr18	79782638	79783084	CpG: 34	446	34	243	15.2	54.5	1.04
chr18	79785790	79786928	CpG: 73	1138	73	777	12.8	68.3	0.62
chr18	79804005	79804746	CpG: 50	741	50	486	13.5	65.6	0.64
chr18	79805626	79807995	CpG: 180	2369	180	1585	15.2	66.9	0.69
chr18	79808448	79808739	CpG: 23	291	23	204	15.8	70.1	0.64
chr18	79809595	79809851	CpG: 22	256	22	160	17.2	62.5	0.88
chr18	79811691	79811922	CpG: 21	231	21	151	18.2	65.4	0.86
chr18	79815038	79815277	CpG: 16	239	16	144	13.4	60.3	0.79
chr18	79822045	79822413	CpG: 26	368	26	221	14.1	60.1	0.80
chr18	79831940	79832141	CpG: 18	201	18	129	17.9	64.2	0.88
chr18	79872546	79874643	CpG: 190	2097	190	1460	18.1	69.6	0.77
chr18	79899669	79899892	CpG: 18	223	18	148	16.1	66.4	0.75
chr18	79909248	79909500	CpG: 20	252	20	157	15.9	62.3	0.84
chr18	79911483	79912700	CpG: 134	1217	134	905	22.0	74.4	0.79
chr18	79923832	79924043	CpG: 18	211	18	134	17.1	63.5	0.86
chr18	79952718	79954196	CpG: 200	1478	200	1072	27.1	72.5	1.03
chr18	79959127	79959388	CpG: 17	261	17	164	13.0	62.8	0.67
chr18	79969663	79969870	CpG: 15	207	15	124	14.5	59.9	0.81
chr18	79980056	79980874	CpG: 53	818	53	495	13.0	60.5	0.71
chr18	79981332	79981603	CpG: 26	271	26	173	19.2	63.8	0.97
chr18	79989801	79990038	CpG: 23	237	23	171	19.4	72.2	0.76
chr18	79990527	79991447	CpG: 70	920	70	617	15.2	67.1	0.68
chr18	79995023	79995311	CpG: 22	288	22	182	15.3	63.2	0.79
chr18	80003302	80003517	CpG: 29	215	29	141	27.0	65.6	1.46
chr18	80009147	80009651	CpG: 38	504	38	326	15.1	64.7	0.72
chr18	80011014	80011904	CpG: 66	890	66	577	14.8	64.8	0.71
chr18	80012276	80012505	CpG: 20	229	20	158	17.5	69.0	0.78
chr18	80012760	80013175	CpG: 29	415	29	261	14.0	62.9	0.75
chr18	80020868	80021727	CpG: 131	859	131	619	30.5	72.1	1.25
chr18	80022779	80023058	CpG: 24	279	24	184	17.2	65.9	0.80
chr18	80024722	80024995	CpG: 21	273	21	182	15.4	66.7	0.72
chr18	80031042	80031343	CpG: 23	301	23	208	15.3	69.1	0.65
chr18	80045482	80046847	CpG: 89	1365	89	983	13.0	72.0	0.94
chr18	80058149	80058608	CpG: 36	459	36	307	15.7	66.9	0.70
chr18	80060251	80060481	CpG: 21	230	21	153	18.3	66.5	0.83
chr18	80063003	80065472	CpG: 220	2469	220	1662	17.8	67.3	0.79
chr18	80067577	80067779	CpG: 19	202	19	135	18.8	66.8	0.85
chr18	80072956	80074124	CpG: 160	1168	160	885	27.4	75.8	0.96
chr18	80075264	80075468	CpG: 16	204	16	142	15.7	69.6	0.70
chr18	80077463	80077677	CpG: 18	214	18	152	16.8	71.0	0.67
chr18	80082459	80084795	CpG: 176	2336	176	1514	15.1	64.8	0.73
chr18	80100670	80101677	CpG: 78	1007	78	593	15.5	58.9	0.90
chr18	80105653	80106771	CpG: 75	1118	75	711	13.4	63.6	0.67
chr18	80138790	80140170	CpG: 172	1380	172	1012	24.9	73.3	0.93
chr18	80147122	80147339	CpG: 19	217	19	156	17.5	71.9	0.68
chr18	80153825	80154079	CpG: 24	254	24	181	18.9	71.3	0.79
chr18	80158246	80158891	CpG: 74	645	74	452	22.9	70.1	0.96
chr18	80164116	80164333	CpG: 32	217	32	168	29.5	77.4	1.00
chr18	80174894	80175982	CpG: 115	1088	115	787	21.1	72.3	0.81
chr18	80191210	80191497	CpG: 21	287	21	199	14.6	69.3	0.64
chr18	80192002	80192402	CpG: 35	400	35	264	17.5	66.0	0.93
chr18	80194452	80194794	CpG: 24	342	24	231	14.0	67.5	0.64
chr18	80226337	80229425	CpG: 368	3088	368	2359	23.8	76.4	0.91
chr18	80240727	80241360	CpG: 76	633	76	476	24.0	75.2	0.85
chr18	80264566	80265426	CpG: 116	860	116	628	27.0	73.0	1.01
chr18	80267346	80267578	CpG: 21	232	21	143	18.1	61.6	0.97
chr18	80309826	80311279	CpG: 179	1453	179	1036	24.6	71.3	1.04
chr18	80354417	80354657	CpG: 18	240	18	156	15.0	65.0	0.71
chr18	80385721	80386426	CpG: 100	705	100	546	28.4	77.4	0.95
chr18	80423871	80424140	CpG: 28	269	28	186	20.8	69.1	0.87
chr18	80436219	80437162	CpG: 115	943	115	674	24.4	71.5	0.95
chr18	80501021	80501267	CpG: 18	246	18	148	14.6	60.2	0.83
chr18	80522608	80524251	CpG: 189	1643	189	1216	23.0	74.0	0.84
chr18	80538635	80539042	CpG: 55	407	55	290	27.0	71.3	1.08
chr19	2626	3826	CpG: 217	1200	217	944	36.2	78.7	1.18
chr19	21329	22199	CpG: 103	870	103	641	23.7	73.7	0.89
chr19	44198	44471	CpG: 31	273	31	190	22.7	69.6	0.95
chr19	197461	198276	CpG: 89	815	89	562	21.8	69.0	0.92
chr19	218324	219001	CpG: 86	677	86	456	25.4	67.4	1.12
chr19	241639	243689	CpG: 205	2050	205	1558	20.0	76.0	0.74
chr19	246554	246794	CpG: 24	240	24	174	20.0	72.5	0.76
chr19	256166	256633	CpG: 40	467	40	339	17.1	72.6	0.66
chr19	258365	258882	CpG: 46	517	46	365	17.8	70.6	0.72
chr19	260212	260760	CpG: 41	548	41	339	15.0	61.9	0.78
chr19	262126	262345	CpG: 24	219	24	162	21.9	74.0	0.82
chr19	267280	267605	CpG: 24	325	24	189	14.8	58.2	0.88
chr19	283209	283424	CpG: 15	215	15	123	14.0	57.2	0.87
chr19	293597	295024	CpG: 165	1427	165	1020	23.1	71.5	0.91
chr19	308930	310808	CpG: 182	1878	182	1232	19.4	65.6	0.90
chr19	312909	313161	CpG: 19	252	19	152	15.1	60.3	0.84
chr19	319223	319796	CpG: 42	573	42	336	14.7	58.6	0.86
chr19	324689	324953	CpG: 24	264	24	178	18.2	67.4	0.83
chr19	332540	333253	CpG: 53	713	53	447	14.9	62.7	0.76
chr19	336753	337139	CpG: 34	386	34	248	17.6	64.2	0.86
chr19	349538	349778	CpG: 18	240	18	158	15.0	65.8	0.70
chr19	350521	350831	CpG: 25	310	25	192	16.1	61.9	0.84
chr19	352104	352415	CpG: 24	311	24	200	15.4	64.3	0.75
chr19	354584	357964	CpG: 280	3380	280	2393	16.6	70.8	0.66
chr19	366567	367595	CpG: 66	1028	66	646	12.8	62.8	0.65
chr19	370387	370595	CpG: 20	208	20	147	19.2	70.7	0.77
chr19	374561	376034	CpG: 112	1473	112	982	15.2	66.7	0.76
chr19	377475	377796	CpG: 21	321	21	161	13.1	50.2	1.07
chr19	378210	378538	CpG: 25	328	25	166	15.2	50.6	1.20
chr19	379472	381951	CpG: 167	2479	167	1371	13.5	55.3	1.18
chr19	388011	388213	CpG: 18	202	18	145	17.8	71.8	0.72
chr19	392006	392389	CpG: 34	383	34	267	17.8	69.7	0.73
chr19	397840	398108	CpG: 19	268	19	155	14.2	57.8	0.85
chr19	402145	402895	CpG: 52	750	52	425	13.9	56.7	0.87
chr19	403637	403907	CpG: 18	270	18	149	13.3	55.2	0.95
chr19	405235	405478	CpG: 19	243	19	153	15.6	63.0	0.79
chr19	409305	413761	CpG: 399	4456	399	3128	17.9	70.2	0.74
chr19	415354	415664	CpG: 28	310	28	230	18.1	74.2	0.68
chr19	420024	420280	CpG: 20	256	20	157	15.6	61.3	0.84
chr19	431281	431648	CpG: 29	367	29	242	15.8	65.9	0.77
chr19	440716	442531	CpG: 190	1815	190	1278	20.9	70.4	0.85
chr19	445152	445637	CpG: 37	485	37	287	15.3	59.2	0.90
chr19	448280	448983	CpG: 49	703	49	462	13.9	65.7	0.65
chr19	454178	454388	CpG: 15	210	15	152	14.3	72.4	0.74
chr19	458630	458897	CpG: 24	267	24	169	18.0	63.3	0.91
chr19	459098	459705	CpG: 40	607	40	405	13.2	66.7	0.62
chr19	460029	460651	CpG: 73	622	73	444	23.5	71.4	0.93
chr19	462666	462932	CpG: 20	266	20	164	15.0	61.7	0.80
chr19	465132	465827	CpG: 59	695	59	481	17.0	69.2	0.71
chr19	468325	468599	CpG: 23	274	23	168	16.8	61.3	0.90
chr19	471419	472477	CpG: 137	1058	137	796	25.9	75.2	0.92
chr19	475737	476539	CpG: 71	802	71	544	17.7	67.8	0.79
chr19	476728	476941	CpG: 17	213	17	153	16.0	71.8	0.68
chr19	483376	483646	CpG: 20	270	20	163	14.8	60.4	0.83
chr19	484541	486297	CpG: 205	1756	205	1313	23.3	74.8	0.84
chr19	488017	488391	CpG: 28	374	28	257	15.0	68.7	0.79
chr19	489541	490365	CpG: 60	824	60	566	14.6	68.7	0.62
chr19	490994	491230	CpG: 20	236	20	143	16.9	60.6	0.94
chr19	492665	493117	CpG: 33	452	33	315	14.6	69.7	0.62
chr19	494851	495804	CpG: 74	953	74	639	15.5	67.1	0.69
chr19	504540	504764	CpG: 14	224	14	152	12.5	67.9	0.70
chr19	505401	505715	CpG: 30	314	30	209	19.1	66.6	0.86
chr19	506654	506907	CpG: 19	253	19	159	15.0	62.8	0.80
chr19	508474	508707	CpG: 19	233	19	145	16.3	62.2	0.87
chr19	512210	512425	CpG: 16	215	16	128	14.9	59.5	0.85
chr19	514740	515009	CpG: 20	269	20	168	14.9	62.5	0.77
chr19	519933	520189	CpG: 19	256	19	137	14.8	53.5	1.06
chr19	523777	525540	CpG: 111	1763	111	1148	12.6	65.1	0.64
chr19	526020	527025	CpG: 118	1005	118	714	23.5	71.0	0.94
chr19	528209	528439	CpG: 17	230	17	137	14.8	59.6	0.85
chr19	531646	532332	CpG: 61	686	61	490	17.8	71.4	0.71
chr19	532810	533681	CpG: 59	871	59	567	13.5	65.1	0.64
chr19	535216	535490	CpG: 22	274	22	178	16.1	65.0	0.76
chr19	539150	539393	CpG: 30	243	30	186	24.7	76.5	0.89
chr19	542141	542513	CpG: 31	372	31	265	16.7	71.2	0.66
chr19	543381	545610	CpG: 322	2229	322	1754	28.9	78.7	0.94
chr19	549552	549862	CpG: 24	310	24	207	15.5	66.8	0.73
chr19	555241	556905	CpG: 106	1664	106	1068	12.7	64.2	0.67
chr19	557921	558228	CpG: 26	307	26	178	16.9	58.0	1.01
chr19	564593	564897	CpG: 23	304	23	214	15.1	70.4	0.61
chr19	565526	565863	CpG: 26	337	26	237	15.4	70.3	0.65
chr19	567222	568374	CpG: 105	1152	105	804	18.2	69.8	0.76
chr19	569997	577811	CpG: 605	7814	605	5431	15.5	69.5	0.64
chr19	587003	587984	CpG: 97	981	97	668	19.8	68.1	0.86
chr19	605241	607237	CpG: 140	1996	140	1349	14.0	67.6	0.61
chr19	614063	614270	CpG: 18	207	18	142	17.4	68.6	0.75
chr19	616319	617644	CpG: 174	1325	174	1002	26.3	75.6	0.92
chr19	621325	621603	CpG: 28	278	28	203	20.1	73.0	0.78
chr19	629744	630743	CpG: 101	999	101	721	20.2	72.2	0.78
chr19	633869	634816	CpG: 121	947	121	737	25.6	77.8	0.84
chr19	635433	635664	CpG: 26	231	26	165	22.5	71.4	0.89
chr19	638858	639124	CpG: 19	266	19	162	14.3	60.9	0.79
chr19	644726	645015	CpG: 22	289	22	190	15.2	65.7	0.70
chr19	645854	646196	CpG: 23	342	23	222	13.5	64.9	0.65
chr19	653047	653304	CpG: 21	257	21	160	16.3	62.3	0.85
chr19	657874	658623	CpG: 54	749	54	529	14.4	70.6	0.63
chr19	662545	664005	CpG: 170	1460	170	1134	23.3	77.7	0.77
chr19	664836	665080	CpG: 21	244	21	161	17.2	66.0	0.79
chr19	673113	674968	CpG: 188	1855	188	1386	20.3	74.7	0.73
chr19	675955	676229	CpG: 21	274	21	168	15.3	61.3	0.82
chr19	680796	681164	CpG: 27	368	27	253	14.7	68.8	0.63
chr19	681971	682192	CpG: 20	221	20	157	18.1	71.0	0.73
chr19	690192	690483	CpG: 29	291	29	210	19.9	72.2	0.77
chr19	694253	694666	CpG: 31	413	31	281	15.0	68.0	0.65
chr19	700357	701218	CpG: 68	861	68	586	15.8	68.1	0.69
chr19	706209	706455	CpG: 20	246	20	151	16.3	61.4	0.86
chr19	711874	712549	CpG: 47	675	47	446	13.9	66.1	0.64
chr19	713515	713752	CpG: 18	237	18	142	15.2	59.9	0.87
chr19	716033	716304	CpG: 22	271	22	166	16.2	61.3	0.88
chr19	724084	724358	CpG: 20	274	20	169	14.6	61.7	0.78
chr19	724464	724680	CpG: 18	216	18	139	16.7	64.4	0.81
chr19	733308	734053	CpG: 49	745	49	449	13.2	60.3	0.73
chr19	749839	750040	CpG: 18	201	18	137	17.9	68.2	0.77
chr19	750985	769762	CpG: 1195	18777	1195	11830	12.7	63.0	0.64
chr19	775752	777324	CpG: 186	1572	186	1193	23.7	75.9	0.83
chr19	778988	779221	CpG: 17	233	17	138	14.6	59.2	0.84
chr19	786331	786583	CpG: 20	252	20	185	15.9	73.4	0.62
chr19	789033	791421	CpG: 265	2388	265	1798	22.2	75.3	0.83
chr19	792454	792820	CpG: 28	366	28	256	15.3	69.9	0.63
chr19	793882	794093	CpG: 19	211	19	130	18.0	61.6	0.97
chr19	799356	800696	CpG: 135	1340	135	1014	20.1	75.7	0.77
chr19	804006	804237	CpG: 22	231	22	165	19.0	71.4	0.77
chr19	808828	809697	CpG: 97	869	97	641	22.3	73.8	0.83
chr19	811635	812255	CpG: 48	620	48	420	15.5	67.7	0.68
chr19	813353	813570	CpG: 19	217	19	134	17.5	61.8	0.93
chr19	814110	814339	CpG: 18	229	18	137	15.7	59.8	0.89
chr19	816553	819334	CpG: 222	2781	222	1966	16.0	70.7	0.64
chr19	820967	821169	CpG: 15	202	15	121	14.9	59.9	0.83
chr19	822663	823132	CpG: 49	469	49	350	20.9	74.6	0.98
chr19	823980	824377	CpG: 33	397	33	272	16.6	68.5	0.72
chr19	826850	827394	CpG: 40	544	40	383	14.7	70.4	0.63
chr19	827920	829767	CpG: 136	1847	136	1448	14.7	78.4	1.02
chr19	831650	831854	CpG: 17	204	17	122	16.7	59.8	0.95
chr19	832666	832872	CpG: 20	206	20	134	19.4	65.0	0.98
chr19	845990	846235	CpG: 21	245	21	177	17.1	72.2	0.82
chr19	847239	848943	CpG: 123	1704	123	1130	14.4	66.3	0.66
chr19	854273	854892	CpG: 45	619	45	427	14.5	69.0	0.69
chr19	855473	855998	CpG: 64	525	64	397	24.4	75.6	0.92
chr19	860103	860353	CpG: 19	250	19	168	15.2	67.2	0.68
chr19	862218	862448	CpG: 18	230	18	160	15.7	69.6	0.65
chr19	863536	863860	CpG: 24	324	24	221	14.8	68.2	0.64
chr19	873578	873813	CpG: 17	235	17	141	14.5	60.0	0.81
chr19	874378	876453	CpG: 190	2075	190	1542	18.3	74.3	0.71
chr19	879773	889604	CpG: 676	9831	676	6302	13.8	64.1	0.67
chr19	892092	892574	CpG: 46	482	46	378	19.1	78.4	0.62
chr19	894317	894540	CpG: 16	223	16	134	14.3	60.1	0.81
chr19	895338	895870	CpG: 40	532	40	373	15.0	70.1	0.64
chr19	898552	898856	CpG: 26	304	26	184	17.1	60.5	0.94
chr19	902335	902556	CpG: 19	221	19	128	17.2	57.9	1.03
chr19	903463	905230	CpG: 134	1767	134	1194	15.2	67.6	0.66
chr19	906954	907215	CpG: 22	261	22	178	16.9	68.2	0.76
chr19	910166	910724	CpG: 40	558	40	359	14.3	64.3	0.69
chr19	912764	913085	CpG: 23	321	23	204	14.3	63.6	0.75
chr19	917309	917637	CpG: 26	328	26	228	15.9	69.5	0.70
chr19	934584	934795	CpG: 19	211	19	149	18.0	70.6	0.75
chr19	939923	940197	CpG: 20	274	20	193	14.6	70.4	0.60
chr19	945394	945785	CpG: 43	391	43	302	22.0	77.2	0.76
chr19	946870	947571	CpG: 78	701	78	489	22.3	69.8	0.94
chr19	956529	957186	CpG: 51	657	51	455	15.5	69.3	0.65
chr19	958749	959399	CpG: 59	650	59	447	18.2	68.8	0.77
chr19	962502	963663	CpG: 133	1161	133	844	22.9	72.7	0.87
chr19	965862	968275	CpG: 168	2413	168	1607	13.9	66.6	0.63
chr19	970188	974892	CpG: 368	4704	368	3279	15.6	69.7	0.64
chr19	976943	977248	CpG: 30	305	30	211	19.7	69.2	0.83
chr19	983181	984065	CpG: 103	884	103	613	23.3	69.3	0.97
chr19	984189	984659	CpG: 31	470	31	254	13.2	54.0	0.90
chr19	988981	989578	CpG: 68	597	68	448	22.8	75.0	0.81
chr19	990989	991542	CpG: 45	553	45	386	16.3	69.8	0.67
chr19	996275	997906	CpG: 137	1631	137	1086	16.8	66.6	1.07
chr19	1002434	1002924	CpG: 43	490	43	335	17.6	68.4	0.76
chr19	1008919	1010371	CpG: 119	1452	119	1013	16.4	69.8	0.67
chr19	1015321	1015579	CpG: 19	258	19	171	14.7	66.3	0.67
chr19	1028210	1028931	CpG: 52	721	52	494	14.4	68.5	0.63
chr19	1029563	1030114	CpG: 51	551	51	386	18.5	70.1	0.76
chr19	1031532	1032340	CpG: 86	808	86	596	21.3	73.8	0.79
chr19	1033104	1033367	CpG: 28	263	28	196	21.3	74.5	0.77
chr19	1035258	1036474	CpG: 122	1216	122	857	20.1	70.5	0.81
chr19	1039384	1039727	CpG: 39	343	39	266	22.7	77.6	0.76
chr19	1050507	1050819	CpG: 24	312	24	214	15.4	68.6	0.65
chr19	1055198	1055415	CpG: 17	217	17	129	15.7	59.4	0.89
chr19	1057890	1058119	CpG: 16	229	16	144	14.0	62.9	0.71
chr19	1059463	1060315	CpG: 94	852	94	577	22.1	67.7	1.00
chr19	1068389	1074277	CpG: 460	5888	460	4080	15.6	69.3	0.65
chr19	1075066	1075368	CpG: 27	302	27	213	17.9	70.5	0.78
chr19	1076867	1077662	CpG: 77	795	77	565	19.4	71.1	0.77
chr19	1081937	1082239	CpG: 27	302	27	213	17.9	70.5	0.74
chr19	1083574	1084882	CpG: 93	1308	93	886	14.2	67.7	0.63
chr19	1087142	1087954	CpG: 66	812	66	580	16.3	71.4	0.65
chr19	1102356	1102770	CpG: 26	414	26	332	12.6	80.2	0.64
chr19	1105476	1105758	CpG: 24	282	24	180	17.0	63.8	0.85
chr19	1110144	1110441	CpG: 23	297	23	202	15.5	68.0	0.67
chr19	1118381	1118615	CpG: 20	234	20	155	17.1	66.2	0.78
chr19	1120389	1120852	CpG: 48	463	48	344	20.7	74.3	0.77
chr19	1121386	1121671	CpG: 22	285	22	200	15.4	70.2	0.63
chr19	1123681	1125376	CpG: 125	1695	125	1137	14.7	67.1	0.66
chr19	1129202	1129650	CpG: 30	448	30	278	13.4	62.1	0.79
chr19	1131681	1131912	CpG: 18	231	18	139	15.6	60.2	0.88
chr19	1132964	1133374	CpG: 32	410	32	291	15.6	71.0	0.62
chr19	1137913	1138141	CpG: 16	228	16	142	14.0	62.3	0.72
chr19	1139405	1139968	CpG: 40	563	40	374	14.2	66.4	0.65
chr19	1140871	1141080	CpG: 20	209	20	136	19.1	65.1	0.92
chr19	1144074	1145261	CpG: 117	1187	117	844	19.7	71.1	0.79
chr19	1151942	1152184	CpG: 18	242	18	145	14.9	59.9	0.85
chr19	1164698	1165617	CpG: 85	919	85	594	18.5	64.6	0.89
chr19	1173916	1175970	CpG: 231	2054	231	1462	22.5	71.2	0.89
chr19	1176914	1177151	CpG: 18	237	18	143	15.2	60.3	0.85
chr19	1189044	1189375	CpG: 29	331	29	242	17.5	73.1	0.66
chr19	1195049	1195548	CpG: 40	499	40	355	16.0	71.1	0.64
chr19	1196090	1219703	CpG: 1706	23613	1706	15939	14.4	67.5	0.63
chr19	1222450	1222978	CpG: 50	528	50	379	18.9	71.8	0.74
chr19	1223740	1224118	CpG: 35	378	35	272	18.5	72.0	0.75
chr19	1224681	1225000	CpG: 25	319	25	193	15.7	60.5	0.86
chr19	1225522	1225872	CpG: 37	350	37	240	21.1	68.6	0.90
chr19	1228789	1229859	CpG: 103	1070	103	779	19.3	72.8	0.73
chr19	1234379	1244882	CpG: 704	10503	704	6659	13.4	63.4	0.67
chr19	1249292	1249750	CpG: 33	458	33	306	14.4	66.8	0.65
chr19	1254651	1255829	CpG: 183	1178	183	955	31.1	81.1	0.95
chr19	1256671	1257140	CpG: 38	469	38	323	16.2	68.9	0.68
chr19	1259664	1259892	CpG: 18	228	18	154	15.8	67.5	0.71
chr19	1264487	1265324	CpG: 86	837	86	622	20.5	74.3	0.74
chr19	1269008	1269493	CpG: 44	485	44	353	18.1	72.8	0.69
chr19	1271787	1272068	CpG: 30	281	30	199	21.4	70.8	0.85
chr19	1274023	1274319	CpG: 22	296	22	207	14.9	69.9	0.61
chr19	1276339	1276996	CpG: 58	657	58	405	17.7	61.6	0.94
chr19	1282095	1282836	CpG: 56	741	56	516	15.1	69.6	0.63
chr19	1284999	1285400	CpG: 49	401	49	304	24.4	75.8	0.85
chr19	1288082	1288705	CpG: 44	623	44	407	14.1	65.3	0.66
chr19	1293024	1293393	CpG: 31	369	31	216	16.8	58.5	0.99
chr19	1294279	1294910	CpG: 63	631	63	424	20.0	67.2	0.89
chr19	1295175	1295525	CpG: 26	350	26	243	14.9	69.4	0.62
chr19	1324391	1325327	CpG: 119	936	119	708	25.4	75.6	0.90
chr19	1330015	1330324	CpG: 23	309	23	180	14.9	58.3	0.88
chr19	1337288	1337666	CpG: 26	378	26	241	13.8	63.8	0.68
chr19	1340960	1341216	CpG: 28	256	28	173	21.9	67.6	0.96
chr19	1346552	1347566	CpG: 65	1014	65	605	12.8	59.7	0.72
chr19	1347842	1348264	CpG: 36	422	36	282	17.1	66.8	0.77
chr19	1353239	1354249	CpG: 115	1010	115	671	22.8	66.4	1.03
chr19	1357525	1358008	CpG: 32	483	32	317	13.3	65.6	0.63
chr19	1360692	1361303	CpG: 55	611	55	413	18.0	67.6	0.79
chr19	1363154	1363469	CpG: 26	315	26	222	16.5	70.5	0.67
chr19	1365289	1365787	CpG: 44	498	44	348	17.7	69.9	0.73
chr19	1369164	1369387	CpG: 17	223	17	154	15.2	69.1	0.64
chr19	1371091	1371783	CpG: 90	692	90	537	26.0	77.6	0.86
chr19	1377061	1378844	CpG: 247	1783	247	1353	27.7	75.9	0.96
chr19	1389756	1390410	CpG: 75	654	75	418	22.9	63.9	1.32
chr19	1393757	1394011	CpG: 21	254	21	166	16.5	65.4	0.78
chr19	1394617	1394979	CpG: 30	362	30	254	16.6	70.2	0.68
chr19	1398808	1399308	CpG: 38	500	38	339	15.2	67.8	0.66
chr19	1404618	1405068	CpG: 39	450	39	309	17.3	68.7	0.74
chr19	1408081	1410421	CpG: 191	2340	191	1477	16.3	63.1	0.82
chr19	1413553	1413824	CpG: 20	271	20	163	14.8	60.1	0.83
chr19	1414915	1417211	CpG: 248	2296	248	1676	21.6	73.0	0.82
chr19	1418562	1418795	CpG: 17	233	17	138	14.6	59.2	0.87
chr19	1419936	1420384	CpG: 61	448	61	351	27.2	78.3	0.90
chr19	1424581	1424863	CpG: 23	282	23	175	16.3	62.1	0.86
chr19	1425222	1427508	CpG: 159	2286	159	1566	13.9	68.5	0.61
chr19	1431612	1431848	CpG: 17	236	17	139	14.4	58.9	0.85
chr19	1435245	1441280	CpG: 646	6035	646	4442	21.4	73.6	0.79
chr19	1442974	1443249	CpG: 23	275	23	167	16.7	60.7	0.92
chr19	1448634	1449652	CpG: 94	1018	94	696	18.5	68.4	0.79
chr19	1451880	1454150	CpG: 168	2270	168	1569	14.8	69.1	0.62
chr19	1456869	1457412	CpG: 50	543	50	386	18.4	71.1	0.73
chr19	1459183	1459459	CpG: 21	276	21	163	15.2	59.1	0.89
chr19	1460165	1461837	CpG: 161	1672	161	1160	19.3	69.4	0.81
chr19	1465227	1465444	CpG: 19	217	19	139	17.5	64.1	0.86
chr19	1466377	1466774	CpG: 37	397	37	264	18.6	66.5	0.84
chr19	1469216	1469778	CpG: 51	562	51	429	18.1	76.3	0.62
chr19	1473487	1473820	CpG: 23	333	23	204	13.8	61.3	0.74
chr19	1473961	1474263	CpG: 26	302	26	218	17.2	72.2	0.66
chr19	1476476	1476718	CpG: 24	242	24	170	19.8	70.2	0.82
chr19	1478367	1478593	CpG: 26	226	26	149	23.0	65.9	1.06
chr19	1478859	1479060	CpG: 18	201	18	146	17.9	72.6	0.69
chr19	1480943	1481175	CpG: 22	232	22	177	19.0	76.3	0.65
chr19	1483411	1484484	CpG: 122	1073	122	836	22.7	77.9	0.75
chr19	1494143	1495038	CpG: 130	895	130	684	29.1	76.4	1.00
chr19	1495771	1496265	CpG: 38	494	38	334	15.4	67.6	0.67
chr19	1496879	1497098	CpG: 18	219	18	151	16.4	68.9	0.70
chr19	1513745	1514016	CpG: 21	271	21	167	15.5	61.6	0.83
chr19	1516275	1516684	CpG: 36	409	36	262	17.6	64.1	0.88
chr19	1517413	1517633	CpG: 17	220	17	136	15.5	61.8	0.84
chr19	1518104	1518339	CpG: 20	235	20	144	17.0	61.3	0.92
chr19	1525827	1527685	CpG: 215	1858	215	1315	23.1	70.8	0.93
chr19	1537374	1539654	CpG: 303	2280	303	1794	26.6	78.7	0.86
chr19	1548287	1549329	CpG: 75	1042	75	705	14.4	67.7	0.63
chr19	1551219	1551450	CpG: 16	231	16	146	13.9	63.2	0.71
chr19	1555256	1556098	CpG: 97	842	97	598	23.0	71.0	0.92
chr19	1562251	1562452	CpG: 15	201	15	137	14.9	68.2	0.65
chr19	1562822	1563919	CpG: 147	1097	147	837	26.8	76.3	0.95
chr19	1575742	1576507	CpG: 86	765	86	522	22.5	68.2	0.97
chr19	1585134	1585425	CpG: 24	291	24	205	16.5	70.4	0.72
chr19	1586028	1586638	CpG: 47	610	47	415	15.4	68.0	0.68
chr19	1589996	1590273	CpG: 25	277	25	203	18.1	73.3	0.67
chr19	1592492	1592727	CpG: 20	235	20	167	17.0	71.1	0.68
chr19	1595994	1596438	CpG: 36	444	36	310	16.2	69.8	0.68
chr19	1597321	1597584	CpG: 23	263	23	184	17.5	70.0	0.71
chr19	1602031	1602233	CpG: 15	202	15	142	14.9	70.3	0.60
chr19	1613330	1613591	CpG: 33	261	33	166	25.3	63.6	1.29
chr19	1613926	1614133	CpG: 16	207	16	117	15.5	56.5	0.97
chr19	1617284	1617880	CpG: 40	596	40	397	13.4	66.6	0.61
chr19	1622788	1624498	CpG: 244	1710	244	1312	28.5	76.7	0.97
chr19	1643176	1643850	CpG: 59	674	59	468	17.5	69.4	0.73
chr19	1646135	1646399	CpG: 22	264	22	165	16.7	62.5	0.87
chr19	1647033	1647592	CpG: 58	559	58	362	20.8	64.8	1.01
chr19	1661145	1661496	CpG: 27	351	27	204	15.4	58.1	0.93
chr19	1668061	1668297	CpG: 18	236	18	142	15.3	60.2	0.87
chr19	1669854	1670409	CpG: 42	555	42	342	15.1	61.6	0.80
chr19	1689935	1690351	CpG: 40	416	40	304	19.2	73.1	0.73
chr19	1696570	1697358	CpG: 93	788	93	581	23.6	73.7	0.87
chr19	1705427	1705833	CpG: 30	406	30	252	14.8	62.1	0.78
chr19	1708180	1708416	CpG: 19	236	19	167	16.1	70.8	0.66
chr19	1712143	1712383	CpG: 17	240	17	141	14.2	58.8	0.84
chr19	1718091	1718344	CpG: 18	253	18	166	14.2	65.6	0.66
chr19	1719434	1721510	CpG: 207	2076	207	1437	19.9	69.2	0.83
chr19	1724483	1729493	CpG: 481	5010	481	3477	19.2	69.4	0.80
chr19	1733240	1734105	CpG: 69	865	69	599	16.0	69.2	0.67
chr19	1736890	1737625	CpG: 56	735	56	490	15.2	66.7	0.69
chr19	1746419	1748086	CpG: 124	1667	124	1110	14.9	66.6	0.68
chr19	1760339	1761230	CpG: 73	891	73	642	16.4	72.1	0.66
chr19	1767264	1768343	CpG: 80	1079	80	730	14.8	67.7	0.65
chr19	1771260	1771574	CpG: 26	314	26	200	16.6	63.7	0.82
chr19	1783271	1784076	CpG: 76	805	76	594	18.9	73.8	0.73
chr19	1787017	1788101	CpG: 79	1084	79	741	14.6	68.4	0.64
chr19	1789782	1790098	CpG: 23	316	23	214	14.6	67.7	0.63
chr19	1793656	1793955	CpG: 21	299	21	204	14.0	68.2	0.61
chr19	1819005	1820092	CpG: 121	1087	121	792	22.3	72.9	0.84
chr19	1822865	1823519	CpG: 59	654	59	477	18.0	72.9	0.69
chr19	1825784	1826179	CpG: 37	395	37	281	18.7	71.1	0.79
chr19	1828041	1828759	CpG: 66	718	66	528	18.4	73.5	0.68
chr19	1831405	1831626	CpG: 17	221	17	156	15.4	70.6	0.62
chr19	1833030	1833233	CpG: 15	203	15	137	14.8	67.5	0.80
chr19	1833575	1836261	CpG: 345	2686	345	2036	25.7	75.8	0.89
chr19	1843952	1844169	CpG: 20	217	20	147	18.4	67.7	0.82
chr19	1846953	1849242	CpG: 216	2289	216	1566	18.9	68.4	0.81
chr19	1851231	1851479	CpG: 20	248	20	162	16.1	65.3	0.76
chr19	1856089	1856929	CpG: 94	840	94	612	22.4	72.9	0.85
chr19	1865516	1865782	CpG: 21	266	21	163	15.8	61.3	0.86
chr19	1868135	1868345	CpG: 15	210	15	123	14.3	58.6	0.86
chr19	1871304	1871515	CpG: 17	211	17	132	16.1	62.6	0.85
chr19	1871723	1871957	CpG: 20	234	20	141	17.1	60.3	0.97
chr19	1876424	1877153	CpG: 93	729	93	523	25.5	71.7	0.99
chr19	1879459	1879850	CpG: 35	391	35	270	17.9	69.1	0.75
chr19	1883237	1884720	CpG: 158	1483	158	1083	21.3	73.0	0.81
chr19	1889216	1889618	CpG: 30	402	30	271	14.9	67.4	0.66
chr19	1890130	1890569	CpG: 35	439	35	284	15.9	64.7	0.76
chr19	1892205	1892513	CpG: 21	308	21	195	13.6	63.3	0.68
chr19	1894419	1894621	CpG: 16	202	16	128	15.8	63.4	0.80
chr19	1895159	1895374	CpG: 16	215	16	130	14.9	60.5	0.82
chr19	1895827	1896090	CpG: 23	263	23	179	17.5	68.1	0.76
chr19	1900421	1900825	CpG: 35	404	35	252	17.3	62.4	0.89
chr19	1911633	1913271	CpG: 201	1638	201	1215	24.5	74.2	0.92
chr19	1919069	1919911	CpG: 60	842	60	533	14.3	63.3	0.71
chr19	1920794	1921043	CpG: 24	249	24	155	19.3	62.2	1.00
chr19	1924250	1924515	CpG: 20	265	20	162	15.1	61.1	0.81
chr19	1925128	1925373	CpG: 20	245	20	158	16.3	64.5	0.79
chr19	1929125	1929389	CpG: 24	264	24	183	18.2	69.3	0.82
chr19	1933149	1933473	CpG: 26	324	26	225	16.0	69.4	0.69
chr19	1939285	1939501	CpG: 16	216	16	139	14.8	64.4	0.72
chr19	1941936	1942634	CpG: 53	698	53	468	15.2	67.0	0.68
chr19	1947717	1948068	CpG: 26	351	26	229	14.8	65.2	0.70
chr19	1950870	1953588	CpG: 214	2718	214	1865	15.7	68.6	0.67
chr19	1958379	1958697	CpG: 28	318	28	212	17.6	66.7	0.80
chr19	1959871	1960186	CpG: 22	315	22	214	14.0	67.9	0.64
chr19	1963156	1963396	CpG: 20	240	20	162	16.7	67.5	0.73
chr19	1965315	1965772	CpG: 44	457	44	316	19.3	69.1	0.83
chr19	1971299	1971831	CpG: 43	532	43	357	16.2	67.1	0.74
chr19	1987757	1988215	CpG: 75	458	75	373	32.8	81.4	0.99
chr19	1997742	1997978	CpG: 18	236	18	139	15.3	58.9	0.89
chr19	2011364	2011763	CpG: 31	399	31	274	15.5	68.7	0.68
chr19	2014896	2015666	CpG: 82	770	82	558	21.3	72.5	0.81
chr19	2019147	2019510	CpG: 31	363	31	246	17.1	67.8	0.76
chr19	2023704	2024640	CpG: 130	936	130	730	27.8	78.0	0.91
chr19	2027354	2027645	CpG: 23	291	23	168	15.8	57.7	0.95
chr19	2034173	2035117	CpG: 92	944	92	670	19.5	71.0	0.78
chr19	2037916	2038328	CpG: 29	412	29	273	14.1	66.3	0.65
chr19	2049537	2050036	CpG: 43	499	43	327	17.2	65.5	0.80
chr19	2051216	2051565	CpG: 32	349	32	226	18.3	64.8	0.87
chr19	2068451	2070547	CpG: 192	2096	192	1442	18.3	68.8	0.77
chr19	2087923	2088831	CpG: 62	908	62	599	13.7	66.0	0.63
chr19	2089619	2089856	CpG: 22	237	22	165	18.6	69.6	0.77
chr19	2093921	2094215	CpG: 25	294	25	199	17.0	67.7	0.74
chr19	2100472	2100733	CpG: 20	261	20	156	15.3	59.8	0.87
chr19	2101439	2102389	CpG: 108	950	108	745	22.7	78.4	0.83
chr19	2104609	2105141	CpG: 49	532	49	365	18.4	68.6	0.78
chr19	2109190	2109423	CpG: 21	233	21	168	18.0	72.1	0.77
chr19	2110081	2110349	CpG: 20	268	20	176	14.9	65.7	0.69
chr19	2117049	2117288	CpG: 19	239	19	146	15.9	61.1	0.86
chr19	2124236	2125209	CpG: 96	973	96	686	19.7	70.5	0.79
chr19	2130407	2130681	CpG: 22	274	22	168	16.1	61.3	0.87
chr19	2136878	2139313	CpG: 249	2435	249	1646	20.5	67.6	0.90
chr19	2146657	2146934	CpG: 19	277	19	183	13.7	66.1	0.63
chr19	2157212	2157660	CpG: 34	448	34	272	15.2	60.7	0.83
chr19	2164554	2164827	CpG: 22	273	22	172	16.1	63.0	0.82
chr19	2170183	2170727	CpG: 42	544	42	341	15.4	62.7	0.79
chr19	2173486	2173691	CpG: 18	205	18	145	17.6	70.7	0.72
chr19	2174253	2174919	CpG: 54	666	54	418	16.2	62.8	1.63
chr19	2187425	2187707	CpG: 23	282	23	185	16.3	65.6	0.77
chr19	2189911	2190306	CpG: 29	395	29	271	14.7	68.6	0.63
chr19	2191307	2191661	CpG: 26	354	26	232	14.7	65.5	0.69
chr19	2195936	2196236	CpG: 30	300	30	208	20.0	69.3	0.84
chr19	2199758	2201907	CpG: 197	2149	197	1528	18.3	71.1	0.73
chr19	2203302	2204159	CpG: 71	857	71	518	16.6	60.4	0.91
chr19	2209246	2210720	CpG: 162	1474	162	1051	22.0	71.3	0.87
chr19	2220385	2220600	CpG: 20	215	20	142	18.6	66.0	0.85
chr19	2224204	2227603	CpG: 346	3399	346	2451	20.4	72.1	0.79
chr19	2230239	2230448	CpG: 20	209	20	134	19.1	64.1	0.95
chr19	2242708	2245009	CpG: 252	2301	252	1652	21.9	71.8	0.87
chr19	2245897	2246101	CpG: 14	204	14	120	13.7	58.8	0.80
chr19	2246346	2246891	CpG: 42	545	42	346	15.4	63.5	0.77
chr19	2247338	2247692	CpG: 35	354	35	243	19.8	68.6	0.84
chr19	2248337	2248571	CpG: 20	234	20	143	17.1	61.1	0.94
chr19	2249356	2250017	CpG: 71	661	71	493	21.5	74.6	0.77
chr19	2250389	2250613	CpG: 18	224	18	140	16.1	62.5	0.85
chr19	2252250	2252493	CpG: 24	243	24	176	19.8	72.4	0.77
chr19	2263539	2265566	CpG: 240	2027	240	1461	23.7	72.1	0.91
chr19	2268526	2268741	CpG: 17	215	17	138	15.8	64.2	0.82
chr19	2276030	2276704	CpG: 56	674	56	455	16.6	67.5	0.73
chr19	2281206	2282084	CpG: 107	878	107	670	24.4	76.3	0.84
chr19	2291455	2291773	CpG: 24	318	24	219	15.1	68.9	0.65
chr19	2295250	2295659	CpG: 30	409	30	286	14.7	69.9	0.60
chr19	2297582	2297797	CpG: 16	215	16	146	14.9	67.9	0.70
chr19	2302038	2303017	CpG: 107	979	107	677	21.9	69.2	0.92
chr19	2308169	2308445	CpG: 22	276	22	191	15.9	69.2	0.67
chr19	2312685	2313915	CpG: 94	1230	94	839	15.3	68.2	0.66
chr19	2317600	2317826	CpG: 18	226	18	162	15.9	71.7	0.72
chr19	2320814	2324149	CpG: 244	3335	244	1744	14.6	52.3	1.64
chr19	2325180	2325689	CpG: 40	509	40	347	15.7	68.2	0.70
chr19	2326643	2327220	CpG: 44	577	44	410	15.3	71.1	0.62
chr19	2327951	2328222	CpG: 23	271	23	186	17.0	68.6	0.73
chr19	2333771	2334422	CpG: 48	651	48	454	14.7	69.7	0.62
chr19	2358196	2358470	CpG: 23	274	23	171	16.8	62.4	0.88
chr19	2365168	2365373	CpG: 14	205	14	121	13.7	59.0	0.80
chr19	2375819	2376055	CpG: 19	236	19	142	16.1	60.2	0.91
chr19	2380894	2381138	CpG: 18	244	18	141	14.8	57.8	0.91
chr19	2383118	2383391	CpG: 23	273	23	184	16.8	67.4	0.75
chr19	2399798	2403776	CpG: 315	3978	315	2701	15.8	67.9	0.69
chr19	2404142	2404524	CpG: 28	382	28	248	14.7	64.9	0.70
chr19	2406074	2406391	CpG: 25	317	25	205	15.8	64.7	0.76
chr19	2408640	2410996	CpG: 163	2356	163	1623	13.8	68.9	0.61
chr19	2412283	2412587	CpG: 38	304	38	242	25.0	79.6	1.07
chr19	2420093	2420315	CpG: 19	222	19	146	17.1	65.8	0.86
chr19	2431656	2432879	CpG: 149	1223	149	917	24.4	75.0	0.88
chr19	2437792	2439114	CpG: 94	1322	94	834	14.2	63.1	0.72
chr19	2450262	2452617	CpG: 204	2355	204	1510	17.3	64.1	0.84
chr19	2452923	2453166	CpG: 21	243	21	166	17.3	68.3	0.74
chr19	2454653	2455046	CpG: 31	393	31	282	15.8	71.8	0.61
chr19	2462782	2463058	CpG: 22	276	22	167	15.9	60.5	0.88
chr19	2464522	2465876	CpG: 119	1354	119	926	17.6	68.4	0.75
chr19	2470306	2471425	CpG: 102	1119	102	747	18.2	66.8	0.82
chr19	2485061	2485286	CpG: 16	225	16	137	14.2	60.9	0.78
chr19	2487596	2487986	CpG: 27	390	27	255	13.8	65.4	0.65
chr19	2489419	2489900	CpG: 35	481	35	306	14.6	63.6	0.72
chr19	2490094	2490340	CpG: 18	246	18	146	14.6	59.3	0.85
chr19	2494131	2494381	CpG: 18	250	18	160	14.4	64.0	0.70
chr19	2500940	2501672	CpG: 46	732	46	465	12.6	63.5	0.62
chr19	2513273	2513487	CpG: 17	214	17	130	15.9	60.7	0.88
chr19	2517155	2517387	CpG: 18	232	18	154	15.5	66.4	0.71
chr19	2519887	2520127	CpG: 18	240	18	161	15.0	67.1	0.67
chr19	2522869	2523232	CpG: 32	363	32	247	17.6	68.0	0.78
chr19	2532009	2532404	CpG: 31	395	31	263	15.7	66.6	0.71
chr19	2551710	2552179	CpG: 38	469	38	305	16.2	65.0	0.78
chr19	2555225	2556015	CpG: 51	790	51	518	12.9	65.6	0.60
chr19	2562027	2562264	CpG: 18	237	18	142	15.2	59.9	0.88
chr19	2564644	2564859	CpG: 18	215	18	131	16.7	60.9	0.91
chr19	2579524	2579747	CpG: 17	223	17	140	15.2	62.8	0.77
chr19	2583997	2584239	CpG: 18	242	18	159	14.9	65.7	0.70
chr19	2587221	2587730	CpG: 38	509	38	344	14.9	67.6	0.66
chr19	2590198	2590399	CpG: 16	201	16	130	15.9	64.7	0.76
chr19	2598787	2599124	CpG: 33	337	33	227	19.6	67.4	0.94
chr19	2600513	2600743	CpG: 16	230	16	137	13.9	59.6	0.81
chr19	2619557	2619903	CpG: 28	346	28	219	16.2	63.3	0.86
chr19	2626957	2627209	CpG: 19	252	19	162	15.1	64.3	0.73
chr19	2660457	2660737	CpG: 20	280	20	166	14.3	59.3	0.81
chr19	2678739	2679194	CpG: 67	455	67	353	29.5	77.6	0.98
chr19	2681244	2681480	CpG: 16	236	16	140	13.6	59.3	0.79
chr19	2692345	2693124	CpG: 69	779	69	514	17.7	66.0	0.82
chr19	2695919	2697072	CpG: 129	1153	129	914	22.4	79.3	0.73
chr19	2698457	2698679	CpG: 18	222	18	157	16.2	70.7	0.65
chr19	2706979	2707255	CpG: 25	276	25	203	18.1	73.6	0.69
chr19	2707944	2708827	CpG: 75	883	75	614	17.0	69.5	0.70
chr19	2715020	2715681	CpG: 67	661	67	454	20.3	68.7	0.87
chr19	2727248	2727482	CpG: 16	234	16	141	13.7	60.3	0.77
chr19	2729833	2730226	CpG: 34	393	34	254	17.3	64.6	0.83
chr19	2730613	2730917	CpG: 23	304	23	197	15.1	64.8	0.73
chr19	2732854	2733144	CpG: 24	290	24	199	16.6	68.6	0.71
chr19	2736953	2737197	CpG: 33	244	33	160	27.0	65.6	1.30
chr19	2748059	2749839	CpG: 152	1780	152	1212	17.1	68.1	0.76
chr19	2758121	2758908	CpG: 76	787	76	529	19.3	67.2	0.86
chr19	2760500	2761251	CpG: 81	751	81	529	21.6	70.4	0.87
chr19	2765665	2766006	CpG: 25	341	25	219	14.7	64.2	0.73
chr19	2774782	2775263	CpG: 36	481	36	315	15.0	65.5	0.71
chr19	2782513	2783675	CpG: 92	1162	92	801	15.8	68.9	0.67
chr19	2785430	2786051	CpG: 49	621	49	434	15.8	69.9	0.65
chr19	2786927	2787157	CpG: 19	230	19	148	16.5	64.3	0.87
chr19	2794018	2794285	CpG: 21	267	21	166	15.7	62.2	0.83
chr19	2794919	2795584	CpG: 85	665	85	503	25.6	75.6	0.90
chr19	2815249	2815552	CpG: 23	303	23	186	15.2	61.4	0.83
chr19	2816155	2817504	CpG: 165	1349	165	1010	24.5	74.9	0.87
chr19	2834182	2834528	CpG: 27	346	27	220	15.6	63.6	0.78
chr19	2864208	2864781	CpG: 43	573	43	356	15.0	62.1	0.78
chr19	2875249	2876428	CpG: 120	1179	120	784	20.4	66.5	0.93
chr19	2876768	2877038	CpG: 21	270	21	164	15.6	60.7	0.85
chr19	2879000	2879231	CpG: 19	231	19	140	16.5	60.6	0.91
chr19	2895268	2895592	CpG: 24	324	24	194	14.8	59.9	0.84
chr19	2900433	2901183	CpG: 60	750	60	515	16.0	68.7	0.74
chr19	2918172	2919078	CpG: 93	906	93	623	20.5	68.8	0.87
chr19	2923851	2924454	CpG: 49	603	49	382	16.3	63.3	0.81
chr19	2924906	2925136	CpG: 18	230	18	138	15.7	60.0	0.88
chr19	2933936	2934171	CpG: 16	235	16	136	13.6	57.9	0.82
chr19	2934351	2934588	CpG: 17	237	17	142	14.3	59.9	0.82
chr19	2950739	2951130	CpG: 39	391	39	275	19.9	70.3	0.82
chr19	2979883	2980213	CpG: 28	330	28	234	17.0	70.9	0.68
chr19	3002083	3003075	CpG: 109	992	109	746	22.0	75.2	0.78
chr19	3009111	3009345	CpG: 18	234	18	152	15.4	65.0	0.74
chr19	3009687	3010089	CpG: 40	402	40	284	19.9	70.6	0.83
chr19	3020661	3020927	CpG: 39	266	39	212	29.3	79.7	0.94
chr19	3034644	3036264	CpG: 192	1620	192	1259	23.7	77.7	0.79
chr19	3042822	3043053	CpG: 18	231	18	150	15.6	64.9	0.74
chr19	3060061	3060297	CpG: 18	236	18	145	15.3	61.4	0.83
chr19	3067147	3068809	CpG: 194	1662	194	1188	23.3	71.5	0.91
chr19	3071318	3071547	CpG: 22	229	22	155	19.2	67.7	0.84
chr19	3083842	3084184	CpG: 32	342	32	235	18.7	68.7	0.79
chr19	3086393	3087374	CpG: 75	981	75	637	15.3	64.9	0.73
chr19	3088498	3088892	CpG: 30	394	30	269	15.2	68.3	0.67
chr19	3091337	3091690	CpG: 26	353	26	246	14.7	69.7	0.61
chr19	3094731	3096454	CpG: 111	1723	111	1065	12.9	61.8	0.68
chr19	3106499	3107231	CpG: 59	732	59	431	16.1	58.9	0.93
chr19	3139169	3139489	CpG: 27	320	27	218	16.9	68.1	0.73
chr19	3153204	3154816	CpG: 116	1612	116	1104	14.4	68.5	0.61
chr19	3160562	3161314	CpG: 88	752	88	562	23.4	74.7	0.85
chr19	3164643	3164865	CpG: 17	222	17	154	15.3	69.4	0.64
chr19	3165456	3166240	CpG: 59	784	59	507	15.1	64.7	0.75
chr19	3167238	3167527	CpG: 33	289	33	209	22.8	72.3	0.87
chr19	3168151	3168401	CpG: 18	250	18	172	14.4	68.8	0.61
chr19	3171044	3171249	CpG: 16	205	16	140	15.6	68.3	0.67
chr19	3173673	3174136	CpG: 36	463	36	314	15.6	67.8	0.68
chr19	3179388	3179778	CpG: 34	390	34	273	17.4	70.0	0.71
chr19	3182788	3183025	CpG: 24	237	24	170	20.3	71.7	0.80
chr19	3193705	3193983	CpG: 24	278	24	164	17.3	59.0	1.03
chr19	3199276	3199888	CpG: 88	612	88	481	28.8	78.6	0.93
chr19	3203474	3203865	CpG: 32	391	32	286	16.4	73.1	0.72
chr19	3213159	3213395	CpG: 17	236	17	140	14.4	59.3	0.83
chr19	3225577	3225814	CpG: 18	237	18	142	15.2	59.9	0.86
chr19	3245847	3246087	CpG: 45	240	45	206	37.5	85.8	1.05
chr19	3250977	3251408	CpG: 40	431	40	315	18.6	73.1	0.73
chr19	3261229	3261508	CpG: 29	279	29	214	20.8	76.7	0.76
chr19	3268639	3268920	CpG: 20	281	20	190	14.2	67.6	0.65
chr19	3283129	3283448	CpG: 27	319	27	196	16.9	61.4	0.90
chr19	3290580	3290881	CpG: 31	301	31	222	20.6	73.8	0.76
chr19	3296290	3296613	CpG: 32	323	32	227	19.8	70.3	0.81
chr19	3303525	3303759	CpG: 17	234	17	142	14.5	60.7	0.81
chr19	3319318	3319583	CpG: 19	265	19	159	14.3	60.0	0.81
chr19	3336631	3339384	CpG: 347	2753	347	2090	25.2	75.9	0.88
chr19	3344574	3345807	CpG: 108	1233	108	890	17.5	72.2	0.67
chr19	3347611	3348047	CpG: 36	436	36	296	16.5	67.9	0.72
chr19	3359656	3360399	CpG: 72	743	72	504	19.4	67.8	0.84
chr19	3366098	3366338	CpG: 23	240	23	182	19.2	75.8	0.67
chr19	3376770	3377077	CpG: 23	307	23	205	15.0	66.8	0.67
chr19	3385284	3385550	CpG: 20	266	20	165	15.0	62.0	0.79
chr19	3413069	3413570	CpG: 61	501	61	341	24.4	68.1	1.05
chr19	3415149	3415385	CpG: 18	236	18	133	15.3	56.4	0.96
chr19	3418014	3418235	CpG: 17	221	17	128	15.4	57.9	0.92
chr19	3430599	3430879	CpG: 22	280	22	189	15.7	67.5	0.76
chr19	3431504	3432097	CpG: 42	593	42	393	14.2	66.3	0.65
chr19	3434323	3434722	CpG: 29	399	29	279	14.5	69.9	0.60
chr19	3441153	3442499	CpG: 110	1346	110	962	16.3	71.5	0.64
chr19	3442905	3443133	CpG: 19	228	19	168	16.7	73.7	0.64
chr19	3459951	3460217	CpG: 20	266	20	174	15.0	65.4	0.70
chr19	3460696	3461598	CpG: 72	902	72	612	16.0	67.8	0.69
chr19	3469224	3470675	CpG: 115	1451	115	1003	15.9	69.1	0.67
chr19	3478589	3479013	CpG: 46	424	46	290	21.7	68.4	0.94
chr19	3483993	3484943	CpG: 113	950	113	692	23.8	72.8	0.90
chr19	3489039	3489296	CpG: 19	257	19	168	14.8	65.4	0.70
chr19	3508425	3508665	CpG: 17	240	17	156	14.2	65.0	1.21
chr19	3509741	3510364	CpG: 47	623	47	430	15.1	69.0	0.63
chr19	3510606	3510839	CpG: 19	233	19	156	16.3	67.0	0.73
chr19	3522981	3523208	CpG: 18	227	18	160	15.9	70.5	0.64
chr19	3524317	3524555	CpG: 20	238	20	163	16.8	68.5	0.73
chr19	3525072	3525443	CpG: 28	371	28	236	15.1	63.6	0.76
chr19	3526101	3526512	CpG: 33	411	33	285	16.1	69.3	0.67
chr19	3531573	3531813	CpG: 18	240	18	136	15.0	56.7	0.95
chr19	3535120	3536451	CpG: 149	1331	149	954	22.4	71.7	0.87
chr19	3537923	3538156	CpG: 17	233	17	140	14.6	60.1	0.82
chr19	3550703	3556472	CpG: 420	5769	420	3802	14.6	65.9	0.67
chr19	3563516	3564106	CpG: 76	590	76	448	25.8	75.9	0.89
chr19	3564901	3565263	CpG: 25	362	25	236	13.8	65.2	0.67
chr19	3573818	3574183	CpG: 32	365	32	260	17.5	71.2	0.70
chr19	3578085	3578737	CpG: 69	652	69	468	21.2	71.8	0.82
chr19	3580976	3581258	CpG: 21	282	21	164	14.9	58.2	0.90
chr19	3584496	3585395	CpG: 74	899	74	660	16.5	73.4	0.61
chr19	3589906	3591783	CpG: 167	1877	167	1278	17.8	68.1	0.77
chr19	3592320	3592721	CpG: 27	401	27	271	13.5	67.6	0.61
chr19	3601947	3602270	CpG: 34	323	34	231	21.1	71.5	0.83
chr19	3604471	3605403	CpG: 91	932	91	644	19.5	69.1	0.82
chr19	3614722	3614956	CpG: 19	234	19	160	16.2	68.4	0.71
chr19	3615437	3615844	CpG: 36	407	36	276	17.7	67.8	0.77
chr19	3627153	3628430	CpG: 117	1277	117	885	18.3	69.3	0.82
chr19	3630193	3630537	CpG: 35	344	35	236	20.3	68.6	0.87
chr19	3631669	3632048	CpG: 27	379	27	245	14.2	64.6	0.69
chr19	3638046	3638783	CpG: 46	737	46	451	12.5	61.2	0.67
chr19	3650306	3650525	CpG: 20	219	20	147	18.3	67.1	0.82
chr19	3654703	3654987	CpG: 22	284	22	177	15.5	62.3	0.82
chr19	3666190	3666666	CpG: 38	476	38	343	16.0	72.1	0.62
chr19	3669642	3669873	CpG: 23	231	23	140	19.9	60.6	1.09
chr19	3672977	3673416	CpG: 32	439	32	289	14.6	65.8	0.71
chr19	3675395	3675895	CpG: 37	500	37	336	14.8	67.2	0.74
chr19	3676241	3676782	CpG: 39	541	39	348	14.4	64.3	0.70
chr19	3678354	3679020	CpG: 104	666	104	539	31.2	80.9	0.96
chr19	3693521	3693787	CpG: 20	266	20	163	15.0	61.3	0.82
chr19	3699358	3699587	CpG: 18	229	18	132	15.7	57.6	0.98
chr19	3699857	3700181	CpG: 28	324	28	228	17.3	70.4	0.71
chr19	3708809	3709166	CpG: 32	357	32	246	17.9	68.9	0.79
chr19	3721021	3721284	CpG: 19	263	19	156	14.4	59.3	0.82
chr19	3727083	3727338	CpG: 28	255	28	178	22.0	69.8	0.91
chr19	3730363	3730822	CpG: 41	459	41	328	17.9	71.5	0.71
chr19	3732998	3733511	CpG: 42	513	42	366	16.4	71.3	0.64
chr19	3740731	3741088	CpG: 38	357	38	251	21.3	70.3	0.88
chr19	3741909	3742363	CpG: 38	454	38	291	16.7	64.1	0.85
chr19	3746424	3746704	CpG: 23	280	23	187	16.4	66.8	0.74
chr19	3749819	3750195	CpG: 35	376	35	285	18.6	75.8	0.66
chr19	3764773	3765916	CpG: 142	1143	142	852	24.8	74.5	0.91
chr19	3780659	3781086	CpG: 39	427	39	286	18.3	67.0	0.83
chr19	3785130	3785443	CpG: 27	313	27	225	17.3	71.9	0.67
chr19	3790049	3790466	CpG: 31	417	31	282	14.9	67.6	0.65
chr19	3795952	3796438	CpG: 40	486	40	316	16.5	65.0	0.78
chr19	3799373	3799578	CpG: 19	205	19	147	18.5	71.7	0.73
chr19	3800333	3800720	CpG: 31	387	31	271	16.0	70.0	0.69
chr19	3801159	3801552	CpG: 42	393	42	256	21.4	65.1	1.01
chr19	3804394	3804790	CpG: 27	396	27	254	13.6	64.1	0.67
chr19	3810637	3811081	CpG: 34	444	34	294	15.3	66.2	0.77
chr19	3813788	3814176	CpG: 28	388	28	250	14.4	64.4	0.70
chr19	3817296	3817497	CpG: 19	201	19	106	18.9	52.7	1.39
chr19	3835203	3835456	CpG: 22	253	22	165	17.4	65.2	0.90
chr19	3847781	3848412	CpG: 72	631	72	476	22.8	75.4	0.82
chr19	3849983	3850638	CpG: 41	655	41	366	12.5	55.9	0.82
chr19	3854542	3854778	CpG: 18	236	18	145	15.3	61.4	0.83
chr19	3859910	3860470	CpG: 41	560	41	366	14.6	65.4	0.69
chr19	3866708	3866970	CpG: 20	262	20	158	15.3	60.3	0.85
chr19	3873396	3873632	CpG: 18	236	18	143	15.3	60.6	0.85
chr19	3886880	3887589	CpG: 59	709	59	470	16.6	66.3	0.76
chr19	3893253	3893489	CpG: 17	236	17	143	14.4	60.6	0.81
chr19	3912766	3913109	CpG: 36	343	36	250	21.0	72.9	0.79
chr19	3916611	3917209	CpG: 41	598	41	432	13.7	72.2	0.70
chr19	3917528	3917789	CpG: 17	261	17	187	13.0	71.6	0.64
chr19	3921249	3921489	CpG: 18	240	18	158	15.0	65.8	0.72
chr19	3937747	3939067	CpG: 122	1320	122	921	18.5	69.8	0.77
chr19	3940237	3940497	CpG: 24	260	24	173	18.5	66.5	0.83
chr19	3943507	3944245	CpG: 52	738	52	475	14.1	64.4	0.71
chr19	3950105	3950736	CpG: 72	631	72	449	22.8	71.2	0.97
chr19	3955645	3956346	CpG: 55	701	55	462	15.7	65.9	0.72
chr19	3961019	3961385	CpG: 29	366	29	236	15.8	64.5	0.76
chr19	3963157	3963918	CpG: 86	761	86	507	22.6	66.6	1.02
chr19	3969279	3969821	CpG: 39	542	39	316	14.4	58.3	0.85
chr19	3976812	3977087	CpG: 23	275	23	172	16.7	62.5	0.86
chr19	3989422	3990428	CpG: 126	1006	126	763	25.0	75.8	0.87
chr19	4015025	4015722	CpG: 55	697	55	481	15.8	69.0	0.66
chr19	4020458	4022001	CpG: 115	1543	115	980	14.9	63.5	0.74
chr19	4028030	4028267	CpG: 17	237	17	152	14.3	64.1	0.76
chr19	4030866	4031540	CpG: 77	674	77	476	22.8	70.6	0.92
chr19	4036589	4038403	CpG: 199	1814	199	1219	21.9	67.2	0.98
chr19	4040327	4040643	CpG: 21	316	21	180	13.3	57.0	0.83
chr19	4043045	4043259	CpG: 19	214	19	157	17.8	73.4	0.69
chr19	4047214	4051108	CpG: 397	3894	397	2944	20.4	75.6	0.72
chr19	4054215	4054487	CpG: 20	272	20	165	14.7	60.7	0.81
chr19	4073361	4073849	CpG: 38	488	38	324	15.6	66.4	0.71
chr19	4083129	4083362	CpG: 17	233	17	140	14.6	60.1	0.84
chr19	4084190	4084676	CpG: 32	486	32	323	13.2	66.5	0.61
chr19	4084932	4085134	CpG: 14	202	14	124	13.9	61.4	0.74
chr19	4091947	4092356	CpG: 29	409	29	253	14.2	61.9	0.75
chr19	4106851	4107650	CpG: 101	799	101	614	25.3	76.8	0.86
chr19	4146339	4146613	CpG: 21	274	21	168	15.3	61.3	0.82
chr19	4156463	4156793	CpG: 35	330	35	236	21.2	71.5	0.85
chr19	4165565	4166109	CpG: 53	544	53	368	19.5	67.6	0.86
chr19	4181197	4181985	CpG: 81	788	81	565	20.6	71.7	0.80
chr19	4200673	4201376	CpG: 81	703	81	548	23.0	78.0	0.80
chr19	4230135	4230529	CpG: 27	394	27	204	13.7	51.8	1.03
chr19	4241427	4241929	CpG: 38	502	38	344	15.1	68.5	0.65
chr19	4262321	4263513	CpG: 120	1192	120	859	20.1	72.1	0.77
chr19	4266856	4267151	CpG: 20	295	20	179	13.6	60.7	0.75
chr19	4287825	4288405	CpG: 59	580	59	439	20.3	75.7	0.72
chr19	4306379	4306606	CpG: 23	227	23	154	20.3	67.8	0.88
chr19	4310282	4310784	CpG: 43	502	43	331	17.1	65.9	0.79
chr19	4311862	4312204	CpG: 37	342	37	246	21.6	71.9	0.89
chr19	4314990	4315264	CpG: 21	274	21	167	15.3	60.9	0.83
chr19	4326726	4327487	CpG: 97	761	97	573	25.5	75.3	0.90
chr19	4344922	4345294	CpG: 32	372	32	262	17.2	70.4	0.70
chr19	4353380	4353583	CpG: 21	203	21	147	20.7	72.4	0.79
chr19	4355179	4355402	CpG: 16	223	16	152	14.3	68.2	0.62
chr19	4365745	4365995	CpG: 21	250	21	155	16.8	62.0	0.89
chr19	4383544	4384209	CpG: 90	665	90	505	27.1	75.9	0.97
chr19	4385926	4386704	CpG: 93	778	93	556	23.9	71.5	0.96
chr19	4429471	4430089	CpG: 55	618	55	434	17.8	70.2	0.73
chr19	4440707	4441483	CpG: 74	776	74	532	19.1	68.6	0.87
chr19	4442027	4442301	CpG: 20	274	20	164	14.6	59.9	0.82
chr19	4455571	4456574	CpG: 89	1003	89	744	17.7	74.2	0.65
chr19	4466481	4467096	CpG: 44	615	44	386	14.3	62.8	0.74
chr19	4477031	4477955	CpG: 84	924	84	664	18.2	71.9	0.71
chr19	4492299	4492720	CpG: 31	421	31	262	14.7	62.2	0.77
chr19	4507360	4507688	CpG: 36	328	36	247	22.0	75.3	0.78
chr19	4515276	4515504	CpG: 19	228	19	161	16.7	70.6	0.67
chr19	4518591	4518994	CpG: 37	403	37	292	18.4	72.5	0.72
chr19	4526594	4528234	CpG: 163	1640	163	1210	19.9	73.8	0.73
chr19	4536116	4536346	CpG: 22	230	22	152	19.1	66.1	0.88
chr19	4539608	4539815	CpG: 19	207	19	133	18.4	64.3	0.96
chr19	4542035	4542251	CpG: 24	216	24	160	22.2	74.1	0.85
chr19	4550129	4550350	CpG: 21	221	21	157	19.0	71.0	0.76
chr19	4550676	4550905	CpG: 19	229	19	149	16.6	65.1	0.86
chr19	4556026	4556263	CpG: 22	237	22	148	18.6	62.4	0.97
chr19	4564148	4565586	CpG: 145	1438	145	1078	20.2	75.0	0.74
chr19	4567862	4568768	CpG: 79	906	79	649	17.4	71.6	0.68
chr19	4590731	4591002	CpG: 23	271	23	185	17.0	68.3	0.73
chr19	4620351	4620711	CpG: 40	360	40	262	22.2	72.8	0.84
chr19	4623362	4623894	CpG: 62	532	62	400	23.3	75.2	0.85
chr19	4630873	4631082	CpG: 17	209	17	128	16.3	61.2	0.88
chr19	4636249	4636646	CpG: 46	397	46	291	23.2	73.3	0.87
chr19	4654073	4654750	CpG: 85	677	85	506	25.1	74.7	0.91
chr19	4660577	4660879	CpG: 24	302	24	207	15.9	68.5	0.69
chr19	4666887	4667591	CpG: 62	704	62	511	17.6	72.6	0.67
chr19	4672869	4673161	CpG: 26	292	26	198	17.8	67.8	0.78
chr19	4707817	4708286	CpG: 61	469	61	352	26.0	75.1	0.96
chr19	4710840	4711225	CpG: 27	385	27	218	14.0	56.6	0.88
chr19	4716451	4716897	CpG: 34	446	34	270	15.2	60.5	0.84
chr19	4740190	4740413	CpG: 18	223	18	138	16.1	61.9	0.86
chr19	4745370	4745622	CpG: 29	252	29	170	23.0	67.5	1.01
chr19	4770230	4770506	CpG: 24	276	24	169	17.4	61.2	0.94
chr19	4770811	4771051	CpG: 23	240	23	168	19.2	70.0	0.80
chr19	4775162	4775440	CpG: 23	278	23	170	16.5	61.2	0.90
chr19	4776644	4778667	CpG: 181	2023	181	1319	17.9	65.2	0.84
chr19	4783417	4783690	CpG: 19	273	19	166	13.9	60.8	0.76
chr19	4797753	4798027	CpG: 22	274	22	169	16.1	61.7	0.85
chr19	4816898	4817357	CpG: 46	459	46	342	20.0	74.5	0.73
chr19	4837409	4837733	CpG: 29	324	29	221	17.9	68.2	0.77
chr19	4851232	4851469	CpG: 18	237	18	145	15.2	61.2	0.84
chr19	4853079	4853457	CpG: 33	378	33	266	17.5	70.4	0.71
chr19	4876397	4876631	CpG: 18	234	18	146	15.4	62.4	0.80
chr19	4879450	4879724	CpG: 21	274	21	168	15.3	61.3	0.82
chr19	4894482	4895701	CpG: 164	1219	164	918	26.9	75.3	0.96
chr19	4901596	4902004	CpG: 31	408	31	262	15.2	64.2	0.75
chr19	4915957	4916170	CpG: 21	213	21	140	19.7	65.7	0.94
chr19	4917880	4918304	CpG: 36	424	36	283	17.0	66.7	0.76
chr19	4926735	4927195	CpG: 38	460	38	304	16.5	66.1	0.76
chr19	4929346	4929712	CpG: 27	366	27	244	14.8	66.7	0.67
chr19	4935883	4936153	CpG: 20	270	20	174	14.8	64.4	0.74
chr19	4939666	4940093	CpG: 36	427	36	287	16.9	67.2	0.76
chr19	4953941	4955013	CpG: 145	1072	145	823	27.1	76.8	0.92
chr19	4971526	4971749	CpG: 16	223	16	146	14.3	65.5	0.68
chr19	5017810	5018448	CpG: 48	638	48	394	15.0	61.8	0.80
chr19	5022320	5022581	CpG: 19	261	19	148	14.6	56.7	0.93
chr19	5025217	5025423	CpG: 22	206	22	137	21.4	66.5	0.97
chr19	5028478	5028840	CpG: 25	362	25	207	13.8	57.2	0.87
chr19	5029019	5029858	CpG: 62	839	62	488	14.8	58.2	0.91
chr19	5046351	5046609	CpG: 18	258	18	169	14.0	65.5	0.65
chr19	5051006	5051286	CpG: 22	280	22	196	15.7	70.0	0.64
chr19	5061398	5062674	CpG: 96	1276	96	769	15.0	60.3	0.83
chr19	5066179	5066435	CpG: 19	256	19	160	14.8	62.5	0.77
chr19	5079197	5079419	CpG: 17	222	17	131	15.3	59.0	0.88
chr19	5082318	5082616	CpG: 36	298	36	215	24.2	72.1	0.97
chr19	5096347	5096613	CpG: 25	266	25	181	18.8	68.0	0.81
chr19	5104982	5105207	CpG: 20	225	20	142	17.8	63.1	0.95
chr19	5120265	5120501	CpG: 19	236	19	164	16.1	69.5	0.67
chr19	5121618	5121878	CpG: 20	260	20	173	15.4	66.5	0.74
chr19	5127596	5127936	CpG: 27	340	27	199	15.9	58.5	0.93
chr19	5128475	5128725	CpG: 19	250	19	170	15.2	68.0	0.66
chr19	5130373	5130731	CpG: 31	358	31	242	17.3	67.6	0.80
chr19	5132375	5132856	CpG: 40	481	40	320	16.6	66.5	0.80
chr19	5134419	5134741	CpG: 25	322	25	221	15.5	68.6	0.66
chr19	5135117	5135358	CpG: 19	241	19	168	15.8	69.7	0.65
chr19	5137897	5138295	CpG: 39	398	39	296	19.6	74.4	0.71
chr19	5197147	5197447	CpG: 23	300	23	201	15.3	67.0	0.68
chr19	5198730	5199067	CpG: 29	337	29	219	17.2	65.0	0.83
chr19	5209095	5209934	CpG: 85	839	85	609	20.3	72.6	0.77
chr19	5215858	5216424	CpG: 67	566	67	420	23.7	74.2	0.87
chr19	5217846	5218188	CpG: 33	342	33	234	19.3	68.4	0.83
chr19	5221597	5221833	CpG: 19	236	19	142	16.1	60.2	0.90
chr19	5223881	5224256	CpG: 30	375	30	251	16.0	66.9	0.73
chr19	5225354	5225647	CpG: 32	293	32	212	21.8	72.4	0.84
chr19	5227154	5227394	CpG: 20	240	20	145	16.7	60.4	0.93
chr19	5230456	5230980	CpG: 52	524	52	349	19.8	66.6	0.90
chr19	5232472	5232682	CpG: 20	210	20	146	19.0	69.5	0.80
chr19	5237045	5237256	CpG: 16	211	16	148	15.2	70.1	0.62
chr19	5276958	5277160	CpG: 17	202	17	139	16.8	68.8	0.72
chr19	5279326	5280891	CpG: 124	1565	124	1124	15.8	71.8	0.63
chr19	5308960	5309217	CpG: 23	257	23	171	17.9	66.5	0.82
chr19	5321646	5321931	CpG: 22	285	22	180	15.4	63.2	0.80
chr19	5325390	5325732	CpG: 24	342	24	230	14.0	67.3	0.62
chr19	5326242	5327750	CpG: 177	1508	177	1149	23.5	76.2	0.81
chr19	5351873	5352147	CpG: 20	274	20	167	14.6	60.9	0.81
chr19	5442120	5442901	CpG: 74	781	74	527	19.0	67.5	0.84
chr19	5464963	5465241	CpG: 20	278	20	174	14.4	62.6	0.74
chr19	5493919	5494190	CpG: 24	271	24	152	17.7	56.1	1.13
chr19	5523199	5523457	CpG: 29	258	29	187	22.5	72.5	0.86
chr19	5554189	5554892	CpG: 94	703	94	548	26.7	78.0	0.89
chr19	5564014	5564230	CpG: 19	216	19	130	17.6	60.2	0.98
chr19	5574354	5574608	CpG: 19	254	19	177	15.0	69.7	0.65
chr19	5580378	5580863	CpG: 54	485	54	334	22.3	68.9	0.96
chr19	5608919	5610473	CpG: 180	1554	180	1068	23.2	68.7	0.98
chr19	5620187	5620457	CpG: 19	270	19	164	14.1	60.7	0.77
chr19	5645288	5645569	CpG: 20	281	20	170	14.2	60.5	0.80
chr19	5648208	5648536	CpG: 42	328	42	225	25.6	68.6	1.12
chr19	5666784	5668106	CpG: 121	1322	121	887	18.3	67.1	0.82
chr19	5673480	5674637	CpG: 121	1157	121	843	20.9	72.9	0.79
chr19	5676524	5678892	CpG: 175	2368	175	1485	14.8	62.7	0.76
chr19	5681061	5681527	CpG: 38	466	38	306	16.3	65.7	0.78
chr19	5685738	5685962	CpG: 18	224	18	145	16.1	64.7	0.78
chr19	5688144	5689111	CpG: 76	967	76	696	15.7	72.0	0.61
chr19	5690879	5691143	CpG: 21	264	21	177	15.9	67.0	0.72
chr19	5693995	5694204	CpG: 16	209	16	128	15.3	61.2	0.82
chr19	5698381	5698658	CpG: 23	277	23	187	16.6	67.5	0.74
chr19	5702059	5702265	CpG: 15	206	15	124	14.6	60.2	0.81
chr19	5706286	5707970	CpG: 161	1684	161	1088	19.1	64.6	0.92
chr19	5709581	5709846	CpG: 21	265	21	163	15.8	61.5	0.87
chr19	5718272	5718553	CpG: 24	281	24	174	17.1	61.9	0.91
chr19	5759052	5759324	CpG: 22	272	22	163	16.2	59.9	0.91
chr19	5772185	5772605	CpG: 39	420	39	290	18.6	69.0	0.78
chr19	5776615	5778708	CpG: 142	2093	142	1306	13.6	62.4	0.70
chr19	5786756	5787009	CpG: 20	253	20	181	15.8	71.5	0.64
chr19	5789701	5790036	CpG: 26	335	26	225	15.5	67.2	0.69
chr19	5790345	5790640	CpG: 23	295	23	179	15.6	60.7	0.91
chr19	5791201	5793492	CpG: 211	2291	211	1638	18.4	71.5	0.73
chr19	5809764	5810012	CpG: 23	248	23	167	18.5	67.3	0.82
chr19	5811583	5811814	CpG: 20	231	20	163	17.3	70.6	0.70
chr19	5815234	5815885	CpG: 105	651	105	488	32.3	75.0	1.15
chr19	5816502	5816928	CpG: 36	426	36	293	16.9	68.8	0.72
chr19	5819050	5819752	CpG: 47	702	47	452	13.4	64.4	0.65
chr19	5831295	5831804	CpG: 37	509	37	334	14.5	65.6	0.68
chr19	5854126	5854888	CpG: 51	762	51	494	13.4	64.8	0.64
chr19	5890901	5892635	CpG: 143	1734	143	1113	16.5	64.2	0.81
chr19	5902436	5902730	CpG: 26	294	26	200	17.7	68.0	0.77
chr19	5964878	5966293	CpG: 148	1415	148	993	20.9	70.2	0.85
chr19	5970148	5970426	CpG: 23	278	23	173	16.5	62.2	0.86
chr19	5982295	5982537	CpG: 19	242	19	166	15.7	68.6	0.68
chr19	5983743	5983991	CpG: 31	248	31	173	25.0	69.8	1.04
chr19	5984565	5984969	CpG: 31	404	31	276	15.3	68.3	0.66
chr19	5990225	5990472	CpG: 24	247	24	168	19.4	68.0	0.87
chr19	5995363	5995759	CpG: 30	396	30	269	15.2	67.9	0.67
chr19	6012270	6012524	CpG: 27	254	27	167	21.3	65.7	1.37
chr19	6027364	6027767	CpG: 28	403	28	274	13.9	68.0	0.60
chr19	6097558	6097810	CpG: 22	252	22	160	17.5	63.5	0.95
chr19	6098803	6099617	CpG: 110	814	110	593	27.0	72.9	1.02
chr19	6099799	6100077	CpG: 20	278	20	169	14.4	60.8	0.79
chr19	6103560	6103794	CpG: 18	234	18	143	15.4	61.1	0.85
chr19	6187466	6188018	CpG: 62	552	62	379	22.5	68.7	1.04
chr19	6199935	6201299	CpG: 93	1364	93	910	13.6	66.7	0.62
chr19	6203186	6203737	CpG: 41	551	41	375	14.9	68.1	0.65
chr19	6218629	6218837	CpG: 19	208	19	146	18.3	70.2	0.75
chr19	6260144	6260388	CpG: 22	244	22	163	18.0	66.8	0.86
chr19	6267668	6268543	CpG: 135	875	135	709	30.9	81.0	0.95
chr19	6307208	6307638	CpG: 30	430	30	238	14.0	55.3	0.91
chr19	6322320	6322571	CpG: 18	251	18	160	14.3	63.7	0.71
chr19	6350332	6350905	CpG: 68	573	68	413	23.7	72.1	0.91
chr19	6359128	6359424	CpG: 23	296	23	181	15.5	61.1	0.85
chr19	6361613	6362522	CpG: 91	909	91	652	20.0	71.7	0.86
chr19	6381766	6382772	CpG: 88	1006	88	645	17.5	64.1	0.85
chr19	6403248	6404602	CpG: 88	1354	88	890	13.0	65.7	0.60
chr19	6413070	6414041	CpG: 129	971	129	737	26.6	75.9	0.92
chr19	6414357	6414715	CpG: 28	358	28	228	15.6	63.7	0.77
chr19	6448725	6450141	CpG: 123	1416	123	970	17.4	68.5	0.74
chr19	6450489	6450722	CpG: 18	233	18	135	15.5	57.9	0.94
chr19	6453467	6454256	CpG: 68	789	68	545	17.2	69.1	0.73
chr19	6464659	6465471	CpG: 65	812	65	547	16.0	67.4	0.71
chr19	6466155	6466600	CpG: 37	445	37	307	16.6	69.0	0.70
chr19	6467229	6467554	CpG: 23	325	23	180	14.2	55.4	0.92
chr19	6467803	6468004	CpG: 17	201	17	112	16.9	55.7	1.10
chr19	6484679	6485712	CpG: 85	1033	85	661	16.5	64.0	0.80
chr19	6487282	6487533	CpG: 18	251	18	146	14.3	58.2	0.86
chr19	6491576	6491897	CpG: 46	321	46	251	28.7	78.2	0.94
chr19	6505916	6506496	CpG: 48	580	48	377	16.6	65.0	0.78
chr19	6520309	6521035	CpG: 77	726	77	510	21.2	70.2	0.86
chr19	6524325	6524645	CpG: 28	320	28	220	17.5	68.8	0.75
chr19	6579986	6580718	CpG: 56	732	56	470	15.3	64.2	0.77
chr19	6581596	6581862	CpG: 19	266	19	163	14.3	61.3	0.78
chr19	6595574	6595803	CpG: 17	229	17	138	14.8	60.3	0.83
chr19	6649510	6649718	CpG: 22	208	22	152	21.2	73.1	0.79
chr19	6677553	6677871	CpG: 25	318	25	193	15.7	60.7	0.87
chr19	6696507	6696962	CpG: 39	455	39	317	17.1	69.7	0.71
chr19	6700020	6700223	CpG: 17	203	17	138	16.7	68.0	0.73
chr19	6726619	6727160	CpG: 60	541	60	387	22.2	71.5	0.88
chr19	6728879	6729538	CpG: 63	659	63	468	19.1	71.0	0.77
chr19	6730049	6730583	CpG: 45	534	45	368	16.9	68.9	0.71
chr19	6735309	6735676	CpG: 29	367	29	255	15.8	69.5	0.70
chr19	6741899	6743041	CpG: 82	1142	82	775	14.4	67.9	0.63
chr19	6757330	6757545	CpG: 18	215	18	138	16.7	64.2	0.82
chr19	6811618	6811955	CpG: 29	337	29	235	17.2	69.7	0.71
chr19	6854277	6854491	CpG: 15	214	15	125	14.0	58.4	0.83
chr19	6980500	6980736	CpG: 19	236	19	145	16.1	61.4	0.88
chr19	6988641	6988916	CpG: 22	275	22	171	16.0	62.2	0.84
chr19	7060107	7060741	CpG: 53	634	53	428	16.7	67.5	0.74
chr19	7065510	7065856	CpG: 25	346	25	246	14.5	71.1	0.65
chr19	7089623	7090444	CpG: 81	821	81	563	19.7	68.6	0.98
chr19	7133998	7134200	CpG: 17	202	17	124	16.8	61.4	0.89
chr19	7189253	7189601	CpG: 28	348	28	211	16.1	60.6	0.90
chr19	7190159	7190701	CpG: 60	542	60	394	22.1	72.7	0.85
chr19	7193872	7194103	CpG: 18	231	18	137	15.6	59.3	0.91
chr19	7259565	7259869	CpG: 23	304	23	163	15.1	53.6	1.05
chr19	7285523	7287291	CpG: 194	1768	194	1252	21.9	70.8	0.88
chr19	7387403	7388000	CpG: 65	597	65	442	21.8	74.0	0.79
chr19	7432550	7432813	CpG: 31	263	31	178	23.6	67.7	1.03
chr19	7464392	7464598	CpG: 17	206	17	144	16.5	69.9	0.69
chr19	7467591	7468450	CpG: 90	859	90	604	21.0	70.3	0.85
chr19	7477885	7478136	CpG: 22	251	22	181	17.5	72.1	0.68
chr19	7489180	7489401	CpG: 15	221	15	129	13.6	58.4	0.81
chr19	7489480	7489814	CpG: 41	334	41	242	24.6	72.5	0.95
chr19	7501521	7502130	CpG: 93	609	93	454	30.5	74.5	1.12
chr19	7516664	7517255	CpG: 84	591	84	490	28.4	82.9	0.87
chr19	7520175	7521239	CpG: 107	1064	107	749	20.1	70.4	0.83
chr19	7523121	7523675	CpG: 63	554	63	391	22.7	70.6	0.92
chr19	7534261	7536856	CpG: 187	2595	187	1653	14.4	63.7	0.71
chr19	7549548	7549769	CpG: 17	221	17	132	15.4	59.7	0.87
chr19	7550631	7552103	CpG: 106	1472	106	973	14.4	66.1	0.66
chr19	7555334	7556478	CpG: 91	1144	91	789	15.9	69.0	0.68
chr19	7557479	7558102	CpG: 57	623	57	418	18.3	67.1	0.82
chr19	7596323	7597416	CpG: 147	1093	147	856	26.9	78.3	0.88
chr19	7610723	7610936	CpG: 18	213	18	129	16.9	60.6	0.92
chr19	7612616	7614017	CpG: 112	1401	112	982	16.0	70.1	0.66
chr19	7616083	7616591	CpG: 50	508	50	372	19.7	73.2	0.74
chr19	7618676	7618985	CpG: 27	309	27	208	17.5	67.3	0.78
chr19	7621149	7622179	CpG: 71	1030	71	681	13.8	66.1	0.63
chr19	7626706	7627102	CpG: 29	396	29	261	14.6	65.9	0.68
chr19	7630092	7630594	CpG: 42	502	42	297	16.7	59.2	0.98
chr19	7637658	7638333	CpG: 65	675	65	481	19.3	71.3	0.78
chr19	7648034	7648352	CpG: 26	318	26	226	16.4	71.1	0.65
chr19	7670984	7671441	CpG: 42	457	42	315	18.4	68.9	0.77
chr19	7681489	7683713	CpG: 197	2224	197	1515	17.7	68.1	0.77
chr19	7730935	7732552	CpG: 145	1617	145	1130	17.9	69.9	0.74
chr19	7787202	7787476	CpG: 20	274	20	166	14.6	60.6	0.81
chr19	7789054	7790864	CpG: 143	1810	143	1242	15.8	68.6	0.67
chr19	7798993	7799259	CpG: 20	266	20	162	15.0	60.9	0.84
chr19	7801562	7801839	CpG: 22	277	22	165	15.9	59.6	0.91
chr19	7806342	7806566	CpG: 16	224	16	133	14.3	59.4	0.84
chr19	7830784	7831528	CpG: 84	744	84	529	22.6	71.1	0.89
chr19	7848702	7848968	CpG: 20	266	20	183	15.0	68.8	0.65
chr19	7849824	7850041	CpG: 20	217	20	147	18.4	67.7	0.82
chr19	7862662	7864823	CpG: 225	2161	225	1582	20.8	73.2	0.78
chr19	7869333	7870968	CpG: 152	1635	152	1167	18.6	71.4	0.73
chr19	7873119	7873685	CpG: 47	566	47	408	16.6	72.1	0.69
chr19	7874403	7875850	CpG: 137	1447	137	1040	18.9	71.9	0.74
chr19	7889349	7889777	CpG: 44	428	44	323	20.6	75.5	0.73
chr19	7900508	7900773	CpG: 24	265	24	163	18.1	61.5	0.96
chr19	7904395	7905491	CpG: 135	1096	135	783	24.6	71.4	0.97
chr19	7913541	7913787	CpG: 24	246	24	176	19.5	71.5	0.79
chr19	7917040	7927268	CpG: 705	10228	705	6761	13.8	66.1	0.63
chr19	7927961	7928248	CpG: 21	287	21	195	14.6	67.9	0.63
chr19	7933603	7933858	CpG: 20	255	20	164	15.7	64.3	0.76
chr19	7934858	7935479	CpG: 43	621	43	415	13.8	66.8	0.62
chr19	7944116	7945031	CpG: 77	915	77	570	16.8	62.3	0.87
chr19	7964619	7964924	CpG: 23	305	23	197	15.1	64.6	0.72
chr19	8004407	8004641	CpG: 20	234	20	142	17.1	60.7	0.95
chr19	8006035	8007133	CpG: 166	1098	166	845	30.2	77.0	1.02
chr19	8051389	8051663	CpG: 29	274	29	200	21.2	73.0	0.79
chr19	8100348	8100588	CpG: 17	240	17	143	14.2	59.6	0.82
chr19	8137258	8137540	CpG: 22	282	22	190	15.6	67.4	0.69
chr19	8142016	8142343	CpG: 27	327	27	188	16.5	57.5	1.01
chr19	8150162	8150918	CpG: 92	756	92	583	24.3	77.1	0.82
chr19	8170026	8170260	CpG: 20	234	20	140	17.1	59.8	0.99
chr19	8173247	8173521	CpG: 21	274	21	168	15.3	61.3	0.82
chr19	8210080	8211380	CpG: 140	1300	140	978	21.5	75.2	0.76
chr19	8255438	8255676	CpG: 18	238	18	146	15.1	61.3	0.82
chr19	8281902	8282107	CpG: 22	205	22	153	21.5	74.6	0.78
chr19	8294235	8294940	CpG: 69	705	69	481	19.6	68.2	0.84
chr19	8307717	8308607	CpG: 78	890	78	572	17.5	64.3	0.85
chr19	8319543	8322312	CpG: 284	2769	284	1980	20.5	71.5	0.80
chr19	8329248	8329912	CpG: 60	664	60	473	18.1	71.2	0.71
chr19	8340372	8340653	CpG: 22	281	22	172	15.7	61.2	0.85
chr19	8350077	8351076	CpG: 88	999	88	659	17.6	66.0	0.82
chr19	8362234	8362555	CpG: 29	321	29	234	18.1	72.9	0.68
chr19	8376415	8377429	CpG: 95	1014	95	680	18.7	67.1	0.85
chr19	8386211	8386585	CpG: 34	374	34	250	18.2	66.8	0.82
chr19	8388559	8388763	CpG: 17	204	17	132	16.7	64.7	0.80
chr19	8389901	8390541	CpG: 54	640	54	447	16.9	69.8	0.70
chr19	8396247	8396520	CpG: 22	273	22	168	16.1	61.5	0.86
chr19	8396731	8397004	CpG: 21	273	21	167	15.4	61.2	0.83
chr19	8399078	8400101	CpG: 103	1023	103	693	20.1	67.7	0.88
chr19	8406008	8406219	CpG: 18	211	18	129	17.1	61.1	0.93
chr19	8410732	8410972	CpG: 19	240	19	147	15.8	61.2	0.86
chr19	8418613	8418853	CpG: 18	240	18	157	15.0	65.4	0.70
chr19	8432674	8433805	CpG: 137	1131	137	808	24.2	71.4	0.95
chr19	8473238	8473914	CpG: 61	676	61	472	18.0	69.8	0.76
chr19	8477696	8477949	CpG: 18	253	18	169	14.2	66.8	0.64
chr19	8478134	8478348	CpG: 21	214	21	140	19.6	65.4	0.92
chr19	8486140	8486924	CpG: 58	784	58	524	14.8	66.8	0.69
chr19	8493334	8493913	CpG: 54	579	54	405	18.7	69.9	0.76
chr19	8498265	8499525	CpG: 118	1260	118	888	18.7	70.5	0.76
chr19	8501361	8501919	CpG: 62	558	62	393	22.2	70.4	0.90
chr19	8509625	8509903	CpG: 21	278	21	169	15.1	60.8	0.83
chr19	8513991	8514539	CpG: 54	548	54	380	19.7	69.3	0.82
chr19	8517783	8518168	CpG: 32	385	32	247	16.6	64.2	0.82
chr19	8523882	8524129	CpG: 21	247	21	169	17.0	68.4	0.76
chr19	8543092	8543296	CpG: 16	204	16	131	15.7	64.2	0.78
chr19	8572255	8572992	CpG: 75	737	75	541	20.4	73.4	0.76
chr19	8576621	8576981	CpG: 31	360	31	249	17.2	69.2	0.75
chr19	8579257	8580386	CpG: 79	1129	79	759	14.0	67.2	0.63
chr19	8583549	8583756	CpG: 16	207	16	136	15.5	65.7	0.73
chr19	8592420	8592671	CpG: 21	251	21	179	16.7	71.3	0.68
chr19	8596797	8597229	CpG: 35	432	35	306	16.2	70.8	0.65
chr19	8597798	8598339	CpG: 73	541	73	412	27.0	76.2	0.93
chr19	8693061	8694042	CpG: 79	981	79	651	16.1	66.4	0.73
chr19	8942940	8943401	CpG: 63	461	63	347	27.3	75.3	0.97
chr19	9051487	9051762	CpG: 20	275	20	165	14.5	60.0	0.82
chr19	9219733	9219977	CpG: 19	244	19	144	15.6	59.0	0.95
chr19	9247841	9248133	CpG: 25	292	25	179	17.1	61.3	0.92
chr19	9264448	9264668	CpG: 17	220	17	133	15.5	60.5	0.88
chr19	9266461	9266955	CpG: 40	494	40	296	16.2	59.9	0.91
chr19	9286424	9287436	CpG: 69	1012	69	560	13.6	55.3	0.89
chr19	9308733	9309011	CpG: 21	278	21	171	15.1	61.5	0.81
chr19	9309872	9310109	CpG: 20	237	20	149	16.9	62.9	0.87
chr19	9347605	9347838	CpG: 20	233	20	140	17.2	60.1	0.97
chr19	9353970	9354244	CpG: 22	274	22	169	16.1	61.7	0.85
chr19	9380884	9381170	CpG: 21	286	21	175	14.7	61.2	0.81
chr19	9385718	9386106	CpG: 38	388	38	288	19.6	74.2	0.71
chr19	9409643	9410036	CpG: 40	393	40	295	20.4	75.1	0.73
chr19	9435422	9436112	CpG: 60	690	60	442	17.4	64.1	0.85
chr19	9450319	9450767	CpG: 42	448	42	299	18.8	66.7	0.84
chr19	9489126	9489538	CpG: 31	412	31	276	15.0	67.0	0.67
chr19	9533044	9533562	CpG: 41	518	41	335	15.8	64.7	0.77
chr19	9561292	9561813	CpG: 50	521	50	313	19.2	60.1	1.06
chr19	9624330	9624869	CpG: 39	539	39	310	14.5	57.5	0.88
chr19	9651168	9651438	CpG: 23	270	23	167	17.0	61.9	0.90
chr19	9664445	9664921	CpG: 39	476	39	281	16.4	59.0	0.95
chr19	9710418	9710930	CpG: 43	512	43	333	16.8	65.0	0.80
chr19	9747206	9747825	CpG: 44	619	44	389	14.2	62.8	0.74
chr19	9800992	9801318	CpG: 25	326	25	205	15.3	62.9	0.78
chr19	9861824	9862081	CpG: 22	257	22	152	17.1	59.1	1.01
chr19	9881664	9881938	CpG: 23	274	23	169	16.8	61.7	0.89
chr19	9894614	9895198	CpG: 54	584	54	382	18.5	65.4	0.87
chr19	9911656	9912459	CpG: 69	803	69	554	17.2	69.0	0.77
chr19	9917817	9919455	CpG: 142	1638	142	1130	17.3	69.0	0.88
chr19	9944544	9945962	CpG: 137	1418	137	987	19.3	69.6	0.84
chr19	9953813	9954303	CpG: 44	490	44	327	18.0	66.7	0.81
chr19	9960993	9961877	CpG: 91	884	91	633	20.6	71.6	0.82
chr19	9980434	9980923	CpG: 38	489	38	301	15.5	61.6	0.83
chr19	10039334	10041101	CpG: 190	1767	190	1272	21.5	72.0	0.83
chr19	10062320	10062974	CpG: 78	654	78	509	23.9	77.8	0.80
chr19	10092545	10092958	CpG: 36	413	36	291	17.4	70.5	0.70
chr19	10135492	10135797	CpG: 26	305	26	221	17.0	72.5	0.66
chr19	10136264	10136745	CpG: 50	481	50	350	20.8	72.8	0.82
chr19	10153907	10154132	CpG: 23	225	23	162	20.4	72.0	0.79
chr19	10188254	10188456	CpG: 15	202	15	136	14.9	67.3	0.66
chr19	10212240	10213401	CpG: 113	1161	113	820	19.5	70.6	0.79
chr19	10222166	10223092	CpG: 121	926	121	674	26.1	72.8	0.99
chr19	10232345	10232873	CpG: 62	528	62	370	23.5	70.1	0.96
chr19	10236334	10236680	CpG: 26	346	26	237	15.0	68.5	0.65
chr19	10239975	10240671	CpG: 53	696	53	479	15.2	68.8	0.65
chr19	10241697	10242232	CpG: 41	535	41	358	15.3	66.9	0.69
chr19	10245693	10246588	CpG: 73	895	73	563	16.3	62.9	0.83
chr19	10268253	10268465	CpG: 15	212	15	137	14.2	64.6	0.68
chr19	10320453	10321352	CpG: 89	899	89	626	19.8	69.6	0.82
chr19	10350077	10350970	CpG: 63	893	63	563	14.1	63.0	0.72
chr19	10356227	10357705	CpG: 149	1478	149	1051	20.2	71.1	0.80
chr19	10376717	10376988	CpG: 20	271	20	162	14.8	59.8	0.83
chr19	10377500	10377738	CpG: 18	238	18	144	15.1	60.5	0.84
chr19	10378205	10378818	CpG: 68	613	68	429	22.2	70.0	0.91
chr19	10395720	10397398	CpG: 138	1678	138	1086	16.4	64.7	0.79
chr19	10413039	10414139	CpG: 80	1100	80	711	14.5	64.6	0.70
chr19	10415280	10422778	CpG: 545	7498	545	4844	14.5	64.6	0.70
chr19	10423130	10423591	CpG: 34	461	34	251	14.8	54.4	1.01
chr19	10435544	10435879	CpG: 23	335	23	227	13.7	67.8	0.61
chr19	10441815	10442157	CpG: 36	342	36	245	21.1	71.6	0.84
chr19	10449458	10449682	CpG: 18	224	18	161	16.1	71.9	0.63
chr19	10457180	10457462	CpG: 22	282	22	172	15.6	61.0	0.85
chr19	10459124	10461458	CpG: 185	2334	185	1482	15.9	63.5	0.80
chr19	10478082	10478448	CpG: 25	366	25	212	13.7	57.9	0.85
chr19	10479074	10480375	CpG: 89	1301	89	865	13.7	66.5	0.62
chr19	10506759	10507461	CpG: 57	702	57	454	16.2	64.7	0.78
chr19	10522026	10522805	CpG: 57	779	57	532	14.6	68.3	0.66
chr19	10529770	10531392	CpG: 133	1622	133	1067	16.4	65.8	0.76
chr19	10542764	10543537	CpG: 70	773	70	528	18.1	68.3	0.78
chr19	10545410	10547787	CpG: 233	2377	233	1631	19.6	68.6	0.83
chr19	10550923	10551291	CpG: 41	368	41	257	22.3	69.8	0.91
chr19	10557034	10559004	CpG: 162	1970	162	1367	16.4	69.4	0.68
chr19	10605440	10605800	CpG: 34	360	34	231	18.9	64.2	0.95
chr19	10607166	10607391	CpG: 19	225	19	136	16.9	60.4	0.94
chr19	10608977	10609217	CpG: 20	240	20	145	16.7	60.4	0.93
chr19	10618042	10618640	CpG: 60	598	60	397	20.1	66.4	0.91
chr19	10628805	10630039	CpG: 148	1234	148	909	24.0	73.7	0.89
chr19	10630948	10631220	CpG: 21	272	21	166	15.4	61.0	0.84
chr19	10640243	10641544	CpG: 147	1301	147	912	22.6	70.1	0.93
chr19	10643746	10644183	CpG: 45	437	45	325	20.6	74.4	0.74
chr19	10669966	10670829	CpG: 87	863	87	641	20.2	74.3	0.74
chr19	10684049	10684364	CpG: 28	315	28	206	17.8	65.4	0.84
chr19	10692048	10692848	CpG: 93	800	93	567	23.2	70.9	0.95
chr19	10694915	10695817	CpG: 111	902	111	661	24.6	73.3	0.92
chr19	10696860	10697136	CpG: 20	276	20	165	14.5	59.8	0.82
chr19	10697846	10698201	CpG: 24	355	24	204	13.5	57.5	0.83
chr19	10705587	10705827	CpG: 17	240	17	142	14.2	59.2	0.83
chr19	10707612	10707834	CpG: 17	222	17	125	15.3	56.3	0.97
chr19	10713687	10713891	CpG: 21	204	21	141	20.6	69.1	0.93
chr19	10728106	10728381	CpG: 20	275	20	167	14.5	60.7	0.80
chr19	10728813	10729353	CpG: 68	540	68	423	25.2	78.3	0.82
chr19	10751733	10752174	CpG: 49	441	49	330	22.2	74.8	0.80
chr19	10762942	10763289	CpG: 27	347	27	232	15.6	66.9	0.70
chr19	10779855	10781615	CpG: 185	1760	185	1179	21.0	67.0	0.94
chr19	10821844	10822482	CpG: 48	638	48	395	15.0	61.9	0.81
chr19	10827807	10828245	CpG: 39	438	39	301	17.8	68.7	0.76
chr19	10830811	10831082	CpG: 19	271	19	152	14.0	56.1	0.90
chr19	10839403	10839663	CpG: 24	260	24	175	18.5	67.3	0.83
chr19	10844577	10845260	CpG: 93	683	93	520	27.2	76.1	0.98
chr19	10891865	10892355	CpG: 35	490	35	289	14.3	59.0	0.83
chr19	10962852	10963820	CpG: 75	968	75	593	15.5	61.3	0.83
chr19	10997822	10999602	CpG: 233	1780	233	1365	26.2	76.7	0.92
chr19	11048268	11048972	CpG: 47	704	47	467	13.4	66.3	0.62
chr19	11055203	11056620	CpG: 150	1417	150	985	21.2	69.5	0.88
chr19	11087447	11088671	CpG: 182	1224	182	925	29.7	75.6	1.05
chr19	11114726	11114940	CpG: 22	214	22	160	20.6	74.8	0.77
chr19	11160304	11160578	CpG: 22	274	22	179	16.1	65.3	0.75
chr19	11160787	11161182	CpG: 38	395	38	265	19.2	67.1	0.86
chr19	11161918	11162119	CpG: 20	201	20	135	19.9	67.2	0.90
chr19	11168200	11168487	CpG: 29	287	29	190	20.2	66.2	0.92
chr19	11172047	11172321	CpG: 20	274	20	169	14.6	61.7	0.78
chr19	11186775	11187167	CpG: 31	392	31	257	15.8	65.6	0.75
chr19	11188352	11188676	CpG: 24	324	24	197	14.8	60.8	0.80
chr19	11200436	11200649	CpG: 18	213	18	127	16.9	59.6	0.98
chr19	11216447	11218008	CpG: 117	1561	117	1022	15.0	65.5	0.70
chr19	11232236	11232639	CpG: 29	403	29	259	14.4	64.3	0.70
chr19	11241551	11241911	CpG: 24	360	24	206	13.3	57.2	0.83
chr19	11259440	11259730	CpG: 20	290	20	177	13.8	61.0	0.76
chr19	11282577	11283100	CpG: 46	523	46	339	17.6	64.8	0.85
chr19	11296975	11297235	CpG: 19	260	19	169	14.6	65.0	0.69
chr19	11301443	11301653	CpG: 22	210	22	144	21.0	68.6	0.89
chr19	11305344	11305571	CpG: 19	227	19	157	16.7	69.2	0.71
chr19	11320022	11320934	CpG: 67	912	67	633	14.7	69.4	0.61
chr19	11323820	11325034	CpG: 113	1214	113	895	18.6	73.7	0.69
chr19	11328896	11329110	CpG: 21	214	21	128	19.6	59.8	1.12
chr19	11335751	11336060	CpG: 27	309	27	209	17.5	67.6	0.76
chr19	11370259	11370661	CpG: 34	402	34	281	16.9	69.9	0.69
chr19	11388978	11389574	CpG: 82	596	82	476	27.5	79.9	0.86
chr19	11397093	11397370	CpG: 20	277	20	168	14.4	60.6	0.80
chr19	11403625	11404337	CpG: 57	712	57	493	16.0	69.2	0.67
chr19	11420079	11420358	CpG: 21	279	21	167	15.1	59.9	0.85
chr19	11420811	11421075	CpG: 26	264	26	189	19.7	71.6	0.78
chr19	11446820	11447055	CpG: 19	235	19	142	16.2	60.4	0.90
chr19	11466325	11466723	CpG: 38	398	38	292	19.1	73.4	0.71
chr19	11473046	11473553	CpG: 43	507	43	309	17.0	60.9	0.95
chr19	11482310	11482750	CpG: 49	440	49	337	22.3	76.6	0.76
chr19	11488201	11488595	CpG: 37	394	37	271	18.8	68.8	0.80
chr19	11489390	11489650	CpG: 24	260	24	174	18.5	66.9	0.83
chr19	11501580	11502063	CpG: 39	483	39	311	16.1	64.4	0.81
chr19	11507806	11510657	CpG: 208	2851	208	1825	14.6	64.0	0.71
chr19	11533360	11533585	CpG: 25	225	25	165	22.2	73.3	0.85
chr19	11535216	11535549	CpG: 24	333	24	193	14.4	58.0	0.87
chr19	11540804	11541014	CpG: 17	210	17	124	16.2	59.0	0.94
chr19	11545509	11546399	CpG: 70	890	70	629	15.7	70.7	0.63
chr19	11547574	11547886	CpG: 30	312	30	207	19.2	66.3	0.88
chr19	11549494	11549915	CpG: 36	421	36	294	17.1	69.8	0.73
chr19	11562649	11563245	CpG: 46	596	46	366	15.4	61.4	0.82
chr19	11576749	11576999	CpG: 20	250	20	170	16.0	68.0	0.69
chr19	11582088	11582415	CpG: 34	327	34	211	20.8	64.5	1.00
chr19	11594623	11594887	CpG: 19	264	19	153	14.4	58.0	0.86
chr19	11606988	11611680	CpG: 393	4692	393	3214	16.8	68.5	0.71
chr19	11631618	11631859	CpG: 18	241	18	147	14.9	61.0	0.84
chr19	11632719	11633535	CpG: 95	816	95	591	23.3	72.4	0.89
chr19	11656301	11656584	CpG: 31	283	31	198	21.9	70.0	0.90
chr19	11663546	11663889	CpG: 38	343	38	249	22.2	72.6	0.84
chr19	11676997	11677219	CpG: 17	222	17	151	15.3	68.0	0.66
chr19	11686485	11686940	CpG: 45	455	45	301	19.8	66.2	0.93
chr19	11706132	11706644	CpG: 50	512	50	362	19.5	70.7	0.79
chr19	11706903	11707170	CpG: 22	267	22	163	16.5	61.0	0.90
chr19	11716416	11716652	CpG: 18	236	18	142	15.3	60.2	0.88
chr19	11724544	11725545	CpG: 79	1001	79	632	15.8	63.1	0.79
chr19	11751722	11751996	CpG: 21	274	21	169	15.3	61.7	0.81
chr19	11752911	11753223	CpG: 22	312	22	185	14.1	59.3	0.80
chr19	11756097	11756583	CpG: 33	486	33	267	13.6	54.9	0.92
chr19	11767894	11768371	CpG: 44	477	44	325	18.4	68.1	0.80
chr19	11786725	11787007	CpG: 21	282	21	171	14.9	60.6	0.82
chr19	11789714	11789950	CpG: 20	236	20	141	16.9	59.7	0.98
chr19	11790420	11790762	CpG: 30	342	30	219	17.5	64.0	0.86
chr19	11802397	11802637	CpG: 20	240	20	170	16.7	70.8	0.68
chr19	11822616	11823255	CpG: 59	639	59	437	18.5	68.4	0.80
chr19	11860438	11860935	CpG: 36	497	36	288	14.5	57.9	0.87
chr19	11866214	11866465	CpG: 19	251	19	154	15.1	61.4	0.80
chr19	11866684	11867187	CpG: 48	503	48	352	19.1	70.0	0.78
chr19	11895106	11895715	CpG: 59	609	59	421	19.4	69.1	0.81
chr19	11913829	11914065	CpG: 17	236	17	141	14.4	59.7	0.83
chr19	11926788	11927257	CpG: 45	469	45	331	19.2	70.6	0.77
chr19	11927795	11928082	CpG: 23	287	23	161	16.0	56.1	1.04
chr19	11942470	11942930	CpG: 46	460	46	318	20.0	69.1	0.84
chr19	11948475	11948717	CpG: 17	242	17	137	14.0	56.6	0.89
chr19	11976969	11977470	CpG: 46	501	46	343	18.4	68.5	0.79
chr19	12016197	12016524	CpG: 34	327	34	231	20.8	70.6	0.84
chr19	12052361	12052595	CpG: 22	234	22	141	18.8	60.3	1.05
chr19	12053292	12053826	CpG: 48	534	48	371	18.0	69.5	0.75
chr19	12056661	12056935	CpG: 24	274	24	170	17.5	62.0	0.92
chr19	12093424	12093761	CpG: 34	337	34	243	20.2	72.1	0.78
chr19	12103651	12103872	CpG: 19	221	19	131	17.2	59.3	1.02
chr19	12115950	12116352	CpG: 36	402	36	270	17.9	67.2	0.80
chr19	12138643	12138969	CpG: 24	326	24	189	14.7	58.0	0.88
chr19	12163422	12164041	CpG: 55	619	55	434	17.8	70.1	0.72
chr19	12168404	12168636	CpG: 18	232	18	139	15.5	59.9	0.89
chr19	12179028	12179511	CpG: 35	483	35	266	14.5	55.1	0.97
chr19	12180728	12180962	CpG: 27	234	27	182	23.1	77.8	0.77
chr19	12182040	12182447	CpG: 30	407	30	227	14.7	55.8	0.95
chr19	12184877	12185339	CpG: 37	462	37	277	16.0	60.0	0.90
chr19	12191620	12191856	CpG: 20	236	20	144	16.9	61.0	0.93
chr19	12192862	12193459	CpG: 57	597	57	421	19.1	70.5	0.77
chr19	12220456	12221258	CpG: 61	802	61	502	15.2	62.6	0.78
chr19	12245874	12246501	CpG: 43	627	43	403	13.7	64.3	0.67
chr19	12249112	12249336	CpG: 17	224	17	136	15.2	60.7	0.84
chr19	12268002	12268654	CpG: 53	652	53	429	16.3	65.8	0.75
chr19	12279658	12279891	CpG: 18	233	18	142	15.5	60.9	0.84
chr19	12284439	12285127	CpG: 58	688	58	478	16.9	69.5	0.70
chr19	12285853	12286093	CpG: 21	240	21	145	17.5	60.4	0.98
chr19	12286280	12286561	CpG: 23	281	23	171	16.4	60.9	0.90
chr19	12291228	12291725	CpG: 49	497	49	339	19.7	68.2	0.85
chr19	12322978	12323730	CpG: 66	752	66	496	17.6	66.0	0.81
chr19	12388513	12388796	CpG: 22	283	22	177	15.5	62.5	0.80
chr19	12394203	12394780	CpG: 45	577	45	396	15.6	68.6	0.67
chr19	12422627	12423082	CpG: 46	455	46	325	20.2	71.4	0.79
chr19	12461564	12462080	CpG: 46	516	46	352	17.8	68.2	0.77
chr19	12490663	12491045	CpG: 34	382	34	294	17.8	77.0	0.60
chr19	12493540	12493904	CpG: 40	364	40	268	22.0	73.6	0.81
chr19	12529172	12529754	CpG: 63	582	63	408	21.6	70.1	0.89
chr19	12568991	12569465	CpG: 49	474	49	334	20.7	70.5	0.84
chr19	12575324	12575556	CpG: 19	232	19	142	16.4	61.2	0.88
chr19	12595665	12596503	CpG: 64	838	64	585	15.3	69.8	0.63
chr19	12612714	12613473	CpG: 61	759	61	502	16.1	66.1	0.74
chr19	12620644	12620879	CpG: 20	235	20	145	17.0	61.7	0.91
chr19	12623774	12624322	CpG: 53	548	53	377	19.3	68.8	0.83
chr19	12641865	12642069	CpG: 26	204	26	150	25.5	73.5	0.94
chr19	12660711	12660936	CpG: 18	225	18	135	16.0	60.0	0.89
chr19	12679410	12679908	CpG: 47	498	47	354	18.9	71.1	0.75
chr19	12683840	12684279	CpG: 44	439	44	307	20.0	69.9	0.83
chr19	12707383	12707619	CpG: 18	236	18	142	15.3	60.2	0.86
chr19	12721227	12721645	CpG: 33	418	33	275	15.8	65.8	0.73
chr19	12735058	12735642	CpG: 54	584	54	377	18.5	64.6	0.89
chr19	12746124	12746357	CpG: 24	233	24	192	20.6	82.4	0.61
chr19	12764572	12764857	CpG: 27	285	27	182	18.9	63.9	0.93
chr19	12766644	12767275	CpG: 46	631	46	371	14.6	58.8	0.85
chr19	12771966	12772447	CpG: 33	481	33	328	13.7	68.2	0.66
chr19	12772668	12772903	CpG: 23	235	23	169	19.6	71.9	0.77
chr19	12781440	12782415	CpG: 71	975	71	622	14.6	63.8	0.72
chr19	12791014	12791322	CpG: 31	308	31	226	20.1	73.4	0.75
chr19	12793479	12794778	CpG: 94	1299	94	783	14.5	60.3	0.80
chr19	12805981	12806804	CpG: 77	823	77	494	18.7	60.0	1.04
chr19	12820618	12821350	CpG: 84	732	84	486	23.0	66.4	1.04
chr19	12822070	12822306	CpG: 17	236	17	142	14.4	60.2	0.80
chr19	12835404	12835685	CpG: 20	281	20	166	14.2	59.1	0.82
chr19	12845466	12847247	CpG: 135	1781	135	1174	15.2	65.9	0.72
chr19	12848332	12848547	CpG: 16	215	16	132	14.9	61.4	0.80
chr19	12858677	12859358	CpG: 85	681	85	493	25.0	72.4	0.97
chr19	12860638	12860951	CpG: 21	313	21	179	13.4	57.2	0.84
chr19	12861957	12862265	CpG: 20	308	20	198	13.0	64.3	0.68
chr19	12879100	12879506	CpG: 41	406	41	269	20.2	66.3	0.92
chr19	12882077	12882521	CpG: 49	444	49	323	22.1	72.7	0.83
chr19	12890570	12890789	CpG: 22	219	22	157	20.1	71.7	0.79
chr19	12891108	12891385	CpG: 21	277	21	163	15.2	58.8	0.88
chr19	12894255	12894569	CpG: 36	314	36	231	22.9	73.6	0.85
chr19	12899438	12900804	CpG: 105	1366	105	881	15.4	64.5	0.75
chr19	12902119	12903022	CpG: 63	903	63	570	14.0	63.1	0.70
chr19	12905038	12905342	CpG: 22	304	22	167	14.5	54.9	0.96
chr19	12905518	12905719	CpG: 14	201	14	120	13.9	59.7	0.80
chr19	12906946	12907774	CpG: 88	828	88	602	21.3	72.7	0.80
chr19	12914082	12918632	CpG: 375	4550	375	3035	16.5	66.7	0.74
chr19	12925622	12926609	CpG: 103	987	103	685	20.9	69.4	0.87
chr19	12928627	12929427	CpG: 55	800	55	489	13.8	61.1	0.77
chr19	12930116	12930384	CpG: 20	268	20	161	14.9	60.1	0.84
chr19	12930873	12931374	CpG: 57	501	57	346	22.8	69.1	0.97
chr19	12950214	12950593	CpG: 35	379	35	250	18.5	66.0	0.89
chr19	12953128	12953375	CpG: 20	247	20	159	16.2	64.4	0.78
chr19	12957053	12957368	CpG: 33	315	33	204	21.0	64.8	1.00
chr19	12958231	12959002	CpG: 90	771	90	591	23.3	76.7	0.81
chr19	12962835	12963437	CpG: 68	602	68	455	22.6	75.6	0.79
chr19	12965717	12965983	CpG: 26	266	26	175	19.5	65.8	0.93
chr19	12971859	12972598	CpG: 65	739	65	482	17.6	65.2	0.83
chr19	12972857	12973143	CpG: 23	286	23	179	16.1	62.6	0.83
chr19	12982880	12983201	CpG: 29	321	29	202	18.1	62.9	0.91
chr19	12992015	12992441	CpG: 36	426	36	302	16.9	70.9	0.68
chr19	12997802	12999136	CpG: 147	1334	147	936	22.0	70.2	0.90
chr19	13005365	13006183	CpG: 59	818	59	537	14.4	65.6	0.67
chr19	13009721	13010674	CpG: 100	953	100	688	21.0	72.2	0.81
chr19	13016055	13016294	CpG: 18	239	18	159	15.1	66.5	0.72
chr19	13043139	13044007	CpG: 79	868	79	539	18.2	62.1	0.95
chr19	13057760	13058339	CpG: 48	579	48	369	16.6	63.7	0.82
chr19	13062712	13063483	CpG: 84	771	84	513	21.8	66.5	0.99
chr19	13070129	13070796	CpG: 86	667	86	483	25.8	72.4	0.99
chr19	13081258	13082292	CpG: 98	1034	98	651	19.0	63.0	0.96
chr19	13085644	13085923	CpG: 22	279	22	175	15.8	62.7	0.81
chr19	13108000	13108282	CpG: 46	282	46	222	32.6	78.7	1.05
chr19	13120370	13122087	CpG: 248	1717	248	1301	28.9	75.8	1.02
chr19	13126563	13127202	CpG: 45	639	45	397	14.1	62.1	0.73
chr19	13127763	13127964	CpG: 16	201	16	144	15.9	71.6	0.66
chr19	13135379	13138060	CpG: 187	2681	187	1708	14.0	63.7	0.69
chr19	13138455	13138763	CpG: 23	308	23	198	14.9	64.3	0.73
chr19	13138964	13139183	CpG: 20	219	20	126	18.3	57.5	1.10
chr19	13139354	13139654	CpG: 25	300	25	179	16.7	59.7	0.95
chr19	13148453	13148701	CpG: 19	248	19	155	15.3	62.5	1.04
chr19	13149719	13150571	CpG: 66	852	66	530	15.5	62.2	0.80
chr19	13213099	13213399	CpG: 26	300	26	190	17.3	63.3	0.88
chr19	13221775	13222078	CpG: 30	303	30	218	19.8	71.9	0.81
chr19	13222743	13224925	CpG: 195	2182	195	1453	17.9	66.6	0.83
chr19	13227850	13228221	CpG: 39	371	39	280	21.0	75.5	0.74
chr19	13229642	13229941	CpG: 28	299	28	217	18.7	72.6	0.72
chr19	13241296	13242059	CpG: 59	763	59	465	15.5	60.9	0.83
chr19	13243218	13244229	CpG: 111	1011	111	768	22.0	76.0	0.80
chr19	13263394	13263635	CpG: 23	241	23	156	19.1	64.7	0.91
chr19	13274961	13279324	CpG: 350	4363	350	2845	16.0	65.2	0.76
chr19	13280789	13281430	CpG: 52	641	52	448	16.2	69.9	0.67
chr19	13288053	13288517	CpG: 45	464	45	319	19.4	68.8	0.82
chr19	13311947	13312343	CpG: 38	396	38	293	19.2	74.0	0.70
chr19	13332510	13333276	CpG: 94	766	94	595	24.5	77.7	0.82
chr19	13333732	13334253	CpG: 45	521	45	376	17.3	72.2	0.68
chr19	13361556	13361940	CpG: 27	384	27	249	14.1	64.8	0.67
chr19	13380521	13380757	CpG: 18	236	18	144	15.3	61.0	0.85
chr19	13412039	13412266	CpG: 19	227	19	161	16.7	70.9	0.75
chr19	13423944	13424753	CpG: 96	809	96	589	23.7	72.8	0.92
chr19	13494184	13494458	CpG: 23	274	23	170	16.8	62.0	0.88
chr19	13631299	13632132	CpG: 85	833	85	553	20.4	66.4	0.93
chr19	13639736	13639972	CpG: 18	236	18	141	15.3	59.7	0.87
chr19	13828663	13830229	CpG: 143	1566	143	1187	18.3	75.8	0.64
chr19	13853134	13853371	CpG: 21	237	21	145	17.7	61.2	0.97
chr19	13873842	13874314	CpG: 57	472	57	343	24.2	72.7	0.92
chr19	13885128	13885496	CpG: 26	368	26	239	14.1	64.9	0.67
chr19	13888840	13889296	CpG: 37	456	37	316	16.2	69.3	0.68
chr19	13890455	13891338	CpG: 102	883	102	638	23.1	72.3	0.89
chr19	13900566	13901179	CpG: 53	613	53	401	17.3	65.4	0.86
chr19	13912284	13912552	CpG: 20	268	20	166	14.9	61.9	0.79
chr19	13921030	13922017	CpG: 102	987	102	707	20.7	71.6	0.82
chr19	13926275	13926734	CpG: 35	459	35	266	15.3	58.0	0.92
chr19	13930959	13931181	CpG: 19	222	19	141	17.1	63.5	0.86
chr19	13935006	13935417	CpG: 37	411	37	284	18.0	69.1	0.76
chr19	13956380	13957085	CpG: 65	705	65	482	18.4	68.4	0.81
chr19	13959456	13960012	CpG: 49	556	49	370	17.6	66.5	0.81
chr19	13968541	13969174	CpG: 92	633	92	507	29.1	80.1	0.91
chr19	13976613	13976903	CpG: 47	290	47	231	32.4	79.7	1.04
chr19	13991008	13992260	CpG: 175	1252	175	982	28.0	78.4	0.91
chr19	13998938	14000260	CpG: 89	1322	89	861	13.5	65.1	0.66
chr19	14003546	14003901	CpG: 30	355	30	234	16.9	65.9	0.79
chr19	14006343	14006559	CpG: 21	216	21	153	19.4	70.8	0.78
chr19	14032009	14032779	CpG: 85	770	85	556	22.1	72.2	0.85
chr19	14058992	14059558	CpG: 53	566	53	409	18.7	72.3	0.72
chr19	14078257	14079075	CpG: 74	818	74	550	18.1	67.2	0.84
chr19	14088137	14090296	CpG: 190	2159	190	1522	17.6	70.5	0.71
chr19	14099011	14099389	CpG: 33	378	33	269	17.5	71.2	0.69
chr19	14104906	14105495	CpG: 65	589	65	442	22.1	75.0	0.79
chr19	14132016	14133501	CpG: 147	1485	147	996	19.8	67.1	0.88
chr19	14133949	14134185	CpG: 18	236	18	143	15.3	60.6	0.85
chr19	14157875	14158454	CpG: 64	579	64	424	22.1	73.2	0.83
chr19	14183620	14184393	CpG: 72	773	72	541	18.6	70.0	0.77
chr19	14196909	14197237	CpG: 24	328	24	212	14.6	64.6	0.71
chr19	14198215	14200224	CpG: 205	2009	205	1434	20.4	71.4	0.80
chr19	14200587	14201081	CpG: 33	494	33	328	13.4	66.4	0.61
chr19	14201383	14201645	CpG: 26	262	26	182	19.8	69.5	0.82
chr19	14207467	14208252	CpG: 53	785	53	466	13.5	59.4	0.77
chr19	14211724	14212186	CpG: 47	462	47	333	20.3	72.1	0.78
chr19	14215717	14218163	CpG: 362	2446	362	1876	29.6	76.7	1.01
chr19	14243953	14245064	CpG: 151	1111	151	872	27.2	78.5	0.88
chr19	14260437	14260712	CpG: 26	275	26	174	18.9	63.3	0.95
chr19	14262699	14264348	CpG: 160	1649	160	1106	19.4	67.1	0.87
chr19	14277604	14278147	CpG: 41	543	41	387	15.1	71.3	0.60
chr19	14289269	14290013	CpG: 64	744	64	458	17.2	61.6	0.91
chr19	14331945	14334311	CpG: 272	2366	272	1718	23.0	72.6	0.87
chr19	14336152	14336494	CpG: 43	342	43	253	25.1	74.0	0.93
chr19	14343998	14344220	CpG: 19	222	19	148	17.1	66.7	0.78
chr19	14354127	14354363	CpG: 17	236	17	140	14.4	59.3	0.83
chr19	14375474	14375811	CpG: 26	337	26	225	15.4	66.8	0.69
chr19	14392529	14392802	CpG: 23	273	23	185	16.8	67.8	0.77
chr19	14404125	14404639	CpG: 41	514	41	369	16.0	71.8	0.62
chr19	14407619	14407828	CpG: 16	209	16	122	15.3	58.4	0.92
chr19	14421238	14421473	CpG: 17	235	17	139	14.5	59.1	0.87
chr19	14460160	14460401	CpG: 24	241	24	180	19.9	74.7	0.73
chr19	14532588	14533326	CpG: 58	738	58	523	15.7	70.9	0.63
chr19	14545588	14546362	CpG: 78	774	78	503	20.2	65.0	0.97
chr19	14558586	14558937	CpG: 30	351	30	224	17.1	63.8	0.84
chr19	14559691	14560522	CpG: 111	831	111	648	26.7	78.0	0.88
chr19	14567815	14568072	CpG: 23	257	23	188	17.9	73.2	0.67
chr19	14598240	14600919	CpG: 257	2679	257	1867	19.2	69.7	0.80
chr19	14606853	14607129	CpG: 26	276	26	193	18.8	69.9	0.77
chr19	14622510	14623190	CpG: 80	680	80	496	23.5	72.9	0.89
chr19	14644302	14645585	CpG: 160	1283	160	953	24.9	74.3	0.92
chr19	14655795	14656956	CpG: 91	1161	91	731	15.7	63.0	0.79
chr19	14670180	14670454	CpG: 23	274	23	169	16.8	61.7	0.89
chr19	14684562	14684798	CpG: 19	236	19	142	16.1	60.2	0.91
chr19	14690963	14691235	CpG: 21	272	21	194	15.4	71.3	0.77
chr19	14692130	14692471	CpG: 27	341	27	240	15.8	70.4	0.64
chr19	14698588	14698925	CpG: 30	337	30	229	17.8	68.0	0.77
chr19	14816327	14816659	CpG: 44	332	44	254	26.5	76.5	0.92
chr19	14829225	14829468	CpG: 17	243	17	148	14.0	60.9	0.78
chr19	14945676	14945955	CpG: 22	279	22	164	15.8	58.8	0.93
chr19	14975115	14975385	CpG: 19	270	19	162	14.1	60.0	0.79
chr19	15001786	15002052	CpG: 19	266	19	159	14.3	59.8	0.82
chr19	15061997	15062238	CpG: 21	241	21	148	17.4	61.4	0.95
chr19	15104264	15104950	CpG: 91	686	91	545	26.5	79.4	0.84
chr19	15135679	15136232	CpG: 69	553	69	395	25.0	71.4	0.98
chr19	15146260	15146844	CpG: 42	584	42	356	14.4	61.0	0.79
chr19	15232083	15232749	CpG: 69	666	69	490	20.7	73.6	0.78
chr19	15238507	15239047	CpG: 51	540	51	351	18.9	65.0	0.89
chr19	15249899	15250764	CpG: 72	865	72	575	16.6	66.5	0.77
chr19	15266167	15266486	CpG: 25	319	25	197	15.7	61.8	0.83
chr19	15295259	15295674	CpG: 34	415	34	293	16.4	70.6	0.66
chr19	15298972	15299302	CpG: 36	330	36	232	21.8	70.3	0.88
chr19	15302410	15303012	CpG: 86	602	86	461	28.6	76.6	0.98
chr19	15306500	15306733	CpG: 21	233	21	160	18.0	68.7	0.79
chr19	15313937	15314273	CpG: 28	336	28	223	16.7	66.4	0.76
chr19	15320346	15321214	CpG: 90	868	90	626	20.7	72.1	0.80
chr19	15324624	15326133	CpG: 150	1509	150	1145	19.9	75.9	0.70
chr19	15348222	15348938	CpG: 74	716	74	496	20.7	69.3	0.89
chr19	15356727	15358520	CpG: 146	1793	146	1185	16.3	66.1	0.76
chr19	15362778	15363107	CpG: 27	329	27	221	16.4	67.2	0.75
chr19	15363652	15364089	CpG: 32	437	32	305	14.6	69.8	0.61
chr19	15427648	15427928	CpG: 21	280	21	165	15.0	58.9	0.87
chr19	15438030	15438266	CpG: 18	236	18	139	15.3	58.9	0.89
chr19	15440803	15441089	CpG: 22	286	22	172	15.4	60.1	0.86
chr19	15456390	15457660	CpG: 194	1270	194	998	30.6	78.6	1.00
chr19	15458464	15458741	CpG: 21	277	21	168	15.2	60.6	0.84
chr19	15471852	15472090	CpG: 16	238	16	140	13.4	58.8	0.80
chr19	15487465	15488575	CpG: 88	1110	88	791	15.9	71.3	0.62
chr19	15493919	15494304	CpG: 27	385	27	234	14.0	60.8	0.76
chr19	15497791	15498309	CpG: 43	518	43	354	16.6	68.3	0.71
chr19	15502497	15502737	CpG: 18	240	18	145	15.0	60.4	0.84
chr19	15504022	15505424	CpG: 167	1402	167	1028	23.8	73.3	0.90
chr19	15509867	15510314	CpG: 33	447	33	269	14.8	60.2	0.83
chr19	15520691	15520965	CpG: 25	274	25	172	18.2	62.8	0.94
chr19	15526210	15526578	CpG: 29	368	29	243	15.8	66.0	0.72
chr19	15533596	15533821	CpG: 17	225	17	134	15.1	59.6	0.89
chr19	15543470	15544082	CpG: 56	612	56	414	18.3	67.6	0.80
chr19	15549635	15550029	CpG: 37	394	37	280	18.8	71.1	0.74
chr19	15553141	15553413	CpG: 29	272	29	205	21.3	75.4	0.78
chr19	15557089	15558071	CpG: 126	982	126	740	25.7	75.4	0.91
chr19	15565027	15565237	CpG: 16	210	16	142	15.2	67.6	0.67
chr19	15574223	15575142	CpG: 106	919	106	740	23.1	80.5	0.72
chr19	15578045	15578399	CpG: 43	354	43	260	24.3	73.4	0.90
chr19	15582203	15583403	CpG: 123	1200	123	826	20.5	68.8	0.87
chr19	15594567	15595048	CpG: 60	481	60	344	24.9	71.5	0.98
chr19	15595930	15596222	CpG: 21	292	21	164	14.4	56.2	0.93
chr19	15596803	15597103	CpG: 27	300	27	209	18.0	69.7	0.74
chr19	15633405	15633795	CpG: 52	390	52	299	26.7	76.7	0.95
chr19	15676335	15676580	CpG: 28	245	28	170	22.9	69.4	0.95
chr19	15709558	15709795	CpG: 24	237	24	165	20.3	69.6	0.84
chr19	15714075	15714315	CpG: 21	240	21	144	17.5	60.0	0.99
chr19	15733727	15734116	CpG: 31	389	31	278	15.9	71.5	0.62
chr19	15849553	15849803	CpG: 23	250	23	161	18.4	64.4	0.90
chr19	15886884	15887138	CpG: 24	254	24	169	18.9	66.5	0.86
chr19	15922095	15922320	CpG: 16	225	16	143	14.2	63.6	0.77
chr19	15935458	15935739	CpG: 22	281	22	180	15.7	64.1	0.83
chr19	15944971	15945245	CpG: 24	274	24	171	17.5	62.4	0.91
chr19	15964543	15965239	CpG: 57	696	57	478	16.4	68.7	0.69
chr19	15992079	15992358	CpG: 22	279	22	169	15.8	60.6	0.87
chr19	16030912	16031303	CpG: 39	391	39	287	19.9	73.4	0.74
chr19	16034046	16034433	CpG: 35	387	35	256	18.1	66.1	0.83
chr19	16041494	16041731	CpG: 20	237	20	146	16.9	61.6	0.90
chr19	16042931	16043354	CpG: 43	423	43	307	20.3	72.6	0.78
chr19	16145129	16145334	CpG: 14	205	14	115	13.7	56.1	0.88
chr19	16201590	16202141	CpG: 38	551	38	341	13.8	61.9	0.78
chr19	16210058	16211547	CpG: 167	1489	167	1077	22.4	72.3	0.86
chr19	16244398	16246413	CpG: 169	2015	169	1306	16.8	64.8	0.80
chr19	16316576	16316861	CpG: 21	285	21	170	14.7	59.6	0.84
chr19	16318512	16318723	CpG: 16	211	16	123	15.2	58.3	0.91
chr19	16319557	16319999	CpG: 35	442	35	275	15.8	62.2	0.84
chr19	16331729	16332573	CpG: 78	844	78	590	18.5	69.9	0.76
chr19	16378671	16378908	CpG: 23	237	23	148	19.4	62.4	1.01
chr19	16418377	16418589	CpG: 18	212	18	127	17.0	59.9	0.97
chr19	16429199	16429419	CpG: 15	220	15	128	13.6	58.2	0.81
chr19	16446770	16447041	CpG: 19	271	19	165	14.0	60.9	0.77
chr19	16459267	16462129	CpG: 329	2862	329	2055	23.0	71.8	0.89
chr19	16490415	16490653	CpG: 21	238	21	159	17.6	66.8	0.82
chr19	16552760	16553031	CpG: 22	271	22	153	16.2	56.5	1.02
chr19	16606120	16607302	CpG: 131	1182	131	860	22.2	72.8	0.84
chr19	16627384	16627617	CpG: 17	233	17	131	14.6	56.2	0.94
chr19	16630723	16631419	CpG: 60	696	60	462	17.2	66.4	0.78
chr19	16632201	16632434	CpG: 16	233	16	131	13.7	56.2	0.88
chr19	16634135	16634360	CpG: 17	225	17	137	15.1	60.9	0.84
chr19	16653907	16654134	CpG: 20	227	20	148	17.6	65.2	0.84
chr19	16659958	16660803	CpG: 71	845	71	596	16.8	70.5	0.68
chr19	16665521	16665816	CpG: 27	295	27	209	18.3	70.8	0.73
chr19	16667251	16667577	CpG: 26	326	26	215	16.0	66.0	0.74
chr19	16673959	16674244	CpG: 22	285	22	175	15.4	61.4	0.83
chr19	16676492	16677719	CpG: 134	1227	134	832	21.8	67.8	0.96
chr19	16706635	16707843	CpG: 153	1208	153	844	25.3	69.9	1.04
chr19	16762295	16763849	CpG: 183	1554	183	1136	23.6	73.1	0.89
chr19	16773972	16774209	CpG: 16	237	16	141	13.5	59.5	0.79
chr19	16794617	16796613	CpG: 163	1996	163	1355	16.3	67.9	0.72
chr19	16942467	16942753	CpG: 20	286	20	174	14.0	60.8	0.77
chr19	16964163	16964614	CpG: 52	451	52	349	23.1	77.4	0.79
chr19	17010853	17011125	CpG: 22	272	22	184	16.2	67.6	0.71
chr19	17013041	17013723	CpG: 53	682	53	470	15.5	68.9	0.65
chr19	17024653	17025424	CpG: 66	771	66	546	17.1	70.8	0.69
chr19	17030718	17032885	CpG: 185	2167	185	1513	17.1	69.8	0.71
chr19	17055015	17055248	CpG: 17	233	17	139	14.6	59.7	0.84
chr19	17161295	17162188	CpG: 95	893	95	675	21.3	75.6	0.79
chr19	17209973	17211347	CpG: 143	1374	143	952	20.8	69.3	0.89
chr19	17236566	17237419	CpG: 59	853	59	539	13.8	63.2	0.69
chr19	17307545	17307880	CpG: 29	335	29	226	17.3	67.5	0.76
chr19	17327638	17327966	CpG: 25	328	25	222	15.2	67.7	0.67
chr19	17340821	17341269	CpG: 34	448	34	306	15.2	68.3	0.65
chr19	17346535	17347052	CpG: 46	517	46	366	17.8	70.8	0.72
chr19	17350108	17350615	CpG: 48	507	48	343	18.9	67.7	0.83
chr19	17359389	17359747	CpG: 25	358	25	206	14.0	57.5	0.85
chr19	17360493	17360861	CpG: 26	368	26	216	14.1	58.7	0.83
chr19	17360985	17361947	CpG: 97	962	97	666	20.2	69.2	0.85
chr19	17370234	17371022	CpG: 101	788	101	595	25.6	75.5	0.90
chr19	17379245	17381568	CpG: 266	2323	266	1717	22.9	73.9	0.84
chr19	17416461	17417854	CpG: 120	1393	120	965	17.2	69.3	0.73
chr19	17427115	17427646	CpG: 47	531	47	373	17.7	70.2	0.73
chr19	17429035	17429453	CpG: 36	418	36	284	17.2	67.9	0.75
chr19	17435950	17436498	CpG: 50	548	50	376	18.2	68.6	0.78
chr19	17437814	17438567	CpG: 71	753	71	532	18.9	70.7	0.76
chr19	17440385	17441334	CpG: 77	949	77	617	16.2	65.0	0.77
chr19	17443488	17445020	CpG: 100	1532	100	933	13.1	60.9	0.71
chr19	17458416	17458810	CpG: 46	394	46	320	23.4	81.2	0.73
chr19	17462086	17464467	CpG: 211	2381	211	1691	17.7	71.0	0.71
chr19	17467991	17469833	CpG: 157	1842	157	1236	17.0	67.1	0.76
chr19	17472210	17472498	CpG: 20	288	20	178	13.9	61.8	0.73
chr19	17472763	17473071	CpG: 35	308	35	218	22.7	70.8	0.95
chr19	17486631	17487047	CpG: 42	416	42	254	20.2	61.1	1.11
chr19	17511812	17512042	CpG: 19	230	19	146	16.5	63.5	0.82
chr19	17525118	17526179	CpG: 93	1061	93	721	17.5	68.0	0.80
chr19	17528596	17528991	CpG: 42	395	42	295	21.3	74.7	0.77
chr19	17554419	17555486	CpG: 103	1067	103	713	19.3	66.8	0.87
chr19	17582866	17583717	CpG: 84	851	84	616	19.7	72.4	0.76
chr19	17590428	17590737	CpG: 38	309	38	228	24.6	73.8	0.92
chr19	17604024	17604425	CpG: 30	401	30	263	15.0	65.6	0.72
chr19	17605017	17605502	CpG: 58	485	58	366	23.9	75.5	0.92
chr19	17621171	17621827	CpG: 59	656	59	466	18.0	71.0	0.72
chr19	17631816	17632239	CpG: 38	423	38	285	18.0	67.4	0.79
chr19	17635179	17635498	CpG: 26	319	26	212	16.3	66.5	0.74
chr19	17645688	17647144	CpG: 136	1456	136	965	18.7	66.3	0.85
chr19	17655607	17655819	CpG: 18	212	18	147	17.0	69.3	0.72
chr19	17673815	17675212	CpG: 125	1397	125	965	17.9	69.1	0.75
chr19	17690001	17690787	CpG: 103	786	103	570	26.2	72.5	1.00
chr19	17693498	17693735	CpG: 17	237	17	142	14.3	59.9	0.83
chr19	17711827	17712188	CpG: 29	361	29	250	16.1	69.3	0.71
chr19	17715279	17715516	CpG: 16	237	16	153	13.5	64.6	0.65
chr19	17740077	17740964	CpG: 93	887	93	622	21.0	70.1	0.88
chr19	17751877	17752081	CpG: 16	204	16	129	15.7	63.2	0.81
chr19	17781406	17781688	CpG: 28	282	28	184	19.9	65.2	0.94
chr19	17782461	17782761	CpG: 28	300	28	210	18.7	70.0	0.79
chr19	17814399	17814754	CpG: 36	355	36	247	20.3	69.6	0.85
chr19	17820856	17821074	CpG: 25	218	25	163	22.9	74.8	0.84
chr19	17822005	17822655	CpG: 70	650	70	479	21.5	73.7	0.80
chr19	17824533	17824770	CpG: 17	237	17	137	14.3	57.8	0.88
chr19	17853415	17853957	CpG: 67	542	67	407	24.7	75.1	0.90
chr19	17860066	17862127	CpG: 165	2061	165	1443	16.0	70.0	0.66
chr19	17881680	17882200	CpG: 64	520	64	392	24.6	75.4	0.87
chr19	17900772	17901081	CpG: 24	309	24	190	15.5	61.5	0.82
chr19	17928872	17929610	CpG: 53	738	53	504	14.4	68.3	0.64
chr19	17942045	17942406	CpG: 31	361	31	247	17.2	68.4	0.77
chr19	17955210	17955672	CpG: 43	462	43	327	18.6	70.8	0.75
chr19	17965228	17965839	CpG: 48	611	48	407	15.7	66.6	0.71
chr19	17975468	17976746	CpG: 89	1278	89	855	13.9	66.9	0.65
chr19	17981759	17982077	CpG: 26	318	26	217	16.4	68.2	0.71
chr19	17993590	17994400	CpG: 81	810	81	530	20.0	65.4	0.95
chr19	18003668	18004491	CpG: 57	823	57	487	13.9	59.2	0.79
chr19	18005942	18008405	CpG: 174	2463	174	1606	14.1	65.2	0.66
chr19	18017830	18018050	CpG: 22	220	22	166	20.0	75.5	0.71
chr19	18030612	18030852	CpG: 18	240	18	142	15.0	59.2	0.87
chr19	18066763	18067426	CpG: 56	663	56	423	16.9	63.8	0.84
chr19	18081553	18082746	CpG: 123	1193	123	866	20.6	72.6	0.80
chr19	18083132	18083431	CpG: 23	299	23	204	15.4	68.2	0.70
chr19	18084390	18084756	CpG: 24	366	24	238	13.1	65.0	0.73
chr19	18086195	18086597	CpG: 50	402	50	305	24.9	75.9	0.87
chr19	18092811	18093044	CpG: 17	233	17	136	14.6	58.4	0.87
chr19	18101023	18101530	CpG: 67	507	67	395	26.4	77.9	0.87
chr19	18107905	18108343	CpG: 36	438	36	307	16.4	70.1	0.67
chr19	18115700	18116218	CpG: 51	518	51	341	19.7	65.8	0.91
chr19	18132163	18132586	CpG: 32	423	32	291	15.1	68.8	0.67
chr19	18134835	18135750	CpG: 116	915	116	660	25.4	72.1	0.99
chr19	18139640	18142822	CpG: 235	3182	235	2078	14.8	65.3	0.69
chr19	18143882	18144109	CpG: 24	227	24	159	21.1	70.0	0.86
chr19	18185940	18186307	CpG: 32	367	32	257	17.4	70.0	0.71
chr19	18189519	18189759	CpG: 17	240	17	144	14.2	60.0	0.81
chr19	18231684	18231993	CpG: 36	309	36	249	23.3	80.6	0.75
chr19	18233175	18233532	CpG: 26	357	26	244	14.6	68.3	0.68
chr19	18243835	18244696	CpG: 96	861	96	634	22.3	73.6	0.82
chr19	18252212	18252776	CpG: 84	564	84	440	29.8	78.0	1.00
chr19	18258324	18258526	CpG: 19	202	19	140	18.8	69.3	0.80
chr19	18265564	18265789	CpG: 15	225	15	136	13.3	60.4	0.73
chr19	18265957	18266190	CpG: 21	233	21	156	18.0	67.0	0.81
chr19	18273943	18274209	CpG: 19	266	19	162	14.3	60.9	0.78
chr19	18279114	18279341	CpG: 25	227	25	151	22.0	66.5	1.02
chr19	18283408	18283814	CpG: 40	406	40	299	19.7	73.6	0.73
chr19	18286102	18287931	CpG: 165	1829	165	1182	18.0	64.6	0.87
chr19	18289972	18290281	CpG: 34	309	34	235	22.0	76.1	0.76
chr19	18295046	18295693	CpG: 72	647	72	492	22.3	76.0	0.77
chr19	18301276	18301486	CpG: 18	210	18	133	17.1	63.3	0.86
chr19	18302836	18303500	CpG: 68	664	68	468	20.5	70.5	0.83
chr19	18307844	18308346	CpG: 43	502	43	340	17.1	67.7	0.75
chr19	18323571	18323796	CpG: 19	225	19	136	16.9	60.4	0.96
chr19	18326936	18327738	CpG: 96	802	96	540	23.9	67.3	1.06
chr19	18329644	18329957	CpG: 25	313	25	181	16.0	57.8	0.96
chr19	18336639	18336868	CpG: 19	229	19	130	16.6	56.8	1.06
chr19	18337199	18338420	CpG: 110	1221	110	810	18.0	66.3	0.83
chr19	18342435	18342653	CpG: 20	218	20	155	18.3	71.1	0.73
chr19	18354332	18354680	CpG: 24	348	24	228	13.8	65.5	0.64
chr19	18355004	18355278	CpG: 25	274	25	202	18.2	73.7	0.75
chr19	18358369	18360672	CpG: 183	2303	183	1518	15.9	65.9	0.73
chr19	18366785	18367481	CpG: 63	696	63	481	18.1	69.1	0.76
chr19	18375389	18375656	CpG: 19	267	19	160	14.2	59.9	0.81
chr19	18391770	18392199	CpG: 37	429	37	296	17.2	69.0	0.73
chr19	18413650	18416288	CpG: 316	2638	316	1884	24.0	71.4	0.94
chr19	18425716	18426712	CpG: 87	996	87	686	17.5	68.9	0.74
chr19	18443796	18444043	CpG: 23	247	23	166	18.6	67.2	0.83
chr19	18456949	18457485	CpG: 69	536	69	375	25.7	70.0	1.05
chr19	18474526	18475098	CpG: 61	572	61	416	21.3	72.7	0.85
chr19	18520398	18520604	CpG: 20	206	20	133	19.4	64.6	0.93
chr19	18522261	18523035	CpG: 85	774	85	526	22.0	68.0	0.95
chr19	18544191	18544468	CpG: 21	277	21	166	15.2	59.9	0.86
chr19	18550977	18554833	CpG: 357	3856	357	2641	18.5	68.5	0.79
chr19	18563148	18563708	CpG: 65	560	65	420	23.2	75.0	0.83
chr19	18567196	18572530	CpG: 412	5334	412	3654	15.4	68.5	0.66
chr19	18581593	18581839	CpG: 24	246	24	166	19.5	67.5	0.88
chr19	18596963	18597174	CpG: 17	211	17	144	16.1	68.2	0.69
chr19	18599117	18599340	CpG: 18	223	18	130	16.1	58.3	0.96
chr19	18656843	18657998	CpG: 123	1155	123	800	21.3	69.3	0.91
chr19	18678312	18679188	CpG: 89	876	89	678	20.3	77.4	0.73
chr19	18692706	18693169	CpG: 53	463	53	313	22.9	67.6	1.01
chr19	18706625	18707285	CpG: 73	660	73	454	22.1	68.8	0.96
chr19	18723567	18724819	CpG: 113	1252	113	869	18.1	69.4	0.75
chr19	18729288	18729685	CpG: 45	397	45	292	22.7	73.6	0.84
chr19	18730185	18730403	CpG: 20	218	20	159	18.3	72.9	0.70
chr19	18732525	18732802	CpG: 23	277	23	171	16.6	61.7	0.88
chr19	18738771	18739091	CpG: 29	320	29	227	18.1	70.9	0.74
chr19	18740494	18743008	CpG: 252	2514	252	1825	20.0	72.6	0.76
chr19	18745787	18748264	CpG: 193	2477	193	1662	15.6	67.1	0.70
chr19	18771947	18772219	CpG: 42	272	42	212	30.9	77.9	1.03
chr19	18785523	18785920	CpG: 29	397	29	246	14.6	62.0	0.76
chr19	18795365	18795627	CpG: 23	262	23	188	17.6	71.8	0.69
chr19	18802772	18804328	CpG: 150	1556	150	1049	19.3	67.4	0.85
chr19	18818481	18819109	CpG: 96	628	96	479	30.6	76.3	1.08
chr19	18836345	18836575	CpG: 18	230	18	144	15.7	62.6	0.80
chr19	18855290	18855525	CpG: 19	235	19	162	16.2	68.9	0.68
chr19	18864739	18864976	CpG: 18	237	18	142	15.2	59.9	0.88
chr19	18878827	18879075	CpG: 20	248	20	166	16.1	66.9	0.73
chr19	18897804	18898134	CpG: 22	330	22	210	13.3	63.6	0.66
chr19	18904123	18904388	CpG: 22	265	22	198	16.6	74.7	0.70
chr19	18910587	18910968	CpG: 32	381	32	277	16.8	72.7	0.64
chr19	18912818	18913755	CpG: 88	937	88	652	18.8	69.6	0.79
chr19	18921301	18921646	CpG: 36	345	36	235	20.9	68.1	0.92
chr19	18923016	18927072	CpG: 338	4056	338	2689	16.7	66.3	0.76
chr19	18954122	18954361	CpG: 18	239	18	144	15.1	60.3	0.85
chr19	18967234	18968360	CpG: 149	1126	149	829	26.5	73.6	0.98
chr19	18990440	18990890	CpG: 38	450	38	292	16.9	64.9	0.80
chr19	19002274	19002641	CpG: 36	367	36	244	19.6	66.5	0.89
chr19	19004159	19006361	CpG: 221	2202	221	1610	20.1	73.1	0.77
chr19	19030845	19032360	CpG: 196	1515	196	1154	25.9	76.2	0.91
chr19	19054256	19054481	CpG: 19	225	19	135	16.9	60.0	0.96
chr19	19054873	19055756	CpG: 82	883	82	547	18.6	61.9	0.97
chr19	19065172	19065410	CpG: 21	238	21	169	17.6	71.0	0.75
chr19	19067699	19068843	CpG: 80	1144	80	782	14.0	68.4	0.62
chr19	19076010	19077111	CpG: 113	1101	113	796	20.5	72.3	0.82
chr19	19096703	19096943	CpG: 18	240	18	145	15.0	60.4	0.83
chr19	19168909	19169812	CpG: 129	903	129	673	28.6	74.5	1.03
chr19	19199272	19200005	CpG: 74	733	74	522	20.2	71.2	0.80
chr19	19246203	19246582	CpG: 52	379	52	276	27.4	72.8	1.04
chr19	19254197	19254463	CpG: 22	266	22	165	16.5	62.0	0.87
chr19	19257516	19257751	CpG: 17	235	17	163	14.5	69.4	0.60
chr19	19274909	19275170	CpG: 28	261	28	165	21.5	63.2	1.08
chr19	19282278	19282551	CpG: 27	273	27	203	19.8	74.4	0.74
chr19	19306722	19307284	CpG: 47	562	47	369	16.7	65.7	0.78
chr19	19328542	19328888	CpG: 36	346	36	243	20.8	70.2	0.85
chr19	19329090	19329362	CpG: 19	272	19	168	14.0	61.8	0.74
chr19	19339660	19340507	CpG: 66	847	66	493	15.6	58.2	0.92
chr19	19349286	19349527	CpG: 29	241	29	179	24.1	74.3	0.91
chr19	19362389	19362769	CpG: 50	380	50	284	26.3	74.7	0.95
chr19	19395298	19396322	CpG: 107	1024	107	723	20.9	70.6	0.84
chr19	19398316	19399034	CpG: 60	718	60	495	16.7	68.9	0.71
chr19	19400142	19400397	CpG: 29	255	29	188	22.7	73.7	0.84
chr19	19410346	19410926	CpG: 63	580	63	432	21.7	74.5	0.80
chr19	19435674	19435886	CpG: 15	212	15	126	14.2	59.4	0.81
chr19	19443340	19443592	CpG: 18	252	18	174	14.3	69.0	0.61
chr19	19457613	19458841	CpG: 113	1228	113	810	18.4	66.0	0.85
chr19	19522632	19523713	CpG: 130	1081	130	777	24.1	71.9	0.94
chr19	19542697	19544059	CpG: 190	1362	190	1034	27.9	75.9	0.97
chr19	19638613	19638982	CpG: 26	369	26	247	14.1	66.9	0.63
chr19	19639391	19639603	CpG: 23	212	23	141	21.7	66.5	0.99
chr19	19651632	19653936	CpG: 211	2304	211	1491	18.3	64.7	0.88
chr19	19659127	19659341	CpG: 16	214	16	128	15.0	59.8	0.85
chr19	19666230	19666466	CpG: 29	236	29	169	24.6	71.6	0.97
chr19	19666580	19666820	CpG: 16	240	16	156	13.3	65.0	0.63
chr19	19669803	19670006	CpG: 24	203	24	138	23.6	68.0	1.03
chr19	19674813	19678726	CpG: 265	3913	265	2555	13.5	65.3	0.64
chr19	19681446	19683497	CpG: 182	2051	182	1409	17.7	68.7	0.75
chr19	19755827	19756514	CpG: 75	687	75	492	21.8	71.6	0.88
chr19	19764086	19764624	CpG: 38	538	38	356	14.1	66.2	0.65
chr19	19765273	19766667	CpG: 138	1394	138	990	19.8	71.0	0.79
chr19	19772176	19772430	CpG: 22	254	22	167	17.3	65.7	0.80
chr19	19774781	19775832	CpG: 87	1051	87	742	16.6	70.6	0.68
chr19	19780985	19781208	CpG: 31	223	31	174	27.8	78.0	0.93
chr19	19791332	19791574	CpG: 18	242	18	164	14.9	67.8	0.65
chr19	19800692	19801756	CpG: 105	1064	105	724	19.7	68.0	0.85
chr19	19802376	19802642	CpG: 20	266	20	163	15.0	61.3	0.81
chr19	19806177	19806848	CpG: 57	671	57	466	17.0	69.4	0.71
chr19	19808337	19808605	CpG: 19	268	19	158	14.2	59.0	0.83
chr19	19809070	19809323	CpG: 21	253	21	150	16.6	59.3	0.96
chr19	19870198	19870659	CpG: 45	461	45	318	19.5	69.0	0.82
chr19	19871144	19871419	CpG: 22	275	22	166	16.0	60.4	0.88
chr19	19894215	19894481	CpG: 22	266	22	163	16.5	61.3	0.90
chr19	19907241	19908014	CpG: 57	773	57	521	14.7	67.4	0.65
chr19	19945847	19946077	CpG: 18	230	18	139	15.7	60.4	0.87
chr19	19975643	19975917	CpG: 26	274	26	173	19.0	63.1	0.96
chr19	19998476	19998762	CpG: 20	286	20	192	14.0	67.1	0.63
chr19	20012367	20012604	CpG: 17	237	17	140	14.3	59.1	0.85
chr19	20038835	20039163	CpG: 25	328	25	210	15.2	64.0	0.74
chr19	20040500	20040769	CpG: 19	269	19	161	14.1	59.9	0.80
chr19	20067394	20067630	CpG: 21	236	21	144	17.8	61.0	0.98
chr19	20140683	20140909	CpG: 17	226	17	138	15.0	61.1	0.82
chr19	20155835	20156106	CpG: 24	271	24	168	17.7	62.0	0.93
chr19	20176769	20177081	CpG: 33	312	33	222	21.2	71.2	0.84
chr19	20189686	20190022	CpG: 26	336	26	209	15.5	62.2	0.80
chr19	20201874	20202482	CpG: 41	608	41	397	13.5	65.3	0.64
chr19	20203289	20203563	CpG: 24	274	24	171	17.5	62.4	0.91
chr19	20206973	20207260	CpG: 25	287	25	179	17.4	62.4	0.91
chr19	20209980	20210204	CpG: 18	224	18	133	16.1	59.4	0.93
chr19	20222627	20222902	CpG: 19	275	19	167	13.8	60.7	0.76
chr19	20243862	20244097	CpG: 16	235	16	135	13.6	57.4	0.85
chr19	20275158	20275405	CpG: 24	247	24	184	19.4	74.5	0.70
chr19	20281219	20281503	CpG: 27	284	27	178	19.0	62.7	0.98
chr19	20305022	20305281	CpG: 20	259	20	158	15.4	61.0	0.83
chr19	20307425	20307693	CpG: 24	268	24	168	17.9	62.7	0.92
chr19	20313404	20314218	CpG: 57	814	57	553	14.0	67.9	0.61
chr19	20397749	20398030	CpG: 24	281	24	176	17.1	62.6	0.88
chr19	20427637	20427896	CpG: 19	259	19	154	14.7	59.5	0.84
chr19	20433911	20434156	CpG: 23	245	23	188	18.8	76.7	0.64
chr19	20447194	20447468	CpG: 23	274	23	169	16.8	61.7	0.89
chr19	20556536	20556808	CpG: 19	272	19	163	14.0	59.9	0.79
chr19	20561000	20561272	CpG: 25	272	25	156	18.4	57.4	1.12
chr19	20561767	20562146	CpG: 29	379	29	216	15.3	57.0	0.95
chr19	20700743	20701017	CpG: 25	274	25	174	18.2	63.5	0.92
chr19	20798247	20798512	CpG: 19	265	19	153	14.3	57.7	0.86
chr19	20914399	20914700	CpG: 23	301	23	191	15.3	63.5	0.76
chr19	20935029	20935306	CpG: 23	277	23	176	16.6	63.5	0.83
chr19	21091017	21091822	CpG: 59	805	59	543	14.7	67.5	0.64
chr19	21134568	21134791	CpG: 15	223	15	134	13.5	60.1	0.76
chr19	21143611	21143847	CpG: 21	236	21	144	17.8	61.0	0.97
chr19	21193353	21193630	CpG: 21	277	21	167	15.2	60.3	0.86
chr19	21218252	21218466	CpG: 16	214	16	127	15.0	59.3	0.86
chr19	21418554	21418786	CpG: 18	232	18	137	15.5	59.1	0.90
chr19	21582041	21582466	CpG: 35	425	35	312	16.5	73.4	0.61
chr19	21602055	21602263	CpG: 18	208	18	143	17.3	68.8	0.73
chr19	21613300	21614169	CpG: 62	869	62	523	14.3	60.2	0.79
chr19	21621820	21622659	CpG: 61	839	61	567	14.5	67.6	0.64
chr19	21625476	21626209	CpG: 54	733	54	500	14.7	68.2	0.63
chr19	21642576	21642857	CpG: 22	281	22	171	15.7	60.9	0.86
chr19	21644386	21644603	CpG: 17	217	17	139	15.7	64.1	0.77
chr19	21714276	21714557	CpG: 24	281	24	174	17.1	61.9	0.91
chr19	21724866	21725463	CpG: 65	597	65	440	21.8	73.7	0.80
chr19	21745629	21745928	CpG: 27	299	27	221	18.1	73.9	0.66
chr19	21752914	21753116	CpG: 17	202	17	124	16.8	61.4	0.90
chr19	21754339	21754613	CpG: 22	274	22	169	16.1	61.7	0.85
chr19	21797904	21798171	CpG: 19	267	19	164	14.2	61.4	0.77
chr19	21816626	21816843	CpG: 21	217	21	145	19.4	66.8	0.87
chr19	21846482	21846855	CpG: 32	373	32	274	17.2	73.5	0.64
chr19	21884143	21884428	CpG: 23	285	23	177	16.1	62.1	0.85
chr19	21889239	21889658	CpG: 40	419	40	299	19.1	71.4	0.77
chr19	21905717	21906031	CpG: 23	314	23	203	14.6	64.6	0.70
chr19	21913936	21914633	CpG: 53	697	53	461	15.2	66.1	0.70
chr19	21973884	21974492	CpG: 40	608	40	362	13.2	59.5	0.75
chr19	21990060	21990609	CpG: 42	549	42	360	15.3	65.6	0.71
chr19	22079269	22079503	CpG: 22	234	22	161	18.8	68.8	0.81
chr19	22148296	22148507	CpG: 17	211	17	120	16.1	56.9	1.02
chr19	22148918	22149171	CpG: 18	253	18	170	14.2	67.2	0.63
chr19	22191081	22191297	CpG: 17	216	17	148	15.7	68.5	0.68
chr19	22194177	22194445	CpG: 21	268	21	163	15.7	60.8	0.86
chr19	22276336	22276569	CpG: 24	233	24	171	20.6	73.4	0.77
chr19	22400258	22400523	CpG: 31	265	31	202	23.4	76.2	0.85
chr19	22425014	22425511	CpG: 33	497	33	317	13.3	63.8	0.65
chr19	22434097	22434338	CpG: 21	241	21	146	17.4	60.6	0.97
chr19	22460232	22460519	CpG: 25	287	25	207	17.4	72.1	0.69
chr19	22592588	22592820	CpG: 19	232	19	134	16.4	57.8	1.01
chr19	22637590	22637981	CpG: 30	391	30	275	15.3	70.3	0.62
chr19	22656214	22657079	CpG: 81	865	81	616	18.7	71.2	0.74
chr19	22671079	22671392	CpG: 25	313	25	211	16.0	67.4	0.73
chr19	22681000	22681274	CpG: 25	274	25	172	18.2	62.8	0.93
chr19	22723992	22724283	CpG: 25	291	25	178	17.2	61.2	0.93
chr19	22756507	22756856	CpG: 35	349	35	262	20.1	75.1	0.71
chr19	22761616	22762537	CpG: 76	921	76	661	16.5	71.8	0.65
chr19	22773091	22773363	CpG: 20	272	20	189	14.7	69.5	0.61
chr19	22780473	22780713	CpG: 18	240	18	145	15.0	60.4	0.85
chr19	22839001	22839782	CpG: 58	781	58	540	14.9	69.1	0.62
chr19	22847664	22847889	CpG: 22	225	22	158	19.6	70.2	0.80
chr19	22925022	22925263	CpG: 19	241	19	143	15.8	59.3	0.92
chr19	22931780	22931996	CpG: 17	216	17	132	15.7	61.1	0.87
chr19	22949238	22949880	CpG: 69	642	69	480	21.5	74.8	0.78
chr19	23006962	23007198	CpG: 19	236	19	143	16.1	60.6	0.91
chr19	23013486	23014340	CpG: 63	854	63	597	14.8	69.9	0.60
chr19	23035863	23036278	CpG: 40	415	40	294	19.3	70.8	0.78
chr19	23043110	23043336	CpG: 16	226	16	133	14.2	58.8	0.82
chr19	23043416	23043999	CpG: 44	583	44	406	15.1	69.6	0.62
chr19	23143213	23143701	CpG: 34	488	34	311	13.9	63.7	0.69
chr19	23205717	23205953	CpG: 17	236	17	156	14.4	66.1	0.66
chr19	23206198	23206784	CpG: 50	586	50	397	17.1	67.7	0.75
chr19	23210359	23210920	CpG: 47	561	47	380	16.8	67.7	0.73
chr19	23252078	23252482	CpG: 32	404	32	266	15.8	65.8	0.73
chr19	23283705	23283971	CpG: 23	266	23	167	17.3	62.8	0.89
chr19	23330024	23330272	CpG: 20	248	20	146	16.1	58.9	0.93
chr19	23338636	23339056	CpG: 37	420	37	290	17.6	69.0	0.74
chr19	23343199	23343487	CpG: 25	288	25	179	17.4	62.2	0.91
chr19	23384284	23384656	CpG: 26	372	26	211	14.0	56.7	0.87
chr19	23408594	23408888	CpG: 32	294	32	209	21.8	71.1	0.86
chr19	23557042	23557505	CpG: 46	463	46	360	19.9	77.8	0.66
chr19	23610403	23610956	CpG: 44	553	44	352	15.9	63.7	0.79
chr19	23697374	23697648	CpG: 26	274	26	173	19.0	63.1	0.96
chr19	23808081	23808469	CpG: 34	388	34	277	17.5	71.4	0.69
chr19	23816350	23816593	CpG: 18	243	18	144	14.8	59.3	0.87
chr19	23839849	23840125	CpG: 21	276	21	168	15.2	60.9	0.83
chr19	23873926	23874207	CpG: 24	281	24	175	17.1	62.3	0.90
chr19	23898750	23899151	CpG: 29	401	29	252	14.5	62.8	0.73
chr19	23903380	23903795	CpG: 32	415	32	277	15.4	66.7	0.69
chr19	23909063	23909337	CpG: 22	274	22	169	16.1	61.7	0.86
chr19	23995713	23995927	CpG: 31	214	31	166	29.0	77.6	0.97
chr19	24117218	24117520	CpG: 32	302	32	209	21.2	69.2	0.89
chr19	24159468	24159742	CpG: 22	274	22	169	16.1	61.7	0.85
chr19	24188951	24189334	CpG: 32	383	32	276	16.7	72.1	0.64
chr19	24232255	24232488	CpG: 20	233	20	141	17.2	60.5	0.95
chr19	30153615	30153894	CpG: 24	279	24	175	17.2	62.7	0.88
chr19	30160113	30160391	CpG: 26	278	26	176	18.7	63.3	0.94
chr19	30321414	30322015	CpG: 42	601	42	367	14.0	61.1	0.79
chr19	30333730	30333990	CpG: 19	260	19	175	14.6	67.3	0.65
chr19	30439047	30439871	CpG: 64	824	64	586	15.5	71.1	0.64
chr19	31063340	31063579	CpG: 17	239	17	146	14.2	61.1	0.78
chr19	31158842	31159120	CpG: 24	278	24	174	17.3	62.6	0.89
chr19	31256982	31257785	CpG: 78	803	78	553	19.4	68.9	0.82
chr19	31323383	31324080	CpG: 95	697	95	532	27.3	76.3	0.94
chr19	31483889	31484120	CpG: 16	231	16	141	13.9	61.0	0.76
chr19	31624076	31624395	CpG: 31	319	31	212	19.4	66.5	0.92
chr19	31743765	31744526	CpG: 93	761	93	556	24.4	73.1	0.92
chr19	32050472	32056058	CpG: 502	5586	502	3843	18.0	68.8	0.76
chr19	32069841	32070111	CpG: 20	270	20	164	14.8	60.7	0.82
chr19	32131456	32131947	CpG: 41	491	41	309	16.7	62.9	0.86
chr19	32135901	32136120	CpG: 20	219	20	156	18.3	71.2	0.72
chr19	32190879	32191636	CpG: 91	757	91	573	24.0	75.7	0.84
chr19	32199609	32200397	CpG: 75	788	75	533	19.0	67.6	0.83
chr19	32240717	32241330	CpG: 70	613	70	479	22.8	78.1	0.75
chr19	32243627	32243864	CpG: 20	237	20	143	16.9	60.3	0.96
chr19	32250067	32250429	CpG: 35	362	35	233	19.3	64.4	0.93
chr19	32337119	32338504	CpG: 215	1385	215	1115	31.0	80.5	0.96
chr19	32368781	32369110	CpG: 27	329	27	230	16.4	69.9	0.67
chr19	32369587	32370556	CpG: 110	969	110	734	22.7	75.7	0.81
chr19	32397513	32399273	CpG: 144	1760	144	1192	16.4	67.7	0.71
chr19	32462542	32463403	CpG: 118	861	118	652	27.4	75.7	0.96
chr19	32469347	32470219	CpG: 72	872	72	622	16.5	71.3	0.65
chr19	32592955	32593229	CpG: 23	274	23	170	16.8	62.0	0.88
chr19	32650033	32650264	CpG: 19	231	19	140	16.5	60.6	0.90
chr19	32733580	32733820	CpG: 19	240	19	147	15.8	61.2	0.88
chr19	32742951	32743408	CpG: 51	457	51	352	22.3	77.0	0.75
chr19	32745095	32745299	CpG: 21	204	21	114	20.6	55.9	1.33
chr19	32745873	32749516	CpG: 324	3643	324	2295	17.8	63.0	0.92
chr19	32781471	32781749	CpG: 23	278	23	173	16.5	62.2	0.86
chr19	32895310	32896117	CpG: 101	807	101	591	25.0	73.2	0.93
chr19	32930997	32931275	CpG: 26	278	26	175	18.7	62.9	0.96
chr19	32964392	32966196	CpG: 131	1804	131	1165	14.5	64.6	0.70
chr19	32971423	32971751	CpG: 30	328	30	225	18.3	68.6	0.78
chr19	33046997	33047271	CpG: 24	274	24	170	17.5	62.0	0.92
chr19	33135554	33135827	CpG: 24	273	24	168	17.6	61.5	0.94
chr19	33240145	33240512	CpG: 46	367	46	272	25.1	74.1	0.93
chr19	33718026	33718307	CpG: 22	281	22	173	15.7	61.6	0.84
chr19	33797612	33797906	CpG: 22	294	22	181	15.0	61.6	0.79
chr19	33867312	33870726	CpG: 394	3414	394	2492	23.1	73.0	0.87
chr19	33871557	33871860	CpG: 31	303	31	188	20.5	62.0	1.06
chr19	33875623	33875886	CpG: 26	263	26	176	19.8	66.9	0.89
chr19	34743009	34743425	CpG: 43	416	43	262	20.7	63.0	1.05
chr19	34836512	34836781	CpG: 23	269	23	172	17.1	63.9	0.85
chr19	34860054	34860327	CpG: 24	273	24	171	17.6	62.6	0.90
chr19	34864065	34864515	CpG: 52	450	52	334	23.1	74.2	0.84
chr19	34923724	34924982	CpG: 154	1258	154	923	24.5	73.4	0.91
chr19	35009279	35009553	CpG: 22	274	22	169	16.1	61.7	0.85
chr19	35099483	35100667	CpG: 113	1184	113	806	19.1	68.1	0.82
chr19	35124327	35124563	CpG: 16	236	16	156	13.6	66.1	0.62
chr19	35193093	35195926	CpG: 308	2833	308	1997	21.7	70.5	0.88
chr19	35210438	35211391	CpG: 113	953	113	702	23.7	73.7	0.89
chr19	35238282	35238895	CpG: 58	613	58	448	18.9	73.1	0.71
chr19	35239610	35239909	CpG: 28	299	28	210	18.7	70.2	0.76
chr19	35378542	35378755	CpG: 15	213	15	132	14.1	62.0	0.74
chr19	35431489	35431726	CpG: 17	237	17	147	14.3	62.0	0.78
chr19	35490484	35491077	CpG: 48	593	48	363	16.2	61.2	0.86
chr19	35555336	35555690	CpG: 33	354	33	259	18.6	73.2	0.70
chr19	35582478	35584557	CpG: 199	2079	199	1430	19.1	68.8	0.81
chr19	35584794	35585125	CpG: 25	331	25	197	15.1	59.5	0.87
chr19	35599537	35600179	CpG: 55	642	55	427	17.1	66.5	0.80
chr19	35650597	35651010	CpG: 48	413	48	289	23.2	70.0	0.95
chr19	35653238	35653576	CpG: 34	338	34	249	20.1	73.7	0.75
chr19	35662763	35663025	CpG: 18	262	18	153	13.7	58.4	0.82
chr19	35695172	35696395	CpG: 110	1223	110	804	18.0	65.7	0.84
chr19	35703057	35703336	CpG: 19	279	19	157	13.6	56.3	0.86
chr19	35712656	35713816	CpG: 174	1160	174	955	30.0	82.3	0.89
chr19	35723921	35725925	CpG: 155	2004	155	1387	15.5	69.2	0.65
chr19	35744154	35746118	CpG: 164	1964	164	1369	16.7	69.7	0.69
chr19	35754486	35754932	CpG: 32	446	32	292	14.3	65.5	0.68
chr19	35793226	35793428	CpG: 16	202	16	146	15.8	72.3	0.63
chr19	35820927	35823810	CpG: 354	2883	354	2125	24.6	73.7	0.90
chr19	35842260	35842486	CpG: 19	226	19	138	16.8	61.1	0.94
chr19	35892212	35894057	CpG: 192	1845	192	1199	20.8	65.0	0.99
chr19	35907657	35907860	CpG: 22	203	22	141	21.7	69.5	0.90
chr19	35921441	35921646	CpG: 17	205	17	131	16.6	63.9	0.82
chr19	36042120	36042785	CpG: 70	665	70	482	21.1	72.5	0.80
chr19	36142069	36144143	CpG: 249	2074	249	1506	24.0	72.6	0.91
chr19	36205135	36205559	CpG: 31	424	31	254	14.6	59.9	0.82
chr19	36264050	36264288	CpG: 17	238	17	145	14.3	60.9	0.79
chr19	36292808	36293771	CpG: 93	963	93	642	19.3	66.7	0.88
chr19	36298560	36299154	CpG: 50	594	50	412	16.8	69.4	0.70
chr19	36316053	36319348	CpG: 356	3295	356	2297	21.6	69.7	0.90
chr19	36332034	36332434	CpG: 43	400	43	280	21.5	70.0	0.88
chr19	36340607	36341380	CpG: 59	773	59	542	15.3	70.1	0.62
chr19	36426347	36428187	CpG: 150	1840	150	1264	16.3	68.7	0.69
chr19	36567901	36568142	CpG: 20	241	20	145	16.6	60.2	0.94
chr19	36568682	36568912	CpG: 19	230	19	137	16.5	59.6	0.97
chr19	36589742	36589975	CpG: 19	233	19	143	16.3	61.4	0.88
chr19	36652678	36653665	CpG: 78	987	78	700	15.8	70.9	0.63
chr19	36654793	36655352	CpG: 54	559	54	389	19.3	69.6	0.80
chr19	36692526	36693655	CpG: 138	1129	138	798	24.4	70.7	0.98
chr19	36781655	36782640	CpG: 137	985	137	780	27.8	79.2	0.90
chr19	36807026	36807300	CpG: 23	274	23	170	16.8	62.0	0.88
chr19	36871591	36871866	CpG: 23	275	23	170	16.7	61.8	0.88
chr19	36886451	36886967	CpG: 56	516	56	355	21.7	68.8	0.95
chr19	36892287	36893292	CpG: 96	1005	96	704	19.1	70.0	0.79
chr19	36948811	36949471	CpG: 67	660	67	461	20.3	69.8	0.84
chr19	36949732	36950006	CpG: 20	274	20	165	14.6	60.2	0.81
chr19	36972790	36973656	CpG: 94	866	94	605	21.7	69.9	0.89
chr19	37002853	37003095	CpG: 20	242	20	148	16.5	61.2	0.90
chr19	37025712	37027303	CpG: 230	1591	230	1255	28.9	78.9	0.93
chr19	37042386	37042589	CpG: 14	203	14	136	13.8	67.0	0.63
chr19	37043158	37043375	CpG: 19	217	19	136	17.5	62.7	0.92
chr19	37044534	37044760	CpG: 17	226	17	151	15.0	66.8	0.67
chr19	37122096	37122587	CpG: 47	491	47	357	19.1	72.7	0.73
chr19	37212758	37213100	CpG: 29	342	29	247	17.0	72.2	0.65
chr19	37221827	37222844	CpG: 98	1017	98	624	19.3	61.4	1.04
chr19	37278596	37279184	CpG: 60	588	60	391	20.4	66.5	0.93
chr19	37317331	37317958	CpG: 65	627	65	413	20.7	65.9	0.96
chr19	37377219	37377640	CpG: 36	421	36	278	17.1	66.0	0.80
chr19	37383411	37383869	CpG: 41	458	41	297	17.9	64.8	0.86
chr19	37404896	37405207	CpG: 26	311	26	191	16.7	61.4	0.90
chr19	37421682	37421922	CpG: 19	240	19	146	15.8	60.8	0.87
chr19	37449590	37450128	CpG: 50	538	50	343	18.6	63.8	0.94
chr19	37466550	37467451	CpG: 67	901	67	621	14.9	68.9	0.63
chr19	37471430	37471946	CpG: 51	516	51	342	19.8	66.3	0.90
chr19	37508176	37509012	CpG: 79	836	79	602	18.9	72.0	0.73
chr19	37544823	37545731	CpG: 94	908	94	700	20.7	77.1	0.71
chr19	37566301	37566521	CpG: 21	220	21	156	19.1	70.9	0.77
chr19	37574876	37575921	CpG: 139	1045	139	815	26.6	78.0	0.88
chr19	37577158	37577367	CpG: 16	209	16	133	15.3	63.6	0.80
chr19	37585494	37585705	CpG: 19	211	19	145	18.0	68.7	0.81
chr19	37604265	37604547	CpG: 25	282	25	200	17.7	70.9	0.71
chr19	37669187	37669440	CpG: 23	253	23	167	18.2	66.0	0.84
chr19	37671028	37671415	CpG: 37	387	37	284	19.1	73.4	0.71
chr19	37685825	37686302	CpG: 40	477	40	346	16.8	72.5	0.70
chr19	37699319	37699769	CpG: 37	450	37	315	16.4	70.0	0.77
chr19	37724894	37725156	CpG: 19	262	19	157	14.5	59.9	0.82
chr19	37769374	37769871	CpG: 34	497	34	334	13.7	67.2	0.61
chr19	37792541	37794299	CpG: 138	1758	138	1159	15.7	65.9	0.73
chr19	37796532	37796806	CpG: 23	274	23	170	16.8	62.0	0.88
chr19	37811802	37814633	CpG: 348	2831	348	2118	24.6	74.8	0.88
chr19	37823312	37823966	CpG: 47	654	47	428	14.4	65.4	0.67
chr19	37840314	37840725	CpG: 29	411	29	268	14.1	65.2	0.67
chr19	37844488	37845053	CpG: 44	565	44	412	15.6	72.9	0.62
chr19	37854531	37854843	CpG: 33	312	33	216	21.2	69.2	0.89
chr19	37896260	37897017	CpG: 55	757	55	527	14.5	69.6	0.61
chr19	38041108	38041383	CpG: 22	275	22	169	16.0	61.5	0.87
chr19	38078228	38079141	CpG: 64	913	64	578	14.0	63.3	0.70
chr19	38090046	38091033	CpG: 102	987	102	683	20.7	69.2	0.86
chr19	38102610	38103727	CpG: 89	1117	89	763	15.9	68.3	0.71
chr19	38126325	38126564	CpG: 16	239	16	139	13.4	58.2	0.81
chr19	38157599	38157849	CpG: 33	250	33	175	26.4	70.0	1.10
chr19	38173952	38174327	CpG: 40	375	40	249	21.3	66.4	0.98
chr19	38182154	38182468	CpG: 24	314	24	196	15.3	62.4	0.79
chr19	38188223	38189852	CpG: 127	1629	127	1078	15.6	66.2	0.71
chr19	38192404	38192690	CpG: 20	286	20	159	14.0	55.6	0.93
chr19	38218148	38218357	CpG: 20	209	20	146	19.1	69.9	0.78
chr19	38234362	38234636	CpG: 25	274	25	172	18.2	62.8	0.94
chr19	38236398	38236794	CpG: 41	396	41	297	20.7	75.0	0.74
chr19	38247468	38248130	CpG: 52	662	52	425	15.7	64.2	0.77
chr19	38249692	38249900	CpG: 21	208	21	143	20.2	68.8	0.85
chr19	38261496	38264112	CpG: 269	2616	269	1860	20.6	71.1	0.82
chr19	38265099	38265338	CpG: 19	239	19	167	15.9	69.9	0.66
chr19	38269039	38269325	CpG: 24	286	24	197	16.8	68.9	0.71
chr19	38283387	38283917	CpG: 36	530	36	320	13.6	60.4	0.75
chr19	38285599	38286632	CpG: 83	1033	83	676	16.1	65.4	0.77
chr19	38290216	38290957	CpG: 56	741	56	457	15.1	61.7	0.80
chr19	38294080	38294292	CpG: 17	212	17	131	16.0	61.8	0.86
chr19	38300740	38302394	CpG: 134	1654	134	1121	16.2	67.8	0.72
chr19	38303390	38303718	CpG: 32	328	32	222	19.5	67.7	0.87
chr19	38320634	38321169	CpG: 74	535	74	402	27.7	75.1	0.98
chr19	38389846	38390173	CpG: 30	327	30	226	18.3	69.1	0.77
chr19	38391127	38391990	CpG: 80	863	80	598	18.5	69.3	0.77
chr19	38401894	38402951	CpG: 76	1057	76	719	14.4	68.0	0.62
chr19	38406290	38407017	CpG: 60	727	60	487	16.5	67.0	0.76
chr19	38414084	38414627	CpG: 67	543	67	422	24.7	77.7	0.84
chr19	38415116	38415687	CpG: 47	571	47	389	16.5	68.1	0.72
chr19	38420305	38420676	CpG: 30	371	30	248	16.2	66.8	0.72
chr19	38444402	38444824	CpG: 32	422	32	275	15.2	65.2	0.72
chr19	38445471	38446452	CpG: 87	981	87	685	17.7	69.8	0.74
chr19	38465783	38465996	CpG: 16	213	16	129	15.0	60.6	0.83
chr19	38477293	38477590	CpG: 35	297	35	203	23.6	68.4	1.01
chr19	38482056	38482605	CpG: 64	549	64	423	23.3	77.0	0.80
chr19	38485297	38486284	CpG: 87	987	87	696	17.6	70.5	0.72
chr19	38490340	38490787	CpG: 56	447	56	323	25.1	72.3	0.97
chr19	38504759	38506023	CpG: 123	1264	123	867	19.5	68.6	0.83
chr19	38532982	38533215	CpG: 29	233	29	175	24.9	75.1	0.89
chr19	38539800	38541748	CpG: 163	1948	163	1256	16.7	64.5	0.80
chr19	38555066	38555427	CpG: 49	361	49	276	27.1	76.5	0.99
chr19	38560097	38560378	CpG: 24	281	24	188	17.1	66.9	0.76
chr19	38578288	38578784	CpG: 37	496	37	349	14.9	70.4	0.61
chr19	38599898	38600962	CpG: 111	1064	111	699	20.9	65.7	0.97
chr19	38614730	38615693	CpG: 80	963	80	680	16.6	70.6	0.67
chr19	38659275	38661822	CpG: 193	2547	193	1615	15.2	63.4	0.76
chr19	38667257	38667847	CpG: 53	590	53	408	18.0	69.2	0.76
chr19	38673642	38674048	CpG: 39	406	39	262	19.2	64.5	0.93
chr19	38685334	38687044	CpG: 133	1710	133	1113	15.6	65.1	0.74
chr19	38689534	38689788	CpG: 20	254	20	148	15.7	58.3	0.95
chr19	38697243	38698502	CpG: 88	1259	88	837	14.0	66.5	0.64
chr19	38762938	38763767	CpG: 75	829	75	521	18.1	62.8	0.93
chr19	38771831	38772064	CpG: 18	233	18	137	15.5	58.8	0.91
chr19	38793534	38794692	CpG: 97	1158	97	731	16.8	63.1	0.85
chr19	38803736	38804030	CpG: 26	294	26	182	17.7	61.9	0.93
chr19	38804224	38804426	CpG: 16	202	16	119	15.8	58.9	0.97
chr19	38805230	38806459	CpG: 100	1229	100	810	16.3	65.9	0.75
chr19	38814308	38984832	CpG: 11872	170524	11872	110159	13.9	64.6	0.67
chr19	39006388	39006683	CpG: 24	295	24	193	16.3	65.4	0.76
chr19	39038106	39038382	CpG: 24	276	24	165	17.4	59.8	0.99
chr19	39050483	39050750	CpG: 20	267	20	166	15.0	62.2	0.78
chr19	39053559	39054445	CpG: 72	886	72	563	16.3	63.5	0.81
chr19	39082019	39082293	CpG: 23	274	23	170	16.8	62.0	0.88
chr19	39093312	39093885	CpG: 66	573	66	409	23.0	71.4	0.90
chr19	39096292	39096913	CpG: 74	621	74	426	23.8	68.6	1.01
chr19	39113438	39113680	CpG: 17	242	17	141	14.0	58.3	0.84
chr19	39157371	39157601	CpG: 18	230	18	139	15.7	60.4	0.87
chr19	39164516	39165059	CpG: 44	543	44	337	16.2	62.1	0.86
chr19	39165818	39166813	CpG: 80	995	80	712	16.1	71.6	0.63
chr19	39203263	39204177	CpG: 65	914	65	561	14.2	61.4	0.76
chr19	39230580	39230870	CpG: 25	290	25	181	17.2	62.4	0.90
chr19	39248270	39249127	CpG: 69	857	69	561	16.1	65.5	0.75
chr19	39280063	39280972	CpG: 87	909	87	624	19.1	68.6	0.81
chr19	39331304	39331566	CpG: 24	262	24	164	18.3	62.6	0.95
chr19	39342015	39342744	CpG: 58	729	58	427	15.9	58.6	0.94
chr19	39342961	39343232	CpG: 24	271	24	168	17.7	62.0	0.93
chr19	39362490	39362975	CpG: 53	485	53	327	21.9	67.4	0.96
chr19	39363811	39364050	CpG: 20	239	20	142	16.7	59.4	0.97
chr19	39447762	39448464	CpG: 53	702	53	428	15.1	61.0	0.83
chr19	39450975	39451421	CpG: 46	446	46	307	20.6	68.8	0.88
chr19	39466134	39467039	CpG: 63	905	63	506	13.9	55.9	0.90
chr19	39467619	39467878	CpG: 19	259	19	164	14.7	63.3	0.73
chr19	39471496	39473503	CpG: 152	2007	152	1144	15.1	57.0	0.94
chr19	39513674	39514294	CpG: 48	620	48	365	15.5	58.9	0.95
chr19	39520448	39520722	CpG: 23	274	23	170	16.8	62.0	0.88
chr19	39525698	39526042	CpG: 26	344	26	223	15.1	64.8	0.72
chr19	39526511	39526780	CpG: 21	269	21	160	15.6	59.5	0.98
chr19	39591703	39592235	CpG: 48	532	48	341	18.0	64.1	0.88
chr19	39647873	39648930	CpG: 75	1057	75	694	14.2	65.7	0.68
chr19	39682540	39683097	CpG: 47	557	47	365	16.9	65.5	0.79
chr19	39684917	39685467	CpG: 39	550	39	349	14.2	63.5	0.71
chr19	39689433	39689695	CpG: 24	262	24	169	18.3	64.5	0.90
chr19	39734195	39734729	CpG: 55	534	55	361	20.6	67.6	0.90
chr19	39753053	39753650	CpG: 56	597	56	410	18.8	68.7	0.80
chr19	39829985	39830247	CpG: 19	262	19	162	14.5	61.8	0.77
chr19	39884736	39884956	CpG: 16	220	16	131	14.5	59.5	0.83
chr19	39892927	39893225	CpG: 25	298	25	196	16.8	65.8	0.78
chr19	39927134	39927425	CpG: 28	291	28	198	19.2	68.0	0.83
chr19	39943963	40106034	CpG: 11300	162071	11300	103888	13.9	64.1	0.68
chr19	40107960	40108476	CpG: 41	516	41	310	15.9	60.1	0.88
chr19	40114138	40114444	CpG: 22	306	22	187	14.4	61.1	0.77
chr19	40117916	40119658	CpG: 126	1742	126	998	14.5	57.3	0.88
chr19	40135711	40136366	CpG: 45	655	45	395	13.7	60.3	0.76
chr19	40172303	40172845	CpG: 57	542	57	374	21.0	69.0	0.89
chr19	40204940	40205462	CpG: 44	522	44	325	16.9	62.3	0.88
chr19	40205639	40205883	CpG: 17	244	17	146	13.9	59.8	0.79
chr19	40268323	40271212	CpG: 190	2889	190	1707	13.2	59.1	0.75
chr19	40308388	40308723	CpG: 26	335	26	201	15.5	60.0	0.93
chr19	40342079	40342363	CpG: 26	284	26	177	18.3	62.3	0.96
chr19	40350477	40351311	CpG: 67	834	67	521	16.1	62.5	0.83
chr19	40353024	40353542	CpG: 53	518	53	358	20.5	69.1	0.86
chr19	40386441	40386721	CpG: 22	280	22	172	15.7	61.4	0.84
chr19	40395192	40395462	CpG: 21	270	21	166	15.6	61.5	0.82
chr19	40396011	40397012	CpG: 75	1001	75	590	15.0	58.9	0.86
chr19	40431074	40431615	CpG: 37	541	37	311	13.7	57.5	0.85
chr19	40456670	40458063	CpG: 118	1393	118	905	16.9	65.0	0.80
chr19	40489256	40489529	CpG: 20	273	20	166	14.7	60.8	0.81
chr19	40493645	40494179	CpG: 47	534	47	322	17.6	60.3	0.99
chr19	40520960	40521545	CpG: 50	585	50	381	17.1	65.1	0.82
chr19	40581160	40581498	CpG: 26	338	26	204	15.4	60.4	0.89
chr19	40591985	40592319	CpG: 34	334	34	224	20.4	67.1	0.91
chr19	40618773	40619421	CpG: 58	648	58	434	17.9	67.0	0.80
chr19	40639060	40639490	CpG: 33	430	33	261	15.3	60.7	0.84
chr19	40656312	40657600	CpG: 98	1288	98	791	15.2	61.4	0.81
chr19	40708415	40709697	CpG: 151	1282	151	891	23.6	69.5	0.98
chr19	40883820	40885215	CpG: 125	1395	125	958	17.9	68.7	0.76
chr19	40925908	40926934	CpG: 79	1026	79	720	15.4	70.2	0.63
chr19	40989600	40989829	CpG: 17	229	17	141	14.8	61.6	0.79
chr19	40995643	40995888	CpG: 26	245	26	184	21.2	75.1	0.79
chr19	41011851	41012095	CpG: 21	244	21	171	17.2	70.1	0.77
chr19	41013401	41013779	CpG: 30	378	30	277	15.9	73.3	0.61
chr19	41024589	41024980	CpG: 44	391	44	287	22.5	73.4	0.85
chr19	41026070	41026657	CpG: 60	587	60	427	20.4	72.7	0.80
chr19	41030615	41032153	CpG: 149	1538	149	1117	19.4	72.6	0.75
chr19	41058169	41059079	CpG: 94	910	94	629	20.7	69.1	0.87
chr19	41063589	41064092	CpG: 36	503	36	287	14.3	57.1	0.91
chr19	41066377	41067230	CpG: 97	853	97	622	22.7	72.9	0.86
chr19	41071800	41072075	CpG: 20	275	20	168	14.5	61.1	0.79
chr19	41117153	41117376	CpG: 16	223	16	141	14.3	63.2	0.73
chr19	41117969	41118281	CpG: 44	312	44	236	28.2	75.6	1.04
chr19	41121911	41122484	CpG: 68	573	68	412	23.7	71.9	0.92
chr19	41137421	41137668	CpG: 18	247	18	144	14.6	58.3	0.88
chr19	41137839	41139465	CpG: 113	1626	113	1050	13.9	64.6	0.78
chr19	41163843	41165017	CpG: 103	1174	103	789	17.5	67.2	0.79
chr19	41176796	41177396	CpG: 64	600	64	406	21.3	67.7	0.96
chr19	41187605	41191094	CpG: 266	3489	266	2366	15.2	67.8	0.66
chr19	41196770	41197042	CpG: 26	272	26	199	19.1	73.2	0.72
chr19	41197646	41198394	CpG: 96	748	96	563	25.7	75.3	0.91
chr19	41205016	41205919	CpG: 100	903	100	649	22.1	71.9	0.87
chr19	41220020	41220773	CpG: 51	753	51	495	13.5	65.7	0.66
chr19	41235784	41236064	CpG: 22	280	22	193	15.7	68.9	0.67
chr19	41254889	41255291	CpG: 32	402	32	274	15.9	68.2	0.70
chr19	41268323	41268584	CpG: 24	261	24	178	18.4	68.2	0.79
chr19	41285486	41285703	CpG: 19	217	19	147	17.5	67.7	0.76
chr19	41287799	41288342	CpG: 48	543	48	373	17.7	68.7	0.76
chr19	41301810	41302020	CpG: 19	210	19	147	18.1	70.0	0.76
chr19	41304710	41305134	CpG: 34	424	34	284	16.0	67.0	0.73
chr19	41321416	41321682	CpG: 22	266	22	183	16.5	68.8	0.70
chr19	41365146	41365600	CpG: 42	454	42	289	18.5	63.7	0.93
chr19	41368841	41369721	CpG: 130	880	130	669	29.5	76.0	1.05
chr19	41400214	41400640	CpG: 37	426	37	295	17.4	69.2	0.72
chr19	41422770	41423200	CpG: 51	430	51	280	23.7	65.1	1.12
chr19	41451402	41452055	CpG: 83	653	83	479	25.4	73.4	1.02
chr19	41530932	41531259	CpG: 26	327	26	209	15.9	63.9	0.82
chr19	41539680	41540492	CpG: 95	812	95	647	23.4	79.7	0.82
chr19	41573792	41576049	CpG: 169	2257	169	1476	15.0	65.4	0.70
chr19	41594783	41597078	CpG: 164	2295	164	1492	14.3	65.0	0.68
chr19	41601746	41602751	CpG: 80	1005	80	715	15.9	71.1	0.63
chr19	41625556	41625896	CpG: 30	340	30	253	17.6	74.4	0.64
chr19	41635676	41636147	CpG: 44	471	44	292	18.7	62.0	0.97
chr19	41636922	41637161	CpG: 18	239	18	148	15.1	61.9	0.80
chr19	41653340	41656674	CpG: 301	3334	301	2180	18.1	65.4	0.85
chr19	41659597	41660610	CpG: 88	1013	88	731	17.4	72.2	0.67
chr19	41673332	41674576	CpG: 94	1244	94	829	15.1	66.6	0.68
chr19	41703448	41704310	CpG: 74	862	74	565	17.2	65.5	0.80
chr19	41709213	41709438	CpG: 21	225	21	161	18.7	71.6	0.74
chr19	41711207	41711631	CpG: 34	424	34	287	16.0	67.7	0.70
chr19	41716018	41716327	CpG: 28	309	28	225	18.1	72.8	0.69
chr19	41727214	41727489	CpG: 23	275	23	171	16.7	62.2	0.87
chr19	41734392	41734944	CpG: 58	552	58	350	21.0	63.4	1.05
chr19	41753718	41754325	CpG: 68	607	68	440	22.4	72.5	0.86
chr19	41779156	41779961	CpG: 79	805	79	578	19.6	71.8	0.77
chr19	41835582	41836545	CpG: 93	963	93	699	19.3	72.6	0.75
chr19	41888013	41888450	CpG: 44	437	44	321	20.1	73.5	0.76
chr19	41902904	41903235	CpG: 33	331	33	235	19.9	71.0	0.81
chr19	41929616	41930158	CpG: 58	542	58	374	21.4	69.0	1.00
chr19	41973669	41973878	CpG: 24	209	24	143	23.0	68.4	0.99
chr19	41977115	41977330	CpG: 23	215	23	154	21.4	71.6	0.84
chr19	42001109	42001476	CpG: 46	367	46	277	25.1	75.5	0.88
chr19	42004488	42004901	CpG: 30	413	30	268	14.5	64.9	0.69
chr19	42007988	42008506	CpG: 50	518	50	357	19.3	68.9	0.83
chr19	42051318	42052917	CpG: 137	1599	137	1111	17.1	69.5	0.71
chr19	42068598	42070165	CpG: 142	1567	142	1081	18.1	69.0	0.76
chr19	42111413	42112877	CpG: 157	1464	157	1041	21.4	71.1	0.85
chr19	42118248	42119581	CpG: 122	1333	122	918	18.3	68.9	0.78
chr19	42124623	42125406	CpG: 109	783	109	626	27.8	79.9	0.90
chr19	42146132	42147307	CpG: 151	1175	151	900	25.7	76.6	0.88
chr19	42194972	42195804	CpG: 72	832	72	532	17.3	63.9	0.86
chr19	42206824	42207256	CpG: 45	432	45	303	20.8	70.1	0.90
chr19	42208201	42208411	CpG: 24	210	24	153	22.9	72.9	0.88
chr19	42210881	42212582	CpG: 116	1701	116	1133	13.6	66.6	0.63
chr19	42213779	42214511	CpG: 75	732	75	515	20.5	70.4	0.84
chr19	42216445	42218112	CpG: 136	1667	136	1124	16.3	67.4	0.72
chr19	42239278	42239549	CpG: 19	271	19	157	14.0	57.9	0.84
chr19	42239847	42240486	CpG: 57	639	57	420	17.8	65.7	0.83
chr19	42248157	42248394	CpG: 18	237	18	140	15.2	59.1	0.89
chr19	42249553	42250260	CpG: 62	707	62	446	17.5	63.1	0.89
chr19	42284961	42285333	CpG: 46	372	46	264	24.7	71.0	0.98
chr19	42286629	42286870	CpG: 19	241	19	146	15.8	60.6	0.88
chr19	42303014	42303757	CpG: 63	743	63	523	17.0	70.4	0.69
chr19	42306974	42307382	CpG: 59	408	59	312	28.9	76.5	0.99
chr19	42310184	42310448	CpG: 19	264	19	160	14.4	60.6	0.79
chr19	42311207	42311908	CpG: 94	701	94	518	26.8	73.9	0.98
chr19	42319268	42320246	CpG: 90	978	90	687	18.4	70.2	0.78
chr19	42336570	42337285	CpG: 69	715	69	459	19.3	64.2	0.94
chr19	42343744	42344603	CpG: 90	859	90	581	21.0	67.6	0.93
chr19	42413009	42413278	CpG: 23	269	23	167	17.1	62.1	0.89
chr19	42571212	42571442	CpG: 19	230	19	140	16.5	60.9	0.90
chr19	42599707	42599971	CpG: 21	264	21	162	15.9	61.4	0.86
chr19	42629208	42629426	CpG: 21	218	21	146	19.3	67.0	0.87
chr19	42631638	42631895	CpG: 30	257	30	198	23.3	77.0	0.79
chr19	42638189	42639287	CpG: 86	1098	86	766	15.7	69.8	0.65
chr19	42651159	42651493	CpG: 42	334	42	235	25.1	70.4	1.05
chr19	42676979	42677570	CpG: 41	591	41	392	13.9	66.3	0.63
chr19	42680310	42680892	CpG: 59	582	59	411	20.3	70.6	0.81
chr19	42691139	42691408	CpG: 20	269	20	174	14.9	64.7	0.71
chr19	42694488	42694738	CpG: 21	250	21	171	16.8	68.4	0.72
chr19	42696552	42697135	CpG: 60	583	60	408	20.6	70.0	0.84
chr19	42706832	42707101	CpG: 19	269	19	171	14.1	63.6	0.70
chr19	42710180	42710430	CpG: 21	250	21	171	16.8	68.4	0.72
chr19	42712243	42712826	CpG: 60	583	60	408	20.6	70.0	0.84
chr19	42726008	42726214	CpG: 16	206	16	139	15.5	67.5	0.68
chr19	42735347	42736059	CpG: 74	712	74	506	20.8	71.1	0.82
chr19	42744582	42744899	CpG: 35	317	35	216	22.1	68.1	0.95
chr19	42790814	42791231	CpG: 39	417	39	268	18.7	64.3	0.92
chr19	42816847	42817593	CpG: 57	746	57	449	15.3	60.2	0.84
chr19	42876121	42876451	CpG: 31	330	31	210	18.8	63.6	0.99
chr19	42910840	42911163	CpG: 26	323	26	210	16.1	65.0	0.82
chr19	42925532	42925790	CpG: 23	258	23	161	17.8	62.4	0.93
chr19	42990632	42991175	CpG: 50	543	50	401	18.4	73.8	0.68
chr19	43011411	43012793	CpG: 162	1382	162	1043	23.4	75.5	0.82
chr19	43026425	43026642	CpG: 18	217	18	148	16.6	68.2	0.74
chr19	43034018	43034719	CpG: 96	701	96	538	27.4	76.7	0.94
chr19	43037682	43038993	CpG: 117	1311	117	923	17.8	70.4	0.73
chr19	43042829	43043212	CpG: 35	383	35	255	18.3	66.6	0.85
chr19	43043681	43044024	CpG: 38	343	38	246	22.2	71.7	0.87
chr19	43044979	43045306	CpG: 23	327	23	211	14.1	64.5	0.68
chr19	43046668	43047258	CpG: 57	590	57	409	19.3	69.3	0.82
chr19	43105330	43106200	CpG: 99	870	99	624	22.8	71.7	0.90
chr19	43156151	43156417	CpG: 18	266	18	156	13.5	58.6	0.81
chr19	43168736	43169347	CpG: 73	611	73	437	23.9	71.5	0.95
chr19	43185027	43185312	CpG: 19	285	19	168	13.3	58.9	0.79
chr19	43186229	43186436	CpG: 18	207	18	151	17.4	72.9	0.66
chr19	43201460	43201800	CpG: 26	340	26	220	15.3	64.7	0.73
chr19	43204546	43204772	CpG: 17	226	17	141	15.0	62.4	0.77
chr19	43210187	43210512	CpG: 22	325	22	192	13.5	59.1	0.78
chr19	43219163	43219674	CpG: 46	511	46	338	18.0	66.1	0.82
chr19	43224230	43225056	CpG: 72	826	72	546	17.4	66.1	0.80
chr19	43241373	43242101	CpG: 54	728	54	510	14.8	70.1	0.62
chr19	43245995	43246847	CpG: 86	852	86	595	20.2	69.8	0.83
chr19	43254560	43254854	CpG: 33	294	33	238	22.4	81.0	0.70
chr19	43255162	43255426	CpG: 18	264	18	156	13.6	59.1	0.80
chr19	43263900	43264300	CpG: 31	400	31	259	15.5	64.8	0.77
chr19	43264777	43265529	CpG: 77	752	77	534	20.5	71.0	0.82
chr19	43278849	43279125	CpG: 22	276	22	197	15.9	71.4	0.66
chr19	43286221	43288138	CpG: 177	1917	177	1282	18.5	66.9	0.84
chr19	43309998	43310333	CpG: 24	335	24	192	14.3	57.3	0.87
chr19	43310618	43310857	CpG: 24	239	24	160	20.1	66.9	0.90
chr19	43333269	43334230	CpG: 128	961	128	704	26.6	73.3	1.02
chr19	43340058	43340850	CpG: 89	792	89	564	22.5	71.2	0.90
chr19	43349842	43350182	CpG: 42	340	42	251	24.7	73.8	0.91
chr19	43351044	43351479	CpG: 66	435	66	361	30.3	83.0	0.91
chr19	43369844	43370170	CpG: 35	326	35	235	21.5	72.1	0.89
chr19	43374775	43375282	CpG: 51	507	51	365	20.1	72.0	0.81
chr19	43388216	43388873	CpG: 75	657	75	477	22.8	72.6	0.87
chr19	43391057	43391413	CpG: 48	356	48	267	27.0	75.0	0.96
chr19	43397235	43398063	CpG: 55	828	55	520	13.3	62.8	0.68
chr19	43417524	43417960	CpG: 50	436	50	326	22.9	74.8	0.82
chr19	43418645	43419001	CpG: 30	356	30	253	16.9	71.1	0.68
chr19	43420680	43421094	CpG: 39	414	39	302	18.8	72.9	0.71
chr19	43421672	43422259	CpG: 81	587	81	465	27.6	79.2	0.88
chr19	43424290	43424752	CpG: 35	462	35	324	15.2	70.1	0.62
chr19	43425645	43426444	CpG: 82	799	82	557	20.5	69.7	0.84
chr19	43430124	43430446	CpG: 32	322	32	229	19.9	71.1	0.79
chr19	43433710	43435073	CpG: 106	1363	106	900	15.6	66.0	0.71
chr19	43444523	43444788	CpG: 25	265	25	183	18.9	69.1	0.82
chr19	43447682	43447883	CpG: 18	201	18	142	17.9	70.6	0.76
chr19	43449930	43450302	CpG: 41	372	41	265	22.0	71.2	0.90
chr19	43483563	43484041	CpG: 51	478	51	341	21.3	71.3	0.86
chr19	43497901	43498125	CpG: 20	224	20	157	17.9	70.1	0.73
chr19	43504788	43505215	CpG: 41	427	41	283	19.2	66.3	0.92
chr19	43511040	43511868	CpG: 95	828	95	615	22.9	74.3	0.85
chr19	43535673	43535992	CpG: 23	319	23	214	14.4	67.1	0.64
chr19	43537385	43538121	CpG: 79	736	79	532	21.5	72.3	0.84
chr19	43571103	43572020	CpG: 75	917	75	544	16.4	59.3	0.93
chr19	43598654	43599050	CpG: 46	396	46	280	23.2	70.7	0.93
chr19	43607365	43607630	CpG: 19	265	19	177	14.3	66.8	0.64
chr19	43619241	43620484	CpG: 144	1243	144	870	23.2	70.0	0.95
chr19	43621756	43622087	CpG: 29	331	29	225	17.5	68.0	0.76
chr19	43631317	43632092	CpG: 68	775	68	498	17.5	64.3	0.87
chr19	43632566	43632925	CpG: 28	359	28	236	15.6	65.7	0.73
chr19	43651617	43651887	CpG: 20	270	20	161	14.8	59.6	0.84
chr19	43669242	43669515	CpG: 29	273	29	194	21.2	71.1	0.84
chr19	43701080	43701393	CpG: 31	313	31	215	19.8	68.7	0.84
chr19	43846807	43847054	CpG: 26	247	26	170	21.1	68.8	0.90
chr19	43910879	43911124	CpG: 29	245	29	175	23.7	71.4	0.93
chr19	43945382	43945771	CpG: 43	389	43	260	22.1	66.8	1.01
chr19	43948753	43949024	CpG: 25	271	25	183	18.5	67.5	0.83
chr19	43955610	43955815	CpG: 17	205	17	139	16.6	67.8	0.74
chr19	43956286	43957061	CpG: 69	775	69	496	17.8	64.0	0.89
chr19	43990376	43990870	CpG: 40	494	40	302	16.2	61.1	0.87
chr19	43999927	44000238	CpG: 21	311	21	178	13.5	57.2	0.83
chr19	44011995	44012220	CpG: 17	225	17	135	15.1	60.0	0.85
chr19	44013746	44014328	CpG: 53	582	53	408	18.2	70.1	0.74
chr19	44046962	44047735	CpG: 68	773	68	520	17.6	67.3	0.78
chr19	44083158	44086068	CpG: 217	2910	217	1731	14.9	59.5	0.86
chr19	44103570	44103849	CpG: 24	279	24	171	17.2	61.3	0.93
chr19	44130979	44131304	CpG: 38	325	38	213	23.4	65.5	1.14
chr19	44151851	44152183	CpG: 35	332	35	246	21.1	74.1	0.77
chr19	44172194	44175063	CpG: 217	2869	217	1977	15.1	68.9	0.64
chr19	44184348	44184808	CpG: 46	460	46	290	20.0	63.0	1.01
chr19	44196601	44196850	CpG: 19	249	19	154	15.3	61.8	0.82
chr19	44197858	44198124	CpG: 34	266	34	191	25.6	71.8	1.00
chr19	44218433	44218680	CpG: 26	247	26	164	21.1	66.4	0.96
chr19	44261026	44261240	CpG: 18	214	18	128	16.8	59.8	0.94
chr19	44271792	44272030	CpG: 18	238	18	138	15.1	58.0	0.91
chr19	44343755	44344088	CpG: 54	333	54	259	32.4	77.8	1.07
chr19	44386161	44387005	CpG: 65	844	65	539	15.4	63.9	0.76
chr19	44561448	44561683	CpG: 19	235	19	140	16.2	59.6	0.93
chr19	44641203	44641437	CpG: 19	234	19	143	16.2	61.1	0.90
chr19	44664088	44664770	CpG: 51	682	51	437	15.0	64.1	0.73
chr19	44679091	44680178	CpG: 109	1087	109	737	20.1	67.8	0.88
chr19	44702285	44704143	CpG: 165	1858	165	1230	17.8	66.2	0.83
chr19	44723659	44723879	CpG: 23	220	23	157	20.9	71.4	0.82
chr19	44727719	44727928	CpG: 17	209	17	152	16.3	72.7	0.62
chr19	44732336	44732857	CpG: 50	521	50	383	19.2	73.5	0.76
chr19	44734469	44734695	CpG: 24	226	24	157	21.2	69.5	0.98
chr19	44747047	44748225	CpG: 113	1178	113	815	19.2	69.2	0.80
chr19	44752348	44752562	CpG: 21	214	21	144	19.6	67.3	0.97
chr19	44755213	44755417	CpG: 19	204	19	119	18.6	58.3	1.11
chr19	44759236	44760471	CpG: 131	1235	131	884	21.2	71.6	0.83
chr19	44777982	44778926	CpG: 74	944	74	641	15.7	67.9	0.69
chr19	44783252	44783526	CpG: 22	274	22	167	16.1	60.9	0.87
chr19	44813029	44813770	CpG: 81	741	81	537	21.9	72.5	0.84
chr19	44816471	44816696	CpG: 20	225	20	168	17.8	74.7	0.66
chr19	44817940	44818708	CpG: 110	768	110	599	28.6	78.0	0.94
chr19	44825070	44825305	CpG: 20	235	20	143	17.0	60.9	0.94
chr19	44832833	44833068	CpG: 18	235	18	144	15.3	61.3	0.85
chr19	44861859	44862108	CpG: 25	249	25	171	20.1	68.7	0.88
chr19	44895152	44895893	CpG: 94	741	94	538	25.4	72.6	1.00
chr19	44899733	44899972	CpG: 19	239	19	163	15.9	68.2	0.72
chr19	44900163	44900434	CpG: 19	271	19	171	14.0	63.1	0.71
chr19	44914722	44915737	CpG: 69	1015	69	681	13.6	67.1	0.60
chr19	44952501	44952908	CpG: 39	407	39	299	19.2	73.5	0.72
chr19	44996140	44996853	CpG: 89	713	89	517	25.0	72.5	0.96
chr19	45012340	45012608	CpG: 18	268	18	154	13.4	57.5	0.83
chr19	45015908	45016197	CpG: 23	289	23	200	15.9	69.2	0.71
chr19	45018826	45019198	CpG: 27	372	27	254	14.5	68.3	0.64
chr19	45036048	45037354	CpG: 120	1306	120	899	18.4	68.8	0.80
chr19	45038396	45038746	CpG: 25	350	25	203	14.3	58.0	0.85
chr19	45039412	45039887	CpG: 41	475	41	315	17.3	66.3	0.80
chr19	45044638	45045583	CpG: 63	945	63	610	13.3	64.6	0.66
chr19	45061536	45062540	CpG: 113	1004	113	704	22.5	70.1	0.92
chr19	45064131	45064497	CpG: 29	366	29	222	15.8	60.7	0.87
chr19	45072717	45074697	CpG: 198	1980	198	1437	20.0	72.6	0.76
chr19	45078168	45078381	CpG: 15	213	15	123	14.1	57.7	0.87
chr19	45087553	45088746	CpG: 94	1193	94	744	15.8	62.4	0.81
chr19	45092457	45093225	CpG: 60	768	60	519	15.6	67.6	0.69
chr19	45099295	45100763	CpG: 127	1468	127	1038	17.3	70.7	0.70
chr19	45102970	45104292	CpG: 190	1322	190	1040	28.7	78.7	0.94
chr19	45121357	45122092	CpG: 68	735	68	495	18.5	67.3	0.82
chr19	45126246	45126452	CpG: 21	206	21	138	20.4	67.0	0.92
chr19	45132645	45133271	CpG: 67	626	67	463	21.4	74.0	0.79
chr19	45142976	45145830	CpG: 237	2854	237	1924	16.6	67.4	0.74
chr19	45188931	45189187	CpG: 20	256	20	174	15.6	68.0	0.69
chr19	45194870	45195521	CpG: 51	651	51	441	15.7	67.7	0.69
chr19	45206544	45206948	CpG: 42	404	42	295	20.8	73.0	0.79
chr19	45216250	45216609	CpG: 31	359	31	234	17.3	65.2	0.82
chr19	45220957	45221584	CpG: 73	627	73	444	23.3	70.8	0.93
chr19	45229736	45230125	CpG: 31	389	31	263	15.9	67.6	0.70
chr19	45242521	45243834	CpG: 102	1313	102	861	15.5	65.6	0.73
chr19	45361437	45361709	CpG: 23	272	23	169	16.9	62.1	0.89
chr19	45458792	45459837	CpG: 80	1045	80	744	15.3	71.2	0.60
chr19	45516913	45517127	CpG: 20	214	20	143	18.7	66.8	0.84
chr19	45637204	45637478	CpG: 25	274	25	171	18.2	62.4	0.94
chr19	46228383	46228859	CpG: 43	476	43	333	18.1	70.0	0.74
chr19	46235077	46235350	CpG: 20	273	20	164	14.7	60.1	0.81
chr19	46271527	46271797	CpG: 24	270	24	169	17.8	62.6	0.92
chr19	46283437	46284815	CpG: 108	1378	108	901	15.7	65.4	0.73
chr19	46295554	46295879	CpG: 35	325	35	218	21.5	67.1	0.96
chr19	46322142	46322683	CpG: 39	541	39	361	14.4	66.7	0.65
chr19	46324248	46325343	CpG: 92	1095	92	754	16.8	68.9	0.72
chr19	46348505	46348882	CpG: 39	377	39	275	20.7	72.9	0.78
chr19	46354680	46355669	CpG: 79	989	79	640	16.0	64.7	0.76
chr19	46356615	46357139	CpG: 52	524	52	378	19.8	72.1	0.89
chr19	46369557	46369838	CpG: 31	281	31	242	22.1	86.1	0.60
chr19	46397060	46397383	CpG: 38	323	38	223	23.5	69.0	0.99
chr19	46413714	46414999	CpG: 103	1285	103	880	16.0	68.5	0.69
chr19	46416416	46418331	CpG: 138	1915	138	1206	14.4	63.0	0.73
chr19	46439542	46439984	CpG: 28	442	28	253	12.7	57.2	0.78
chr19	46440992	46441751	CpG: 84	759	84	515	22.1	67.9	0.97
chr19	46445505	46445787	CpG: 21	282	21	170	14.9	60.3	0.90
chr19	46446679	46446896	CpG: 26	217	26	149	24.0	68.7	1.08
chr19	46461022	46462006	CpG: 121	984	121	766	24.6	77.8	0.84
chr19	46490920	46491256	CpG: 31	336	31	219	18.5	65.2	0.96
chr19	46492194	46492476	CpG: 24	282	24	193	17.0	68.4	0.73
chr19	46522135	46522564	CpG: 52	429	52	312	24.2	72.7	0.93
chr19	46536970	46537203	CpG: 16	233	16	138	13.7	59.2	0.80
chr19	46541438	46542523	CpG: 92	1085	92	725	17.0	66.8	0.76
chr19	46577197	46578453	CpG: 111	1256	111	809	17.7	64.4	0.88
chr19	46596854	46597430	CpG: 58	576	58	408	20.1	70.8	0.80
chr19	46621394	46621905	CpG: 55	511	55	357	21.5	69.9	0.88
chr19	46643180	46643753	CpG: 46	573	46	342	16.1	59.7	0.92
chr19	46650354	46650637	CpG: 24	283	24	192	17.0	67.8	0.83
chr19	46674332	46674611	CpG: 23	279	23	173	16.5	62.0	0.87
chr19	46676597	46676798	CpG: 16	201	16	125	15.9	62.2	0.83
chr19	46689831	46690191	CpG: 28	360	28	214	15.6	59.4	0.88
chr19	46724576	46724812	CpG: 18	236	18	141	15.3	59.7	0.86
chr19	46757837	46758370	CpG: 41	533	41	329	15.4	61.7	0.81
chr19	46774098	46774527	CpG: 35	429	35	255	16.3	59.4	0.93
chr19	46774822	46775100	CpG: 26	278	26	177	18.7	63.7	0.93
chr19	46825840	46826215	CpG: 28	375	28	225	14.9	60.0	0.84
chr19	46848149	46848534	CpG: 27	385	27	232	14.0	60.3	0.77
chr19	46879594	46879805	CpG: 15	211	15	124	14.2	58.8	0.83
chr19	46894871	46895319	CpG: 33	448	33	260	14.7	58.0	0.91
chr19	46916030	46916238	CpG: 15	208	15	120	14.4	57.7	0.87
chr19	46917123	46917627	CpG: 41	504	41	306	16.3	60.7	0.90
chr19	46936231	46936659	CpG: 36	428	36	256	16.8	59.8	0.95
chr19	46964235	46964769	CpG: 43	534	43	337	16.1	63.1	0.83
chr19	47026706	47027217	CpG: 40	511	40	366	15.7	71.6	0.61
chr19	47035170	47035662	CpG: 35	492	35	286	14.2	58.1	0.84
chr19	47082691	47083025	CpG: 24	334	24	204	14.4	61.1	0.78
chr19	47127639	47127971	CpG: 27	332	27	214	16.3	64.5	0.79
chr19	47132023	47132298	CpG: 24	275	24	171	17.5	62.2	0.91
chr19	47179290	47179561	CpG: 21	271	21	167	15.5	61.6	0.82
chr19	47223435	47223649	CpG: 15	214	15	125	14.0	58.4	0.83
chr19	47224041	47224457	CpG: 30	416	30	256	14.4	61.5	0.80
chr19	47271018	47271411	CpG: 37	393	37	245	18.8	62.3	0.98
chr19	47325585	47326368	CpG: 75	783	75	523	19.2	66.8	0.86
chr19	47387976	47388326	CpG: 29	350	29	253	16.6	72.3	0.63
chr19	47468388	47469143	CpG: 70	755	70	528	18.5	69.9	0.76
chr19	47471876	47472341	CpG: 37	465	37	301	15.9	64.7	0.76
chr19	47528803	47529019	CpG: 20	216	20	153	18.5	70.8	0.74
chr19	47532591	47532805	CpG: 17	214	17	146	15.9	68.2	0.70
chr19	47573236	47573822	CpG: 84	586	84	479	28.7	81.7	0.86
chr19	47579195	47579410	CpG: 17	215	17	148	15.8	68.8	0.70
chr19	47581844	47583301	CpG: 124	1457	124	997	17.0	68.4	0.73
chr19	47602630	47603024	CpG: 40	394	40	286	20.3	72.6	0.77
chr19	47633551	47633965	CpG: 45	414	45	316	21.7	76.3	0.75
chr19	47636869	47637214	CpG: 28	345	28	244	16.2	70.7	0.65
chr19	47637984	47638334	CpG: 31	350	31	245	17.7	70.0	0.73
chr19	47663455	47663807	CpG: 24	352	24	196	13.6	55.7	0.89
chr19	47669307	47669811	CpG: 42	504	42	357	16.7	70.8	0.68
chr19	47670408	47671505	CpG: 103	1097	103	773	18.8	70.5	0.77
chr19	47679563	47679792	CpG: 18	229	18	141	15.7	61.6	0.85
chr19	47715297	47716456	CpG: 110	1159	110	792	19.0	68.3	0.82
chr19	47733159	47734039	CpG: 90	880	90	641	20.5	72.8	0.77
chr19	47740037	47740286	CpG: 22	249	22	153	17.7	61.4	0.95
chr19	47746385	47746674	CpG: 28	289	28	208	19.4	72.0	0.75
chr19	47762957	47763271	CpG: 26	314	26	183	16.6	58.3	0.98
chr19	47779790	47780660	CpG: 81	870	81	570	18.6	65.5	0.91
chr19	47791701	47791963	CpG: 21	262	21	159	16.0	60.7	0.88
chr19	47826074	47826861	CpG: 94	787	94	583	23.9	74.1	0.88
chr19	47827999	47828250	CpG: 20	251	20	154	15.9	61.4	0.87
chr19	47835151	47835387	CpG: 20	236	20	145	16.9	61.4	0.91
chr19	47837055	47837452	CpG: 45	397	45	291	22.7	73.3	0.84
chr19	47862498	47862896	CpG: 30	398	30	278	15.1	69.8	0.63
chr19	47864043	47864552	CpG: 52	509	52	344	20.4	67.6	0.94
chr19	47889004	47889794	CpG: 83	790	83	579	21.0	73.3	0.79
chr19	47892471	47892719	CpG: 23	248	23	180	18.5	72.6	0.71
chr19	47896723	47897000	CpG: 24	277	24	187	17.3	67.5	0.77
chr19	47901193	47901890	CpG: 81	697	81	485	23.2	69.6	0.97
chr19	47904184	47904809	CpG: 57	625	57	426	18.2	68.2	0.79
chr19	47916270	47918744	CpG: 202	2474	202	1460	16.3	59.0	0.94
chr19	47969830	47970720	CpG: 76	890	76	623	17.1	70.0	0.70
chr19	47977166	47979119	CpG: 216	1953	216	1365	22.1	69.9	0.90
chr19	48003070	48005031	CpG: 183	1961	183	1288	18.7	65.7	0.87
chr19	48042352	48042737	CpG: 29	385	29	267	15.1	69.4	0.63
chr19	48044155	48044464	CpG: 36	309	36	229	23.3	74.1	0.87
chr19	48060894	48061557	CpG: 96	663	96	521	29.0	78.6	0.94
chr19	48065287	48065560	CpG: 23	273	23	201	16.8	73.6	0.62
chr19	48075125	48075349	CpG: 21	224	21	140	18.8	62.5	0.99
chr19	48077658	48078677	CpG: 105	1019	105	766	20.6	75.2	0.80
chr19	48129071	48129394	CpG: 29	323	29	233	18.0	72.1	0.71
chr19	48150232	48150595	CpG: 35	363	35	249	19.3	68.6	0.84
chr19	48154008	48154240	CpG: 17	232	17	131	14.7	56.5	0.94
chr19	48159419	48159655	CpG: 19	236	19	144	16.1	61.0	0.89
chr19	48167823	48168371	CpG: 58	548	58	421	21.2	76.8	0.74
chr19	48173807	48174009	CpG: 21	202	21	148	20.8	73.3	0.81
chr19	48190912	48191344	CpG: 44	432	44	314	20.4	72.7	0.77
chr19	48197155	48198013	CpG: 76	858	76	567	17.7	66.1	0.82
chr19	48209765	48209978	CpG: 25	213	25	143	23.5	67.1	1.09
chr19	48212747	48213444	CpG: 72	697	72	486	20.7	69.7	0.85
chr19	48217760	48217981	CpG: 16	221	16	115	14.5	52.0	1.08
chr19	48222852	48224288	CpG: 136	1436	136	1017	18.9	70.8	0.78
chr19	48225437	48225673	CpG: 21	236	21	166	17.8	70.3	0.73
chr19	48226585	48226862	CpG: 21	277	21	168	15.2	60.6	0.84
chr19	48228083	48228319	CpG: 20	236	20	144	16.9	61.0	0.94
chr19	48232129	48234113	CpG: 124	1984	124	1214	12.5	61.2	0.67
chr19	48250650	48251180	CpG: 44	530	44	356	16.6	67.2	0.80
chr19	48255678	48256286	CpG: 67	608	67	425	22.0	69.9	0.90
chr19	48266856	48267387	CpG: 75	531	75	405	28.2	76.3	0.97
chr19	48270733	48270944	CpG: 25	211	25	154	23.7	73.0	0.89
chr19	48271533	48272038	CpG: 45	505	45	349	17.8	69.1	0.75
chr19	48277658	48278492	CpG: 89	834	89	544	21.3	65.2	1.00
chr19	48294789	48296658	CpG: 150	1869	150	1151	16.1	61.6	0.85
chr19	48299838	48300252	CpG: 33	414	33	267	15.9	64.5	0.79
chr19	48321880	48322263	CpG: 29	383	29	257	15.1	67.1	0.67
chr19	48323774	48326690	CpG: 225	2916	225	1855	15.4	63.6	0.77
chr19	48333778	48335296	CpG: 117	1518	117	1023	15.4	67.4	0.68
chr19	48344927	48345384	CpG: 33	457	33	301	14.4	65.9	0.68
chr19	48356320	48356871	CpG: 47	551	47	359	17.1	65.2	0.81
chr19	48380801	48381167	CpG: 37	366	37	259	20.2	70.8	0.81
chr19	48411880	48412359	CpG: 50	479	50	295	20.9	61.6	1.10
chr19	48418348	48419125	CpG: 64	777	64	503	16.5	64.7	0.79
chr19	48429228	48429534	CpG: 40	306	40	238	26.1	77.8	0.86
chr19	48443463	48443824	CpG: 27	361	27	231	15.0	64.0	0.75
chr19	48466575	48466869	CpG: 27	294	27	214	18.4	72.8	0.70
chr19	48468880	48469639	CpG: 61	759	61	497	16.1	65.5	0.75
chr19	48472504	48472949	CpG: 39	445	39	311	17.5	69.9	0.74
chr19	48480351	48480763	CpG: 32	412	32	241	15.5	58.5	0.91
chr19	48496803	48497445	CpG: 45	642	45	412	14.0	64.2	0.68
chr19	48498653	48498856	CpG: 17	203	17	140	16.7	69.0	0.70
chr19	48504442	48505049	CpG: 48	607	48	416	15.8	68.5	0.68
chr19	48505500	48505735	CpG: 19	235	19	164	16.2	69.8	0.67
chr19	48509062	48509411	CpG: 39	349	39	256	22.3	73.4	0.84
chr19	48517589	48517862	CpG: 23	273	23	175	16.8	64.1	0.83
chr19	48518729	48520574	CpG: 128	1845	128	1081	13.9	58.6	0.81
chr19	48539145	48540464	CpG: 115	1319	115	913	17.4	69.2	0.73
chr19	48544774	48544999	CpG: 25	225	25	155	22.2	68.9	0.98
chr19	48558326	48558663	CpG: 35	337	35	230	20.8	68.2	0.90
chr19	48560716	48561245	CpG: 57	529	57	365	21.6	69.0	0.91
chr19	48594439	48594697	CpG: 19	258	19	180	14.7	69.8	0.61
chr19	48594976	48599399	CpG: 401	4423	401	3039	18.1	68.7	0.77
chr19	48604785	48605273	CpG: 36	488	36	313	14.8	64.1	0.72
chr19	48606775	48607358	CpG: 43	583	43	371	14.8	63.6	0.80
chr19	48613220	48614166	CpG: 74	946	74	662	15.6	70.0	0.64
chr19	48619788	48620579	CpG: 106	791	106	589	26.8	74.5	0.97
chr19	48631689	48632442	CpG: 59	753	59	484	15.7	64.3	0.76
chr19	48642673	48643451	CpG: 64	778	64	526	16.5	67.6	0.73
chr19	48690184	48692170	CpG: 159	1986	159	1279	16.0	64.4	0.77
chr19	48704066	48704390	CpG: 27	324	27	232	16.7	71.6	0.67
chr19	48710210	48710447	CpG: 20	237	20	168	16.9	70.9	0.68
chr19	48711511	48713761	CpG: 228	2250	228	1593	20.3	70.8	0.81
chr19	48714229	48714446	CpG: 18	217	18	136	16.6	62.7	0.86
chr19	48724081	48724362	CpG: 23	281	23	174	16.4	61.9	0.87
chr19	48728721	48730729	CpG: 190	2008	190	1361	18.9	67.8	0.83
chr19	48741711	48741928	CpG: 21	217	21	145	19.4	66.8	0.87
chr19	48755226	48755489	CpG: 23	263	23	168	17.5	63.9	0.87
chr19	48762776	48763020	CpG: 17	244	17	153	13.9	62.7	0.71
chr19	48767333	48768380	CpG: 110	1047	110	756	21.0	72.2	0.81
chr19	48780375	48780669	CpG: 27	294	27	198	18.4	67.3	0.81
chr19	48790518	48790763	CpG: 19	245	19	146	15.5	59.6	0.89
chr19	48800646	48801601	CpG: 95	955	95	737	19.9	77.2	0.70
chr19	48828319	48828541	CpG: 19	222	19	152	17.1	68.5	0.78
chr19	48842480	48844471	CpG: 181	1991	181	1392	18.2	69.9	0.76
chr19	48850243	48850531	CpG: 22	288	22	200	15.3	69.4	0.65
chr19	48904581	48905167	CpG: 43	586	43	360	14.7	61.4	0.78
chr19	48906241	48906592	CpG: 56	351	56	223	31.9	63.5	1.59
chr19	49121024	49121310	CpG: 22	286	22	175	15.4	61.2	0.83
chr19	49124261	49124811	CpG: 43	550	43	373	15.6	67.8	0.69
chr19	49131210	49131828	CpG: 55	618	55	421	17.8	68.1	0.80
chr19	49174090	49174867	CpG: 69	777	69	516	17.8	66.4	0.81
chr19	49190527	49190742	CpG: 15	215	15	124	14.0	57.7	0.84
chr19	49231415	49231727	CpG: 23	312	23	203	14.7	65.1	0.73
chr19	49232527	49233023	CpG: 33	496	33	268	13.3	54.0	0.92
chr19	49239368	49240919	CpG: 106	1551	106	1008	13.7	65.0	0.65
chr19	49242167	49242460	CpG: 24	293	24	164	16.4	56.0	1.05
chr19	49256154	49256443	CpG: 26	289	26	194	18.0	67.1	0.80
chr19	49258632	49258881	CpG: 18	249	18	146	14.5	58.6	0.85
chr19	49263561	49263794	CpG: 18	233	18	137	15.5	58.8	0.92
chr19	49280285	49280520	CpG: 19	235	19	144	16.2	61.3	0.90
chr19	49296900	49297416	CpG: 56	516	56	362	21.7	70.2	0.88
chr19	49313591	49313808	CpG: 21	217	21	136	19.4	62.7	1.00
chr19	49315152	49315653	CpG: 37	501	37	320	14.8	63.9	0.75
chr19	49318692	49321655	CpG: 250	2963	250	2012	16.9	67.9	0.74
chr19	49339206	49339476	CpG: 24	270	24	183	17.8	67.8	0.78
chr19	49426143	49427221	CpG: 122	1078	122	742	22.6	68.8	0.97
chr19	49449119	49449815	CpG: 68	696	68	499	19.5	71.7	0.77
chr19	49459706	49460422	CpG: 51	716	51	494	14.2	69.0	0.62
chr19	49461619	49461829	CpG: 20	210	20	161	19.0	76.7	0.65
chr19	49464127	49465239	CpG: 78	1112	78	745	14.0	67.0	0.64
chr19	49469573	49469858	CpG: 21	285	21	177	14.7	62.1	0.77
chr19	49474045	49475402	CpG: 200	1357	200	1058	29.5	78.0	0.97
chr19	49475688	49475909	CpG: 18	221	18	133	16.3	60.2	0.91
chr19	49486165	49487062	CpG: 91	897	91	645	20.3	71.9	0.83
chr19	49503966	49504176	CpG: 18	210	18	129	17.1	61.4	0.91
chr19	49519447	49519709	CpG: 19	262	19	175	14.5	66.8	0.65
chr19	49523157	49523378	CpG: 21	221	21	154	19.0	69.7	0.90
chr19	49536388	49536629	CpG: 21	241	21	166	17.4	68.9	0.75
chr19	49539398	49539880	CpG: 37	482	37	330	15.4	68.5	0.66
chr19	49541767	49543150	CpG: 103	1383	103	932	14.9	67.4	0.69
chr19	49571069	49572268	CpG: 139	1199	139	906	23.2	75.6	0.83
chr19	49581375	49582790	CpG: 151	1415	151	999	21.3	70.6	0.86
chr19	49613149	49614547	CpG: 116	1398	116	944	16.6	67.5	0.73
chr19	49656130	49656521	CpG: 30	391	30	228	15.3	58.3	0.92
chr19	49676185	49676721	CpG: 49	536	49	355	18.3	66.2	0.92
chr19	49685934	49687383	CpG: 180	1449	180	1075	24.8	74.2	0.91
chr19	49721083	49721325	CpG: 19	242	19	146	15.7	60.3	0.89
chr19	49733031	49733446	CpG: 29	415	29	237	14.0	57.1	0.86
chr19	49748991	49749275	CpG: 20	284	20	162	14.1	57.0	0.88
chr19	49829949	49830335	CpG: 40	386	40	281	20.7	72.8	0.81
chr19	49835163	49836005	CpG: 68	842	68	585	16.2	69.5	0.67
chr19	49845586	49847872	CpG: 211	2286	211	1628	18.5	71.2	0.73
chr19	49861212	49861518	CpG: 26	306	26	196	17.0	64.1	0.85
chr19	49870502	49871545	CpG: 95	1043	95	752	18.2	72.1	0.71
chr19	49873439	49874189	CpG: 83	750	83	515	22.1	68.7	0.96
chr19	49936458	49936711	CpG: 20	253	20	160	15.8	63.2	0.81
chr19	49937304	49939152	CpG: 161	1848	161	1212	17.4	65.6	0.84
chr19	49940161	49940431	CpG: 24	270	24	170	17.8	63.0	0.91
chr19	49943533	49943787	CpG: 19	254	19	151	15.0	59.4	0.87
chr19	49955965	49956418	CpG: 50	453	50	311	22.1	68.7	1.00
chr19	49957071	49957312	CpG: 18	241	18	138	14.9	57.3	0.92
chr19	50017089	50017330	CpG: 19	241	19	147	15.8	61.0	0.86
chr19	50051386	50052102	CpG: 88	716	88	556	24.6	77.7	0.82
chr19	50053444	50053782	CpG: 42	338	42	276	24.9	81.7	0.77
chr19	50055527	50056873	CpG: 166	1346	166	1023	24.7	76.0	0.87
chr19	50064796	50065321	CpG: 70	525	70	417	26.7	79.4	0.85
chr19	50068335	50068679	CpG: 41	344	41	253	23.8	73.5	0.88
chr19	50069412	50069764	CpG: 40	352	40	248	22.7	70.5	0.92
chr19	50079804	50080078	CpG: 24	274	24	170	17.5	62.0	0.92
chr19	50080636	50083093	CpG: 174	2457	174	1565	14.2	63.7	0.73
chr19	50089991	50090272	CpG: 29	281	29	205	20.6	73.0	0.78
chr19	50091875	50092113	CpG: 20	238	20	167	16.8	70.2	0.74
chr19	50098425	50100797	CpG: 218	2372	218	1656	18.4	69.8	0.77
chr19	50174507	50175185	CpG: 57	678	57	434	16.8	64.0	0.92
chr19	50232297	50232778	CpG: 43	481	43	335	17.9	69.6	0.75
chr19	50244433	50245417	CpG: 102	984	102	776	20.7	78.9	0.69
chr19	50252903	50253123	CpG: 19	220	19	160	17.3	72.7	0.70
chr19	50260893	50261425	CpG: 62	532	62	377	23.3	70.9	0.93
chr19	50263076	50263308	CpG: 17	232	17	153	14.7	65.9	0.67
chr19	50278468	50279165	CpG: 89	697	89	496	25.5	71.2	1.01
chr19	50287695	50288495	CpG: 95	800	95	567	23.8	70.9	0.95
chr19	50296685	50297113	CpG: 33	428	33	267	15.4	62.4	0.79
chr19	50314833	50315226	CpG: 45	393	45	273	22.9	69.5	0.98
chr19	50345264	50346329	CpG: 105	1065	105	724	19.7	68.0	0.91
chr19	50375338	50376704	CpG: 107	1366	107	962	15.7	70.4	0.65
chr19	50403511	50404420	CpG: 95	909	95	644	20.9	70.8	0.86
chr19	50430439	50430680	CpG: 18	241	18	143	14.9	59.3	0.87
chr19	50431036	50431625	CpG: 61	589	61	409	20.7	69.4	0.86
chr19	50438874	50441250	CpG: 237	2376	237	1699	19.9	71.5	0.78
chr19	50500542	50500776	CpG: 20	234	20	143	17.1	61.1	0.93
chr19	50510670	50511968	CpG: 122	1298	122	963	18.8	74.2	0.70
chr19	50512843	50513069	CpG: 18	226	18	169	15.9	74.8	0.65
chr19	50529655	50530108	CpG: 36	453	36	304	15.9	67.1	0.72
chr19	50532096	50533343	CpG: 130	1247	130	912	20.9	73.1	0.81
chr19	50544047	50544398	CpG: 40	351	40	265	22.8	75.5	0.83
chr19	50547389	50547856	CpG: 39	467	39	317	16.7	67.9	0.73
chr19	50556632	50557067	CpG: 45	435	45	291	20.7	66.9	0.93
chr19	50571705	50572248	CpG: 44	543	44	355	16.2	65.4	0.76
chr19	50574187	50574667	CpG: 50	480	50	328	20.8	68.3	0.89
chr19	50576282	50576727	CpG: 44	445	44	302	19.8	67.9	0.93
chr19	50609147	50609913	CpG: 69	766	69	523	18.0	68.3	0.77
chr19	50619978	50620201	CpG: 18	223	18	130	16.1	58.3	0.98
chr19	50633996	50634249	CpG: 19	253	19	181	15.0	71.5	0.63
chr19	50671350	50671556	CpG: 16	206	16	121	15.5	58.7	0.92
chr19	50691228	50691828	CpG: 45	600	45	432	15.0	72.0	0.61
chr19	50718857	50719087	CpG: 18	230	18	140	15.7	60.9	0.86
chr19	50879981	50880267	CpG: 21	286	21	156	14.7	54.5	0.99
chr19	50968054	50968288	CpG: 18	234	18	140	15.4	59.8	0.89
chr19	50990798	50991071	CpG: 23	273	23	165	16.8	60.4	0.95
chr19	51103616	51103840	CpG: 17	224	17	135	15.2	60.3	0.85
chr19	51131381	51131677	CpG: 24	296	24	202	16.2	68.2	0.70
chr19	51135079	51135302	CpG: 16	223	16	126	14.3	56.5	0.90
chr19	51164063	51164869	CpG: 86	806	86	583	21.3	72.3	0.83
chr19	51165799	51166086	CpG: 34	287	34	203	23.7	70.7	0.95
chr19	51176464	51176826	CpG: 37	362	37	256	20.4	70.7	0.82
chr19	51177215	51177425	CpG: 15	210	15	121	14.3	57.6	0.87
chr19	51188713	51189482	CpG: 108	769	108	576	28.1	74.9	1.00
chr19	51195572	51195839	CpG: 18	267	18	160	13.5	59.9	0.77
chr19	51197976	51198268	CpG: 22	292	22	190	15.1	65.1	0.73
chr19	51243010	51243214	CpG: 15	204	15	117	14.7	57.4	0.90
chr19	51264893	51265145	CpG: 20	252	20	154	15.9	61.1	0.86
chr19	51265395	51266246	CpG: 63	851	63	540	14.8	63.5	0.75
chr19	51267887	51268117	CpG: 18	230	18	137	15.7	59.6	0.89
chr19	51285245	51285619	CpG: 34	374	34	232	18.2	62.0	0.96
chr19	51291115	51291654	CpG: 39	539	39	365	14.5	67.7	0.63
chr19	51315013	51316381	CpG: 113	1368	113	886	16.5	64.8	0.81
chr19	51324283	51324751	CpG: 40	468	40	304	17.1	65.0	0.82
chr19	51328030	51328438	CpG: 40	408	40	295	19.6	72.3	0.75
chr19	51357374	51357594	CpG: 17	220	17	149	15.5	67.7	0.68
chr19	51358075	51358494	CpG: 43	419	43	273	20.5	65.2	0.97
chr19	51385370	51385834	CpG: 34	464	34	324	14.7	69.8	0.63
chr19	51387797	51388106	CpG: 27	309	27	216	17.5	69.9	0.72
chr19	51392386	51393121	CpG: 111	735	111	571	30.2	77.7	1.00
chr19	51393454	51393687	CpG: 18	233	18	136	15.5	58.4	0.92
chr19	51399066	51399487	CpG: 37	421	37	301	17.6	71.5	0.69
chr19	51408536	51408773	CpG: 20	237	20	155	16.9	65.4	0.81
chr19	51409000	51409470	CpG: 41	470	41	291	17.4	61.9	0.93
chr19	51410058	51410297	CpG: 25	239	25	162	20.9	67.8	0.95
chr19	51418484	51418708	CpG: 16	224	16	134	14.3	59.8	0.82
chr19	51432668	51432880	CpG: 15	212	15	123	14.2	58.0	0.85
chr19	51436712	51438548	CpG: 256	1836	256	1414	27.9	77.0	0.95
chr19	51439945	51440353	CpG: 45	408	45	260	22.1	63.7	1.09
chr19	51446900	51447190	CpG: 23	290	23	201	15.9	69.3	0.66
chr19	51455908	51456698	CpG: 94	790	94	557	23.8	70.5	0.96
chr19	51463130	51464062	CpG: 96	932	96	634	20.6	68.0	0.91
chr19	51474467	51475153	CpG: 62	686	62	452	18.1	65.9	0.84
chr19	51479211	51479426	CpG: 16	215	16	140	14.9	65.1	0.71
chr19	51480239	51480513	CpG: 23	274	23	170	16.8	62.0	0.89
chr19	51485250	51485692	CpG: 41	442	41	324	18.6	73.3	0.69
chr19	51487196	51488271	CpG: 111	1075	111	805	20.7	74.9	0.82
chr19	51495414	51495781	CpG: 29	367	29	255	15.8	69.5	0.65
chr19	51505514	51505843	CpG: 31	329	31	252	18.8	76.6	0.66
chr19	51507592	51508110	CpG: 44	518	44	358	17.0	69.1	0.71
chr19	51552459	51552683	CpG: 20	224	20	153	17.9	68.3	0.77
chr19	51575684	51575911	CpG: 16	227	16	137	14.1	60.4	0.79
chr19	51597660	51598027	CpG: 41	367	41	271	22.3	73.8	0.85
chr19	51607457	51607853	CpG: 31	396	31	279	15.7	70.5	0.64
chr19	51613504	51614150	CpG: 67	646	67	427	20.7	66.1	0.95
chr19	51616455	51616738	CpG: 23	283	23	172	16.3	60.8	0.89
chr19	51618613	51618945	CpG: 37	332	37	242	22.3	72.9	0.84
chr19	51620448	51620788	CpG: 28	340	28	240	16.5	70.6	0.69
chr19	51623828	51625516	CpG: 116	1688	116	1089	13.7	64.5	0.66
chr19	51629923	51632355	CpG: 174	2432	174	1612	14.3	66.3	0.66
chr19	51635135	51635453	CpG: 24	318	24	193	15.1	60.7	0.82
chr19	51655966	51656504	CpG: 66	538	66	385	24.5	71.6	0.96
chr19	51664749	51664955	CpG: 20	206	20	156	19.4	75.7	0.70
chr19	51674646	51675315	CpG: 49	669	49	449	14.6	67.1	0.65
chr19	51691113	51691490	CpG: 27	377	27	252	14.3	66.8	0.79
chr19	51708167	51709031	CpG: 73	864	73	581	16.9	67.2	0.75
chr19	51714214	51714472	CpG: 20	258	20	190	15.5	73.6	0.61
chr19	51714993	51715436	CpG: 36	443	36	269	16.3	60.7	0.88
chr19	51723318	51723987	CpG: 77	669	77	502	23.0	75.0	0.82
chr19	51729589	51729975	CpG: 34	386	34	271	17.6	70.2	0.72
chr19	51733180	51734124	CpG: 129	944	129	724	27.3	76.7	0.95
chr19	51744861	51745394	CpG: 44	533	44	344	16.5	64.5	0.79
chr19	51746951	51747668	CpG: 71	717	71	525	19.8	73.2	0.74
chr19	51772595	51772831	CpG: 18	236	18	140	15.3	59.3	0.88
chr19	51777202	51777445	CpG: 20	243	20	150	16.5	61.7	0.91
chr19	51785357	51785595	CpG: 19	238	19	145	16.0	60.9	0.89
chr19	51790171	51790511	CpG: 28	340	28	211	16.5	62.1	0.87
chr19	51794620	51794883	CpG: 21	263	21	176	16.0	66.9	0.72
chr19	51805862	51806199	CpG: 43	337	43	254	25.5	75.4	0.90
chr19	51807310	51807530	CpG: 20	220	20	164	18.2	74.5	0.71
chr19	51832110	51832396	CpG: 26	286	26	197	18.2	68.9	0.77
chr19	51843072	51843342	CpG: 22	270	22	166	16.3	61.5	0.87
chr19	51867090	51867562	CpG: 48	472	48	299	20.3	63.3	1.01
chr19	51875233	51875465	CpG: 16	232	16	131	13.8	56.5	0.87
chr19	51877803	51878039	CpG: 17	236	17	138	14.4	58.5	0.86
chr19	51887424	51887644	CpG: 18	220	18	130	16.4	59.1	0.96
chr19	51890208	51890940	CpG: 50	732	50	431	13.7	58.9	0.80
chr19	51893641	51893955	CpG: 25	314	25	184	15.9	58.6	0.95
chr19	51894826	51895222	CpG: 29	396	29	231	14.6	58.3	0.88
chr19	51928302	51928719	CpG: 41	417	41	267	19.7	64.0	0.97
chr19	51932142	51932608	CpG: 35	466	35	281	15.0	60.3	0.83
chr19	51949551	51950118	CpG: 66	567	66	410	23.3	72.3	0.90
chr19	51959995	51960999	CpG: 78	1004	78	622	15.5	62.0	0.82
chr19	51964145	51964503	CpG: 36	358	36	250	20.1	69.8	0.84
chr19	51988090	51988415	CpG: 33	325	33	228	20.3	70.2	0.83
chr19	51996083	51996314	CpG: 18	231	18	141	15.6	61.0	0.85
chr19	52012603	52013757	CpG: 95	1154	95	758	16.5	65.7	0.77
chr19	52014292	52014612	CpG: 31	320	31	222	19.4	69.4	0.81
chr19	52028131	52028374	CpG: 17	243	17	146	14.0	60.1	0.79
chr19	52042065	52042308	CpG: 17	243	17	146	14.0	60.1	0.79
chr19	52050750	52052025	CpG: 100	1275	100	825	15.7	64.7	0.76
chr19	52052621	52053147	CpG: 40	526	40	345	15.2	65.6	0.71
chr19	52059636	52059977	CpG: 40	341	40	264	23.5	77.4	0.78
chr19	52066595	52067682	CpG: 161	1087	161	816	29.6	75.1	1.06
chr19	52073451	52073726	CpG: 24	275	24	171	17.5	62.2	0.91
chr19	52079837	52080559	CpG: 86	722	86	503	23.8	69.7	0.99
chr19	52102407	52103215	CpG: 94	808	94	577	23.3	71.4	0.95
chr19	52108931	52110046	CpG: 121	1115	121	827	21.7	74.2	0.79
chr19	52113437	52115112	CpG: 176	1675	176	1224	21.0	73.1	0.79
chr19	52122582	52122971	CpG: 46	389	46	287	23.7	73.8	0.90
chr19	52125137	52125423	CpG: 23	286	23	197	16.1	68.9	0.69
chr19	52127698	52128168	CpG: 43	470	43	320	18.3	68.1	0.81
chr19	52137573	52137789	CpG: 19	216	19	142	17.6	65.7	0.86
chr19	52143687	52145735	CpG: 148	2048	148	1352	14.5	66.0	0.66
chr19	52146579	52146872	CpG: 22	293	22	207	15.0	70.6	0.60
chr19	52152178	52152492	CpG: 28	314	28	231	17.8	73.6	0.66
chr19	52153456	52153979	CpG: 39	523	39	302	14.9	57.7	0.90
chr19	52160013	52160265	CpG: 19	252	19	141	15.1	56.0	0.96
chr19	52160400	52160880	CpG: 37	480	37	343	15.4	71.5	0.60
chr19	52179949	52180319	CpG: 29	370	29	258	15.7	69.7	0.65
chr19	52193789	52194161	CpG: 40	372	40	269	21.5	72.3	0.82
chr19	52196671	52196920	CpG: 19	249	19	150	15.3	60.2	0.87
chr19	52207593	52208217	CpG: 47	624	47	391	15.1	62.7	0.78
chr19	52278963	52279189	CpG: 20	226	20	140	17.7	61.9	0.93
chr19	52322583	52322839	CpG: 26	256	26	169	20.3	66.0	1.13
chr19	52335358	52335799	CpG: 32	441	32	291	14.5	66.0	0.73
chr19	52336189	52336494	CpG: 22	305	22	194	14.4	63.6	0.73
chr19	52336825	52337799	CpG: 71	974	71	637	14.6	65.4	0.69
chr19	52359540	52359970	CpG: 42	430	42	302	19.5	70.2	0.80
chr19	52360951	52361408	CpG: 35	457	35	293	15.3	64.1	0.79
chr19	52383685	52383959	CpG: 23	274	23	171	16.8	62.4	0.87
chr19	52385442	52385995	CpG: 52	553	52	354	18.8	64.0	0.92
chr19	52419800	52420399	CpG: 63	599	63	396	21.0	66.1	0.97
chr19	52425525	52426416	CpG: 65	891	65	577	14.6	64.8	0.73
chr19	52428638	52429190	CpG: 41	552	41	361	14.9	65.4	0.70
chr19	52430071	52430596	CpG: 47	525	47	352	17.9	67.0	0.80
chr19	52431139	52431609	CpG: 39	470	39	303	16.6	64.5	0.80
chr19	52433931	52434366	CpG: 40	435	40	291	18.4	66.9	0.84
chr19	52438729	52439299	CpG: 57	570	57	413	20.0	72.5	0.78
chr19	52440427	52441542	CpG: 86	1115	86	752	15.4	67.4	0.68
chr19	52448964	52449386	CpG: 31	422	31	233	14.7	55.2	1.02
chr19	52450244	52451024	CpG: 74	780	74	484	19.0	62.1	0.99
chr19	52461835	52462420	CpG: 53	585	53	393	18.1	67.2	0.81
chr19	52464180	52464583	CpG: 28	403	28	271	13.9	67.2	0.63
chr19	52487144	52487674	CpG: 51	530	51	345	19.2	65.1	0.91
chr19	52487949	52488227	CpG: 21	278	21	152	15.1	54.7	1.07
chr19	52493861	52494097	CpG: 19	236	19	144	16.1	61.0	0.90
chr19	52494512	52494740	CpG: 20	228	20	137	17.5	60.1	1.01
chr19	52495896	52496566	CpG: 62	670	62	416	18.5	62.1	0.97
chr19	52507077	52507373	CpG: 20	296	20	172	13.5	58.1	0.80
chr19	52513279	52513599	CpG: 32	320	32	249	20.0	77.8	0.66
chr19	52522838	52523070	CpG: 17	232	17	139	14.7	59.9	0.83
chr19	52524521	52524755	CpG: 18	234	18	149	15.4	63.7	0.77
chr19	52527509	52528036	CpG: 48	527	48	317	18.2	60.2	1.01
chr19	52533814	52534406	CpG: 73	592	73	429	24.7	72.5	0.94
chr19	52555625	52557264	CpG: 117	1639	117	1111	14.3	67.8	0.64
chr19	52566068	52566335	CpG: 19	267	19	159	14.2	59.6	0.81
chr19	52567211	52567446	CpG: 17	235	17	138	14.5	58.7	0.87
chr19	52580532	52580761	CpG: 17	229	17	134	14.8	58.5	0.94
chr19	52590425	52592273	CpG: 149	1848	149	1207	16.1	65.3	0.76
chr19	52593375	52593678	CpG: 21	303	21	203	13.9	67.0	0.68
chr19	52596802	52597984	CpG: 109	1182	109	851	18.4	72.0	0.74
chr19	52598126	52598401	CpG: 21	275	21	168	15.3	61.1	0.84
chr19	52601581	52601915	CpG: 32	334	32	247	19.2	74.0	0.74
chr19	52611673	52611947	CpG: 25	274	25	175	18.2	63.9	0.91
chr19	52616013	52616266	CpG: 20	253	20	174	15.8	68.8	0.67
chr19	52640001	52642542	CpG: 189	2541	189	1593	14.9	62.7	0.76
chr19	52651310	52653064	CpG: 213	1754	213	1289	24.3	73.5	0.90
chr19	52664503	52665011	CpG: 45	508	45	342	17.7	67.3	0.82
chr19	52665648	52666155	CpG: 41	507	41	307	16.2	60.6	0.88
chr19	52670193	52670566	CpG: 32	373	32	272	17.2	72.9	0.65
chr19	52675778	52676315	CpG: 37	537	37	295	13.8	54.9	0.92
chr19	52676823	52677859	CpG: 88	1036	88	692	17.0	66.8	0.78
chr19	52680736	52680986	CpG: 21	250	21	181	16.8	72.4	0.64
chr19	52688141	52688370	CpG: 18	229	18	158	15.7	69.0	0.69
chr19	52689310	52689613	CpG: 20	303	20	196	13.2	64.7	0.64
chr19	52689831	52691604	CpG: 124	1773	124	1115	14.0	62.9	0.71
chr19	52701398	52701819	CpG: 37	421	37	282	17.6	67.0	0.79
chr19	52717312	52717555	CpG: 18	243	18	145	14.8	59.7	0.86
chr19	52719694	52720266	CpG: 43	572	43	342	15.0	59.8	0.84
chr19	52721292	52721528	CpG: 20	236	20	144	16.9	61.0	0.93
chr19	52737820	52738058	CpG: 18	238	18	147	15.1	61.8	0.81
chr19	52746027	52746904	CpG: 68	877	68	571	15.5	65.1	0.75
chr19	52766520	52767393	CpG: 81	873	81	599	18.6	68.6	0.80
chr19	52788544	52788941	CpG: 27	397	27	252	13.6	63.5	0.78
chr19	52800060	52800280	CpG: 19	220	19	137	17.3	62.3	0.89
chr19	52808892	52809702	CpG: 66	810	66	566	16.3	69.9	0.68
chr19	52813092	52813350	CpG: 23	258	23	176	17.8	68.2	0.77
chr19	52816330	52816542	CpG: 15	212	15	132	14.2	62.3	0.74
chr19	52817645	52818643	CpG: 86	998	86	591	17.2	59.2	0.98
chr19	52850671	52852363	CpG: 195	1692	195	1208	23.0	71.4	0.91
chr19	52858607	52858861	CpG: 19	254	19	176	15.0	69.3	0.63
chr19	52861715	52863166	CpG: 104	1451	104	977	14.3	67.3	0.63
chr19	52867259	52867873	CpG: 56	614	56	430	18.2	70.0	0.76
chr19	52869816	52870277	CpG: 53	461	53	324	23.0	70.3	0.95
chr19	52873236	52873444	CpG: 26	208	26	161	25.0	77.4	0.84
chr19	52876276	52878445	CpG: 159	2169	159	1351	14.7	62.3	0.77
chr19	52888187	52888840	CpG: 58	653	58	460	17.8	70.4	0.75
chr19	52889948	52891213	CpG: 131	1265	131	874	20.7	69.1	0.88
chr19	52928373	52928651	CpG: 21	278	21	169	15.1	60.8	0.83
chr19	52929233	52930016	CpG: 77	783	77	516	19.7	65.9	0.91
chr19	53025015	53026325	CpG: 100	1310	100	795	15.3	60.7	0.83
chr19	53050852	53051332	CpG: 42	480	42	298	17.5	62.1	0.91
chr19	53086002	53086836	CpG: 62	834	62	571	14.9	68.5	0.64
chr19	53228021	53228748	CpG: 53	727	53	505	14.6	69.5	0.60
chr19	53235357	53235719	CpG: 34	362	34	245	18.8	67.7	0.84
chr19	53250330	53250742	CpG: 33	412	33	284	16.0	68.9	0.68
chr19	53255244	53255701	CpG: 31	457	31	258	13.6	56.5	0.86
chr19	53258266	53258499	CpG: 18	233	18	130	15.5	55.8	1.02
chr19	53290740	53291454	CpG: 79	714	79	533	22.1	74.6	0.80
chr19	53292734	53293219	CpG: 46	485	46	352	19.0	72.6	0.72
chr19	53297890	53298333	CpG: 52	443	52	325	23.5	73.4	0.88
chr19	53305838	53306072	CpG: 17	234	17	140	14.5	59.8	0.83
chr19	53318244	53318548	CpG: 33	304	33	205	21.7	67.4	0.97
chr19	53346600	53346843	CpG: 23	243	23	176	18.9	72.4	0.72
chr19	53374026	53374232	CpG: 17	206	17	147	16.5	71.4	0.69
chr19	53396569	53396780	CpG: 17	211	17	139	16.1	65.9	0.75
chr19	53411059	53411307	CpG: 23	248	23	163	18.5	65.7	0.87
chr19	53413175	53413506	CpG: 39	331	39	243	23.6	73.4	0.87
chr19	53415733	53416911	CpG: 167	1178	167	893	28.4	75.8	1.00
chr19	53418092	53418606	CpG: 44	514	44	354	17.1	68.9	0.76
chr19	53420669	53421726	CpG: 87	1057	87	678	16.5	64.1	0.80
chr19	53445124	53446361	CpG: 91	1237	91	731	14.7	59.1	0.84
chr19	53463897	53464574	CpG: 59	677	59	452	17.4	66.8	0.83
chr19	53465709	53465955	CpG: 20	246	20	162	16.3	65.9	0.76
chr19	53469472	53469784	CpG: 34	312	34	216	21.8	69.2	0.91
chr19	53471476	53472228	CpG: 77	752	77	536	20.5	71.3	0.89
chr19	53478586	53479077	CpG: 37	491	37	327	15.1	66.6	0.68
chr19	53482868	53483131	CpG: 23	263	23	163	17.5	62.0	0.92
chr19	53489776	53490368	CpG: 48	592	48	407	16.2	68.8	0.69
chr19	53494547	53494755	CpG: 15	208	15	136	14.4	65.4	0.68
chr19	53502969	53503460	CpG: 39	491	39	340	15.9	69.2	0.68
chr19	53515573	53515941	CpG: 37	368	37	252	20.1	68.5	0.86
chr19	53519208	53519981	CpG: 66	773	66	544	17.1	70.4	0.70
chr19	53546033	53546854	CpG: 79	821	79	568	19.2	69.2	0.81
chr19	53563658	53564513	CpG: 76	855	76	572	17.8	66.9	0.83
chr19	53568081	53568303	CpG: 18	222	18	158	16.2	71.2	0.64
chr19	53599915	53600470	CpG: 68	555	68	391	24.5	70.5	0.99
chr19	53605888	53608388	CpG: 218	2500	218	1688	17.4	67.5	0.77
chr19	53637359	53637699	CpG: 29	340	29	241	17.1	70.9	0.68
chr19	53645475	53645763	CpG: 23	288	23	201	16.0	69.8	0.68
chr19	53654931	53655172	CpG: 20	241	20	165	16.6	68.5	0.78
chr19	53656241	53657288	CpG: 89	1047	89	771	17.0	73.6	0.65
chr19	53692995	53693312	CpG: 38	317	38	211	24.0	66.6	1.09
chr19	53694884	53695201	CpG: 40	317	40	213	25.2	67.2	1.12
chr19	53696337	53696546	CpG: 15	209	15	132	14.4	63.2	0.86
chr19	53696748	53697084	CpG: 36	336	36	205	21.4	61.0	1.16
chr19	53713807	53714287	CpG: 41	480	41	323	17.1	67.3	0.75
chr19	53727739	53728652	CpG: 77	913	77	622	16.9	68.1	0.73
chr19	53746784	53747982	CpG: 98	1198	98	799	16.4	66.7	0.78
chr19	53750717	53751243	CpG: 40	526	40	360	15.2	68.4	0.66
chr19	53755124	53757769	CpG: 251	2645	251	1989	19.0	75.2	0.68
chr19	53775460	53775889	CpG: 41	429	41	319	19.1	74.4	0.76
chr19	53783718	53784982	CpG: 142	1264	142	971	22.5	76.8	0.76
chr19	53805607	53805851	CpG: 23	244	23	176	18.9	72.1	0.73
chr19	53807000	53808754	CpG: 174	1754	174	1345	19.8	76.7	0.67
chr19	53813215	53814437	CpG: 127	1222	127	866	20.8	70.9	0.83
chr19	53817186	53817523	CpG: 28	337	28	219	16.6	65.0	0.80
chr19	53826081	53826416	CpG: 22	335	22	184	13.1	54.9	0.88
chr19	53831713	53832042	CpG: 31	329	31	208	18.8	63.2	0.95
chr19	53834828	53835098	CpG: 20	270	20	165	14.8	61.1	0.80
chr19	53881108	53881769	CpG: 47	661	47	455	14.2	68.8	0.60
chr19	53893673	53894614	CpG: 81	941	81	590	17.2	62.7	0.88
chr19	53907612	53908126	CpG: 39	514	39	347	15.2	67.5	0.67
chr19	53916591	53916849	CpG: 28	258	28	174	21.7	67.4	1.00
chr19	53925420	53925890	CpG: 56	470	56	337	23.8	71.7	0.94
chr19	53996402	53996763	CpG: 26	361	26	221	14.4	61.2	0.77
chr19	54000741	54000992	CpG: 22	251	22	168	17.5	66.9	0.92
chr19	54039369	54039649	CpG: 21	280	21	168	15.0	60.0	0.84
chr19	54042304	54042579	CpG: 24	275	24	172	17.5	62.5	0.90
chr19	54091129	54091578	CpG: 31	449	31	295	13.8	65.7	0.66
chr19	54104367	54104589	CpG: 18	222	18	152	16.2	68.5	0.70
chr19	54105378	54108029	CpG: 176	2651	176	1593	13.3	60.1	0.75
chr19	54120516	54120775	CpG: 25	259	25	184	19.3	71.0	0.77
chr19	54153498	54153756	CpG: 23	258	23	189	17.8	73.3	0.67
chr19	54180269	54180504	CpG: 20	235	20	145	17.0	61.7	0.93
chr19	54187171	54187790	CpG: 90	619	90	480	29.1	77.5	0.97
chr19	54192556	54193189	CpG: 88	633	88	471	27.8	74.4	1.01
chr19	54196773	54197526	CpG: 54	753	54	448	14.3	59.5	0.81
chr19	54270085	54271364	CpG: 90	1279	90	833	14.1	65.1	0.67
chr19	54359731	54360065	CpG: 27	334	27	205	16.2	61.4	0.86
chr19	54399768	54400489	CpG: 75	721	75	566	20.8	78.5	0.68
chr19	54414945	54416246	CpG: 106	1301	106	885	16.3	68.0	0.72
chr19	54425117	54425349	CpG: 18	232	18	144	15.5	62.1	0.82
chr19	54427157	54427382	CpG: 24	225	24	169	21.3	75.1	0.77
chr19	54428104	54428955	CpG: 105	851	105	635	24.7	74.6	0.89
chr19	54454789	54456976	CpG: 153	2187	153	1435	14.0	65.6	0.66
chr19	54483000	54483255	CpG: 26	255	26	156	20.4	61.2	1.09
chr19	54510381	54510795	CpG: 31	414	31	293	15.0	70.8	0.63
chr19	54511046	54511319	CpG: 20	273	20	163	14.7	59.7	0.83
chr19	54552676	54553002	CpG: 25	326	25	228	15.3	69.9	0.69
chr19	54553380	54553657	CpG: 21	277	21	172	15.2	62.1	0.79
chr19	54659728	54659953	CpG: 21	225	21	121	18.7	53.8	1.30
chr19	54682648	54683396	CpG: 62	748	62	462	16.6	61.8	0.87
chr19	54687199	54687422	CpG: 21	223	21	157	18.8	70.4	0.76
chr19	54689816	54690396	CpG: 79	580	79	446	27.2	76.9	0.93
chr19	54776119	54776754	CpG: 64	635	64	485	20.2	76.4	0.74
chr19	54790154	54791641	CpG: 112	1487	112	940	15.1	63.2	0.77
chr19	54800569	54801299	CpG: 68	730	68	505	18.6	69.2	0.78
chr19	54806348	54807133	CpG: 90	785	90	560	22.9	71.3	0.90
chr19	54873255	54873491	CpG: 17	236	17	141	14.4	59.7	0.83
chr19	54974783	54975310	CpG: 47	527	47	321	17.8	60.9	0.99
chr19	55036261	55036488	CpG: 23	227	23	141	20.3	62.1	1.09
chr19	55095173	55095567	CpG: 34	394	34	246	17.3	62.4	0.89
chr19	55115268	55115669	CpG: 42	401	42	249	20.9	62.1	1.12
chr19	55135798	55136181	CpG: 36	383	36	244	18.8	63.7	1.00
chr19	55182439	55183197	CpG: 57	758	57	464	15.0	61.2	0.86
chr19	55226571	55227366	CpG: 58	795	58	494	14.6	62.1	0.82
chr19	55258284	55258957	CpG: 47	673	47	407	14.0	60.5	0.82
chr19	55276761	55277773	CpG: 92	1012	92	664	18.2	65.6	0.85
chr19	55278113	55278356	CpG: 20	243	20	143	16.5	58.8	0.98
chr19	55356643	55357194	CpG: 59	551	59	359	21.4	65.2	1.01
chr19	55383986	55384807	CpG: 76	821	76	531	18.5	64.7	0.93
chr19	55423419	55423912	CpG: 50	493	50	310	20.3	62.9	1.05
chr19	55457046	55457534	CpG: 40	488	40	295	16.4	60.5	0.91
chr19	55482364	55482584	CpG: 25	220	25	148	22.7	67.3	1.00
chr19	55482732	55482953	CpG: 15	221	15	124	13.6	56.1	0.93
chr19	55535758	55536142	CpG: 48	384	48	275	25.0	71.6	0.98
chr19	55537954	55538542	CpG: 46	588	46	351	15.6	59.7	0.89
chr19	55577267	55577922	CpG: 48	655	48	408	14.7	62.3	0.77
chr19	55580965	55581197	CpG: 18	232	18	140	15.5	60.3	0.88
chr19	55612041	55612696	CpG: 56	655	56	415	17.1	63.4	0.87
chr19	55620416	55621259	CpG: 63	843	63	530	14.9	62.9	0.77
chr19	55642735	55642948	CpG: 18	213	18	136	16.9	63.8	0.85
chr19	55654629	55655360	CpG: 55	731	55	439	15.0	60.1	0.86
chr19	55669518	55669852	CpG: 27	334	27	219	16.2	65.6	0.78
chr19	55682450	55682686	CpG: 19	236	19	144	16.1	61.0	0.88
chr19	55685577	55686342	CpG: 58	765	58	478	15.2	62.5	0.80
chr19	55722689	55723002	CpG: 27	313	27	197	17.3	62.9	0.89
chr19	55760574	55761019	CpG: 32	445	32	303	14.4	68.1	0.62
chr19	55765085	55765359	CpG: 25	274	25	171	18.2	62.4	0.95
chr19	55774324	55775129	CpG: 65	805	65	504	16.1	62.6	0.86
chr19	55810238	55810460	CpG: 20	222	20	151	18.0	68.0	0.78
chr19	55818808	55819711	CpG: 69	903	69	572	15.3	63.3	0.78
chr19	55870807	55871429	CpG: 47	622	47	388	15.1	62.4	0.79
chr19	55894288	55894530	CpG: 28	242	28	186	23.1	76.9	0.85
chr19	55895476	55896623	CpG: 85	1147	85	803	14.8	70.0	0.61
chr19	55904462	55904743	CpG: 23	281	23	173	16.4	61.6	0.88
chr19	55934917	55935191	CpG: 22	274	22	170	16.1	62.0	0.85
chr19	55941874	55942117	CpG: 29	243	29	171	23.9	70.4	0.97
chr19	55981729	55982474	CpG: 56	745	56	471	15.0	63.2	0.78
chr19	56005344	56005654	CpG: 23	310	23	205	14.8	66.1	0.73
chr19	56005886	56006131	CpG: 24	245	24	171	19.6	69.8	0.82
chr19	56024623	56025279	CpG: 52	656	52	409	15.9	62.3	0.85
chr19	56044992	56045602	CpG: 49	610	49	394	16.1	64.6	0.78
chr19	56075284	56076344	CpG: 78	1060	78	658	14.7	62.1	0.79
chr19	56077838	56078117	CpG: 22	279	22	169	15.8	60.6	0.87
chr19	56079944	56080322	CpG: 26	378	26	237	13.8	62.7	0.73
chr19	56120049	56120547	CpG: 41	498	41	285	16.5	57.2	1.04
chr19	56138720	56138922	CpG: 14	202	14	119	13.9	58.9	0.84
chr19	56140053	56140319	CpG: 19	266	19	154	14.3	57.9	0.88
chr19	56140532	56141129	CpG: 57	597	57	398	19.1	66.7	0.92
chr19	56185362	56186401	CpG: 88	1039	88	699	16.9	67.3	0.81
chr19	56214662	56215267	CpG: 45	605	45	393	14.9	65.0	0.74
chr19	56240445	56241515	CpG: 91	1070	91	681	17.0	63.6	0.86
chr19	56249772	56250191	CpG: 30	419	30	243	14.3	58.0	0.85
chr19	56272276	56273001	CpG: 54	725	54	456	14.9	62.9	0.80
chr19	56274245	56274524	CpG: 24	279	24	174	17.2	62.4	0.90
chr19	56276358	56277356	CpG: 73	998	73	620	14.6	62.1	0.79
chr19	56301896	56302618	CpG: 55	722	55	495	15.2	68.6	0.65
chr19	56304775	56305014	CpG: 17	239	17	144	14.2	60.3	0.80
chr19	56334071	56334818	CpG: 68	747	68	460	18.2	61.6	1.00
chr19	56349448	56350029	CpG: 48	581	48	393	16.5	67.6	0.72
chr19	56366950	56367225	CpG: 26	275	26	173	18.9	62.9	0.96
chr19	56370646	56370967	CpG: 30	321	30	217	18.7	67.6	0.83
chr19	56387854	56388245	CpG: 31	391	31	251	15.9	64.2	0.77
chr19	56388752	56389189	CpG: 32	437	32	253	14.6	57.9	0.88
chr19	56397060	56397334	CpG: 23	274	23	171	16.8	62.4	0.87
chr19	56408611	56408818	CpG: 17	207	17	141	16.4	68.1	0.71
chr19	56413039	56413739	CpG: 55	700	55	429	15.7	61.3	0.86
chr19	56437737	56438060	CpG: 27	323	27	218	16.7	67.5	0.78
chr19	56445060	56445817	CpG: 59	757	59	495	15.6	65.4	0.78
chr19	56474513	56475164	CpG: 52	651	52	409	16.0	62.8	0.83
chr19	56511391	56511593	CpG: 27	202	27	148	26.7	73.3	1.02
chr19	56511856	56512125	CpG: 20	269	20	181	14.9	67.3	0.68
chr19	56547110	56547781	CpG: 53	671	53	421	15.8	62.7	0.82
chr19	56582097	56582333	CpG: 21	236	21	143	17.8	60.6	1.00
chr19	56600205	56600897	CpG: 45	692	45	409	13.0	59.1	0.75
chr19	56600984	56601262	CpG: 20	278	20	172	14.4	61.9	0.77
chr19	56617152	56618197	CpG: 100	1045	100	709	19.1	67.8	0.85
chr19	56633761	56634601	CpG: 83	840	83	566	19.8	67.4	0.90
chr19	56635563	56635804	CpG: 18	241	18	147	14.9	61.0	0.82
chr19	56727341	56728969	CpG: 116	1628	116	1042	14.3	64.0	0.70
chr19	56743135	56743369	CpG: 19	234	19	146	16.2	62.4	0.86
chr19	56847683	56848180	CpG: 39	497	39	314	15.7	63.2	0.79
chr19	56867656	56867931	CpG: 26	275	26	177	18.9	64.4	0.92
chr19	56926003	56926231	CpG: 19	228	19	139	16.7	61.0	0.91
chr19	56928657	56928907	CpG: 19	250	19	156	15.2	62.4	0.81
chr19	56945912	56946334	CpG: 42	422	42	304	19.9	72.0	0.79
chr19	56948385	56949526	CpG: 98	1141	98	804	17.2	70.5	0.69
chr19	56953628	56953897	CpG: 27	269	27	177	20.1	65.8	0.94
chr19	56959115	56959402	CpG: 35	287	35	212	24.4	73.9	0.91
chr19	56961766	56962055	CpG: 31	289	31	215	21.5	74.4	0.78
chr19	56969490	56969751	CpG: 23	261	23	185	17.6	70.9	0.71
chr19	56978155	56978924	CpG: 55	769	55	508	14.3	66.1	0.71
chr19	56986418	56986652	CpG: 24	234	24	158	20.5	67.5	0.96
chr19	56987828	56988420	CpG: 48	592	48	413	16.2	69.8	0.67
chr19	56988964	56989539	CpG: 70	575	70	444	24.3	77.2	0.86
chr19	56998504	56998771	CpG: 20	267	20	158	15.0	59.2	0.86
chr19	57020470	57020983	CpG: 46	513	46	351	17.9	68.4	0.81
chr19	57028307	57028511	CpG: 16	204	16	122	15.7	59.8	0.89
chr19	57041414	57041961	CpG: 61	547	61	411	22.3	75.1	0.82
chr19	57056648	57057191	CpG: 47	543	47	341	17.3	62.8	0.88
chr19	57058257	57058808	CpG: 55	551	55	376	20.0	68.2	0.86
chr19	57060423	57061558	CpG: 161	1135	161	878	28.4	77.4	0.95
chr19	57069844	57070366	CpG: 53	522	53	384	20.3	73.6	0.77
chr19	57071292	57071848	CpG: 58	556	58	402	20.9	72.3	0.80
chr19	57090322	57090570	CpG: 19	248	19	175	15.3	70.6	0.62
chr19	57130628	57130862	CpG: 17	234	17	142	14.5	60.7	0.80
chr19	57174457	57174772	CpG: 45	315	45	234	28.6	74.3	1.04
chr19	57180272	57180510	CpG: 18	238	18	140	15.1	58.8	0.89
chr19	57181374	57181979	CpG: 54	605	54	405	17.9	66.9	0.80
chr19	57182560	57182826	CpG: 21	266	21	163	15.8	61.3	0.85
chr19	57193969	57195063	CpG: 79	1094	79	630	14.4	57.6	0.87
chr19	57209043	57209279	CpG: 18	236	18	144	15.3	61.0	0.84
chr19	57217627	57218881	CpG: 140	1254	140	905	22.3	72.2	0.86
chr19	57239631	57240438	CpG: 72	807	72	497	17.8	61.6	0.95
chr19	57242451	57242909	CpG: 36	458	36	311	15.7	67.9	0.71
chr19	57244689	57245097	CpG: 28	408	28	272	13.7	66.7	0.67
chr19	57255206	57255426	CpG: 16	220	16	131	14.5	59.5	0.84
chr19	57260977	57261377	CpG: 42	400	42	293	21.0	73.2	0.83
chr19	57269566	57272034	CpG: 256	2468	256	1703	20.7	69.0	0.89
chr19	57280713	57281724	CpG: 79	1011	79	606	15.6	59.9	0.88
chr19	57287626	57287895	CpG: 21	269	21	175	15.6	65.1	0.74
chr19	57292134	57292404	CpG: 23	270	23	170	17.0	63.0	0.87
chr19	57307002	57307227	CpG: 20	225	20	137	17.8	60.9	0.99
chr19	57309988	57310207	CpG: 19	219	19	136	17.4	62.1	0.92
chr19	57473183	57473457	CpG: 20	274	20	168	14.6	61.3	0.80
chr19	57475259	57475537	CpG: 23	278	23	174	16.5	62.6	0.86
chr19	57475956	57476185	CpG: 19	229	19	139	16.6	60.7	0.91
chr19	57508506	57509144	CpG: 67	638	67	494	21.0	77.4	0.71
chr19	57510005	57510328	CpG: 35	323	35	242	21.7	74.9	0.79
chr19	57520600	57520810	CpG: 16	210	16	126	15.2	60.0	0.86
chr19	57541928	57543048	CpG: 116	1120	116	734	20.7	65.5	0.97
chr19	57553978	57554190	CpG: 17	212	17	152	16.0	71.7	0.67
chr19	57554525	57554838	CpG: 26	313	26	225	16.6	71.9	0.66
chr19	57556275	57559023	CpG: 266	2748	266	1841	19.4	67.0	0.86
chr19	57564498	57565007	CpG: 51	509	51	368	20.0	72.3	0.79
chr19	57568779	57568996	CpG: 16	217	16	131	14.7	60.4	0.82
chr19	57575445	57575674	CpG: 18	229	18	140	15.7	61.1	0.87
chr19	57604846	57605114	CpG: 20	268	20	168	14.9	62.7	0.76
chr19	57605450	57605715	CpG: 25	265	25	169	18.9	63.8	0.95
chr19	57620370	57620630	CpG: 25	260	25	160	19.2	61.5	1.10
chr19	57657440	57657715	CpG: 25	275	25	171	18.2	62.2	0.95
chr19	57756680	57756952	CpG: 20	272	20	169	14.7	62.1	0.77
chr19	57975869	57976193	CpG: 28	324	28	205	17.3	63.3	0.90
chr19	58033744	58034050	CpG: 28	306	28	213	18.3	69.6	0.76
chr19	58037661	58037908	CpG: 22	247	22	158	17.8	64.0	0.89
chr19	58076634	58076847	CpG: 15	213	15	137	14.1	64.3	0.70
chr19	58076957	58077263	CpG: 30	306	30	214	19.6	69.9	0.80
chr19	58093140	58093345	CpG: 16	205	16	145	15.6	70.7	0.63
chr19	58126981	58127734	CpG: 97	753	97	422	25.8	56.0	1.86
chr19	58156959	58157562	CpG: 71	603	71	436	23.5	72.3	0.92
chr19	58174555	58177102	CpG: 200	2547	200	1699	15.7	66.7	0.71
chr19	58177906	58178208	CpG: 27	302	27	212	17.9	70.2	0.73
chr19	58180938	58182010	CpG: 94	1072	94	731	17.5	68.2	0.76
chr19	58190310	58191368	CpG: 90	1058	90	680	17.0	64.3	1.28
chr19	58210796	58211877	CpG: 127	1081	127	770	23.5	71.2	0.93
chr19	58213130	58213364	CpG: 18	234	18	139	15.4	59.4	0.88
chr19	58250223	58251156	CpG: 60	933	60	601	12.9	64.4	0.65
chr19	58254714	58256354	CpG: 131	1640	131	1123	16.0	68.5	0.68
chr19	58257090	58257513	CpG: 32	423	32	240	15.1	56.7	0.95
chr19	58260211	58260907	CpG: 49	696	49	447	14.1	64.2	0.68
chr19	58266204	58266439	CpG: 19	235	19	140	16.2	59.6	0.96
chr19	58267571	58268012	CpG: 42	441	42	314	19.0	71.2	0.77
chr19	58272876	58274462	CpG: 126	1586	126	1074	15.9	67.7	0.70
chr19	58281128	58281364	CpG: 18	236	18	144	15.3	61.0	0.83
chr19	58310752	58311036	CpG: 20	284	20	185	14.1	65.1	0.66
chr19	58351846	58353452	CpG: 170	1606	170	1127	21.2	70.2	0.87
chr19	58375014	58375271	CpG: 20	257	20	173	15.6	67.3	0.71
chr19	58375440	58375984	CpG: 46	544	46	352	16.9	64.7	0.89
chr19	58379524	58379991	CpG: 47	467	47	376	20.1	80.5	0.64
chr19	58382486	58382820	CpG: 23	334	23	214	13.8	64.1	0.67
chr19	58386237	58386473	CpG: 18	236	18	141	15.3	59.7	0.89
chr19	58398232	58398443	CpG: 17	211	17	143	16.1	67.8	0.70
chr19	58400105	58400442	CpG: 31	337	31	255	18.4	75.7	0.66
chr19	58422404	58422679	CpG: 25	275	25	175	18.2	63.6	0.90
chr19	58434621	58435619	CpG: 92	998	92	655	18.4	65.6	0.87
chr19	58448268	58448517	CpG: 18	249	18	158	14.5	63.5	0.83
chr19	58449154	58450484	CpG: 114	1330	114	924	17.1	69.5	0.73
chr19	58464696	58466125	CpG: 133	1429	133	1080	18.6	75.6	0.66
chr19	58473123	58473594	CpG: 38	471	38	324	16.1	68.8	0.68
chr19	58479133	58482359	CpG: 280	3226	280	2058	17.4	63.8	0.85
chr19	58488064	58488297	CpG: 20	233	20	144	17.2	61.8	0.91
chr19	58496894	58497182	CpG: 27	288	27	201	18.8	69.8	0.78
chr19	58502784	58503901	CpG: 125	1117	125	782	22.4	70.0	0.91
chr19	58528538	58529256	CpG: 80	718	80	550	22.3	76.6	0.77
chr19	58535884	58536187	CpG: 28	303	28	217	18.5	71.6	0.75
chr19	58537455	58538831	CpG: 145	1376	145	1006	21.1	73.1	0.80
chr19	58546998	58548764	CpG: 163	1766	163	1263	18.5	71.5	0.72
chr19	58557475	58558234	CpG: 66	759	66	510	17.4	67.2	0.77
chr19	58566794	58567042	CpG: 22	248	22	152	17.7	61.3	0.98
chr19	58572447	58573167	CpG: 70	720	70	494	19.4	68.6	0.84
chr19	58577483	58581822	CpG: 354	4339	354	3042	16.3	70.1	0.67
chr19	58582682	58583125	CpG: 42	443	42	337	19.0	76.1	0.66
chr19	58585783	58586087	CpG: 29	304	29	229	19.1	75.3	0.69
chr19	58587208	58587523	CpG: 28	315	28	227	17.8	72.1	0.71
chr19	58590041	58590445	CpG: 42	404	42	298	20.8	73.8	0.81
chr19	58599891	58600720	CpG: 72	829	72	556	17.4	67.1	0.78
chr19	58612569	58612835	CpG: 19	266	19	164	14.3	61.7	0.76
chr19	58613220	58613808	CpG: 56	588	56	418	19.0	71.1	0.79
chr19	58626064	58626732	CpG: 68	668	68	498	20.4	74.6	0.74
chr19	58627059	58627290	CpG: 21	231	21	154	18.2	66.7	0.84
chr19	58631979	58632244	CpG: 21	265	21	176	15.8	66.4	0.74
chr19	58645768	58646040	CpG: 24	272	24	190	17.6	69.9	0.73
chr19	58673835	58675524	CpG: 180	1689	180	1268	21.3	75.1	0.76
chr19	58682953	58683499	CpG: 39	546	39	339	14.3	62.1	0.74
chr19	58688296	58689539	CpG: 142	1243	142	927	22.8	74.6	0.82
chr19	58690352	58690618	CpG: 20	266	20	162	15.0	60.9	0.83
chr19	58693524	58693808	CpG: 26	284	26	195	18.3	68.7	0.83
chr19	58695271	58696632	CpG: 141	1361	141	934	20.7	68.6	0.88
chr19	58698396	58698801	CpG: 39	405	39	284	19.3	70.1	0.79
chr19	58701290	58701758	CpG: 62	468	62	357	26.5	76.3	0.91
chr19	58709481	58712743	CpG: 337	3262	337	2352	20.7	72.1	0.80
chr19	58717598	58718425	CpG: 83	827	83	594	20.1	71.8	0.78
chr19	58720332	58720988	CpG: 50	656	50	414	15.2	63.1	0.77
chr19	58736067	58740020	CpG: 288	3953	288	2593	14.6	65.6	0.68
chr19	58740861	58741092	CpG: 20	231	20	157	17.3	68.0	0.75
chr19	58743820	58744501	CpG: 82	681	82	504	24.1	74.0	0.88
chr19	58748223	58751819	CpG: 332	3596	332	2291	18.5	63.7	0.91
chr19	58755068	58755270	CpG: 27	202	27	147	26.7	72.8	1.02
chr19	58761190	58761473	CpG: 18	283	18	167	12.7	59.0	0.73
chr19	58765492	58765762	CpG: 23	270	23	173	17.0	64.1	0.85
chr19	58771718	58772494	CpG: 104	776	104	591	26.8	76.2	0.93
chr19	58782096	58782729	CpG: 63	633	63	423	19.9	66.8	0.89
chr19	58800790	58801184	CpG: 38	394	38	262	19.3	66.5	0.88
chr19	58850508	58850732	CpG: 19	224	19	136	17.0	60.7	0.94
chr19	58921763	58922122	CpG: 28	359	28	215	15.6	59.9	0.87
chr19	58949160	58951062	CpG: 195	1902	195	1090	20.5	57.3	1.37
chr19	58957369	58957623	CpG: 19	254	19	147	15.0	57.9	0.90
chr19	59179681	59179882	CpG: 16	201	16	128	15.9	63.7	0.81
chr19	59185527	59187920	CpG: 223	2393	223	1685	18.6	70.4	0.75
chr19	59196289	59196601	CpG: 25	312	25	181	16.0	58.0	0.95
chr19	59197288	59197668	CpG: 37	380	37	253	19.5	66.6	0.92
chr19	59199667	59200169	CpG: 36	502	36	326	14.3	64.9	0.70
chr19	59202514	59203334	CpG: 123	820	123	611	30.0	74.5	1.13
chr19	59204600	59205227	CpG: 69	627	69	427	22.0	68.1	1.03
chr19	59208417	59208644	CpG: 16	227	16	137	14.1	60.4	0.78
chr19	59214040	59214520	CpG: 34	480	34	290	14.2	60.4	0.80
chr19	59219239	59220543	CpG: 159	1304	159	998	24.4	76.5	0.87
chr19	59239703	59240196	CpG: 41	493	41	309	16.6	62.7	0.85
chr19	59245720	59246065	CpG: 37	345	37	259	21.4	75.1	0.77
chr19	59246197	59246471	CpG: 19	274	19	179	13.9	65.3	0.65
chr19	59258588	59259131	CpG: 64	543	64	407	23.6	75.0	0.85
chr19	59296465	59296683	CpG: 21	218	21	135	19.3	61.9	1.03
chr19	59297807	59298081	CpG: 21	274	21	168	15.3	61.3	0.82
chr19	59315998	59316785	CpG: 83	787	83	550	21.1	69.9	0.86
chr19	59326934	59327202	CpG: 22	268	22	153	16.4	57.1	1.05
chr19	59412119	59413139	CpG: 74	1020	74	597	14.5	58.5	0.85
chr19	59437005	59437721	CpG: 64	716	64	379	17.9	52.9	1.34
chr19	59442455	59442773	CpG: 27	318	27	191	17.0	60.1	0.95
chr19	59462440	59463018	CpG: 57	578	57	379	19.7	65.6	0.92
chr19	59487671	59488390	CpG: 69	719	69	454	19.2	63.1	0.97
chr19	59498390	59498884	CpG: 53	494	53	361	21.5	73.1	0.81
chr19	59571380	59572808	CpG: 148	1428	148	962	20.7	67.4	0.92
chr19	59573317	59573575	CpG: 20	258	20	157	15.5	60.9	0.85
chr19	59601811	59602574	CpG: 78	763	78	502	20.4	65.8	0.94
chr19	59632740	59633686	CpG: 104	946	104	696	22.0	73.6	0.82
chr19	59661397	59662179	CpG: 72	782	72	535	18.4	68.4	0.79
chr19	59689574	59689933	CpG: 45	359	45	272	25.1	75.8	0.92
chr19	59715886	59716912	CpG: 95	1026	95	667	18.5	65.0	0.88
chr19	59731503	59731792	CpG: 25	289	25	168	17.3	58.1	1.04
chr19	59732232	59732440	CpG: 14	208	14	122	13.5	58.7	0.80
chr19	59736937	59737824	CpG: 75	887	75	619	16.9	69.8	0.69
chr19	59757843	59759189	CpG: 139	1346	139	910	20.7	67.6	0.92
chr19	59765629	59766117	CpG: 46	488	46	330	18.9	67.6	0.83
chr19	59860342	59860670	CpG: 31	328	31	198	18.9	60.4	1.13
chr19	59863560	59863843	CpG: 23	283	23	174	16.3	61.5	0.87
chr19	59890398	59890748	CpG: 38	350	38	248	21.7	70.9	0.87
chr19	59933697	59934170	CpG: 36	473	36	312	15.2	66.0	0.73
chr19	59934983	59935984	CpG: 82	1001	82	699	16.4	69.8	0.68
chr19	59959541	59960121	CpG: 50	580	50	371	17.2	64.0	0.84
chr19	60009248	60009525	CpG: 24	277	24	173	17.3	62.5	0.90
chr19	60038366	60039681	CpG: 184	1315	184	995	28.0	75.7	1.06
chr19	60062418	60062657	CpG: 18	239	18	126	15.1	52.7	1.10
chr19	60094444	60094756	CpG: 24	312	24	184	15.4	59.0	0.90
chr19	60195869	60196118	CpG: 28	249	28	165	22.5	66.3	1.05
chr19	60201256	60201530	CpG: 23	274	23	169	16.8	61.7	0.89
chr19	60202782	60203629	CpG: 86	847	86	627	20.3	74.0	0.74
chr19	60215633	60216700	CpG: 79	1067	79	664	14.8	62.2	0.77
chr19	60251252	60251482	CpG: 20	230	20	141	17.4	61.3	0.94
chr19	60258019	60258251	CpG: 17	232	17	138	14.7	59.5	0.84
chr19	60262201	60262437	CpG: 16	236	16	140	13.6	59.3	0.78
chr19	60268313	60268998	CpG: 104	685	104	559	30.4	81.6	1.04
chr19	60287863	60288592	CpG: 73	729	73	495	20.0	67.9	0.87
chr19	60302861	60303080	CpG: 18	219	18	129	16.4	58.9	0.98
chr19	60327132	60327634	CpG: 39	502	39	313	15.5	62.4	0.80
chr19	60336186	60336418	CpG: 18	232	18	135	15.5	58.2	0.94
chr19	60337061	60337459	CpG: 43	398	43	278	21.6	69.8	0.90
chr19	60376602	60377363	CpG: 74	761	74	495	19.4	65.0	0.92
chr19	60414077	60414292	CpG: 26	215	26	162	24.2	75.3	0.86
chr19	60416857	60417516	CpG: 62	659	62	436	18.8	66.2	0.86
chr19	60426577	60426851	CpG: 20	274	20	167	14.6	60.9	0.80
chr19	60448103	60448898	CpG: 58	795	58	478	14.6	60.1	0.81
chr19	60460311	60460775	CpG: 44	464	44	287	19.0	61.9	0.99
chr19	60461496	60461841	CpG: 27	345	27	201	15.7	58.3	0.93
chr19	60486753	60487179	CpG: 38	426	38	264	17.8	62.0	0.93
chr19	60508105	60508731	CpG: 50	626	50	407	16.0	65.0	0.77
chr19	60532162	60532859	CpG: 53	697	53	446	15.2	64.0	0.75
chr19	60558865	60559139	CpG: 19	274	19	168	13.9	61.3	0.75
chr19	60579671	60580731	CpG: 84	1060	84	770	15.8	72.6	0.60
chr19	60584719	60585348	CpG: 65	629	65	424	20.7	67.4	0.91
chr19	60596704	60597364	CpG: 68	660	68	446	20.6	67.6	0.91
chr19	60618036	60618270	CpG: 16	234	16	138	13.7	59.0	0.82
chr19	60624132	60624768	CpG: 63	636	63	424	19.8	66.7	0.90
chr19	60656113	60656833	CpG: 71	720	71	469	19.7	65.1	0.94
chr19	60675361	60676084	CpG: 67	723	67	470	18.5	65.0	0.88
chr19	60680299	60681324	CpG: 88	1025	88	675	17.2	65.9	0.79
chr19	60696790	60697331	CpG: 53	541	53	373	19.6	68.9	0.83
chr19	60711091	60711463	CpG: 46	372	46	263	24.7	70.7	1.00
chr19	60729900	60730560	CpG: 57	660	57	436	17.3	66.1	0.79
chr19	60761184	60761665	CpG: 54	481	54	341	22.5	70.9	0.93
chr19	60778830	60779200	CpG: 41	370	41	245	22.2	66.2	1.01
chr19	60805416	60806079	CpG: 54	663	54	404	16.3	60.9	0.88
chr19	60824149	60824592	CpG: 42	443	42	294	19.0	66.4	0.88
chr19	60843658	60844189	CpG: 43	531	43	318	16.2	59.9	0.90
chr19	60866491	60867367	CpG: 70	876	70	557	16.0	63.6	0.79
chr19	60867804	60868021	CpG: 21	217	21	136	19.4	62.7	0.99
chr19	60882414	60882648	CpG: 18	234	18	138	15.4	59.0	0.91
chr19	60883021	60883668	CpG: 61	647	61	416	18.9	64.3	0.91
chr19	60887632	60887906	CpG: 24	274	24	172	17.5	62.8	0.90
chr19	60911404	60912063	CpG: 52	659	52	408	15.8	61.9	0.83
chr19	60916266	60916981	CpG: 52	715	52	425	14.5	59.4	0.82
chr19	60946678	60947099	CpG: 32	421	32	268	15.2	63.7	0.75
chr19	60985479	60985810	CpG: 29	331	29	217	17.5	65.6	0.82
chr19	60997834	60998048	CpG: 17	214	17	129	15.9	60.3	0.89
chr19	61013174	61013607	CpG: 38	433	38	276	17.6	63.7	0.87
chr19	61031891	61032355	CpG: 42	464	42	290	18.1	62.5	0.94
chr19	61044243	61044776	CpG: 52	533	52	361	19.5	67.7	0.85
chr19	61046375	61046601	CpG: 18	226	18	152	15.9	67.3	0.72
chr19	61062985	61063222	CpG: 17	237	17	141	14.3	59.5	0.84
chr19	61097194	61097454	CpG: 18	260	18	156	13.8	60.0	0.79
chr19	61099030	61100499	CpG: 136	1469	136	928	18.5	63.2	0.93
chr19	61106329	61107009	CpG: 53	680	53	439	15.6	64.6	0.75
chr19	61130696	61131478	CpG: 111	782	111	595	28.4	76.1	0.98
chr19	61134882	61135289	CpG: 32	407	32	290	15.7	71.3	0.62
chr19	61139260	61139480	CpG: 18	220	18	132	16.4	60.0	0.94
chr19	61139929	61140225	CpG: 29	296	29	194	19.6	65.5	0.93
chr19	61141377	61142193	CpG: 73	816	73	549	17.9	67.3	0.79
chr19	61155846	61157220	CpG: 120	1374	120	951	17.5	69.2	0.73
chr19	61181251	61182324	CpG: 94	1073	94	763	17.5	71.1	0.69
chr19	61185826	61186100	CpG: 24	274	24	172	17.5	62.8	0.90
chr19	61194768	61195418	CpG: 61	650	61	435	18.8	66.9	0.84
chr19	61214412	61215350	CpG: 99	938	99	642	21.1	68.4	0.90
chr19	61246840	61247390	CpG: 61	550	61	386	22.2	70.2	0.90
chr19	61251125	61251934	CpG: 80	809	80	570	19.8	70.5	0.80
chr19	61253774	61254206	CpG: 46	432	46	326	21.3	75.5	0.75
chr19	61279611	61280217	CpG: 73	606	73	433	24.1	71.5	0.95
chr19	61300314	61301127	CpG: 65	813	65	502	16.0	61.7	0.86
chr19	61313369	61313821	CpG: 45	452	45	286	19.9	63.3	1.01
chr19	61315021	61315291	CpG: 20	270	20	165	14.8	61.1	0.80
chr19	61324784	61325644	CpG: 77	860	77	576	17.9	67.0	0.80
chr19	61374032	61374259	CpG: 17	227	17	133	15.0	58.6	0.89
chr19	61374953	61376011	CpG: 95	1058	95	695	18.0	65.7	0.83
chr19	61386588	61386825	CpG: 17	237	17	139	14.3	58.6	0.85
chr19	61395895	61396101	CpG: 15	206	15	123	14.6	59.7	0.83
chr19	61401576	61402067	CpG: 47	491	47	332	19.1	67.6	0.87
chr19	61423246	61423915	CpG: 62	669	62	440	18.5	65.8	0.89
chr19	61443503	61444271	CpG: 78	768	78	557	20.3	72.5	0.78
chr19	61446389	61447454	CpG: 99	1065	99	716	18.6	67.2	0.82
chr19	61452447	61453918	CpG: 169	1471	169	1041	23.0	70.8	0.92
chr19	61458306	61460073	CpG: 156	1767	156	1127	17.7	63.8	0.87
chr19	61463430	61465678	CpG: 227	2248	227	1531	20.2	68.1	0.87
chr19	61467359	61467638	CpG: 21	279	21	175	15.1	62.7	0.78
chr19	61476856	61478071	CpG: 112	1215	112	784	18.4	64.5	0.89
chr19	61482744	61483795	CpG: 98	1051	98	691	18.6	65.7	0.86
chr19	61492477	61493446	CpG: 127	969	127	742	26.2	76.6	0.90
chr19	61497284	61498459	CpG: 100	1175	100	726	17.0	61.8	0.89
chr19	61501196	61502453	CpG: 97	1257	97	899	15.4	71.5	0.60
chr19	61504384	61505356	CpG: 120	972	120	681	24.7	70.1	1.01
chr19	61535832	61536868	CpG: 82	1036	82	638	15.8	61.6	0.83
chr19	61538175	61538462	CpG: 24	287	24	176	16.7	61.3	0.91
chr19	61547345	61548309	CpG: 93	964	93	669	19.3	69.4	0.81
chr19	61551529	61552387	CpG: 84	858	84	574	19.6	66.9	0.88
chr19	61554832	61555069	CpG: 17	237	17	139	14.3	58.6	0.85
chr19	61562802	61563551	CpG: 90	749	90	540	24.0	72.1	0.93
chr19	61566922	61568105	CpG: 109	1183	109	795	18.4	67.2	0.82
chr19	61571453	61572649	CpG: 97	1196	97	774	16.2	64.7	0.77
chr19	61576337	61576734	CpG: 29	397	29	260	14.6	65.5	0.68
chr19	61595186	61595713	CpG: 54	527	54	349	20.5	66.2	0.96
chr19	61609934	61610331	CpG: 53	397	53	286	26.7	72.0	1.05
chr19	61612682	61612915	CpG: 16	233	16	150	13.7	64.4	0.66
chr19	61612979	61613566	CpG: 59	587	59	398	20.1	67.8	0.88
chr19	61615284	61616053	CpG: 85	769	85	529	22.1	68.8	0.97
chr19	61616969	61617345	CpG: 28	376	28	216	14.9	57.4	0.92
chr19	61622453	61622719	CpG: 23	266	23	166	17.3	62.4	0.90
chr19	61634302	61634828	CpG: 48	526	48	373	18.3	70.9	0.73
chr19	61641152	61642791	CpG: 183	1639	183	1124	22.3	68.6	0.95
chr19	61652461	61652972	CpG: 58	511	58	339	22.7	66.3	1.03
chr19	61655960	61657410	CpG: 160	1450	160	995	22.1	68.6	0.94
chr19	61659723	61661065	CpG: 147	1342	147	933	21.9	69.5	0.91
chr19	61663197	61663767	CpG: 41	570	41	343	14.4	60.2	0.80
chr19	61670474	61671370	CpG: 86	896	86	581	19.2	64.8	0.94
chr19	61672576	61673610	CpG: 87	1034	87	651	16.8	63.0	0.85
chr19	61678980	61679562	CpG: 47	582	47	369	16.2	63.4	0.81
chr19	61703603	61704424	CpG: 133	821	133	620	32.4	75.5	1.16
chr20	3079	4070	CpG: 159	991	159	749	32.1	75.6	1.14
chr20	4943	5228	CpG: 22	285	22	174	15.4	61.1	0.85
chr20	71534	72074	CpG: 72	540	72	394	26.7	73.0	1.01
chr20	91600	92601	CpG: 105	1001	105	725	21.0	72.4	0.82
chr20	172530	172846	CpG: 28	316	28	198	17.7	62.7	0.91
chr20	309481	309755	CpG: 28	274	28	179	20.4	65.3	0.98
chr20	321439	322713	CpG: 138	1274	138	981	21.7	77.0	0.99
chr20	333593	333978	CpG: 33	385	33	217	17.1	56.4	1.10
chr20	339572	339803	CpG: 20	231	20	145	17.3	62.8	0.89
chr20	340379	341693	CpG: 162	1314	162	915	24.7	69.6	1.04
chr20	367543	371040	CpG: 357	3497	357	2434	20.4	69.6	0.84
chr20	390080	391681	CpG: 125	1601	125	1114	15.6	69.6	0.65
chr20	423755	425570	CpG: 173	1815	173	1254	19.1	69.1	0.82
chr20	434720	434981	CpG: 20	261	20	171	15.3	65.5	0.73
chr20	439676	439925	CpG: 21	249	21	169	16.9	67.9	0.74
chr20	450945	452237	CpG: 141	1292	141	955	21.8	73.9	0.82
chr20	461933	462163	CpG: 19	230	19	138	16.5	60.0	0.93
chr20	463143	463368	CpG: 23	225	23	162	20.4	72.0	0.79
chr20	464579	465105	CpG: 41	526	41	358	15.6	68.1	0.68
chr20	505442	506448	CpG: 120	1006	120	715	23.9	71.1	0.95
chr20	586159	586430	CpG: 20	271	20	168	14.8	62.0	0.78
chr20	587264	587563	CpG: 30	299	30	212	20.1	70.9	0.80
chr20	653315	654418	CpG: 158	1103	158	836	28.6	75.8	1.00
chr20	686717	687088	CpG: 49	371	49	286	26.4	77.1	0.93
chr20	697136	698004	CpG: 118	868	118	654	27.2	75.3	0.96
chr20	706301	706524	CpG: 21	223	21	161	18.8	72.2	0.75
chr20	707604	708862	CpG: 160	1258	160	915	25.4	72.7	0.99
chr20	719492	720216	CpG: 81	724	81	528	22.4	72.9	0.84
chr20	730409	730645	CpG: 20	236	20	143	16.9	60.6	0.94
chr20	754292	754816	CpG: 67	524	67	391	25.6	74.6	0.96
chr20	772006	772971	CpG: 108	965	108	665	22.4	68.9	0.94
chr20	805317	805742	CpG: 41	425	41	293	19.3	68.9	0.82
chr20	863203	863625	CpG: 40	422	40	256	19.0	60.7	1.03
chr20	880590	881225	CpG: 62	635	62	448	19.5	70.6	0.80
chr20	888144	889530	CpG: 110	1386	110	944	15.9	68.1	0.69
chr20	891728	892734	CpG: 88	1006	88	695	17.5	69.1	0.74
chr20	932287	932523	CpG: 25	236	25	168	21.2	71.2	0.84
chr20	1048976	1049576	CpG: 85	600	85	467	28.3	77.8	0.94
chr20	1160663	1160948	CpG: 22	285	22	172	15.4	60.4	0.85
chr20	1165469	1165952	CpG: 54	483	54	329	22.4	68.1	0.97
chr20	1228199	1228495	CpG: 24	296	24	186	16.2	62.8	0.82
chr20	1231781	1233180	CpG: 156	1399	156	1025	22.3	73.3	0.84
chr20	1272677	1274082	CpG: 143	1405	143	1034	20.4	73.6	0.83
chr20	1314110	1314902	CpG: 69	792	69	559	17.4	70.6	0.70
chr20	1344304	1344538	CpG: 17	234	17	164	14.5	70.1	0.61
chr20	1355075	1355286	CpG: 18	211	18	154	17.1	73.0	0.65
chr20	1362244	1362891	CpG: 51	647	51	461	15.8	71.3	0.62
chr20	1374461	1375116	CpG: 52	655	52	390	15.9	59.5	0.90
chr20	1441802	1442460	CpG: 85	658	85	492	25.8	74.8	0.93
chr20	1515488	1516281	CpG: 103	793	103	587	26.0	74.0	0.96
chr20	1650895	1651134	CpG: 20	239	20	145	16.7	60.7	0.93
chr20	1751802	1752125	CpG: 30	323	30	239	18.6	74.0	0.68
chr20	1793669	1793916	CpG: 23	247	23	149	18.6	60.3	1.03
chr20	1819636	1820364	CpG: 98	728	98	529	26.9	72.7	1.02
chr20	1893506	1894153	CpG: 45	647	45	478	13.9	73.9	0.83
chr20	1898869	1899078	CpG: 15	209	15	142	14.4	67.9	1.11
chr20	1904897	1905246	CpG: 25	349	25	235	14.3	67.3	1.19
chr20	1924052	1925742	CpG: 188	1690	188	1257	22.2	74.4	0.81
chr20	1967608	1967809	CpG: 15	201	15	130	14.9	64.7	0.74
chr20	1977249	1977649	CpG: 28	400	28	248	14.0	62.0	0.73
chr20	1984364	1984619	CpG: 21	255	21	161	16.5	63.1	0.84
chr20	2131663	2133449	CpG: 186	1786	186	1213	20.8	67.9	0.91
chr20	2236906	2237950	CpG: 101	1044	101	732	19.3	70.1	0.79
chr20	2358284	2358548	CpG: 19	264	19	153	14.4	58.0	0.86
chr20	2433958	2434160	CpG: 17	202	17	126	16.8	62.4	0.87
chr20	2500799	2501296	CpG: 47	497	47	326	18.9	65.6	0.92
chr20	2538937	2539391	CpG: 39	454	39	291	17.2	64.1	0.88
chr20	2539543	2539745	CpG: 16	202	16	115	15.8	56.9	0.98
chr20	2554902	2555722	CpG: 73	820	73	546	17.8	66.6	0.83
chr20	2588876	2589620	CpG: 63	744	63	504	16.9	67.7	0.74
chr20	2604010	2604246	CpG: 21	236	21	148	17.8	62.7	0.93
chr20	2679174	2679399	CpG: 16	225	16	133	14.2	59.1	0.82
chr20	2682493	2683609	CpG: 129	1116	129	793	23.1	71.1	0.92
chr20	2694396	2694736	CpG: 30	340	30	219	17.6	64.4	0.87
chr20	2722715	2724500	CpG: 261	1785	261	1417	29.2	79.4	0.93
chr20	2727714	2727950	CpG: 19	236	19	143	16.1	60.6	0.90
chr20	2753810	2754083	CpG: 21	273	21	168	15.4	61.5	0.83
chr20	2779792	2780592	CpG: 66	800	66	557	16.5	69.6	0.69
chr20	2780858	2781190	CpG: 25	332	25	215	15.1	64.8	0.75
chr20	2782034	2783506	CpG: 150	1472	150	1080	20.4	73.4	0.76
chr20	2830591	2831326	CpG: 90	735	90	536	24.5	72.9	0.94
chr20	2835419	2836374	CpG: 62	955	62	625	13.0	65.4	0.61
chr20	2839863	2840139	CpG: 24	276	24	175	17.4	63.4	0.88
chr20	2851465	2852004	CpG: 56	539	56	398	20.8	73.8	0.80
chr20	2870537	2871939	CpG: 139	1402	139	988	19.8	70.5	0.80
chr20	2903098	2904834	CpG: 177	1736	177	1180	20.4	68.0	0.88
chr20	2914219	2914493	CpG: 25	274	25	174	18.2	63.5	0.91
chr20	3041097	3041363	CpG: 20	266	20	163	15.0	61.3	0.81
chr20	3049545	3050809	CpG: 98	1264	98	906	15.5	71.7	0.60
chr20	3076377	3077568	CpG: 135	1191	135	865	22.7	72.6	0.87
chr20	3102348	3103355	CpG: 106	1007	106	725	21.1	72.0	0.83
chr20	3113257	3114399	CpG: 131	1142	131	851	22.9	74.5	0.83
chr20	3123485	3124484	CpG: 96	999	96	700	19.2	70.1	0.79
chr20	3189395	3189621	CpG: 18	226	18	137	15.9	60.6	0.89
chr20	3190549	3191203	CpG: 58	654	58	412	17.7	63.0	0.89
chr20	3195380	3196005	CpG: 61	625	61	448	19.5	71.7	0.78
chr20	3198724	3199319	CpG: 48	595	48	428	16.1	71.9	0.63
chr20	3203903	3205343	CpG: 146	1440	146	1022	20.3	71.0	0.81
chr20	3235179	3235690	CpG: 47	511	47	342	18.4	66.9	0.82
chr20	3240316	3240867	CpG: 44	551	44	358	16.0	65.0	0.80
chr20	3259349	3259692	CpG: 28	343	28	233	16.3	67.9	0.71
chr20	3260117	3260384	CpG: 21	267	21	176	15.7	65.9	0.72
chr20	3261694	3261926	CpG: 18	232	18	159	15.5	68.5	0.66
chr20	3262210	3262482	CpG: 20	272	20	178	14.7	65.4	0.69
chr20	3265000	3265231	CpG: 21	231	21	155	18.2	67.1	0.81
chr20	3268878	3271230	CpG: 257	2352	257	1665	21.9	70.8	0.87
chr20	3279538	3279993	CpG: 47	455	47	310	20.7	68.1	0.89
chr20	3291006	3291287	CpG: 23	281	23	175	16.4	62.3	0.86
chr20	3402347	3402583	CpG: 19	236	19	145	16.1	61.4	0.88
chr20	3425902	3426184	CpG: 24	282	24	171	17.0	60.6	0.93
chr20	3438237	3439173	CpG: 117	936	117	697	25.0	74.5	0.90
chr20	3468620	3468847	CpG: 19	227	19	136	16.7	59.9	0.94
chr20	3471921	3472547	CpG: 57	626	57	480	18.2	76.7	0.62
chr20	3501514	3502454	CpG: 112	940	112	684	23.8	72.8	0.90
chr20	3571969	3572243	CpG: 25	274	25	171	18.2	62.4	0.95
chr20	3585893	3586172	CpG: 23	279	23	176	16.5	63.1	0.84
chr20	3691423	3692407	CpG: 125	984	125	732	25.4	74.4	0.92
chr20	3703484	3705067	CpG: 155	1583	155	1102	19.6	69.6	0.81
chr20	3712607	3713484	CpG: 81	877	81	638	18.5	72.7	0.71
chr20	3763482	3763838	CpG: 53	356	53	291	29.8	81.7	0.94
chr20	3775847	3776201	CpG: 26	354	26	229	14.7	64.7	0.72
chr20	3777286	3777552	CpG: 19	266	19	161	14.3	60.5	0.79
chr20	3780631	3783251	CpG: 218	2620	218	1693	16.6	64.6	0.80
chr20	3798259	3799699	CpG: 134	1440	134	1007	18.6	69.9	0.76
chr20	3808500	3809478	CpG: 81	978	81	675	16.6	69.0	0.70
chr20	3816636	3817929	CpG: 196	1293	196	989	30.3	76.5	1.04
chr20	3826493	3827671	CpG: 94	1178	94	798	16.0	67.7	0.71
chr20	3847994	3848219	CpG: 17	225	17	134	15.1	59.6	0.89
chr20	3851055	3851840	CpG: 95	785	95	557	24.2	71.0	0.96
chr20	3877522	3878328	CpG: 87	806	87	577	21.6	71.6	0.84
chr20	3884017	3884425	CpG: 34	408	34	243	16.7	59.6	0.94
chr20	3919742	3920859	CpG: 129	1117	129	808	23.1	72.3	0.88
chr20	4045872	4046898	CpG: 118	1026	118	744	23.0	72.5	0.87
chr20	4117360	4117639	CpG: 23	279	23	169	16.5	60.6	0.91
chr20	4174209	4174496	CpG: 24	287	24	178	16.7	62.0	0.89
chr20	4183135	4184350	CpG: 136	1215	136	933	22.4	76.8	0.79
chr20	4192515	4192858	CpG: 27	343	27	212	15.7	61.8	0.83
chr20	4206807	4207339	CpG: 53	532	53	376	19.9	70.7	0.80
chr20	4233650	4233873	CpG: 18	223	18	135	16.1	60.5	0.91
chr20	4255821	4256438	CpG: 73	617	73	435	23.7	70.5	0.97
chr20	4282225	4284189	CpG: 236	1964	236	1418	24.0	72.2	0.92
chr20	4631788	4632230	CpG: 42	442	42	306	19.0	69.2	0.79
chr20	4710700	4710975	CpG: 26	275	26	174	18.9	63.3	0.96
chr20	4725417	4726592	CpG: 145	1175	145	888	24.7	75.6	0.87
chr20	4746829	4747057	CpG: 16	228	16	140	14.0	61.4	0.76
chr20	4799941	4800541	CpG: 44	600	44	390	14.7	65.0	0.70
chr20	4861612	4862745	CpG: 110	1133	110	793	19.4	70.0	0.79
chr20	5026998	5027232	CpG: 17	234	17	136	14.5	58.1	0.88
chr20	5040378	5041164	CpG: 105	786	105	632	26.7	80.4	0.83
chr20	5042522	5042801	CpG: 25	279	25	175	17.9	62.7	0.92
chr20	5066482	5067559	CpG: 87	1077	87	782	16.2	72.6	0.61
chr20	5152141	5152926	CpG: 73	785	73	507	18.6	64.6	0.89
chr20	5158770	5159643	CpG: 88	873	88	577	20.2	66.1	0.92
chr20	5165974	5166858	CpG: 110	884	110	644	24.9	72.9	0.94
chr20	5327732	5328585	CpG: 71	853	71	601	16.6	70.5	0.67
chr20	5343123	5343350	CpG: 17	227	17	129	15.0	56.8	0.93
chr20	5356555	5358087	CpG: 133	1532	133	1016	17.4	66.3	0.80
chr20	5365724	5365998	CpG: 21	274	21	166	15.3	60.6	0.85
chr20	5491760	5492026	CpG: 20	266	20	160	15.0	60.2	0.84
chr20	5493261	5494601	CpG: 115	1340	115	937	17.2	69.9	0.70
chr20	5622217	5622494	CpG: 25	277	25	173	18.1	62.5	0.93
chr20	5650948	5651693	CpG: 104	745	104	562	27.9	75.4	0.99
chr20	5679573	5680224	CpG: 58	651	58	461	17.8	70.8	0.71
chr20	5696879	5697120	CpG: 19	241	19	144	15.8	59.8	0.91
chr20	5713156	5713401	CpG: 19	245	19	148	15.5	60.4	0.88
chr20	5741897	5742646	CpG: 61	749	61	522	16.3	69.7	0.67
chr20	5773827	5774087	CpG: 18	260	18	156	13.8	60.0	0.78
chr20	5789487	5789761	CpG: 20	274	20	170	14.6	62.0	0.76
chr20	5824881	5825117	CpG: 21	236	21	144	17.8	61.0	0.98
chr20	5890026	5890307	CpG: 24	281	24	175	17.1	62.3	0.89
chr20	5951563	5952102	CpG: 57	539	57	389	21.2	72.2	0.83
chr20	5990651	5991312	CpG: 60	661	60	420	18.2	63.5	0.90
chr20	6002721	6003002	CpG: 25	281	25	176	17.8	62.6	0.92
chr20	6046063	6046961	CpG: 105	898	105	653	23.4	72.7	0.88
chr20	6081257	6082548	CpG: 95	1291	95	859	14.7	66.5	0.67
chr20	6092348	6093190	CpG: 91	842	91	609	21.6	72.3	0.83
chr20	6164372	6164906	CpG: 55	534	55	379	20.6	71.0	0.82
chr20	6185425	6185715	CpG: 23	290	23	176	15.9	60.7	0.87
chr20	6254191	6254446	CpG: 23	255	23	177	18.0	69.4	0.79
chr20	6302471	6302737	CpG: 24	266	24	167	18.0	62.8	0.93
chr20	6362576	6363004	CpG: 34	428	34	266	15.9	62.1	0.83
chr20	6762030	6762304	CpG: 21	274	21	168	15.3	61.3	0.82
chr20	6808590	6810084	CpG: 191	1494	191	1086	25.6	72.7	0.97
chr20	6811245	6811616	CpG: 39	371	39	263	21.0	70.9	0.84
chr20	6850515	6850791	CpG: 25	276	25	172	18.1	62.3	0.95
chr20	6921996	6922275	CpG: 21	279	21	166	15.1	59.5	0.87
chr20	6968457	6968731	CpG: 21	274	21	167	15.3	60.9	0.84
chr20	7089062	7089291	CpG: 18	229	18	138	15.7	60.3	0.88
chr20	7163337	7163646	CpG: 24	309	24	181	15.5	58.6	0.91
chr20	7253639	7253844	CpG: 16	205	16	122	15.6	59.5	0.90
chr20	7568151	7568425	CpG: 25	274	25	170	18.2	62.0	0.96
chr20	7605365	7605642	CpG: 25	277	25	174	18.1	62.8	0.92
chr20	7766658	7766893	CpG: 18	235	18	139	15.3	59.1	0.90
chr20	7845279	7845794	CpG: 47	515	47	372	18.3	72.2	0.70
chr20	8060942	8061652	CpG: 96	710	96	526	27.0	74.1	0.99
chr20	8156426	8156721	CpG: 22	295	22	180	14.9	61.0	0.81
chr20	8173994	8174907	CpG: 99	913	99	655	21.7	71.7	0.86
chr20	8178305	8178545	CpG: 18	240	18	146	15.0	60.8	0.83
chr20	8221846	8222120	CpG: 21	274	21	169	15.3	61.7	0.81
chr20	8382414	8382690	CpG: 24	276	24	174	17.4	63.0	0.88
chr20	8528481	8528762	CpG: 24	281	24	175	17.1	62.3	0.90
chr20	8642556	8643030	CpG: 33	474	33	284	13.9	59.9	0.78
chr20	8685829	8686671	CpG: 63	842	63	576	15.0	68.4	0.64
chr20	8732855	8733121	CpG: 27	266	27	170	20.3	63.9	1.01
chr20	8794192	8794441	CpG: 18	249	18	148	14.5	59.4	0.83
chr20	9111266	9112326	CpG: 125	1060	125	803	23.6	75.8	0.82
chr20	9428330	9429150	CpG: 58	820	58	559	14.1	68.2	0.61
chr20	9549374	9550152	CpG: 61	778	61	497	15.7	63.9	0.77
chr20	9557509	9557853	CpG: 28	344	28	219	16.3	63.7	0.81
chr20	9558727	9559149	CpG: 39	422	39	275	18.5	65.2	0.87
chr20	9765232	9765461	CpG: 18	229	18	132	15.7	57.6	0.96
chr20	9881525	9882115	CpG: 48	590	48	408	16.3	69.2	0.68
chr20	9998243	9998517	CpG: 24	274	24	169	17.5	61.7	0.93
chr20	10015855	10016130	CpG: 24	275	24	172	17.5	62.5	0.90
chr20	10074567	10074955	CpG: 36	388	36	281	18.6	72.4	0.71
chr20	10077677	10078140	CpG: 56	463	56	357	24.2	77.1	0.82
chr20	10214980	10215405	CpG: 35	425	35	306	16.5	72.0	0.65
chr20	10260352	10261201	CpG: 59	849	59	512	13.9	60.3	0.80
chr20	10261461	10262601	CpG: 83	1140	83	699	14.6	61.3	0.78
chr20	10371599	10371876	CpG: 20	277	20	173	14.4	62.5	0.76
chr20	10437852	10438683	CpG: 68	831	68	583	16.4	70.2	0.67
chr20	10476067	10476308	CpG: 18	241	18	149	14.9	61.8	0.80
chr20	10476632	10477349	CpG: 71	717	71	482	19.8	67.2	0.89
chr20	10493776	10494051	CpG: 20	275	20	168	14.5	61.1	0.78
chr20	10714943	10717981	CpG: 276	3038	276	2014	18.2	66.3	0.83
chr20	11344307	11344551	CpG: 20	244	20	158	16.4	64.8	0.79
chr20	11556993	11557726	CpG: 60	733	60	506	16.4	69.0	0.69
chr20	11676086	11676559	CpG: 35	473	35	282	14.8	59.6	0.84
chr20	11730174	11730649	CpG: 37	475	37	306	15.6	64.4	0.75
chr20	11868229	11868476	CpG: 20	247	20	147	16.2	59.5	0.94
chr20	11897707	11897973	CpG: 21	266	21	166	15.8	62.4	0.83
chr20	11921631	11921850	CpG: 21	219	21	138	19.2	63.0	0.99
chr20	11934019	11934852	CpG: 126	833	126	660	30.3	79.2	0.98
chr20	12053839	12054109	CpG: 21	270	21	166	15.6	61.5	0.84
chr20	12065975	12066210	CpG: 18	235	18	139	15.3	59.1	0.91
chr20	12114752	12115026	CpG: 23	274	23	171	16.8	62.4	0.87
chr20	12369179	12369415	CpG: 20	236	20	141	16.9	59.7	0.98
chr20	12815530	12815756	CpG: 18	226	18	136	15.9	60.2	0.89
chr20	12850006	12850433	CpG: 31	427	31	255	14.5	59.7	0.82
chr20	13263342	13265281	CpG: 222	1939	222	1414	22.9	72.9	0.86
chr20	13342409	13342645	CpG: 19	236	19	153	16.1	64.8	0.77
chr20	13682055	13682540	CpG: 43	485	43	332	17.7	68.5	0.76
chr20	13723417	13723651	CpG: 16	234	16	138	13.7	59.0	0.79
chr20	13766977	13767213	CpG: 19	236	19	141	16.1	59.7	0.93
chr20	13803976	13804526	CpG: 47	550	47	408	17.1	74.2	0.62
chr20	13828239	13829106	CpG: 73	867	73	536	16.8	61.8	0.88
chr20	13926657	13926931	CpG: 22	274	22	168	16.1	61.3	0.86
chr20	13969856	13970127	CpG: 19	271	19	164	14.0	60.5	0.78
chr20	13995171	13995446	CpG: 19	275	19	163	13.8	59.3	0.80
chr20	14044374	14045674	CpG: 132	1300	132	907	20.3	69.8	0.84
chr20	14094303	14094558	CpG: 22	255	22	185	17.3	72.5	0.66
chr20	14195290	14195558	CpG: 18	268	18	162	13.4	60.4	0.74
chr20	14275718	14276107	CpG: 42	389	42	293	21.6	75.3	0.76
chr20	14276643	14276854	CpG: 17	211	17	121	16.1	57.3	1.00
chr20	14412691	14412950	CpG: 20	259	20	156	15.4	60.2	0.87
chr20	14505918	14506124	CpG: 15	206	15	123	14.6	59.7	0.85
chr20	14597594	14597868	CpG: 25	274	25	172	18.2	62.8	0.94
chr20	14623881	14624158	CpG: 23	277	23	175	16.6	63.2	0.85
chr20	14628347	14628628	CpG: 23	281	23	175	16.4	62.3	0.86
chr20	15050219	15050504	CpG: 25	285	25	181	17.5	63.5	0.89
chr20	15156917	15157198	CpG: 22	281	22	171	15.7	60.9	0.86
chr20	15256993	15257274	CpG: 23	281	23	176	16.4	62.6	0.85
chr20	15284344	15284581	CpG: 19	237	19	143	16.0	60.3	0.91
chr20	15529577	15529852	CpG: 23	275	23	170	16.7	61.8	0.89
chr20	15609285	15609514	CpG: 17	229	17	134	14.8	58.5	0.88
chr20	15952695	15952896	CpG: 16	201	16	117	15.9	58.2	0.97
chr20	16125329	16125606	CpG: 20	277	20	166	14.4	59.9	0.82
chr20	16243390	16243656	CpG: 19	266	19	157	14.3	59.0	0.83
chr20	16278402	16278676	CpG: 22	274	22	165	16.1	60.2	0.90
chr20	16297295	16297570	CpG: 23	275	23	170	16.7	61.8	0.88
chr20	16624304	16624728	CpG: 51	424	51	311	24.1	73.3	0.90
chr20	16625238	16625499	CpG: 19	261	19	157	14.6	60.2	0.81
chr20	16625992	16626253	CpG: 24	261	24	177	18.4	67.8	0.83
chr20	16670108	16670384	CpG: 23	276	23	172	16.7	62.3	0.87
chr20	16674605	16674833	CpG: 18	228	18	137	15.8	60.1	0.89
chr20	16688340	16688641	CpG: 22	301	22	180	14.6	59.8	0.83
chr20	16780983	16781591	CpG: 49	608	49	373	16.1	61.3	0.87
chr20	16907963	16908237	CpG: 23	274	23	169	16.8	61.7	0.89
chr20	17276623	17277690	CpG: 81	1067	81	688	15.2	64.5	0.73
chr20	17278643	17278849	CpG: 16	206	16	129	15.5	62.6	0.82
chr20	17279511	17279715	CpG: 19	204	19	134	18.6	65.7	0.94
chr20	17344861	17345137	CpG: 26	276	26	173	18.8	62.7	0.97
chr20	17366154	17366560	CpG: 31	406	31	269	15.3	66.3	0.70
chr20	17500786	17501023	CpG: 20	237	20	146	16.9	61.6	0.91
chr20	17530945	17531181	CpG: 17	236	17	140	14.4	59.3	0.85
chr20	17581500	17582231	CpG: 105	731	105	546	28.7	74.7	1.03
chr20	17619641	17621330	CpG: 141	1689	141	1169	16.7	69.2	0.71
chr20	17731813	17733943	CpG: 265	2130	265	1593	24.9	74.8	0.89
chr20	17829861	17830447	CpG: 49	586	49	395	16.7	67.4	0.74
chr20	17856740	17856973	CpG: 18	233	18	140	15.5	60.1	0.86
chr20	17969807	17970029	CpG: 18	222	18	134	16.2	60.4	0.90
chr20	18019235	18020488	CpG: 128	1253	128	845	20.4	67.4	0.90
chr20	18042399	18042683	CpG: 23	284	23	175	16.2	61.6	0.86
chr20	18046722	18046990	CpG: 19	268	19	161	14.2	60.1	0.80
chr20	18061205	18062075	CpG: 78	870	78	672	17.9	77.2	0.60
chr20	18087969	18088243	CpG: 22	274	22	172	16.1	62.8	0.82
chr20	18107331	18109100	CpG: 175	1769	175	1256	19.8	71.0	0.79
chr20	18109999	18110395	CpG: 39	396	39	277	19.7	69.9	0.81
chr20	18143635	18143915	CpG: 21	280	21	177	15.0	63.2	0.75
chr20	18169541	18169777	CpG: 21	236	21	145	17.8	61.4	0.97
chr20	18188028	18189215	CpG: 112	1187	112	781	18.9	65.8	0.88
chr20	18244894	18245679	CpG: 61	785	61	554	15.5	70.6	0.62
chr20	18277870	18278260	CpG: 31	390	31	281	15.9	72.1	0.61
chr20	18338990	18339851	CpG: 66	861	66	532	15.3	61.8	0.83
chr20	18426652	18427405	CpG: 57	753	57	508	15.1	67.5	0.67
chr20	18517885	18518797	CpG: 65	912	65	571	14.3	62.6	0.73
chr20	18519207	18519471	CpG: 22	264	22	161	16.7	61.0	0.90
chr20	18548141	18548374	CpG: 18	233	18	156	15.5	67.0	0.70
chr20	18550706	18550979	CpG: 22	273	22	172	16.1	63.0	0.82
chr20	18555581	18555991	CpG: 29	410	29	246	14.1	60.0	0.79
chr20	18558494	18559214	CpG: 62	720	62	447	17.2	62.1	0.91
chr20	18618302	18618710	CpG: 41	408	41	256	20.1	62.7	1.02
chr20	18638847	18639503	CpG: 83	656	83	489	25.3	74.5	0.91
chr20	18845863	18846065	CpG: 18	202	18	126	17.8	62.4	0.92
chr20	18882115	18882393	CpG: 22	278	22	172	15.8	61.9	0.84
chr20	19199176	19199429	CpG: 20	253	20	153	15.8	60.5	0.88
chr20	19240974	19241248	CpG: 23	274	23	170	16.8	62.0	0.88
chr20	19252788	19253069	CpG: 23	281	23	174	16.4	61.9	0.87
chr20	19263332	19264775	CpG: 175	1443	175	1091	24.3	75.6	0.85
chr20	19313664	19313940	CpG: 25	276	25	174	18.1	63.0	0.92
chr20	19374486	19374760	CpG: 25	274	25	171	18.2	62.4	0.95
chr20	19684914	19685194	CpG: 25	280	25	177	17.9	63.2	0.90
chr20	19691164	19691561	CpG: 31	397	31	286	15.6	72.0	0.60
chr20	19730339	19731456	CpG: 90	1117	90	801	16.1	71.7	0.63
chr20	19809432	19811166	CpG: 129	1734	129	1174	14.9	67.7	0.65
chr20	20029173	20029671	CpG: 37	498	37	326	14.9	65.5	0.70
chr20	20071339	20072194	CpG: 90	855	90	604	21.1	70.6	0.84
chr20	20106376	20107107	CpG: 63	731	63	474	17.2	64.8	0.82
chr20	20348938	20349219	CpG: 23	281	23	174	16.4	61.9	0.87
chr20	20403193	20403478	CpG: 24	285	24	178	16.8	62.5	0.88
chr20	20422284	20428489	CpG: 567	6205	567	3953	18.3	63.7	0.90
chr20	20445598	20445877	CpG: 23	279	23	175	16.5	62.7	0.85
chr20	20510987	20511211	CpG: 17	224	17	142	15.2	63.4	0.76
chr20	20770795	20771849	CpG: 122	1054	122	755	23.1	71.6	0.91
chr20	21079611	21080126	CpG: 38	515	38	320	14.8	62.1	0.77
chr20	21086117	21086353	CpG: 22	236	22	146	18.6	61.9	1.01
chr20	21159742	21161637	CpG: 149	1895	149	1145	15.7	60.4	0.87
chr20	21162315	21162661	CpG: 30	346	30	236	17.3	68.2	0.75
chr20	21164953	21165989	CpG: 79	1036	79	668	15.3	64.5	0.74
chr20	21186491	21187111	CpG: 68	620	68	439	21.9	70.8	0.88
chr20	21351251	21351565	CpG: 29	314	29	230	18.5	73.2	0.69
chr20	21362365	21363175	CpG: 90	810	90	574	22.2	70.9	0.89
chr20	21448061	21448483	CpG: 53	422	53	311	25.1	73.7	0.93
chr20	21452378	21454265	CpG: 252	1887	252	1396	26.7	74.0	0.98
chr20	21561938	21572716	CpG: 691	10778	691	6402	12.8	59.4	0.73
chr20	21577963	21579933	CpG: 214	1970	214	1363	21.7	69.2	0.92
chr20	21594945	21595177	CpG: 18	232	18	137	15.5	59.1	0.91
chr20	21703083	21703313	CpG: 19	230	19	140	16.5	60.9	0.90
chr20	21727199	21727473	CpG: 20	274	20	161	14.6	58.8	0.87
chr20	21759797	21760473	CpG: 50	676	50	416	14.8	61.5	0.78
chr20	21762254	21763744	CpG: 145	1490	145	1021	19.5	68.5	0.83
chr20	21765813	21766103	CpG: 31	290	31	205	21.4	70.7	0.86
chr20	21770527	21771399	CpG: 73	872	73	570	16.7	65.4	0.78
chr20	21944830	21945072	CpG: 20	242	20	146	16.5	60.3	0.91
chr20	21973539	21973866	CpG: 24	327	24	193	14.7	59.0	0.85
chr20	22019132	22019373	CpG: 20	241	20	151	16.6	62.7	0.86
chr20	22176827	22177066	CpG: 18	239	18	142	15.1	59.4	0.88
chr20	22627698	22628451	CpG: 69	753	69	515	18.3	68.4	0.78
chr20	22636248	22637971	CpG: 120	1723	120	1079	13.9	62.6	0.71
chr20	22638284	22638732	CpG: 34	448	34	254	15.2	56.7	0.95
chr20	22641467	22644835	CpG: 283	3368	283	2263	16.8	67.2	0.74
chr20	22645552	22645786	CpG: 20	234	20	152	17.1	65.0	0.82
chr20	22646184	22646611	CpG: 40	427	40	291	18.7	68.1	0.81
chr20	22735117	22735331	CpG: 18	214	18	132	16.8	61.7	0.91
chr20	23094560	23095723	CpG: 128	1163	128	841	22.0	72.3	0.84
chr20	23107247	23111062	CpG: 312	3815	312	2518	16.4	66.0	0.75
chr20	23193292	23193513	CpG: 18	221	18	139	16.3	62.9	0.84
chr20	23409541	23410951	CpG: 130	1410	130	919	18.4	65.2	0.87
chr20	23415771	23416104	CpG: 27	333	27	229	16.2	68.8	0.69
chr20	23417313	23417981	CpG: 70	668	70	458	21.0	68.6	0.89
chr20	23421048	23422309	CpG: 156	1261	156	928	24.7	73.6	0.92
chr20	23424937	23425553	CpG: 61	616	61	409	19.8	66.4	0.90
chr20	23480018	23481202	CpG: 107	1184	107	854	18.1	72.1	0.70
chr20	23485668	23486095	CpG: 30	427	30	254	14.1	59.5	0.80
chr20	23649012	23649322	CpG: 26	310	26	192	16.8	61.9	0.88
chr20	23696845	23697625	CpG: 90	780	90	569	23.1	72.9	0.87
chr20	24047609	24047856	CpG: 18	247	18	148	14.6	59.9	0.82
chr20	24048850	24049318	CpG: 33	468	33	274	14.1	58.5	0.82
chr20	24049835	24050119	CpG: 25	284	25	173	17.6	60.9	0.97
chr20	24269640	24270188	CpG: 42	548	42	294	15.3	53.6	1.19
chr20	24282488	24282720	CpG: 18	232	18	164	15.5	70.7	0.62
chr20	24531189	24533382	CpG: 199	2193	199	1487	18.1	67.8	0.80
chr20	24653078	24653350	CpG: 21	272	21	186	15.4	68.4	0.74
chr20	24688964	24690005	CpG: 72	1041	72	704	13.8	67.6	0.62
chr20	24876231	24876532	CpG: 34	301	34	186	22.6	61.8	1.45
chr20	24982446	24982673	CpG: 18	227	18	160	15.9	70.5	0.65
chr20	25056243	25057278	CpG: 102	1035	102	691	19.7	66.8	0.88
chr20	25121256	25122760	CpG: 144	1504	144	1075	19.1	71.5	0.75
chr20	25142269	25142707	CpG: 36	438	36	294	16.4	67.1	0.73
chr20	25145742	25146909	CpG: 116	1167	116	822	19.9	70.4	0.80
chr20	25147820	25149507	CpG: 119	1687	119	1014	14.1	60.1	0.78
chr20	25212723	25213569	CpG: 66	846	66	557	15.6	65.8	0.73
chr20	25221042	25221285	CpG: 23	243	23	154	18.9	63.4	0.96
chr20	25259975	25260567	CpG: 69	592	69	437	23.3	73.8	0.86
chr20	25260721	25260975	CpG: 19	254	19	162	15.0	63.8	0.74
chr20	25312349	25313812	CpG: 175	1463	175	1081	23.9	73.9	0.88
chr20	25377413	25378112	CpG: 55	699	55	477	15.7	68.2	0.68
chr20	25395191	25395434	CpG: 17	243	17	140	14.0	57.6	0.84
chr20	25424245	25424522	CpG: 22	277	22	168	15.9	60.6	0.87
chr20	25453953	25454222	CpG: 21	269	21	152	15.6	56.5	1.00
chr20	25454802	25456291	CpG: 164	1489	164	1097	22.0	73.7	0.81
chr20	25456857	25457129	CpG: 20	272	20	165	14.7	60.7	0.81
chr20	25471708	25471979	CpG: 21	271	21	163	15.5	60.1	0.87
chr20	25472698	25473108	CpG: 42	410	42	268	20.5	65.4	0.98
chr20	25626189	25627266	CpG: 86	1077	86	767	16.0	71.2	0.63
chr20	25649823	25650950	CpG: 133	1127	133	786	23.6	69.7	0.97
chr20	25668299	25668579	CpG: 22	280	22	175	15.7	62.5	0.81
chr20	25687160	25687395	CpG: 17	235	17	140	14.5	59.6	0.83
chr20	25688725	25690097	CpG: 138	1372	138	933	20.1	68.0	0.87
chr20	25754356	25754609	CpG: 19	253	19	151	15.0	59.7	0.85
chr20	25761572	25762657	CpG: 107	1085	107	744	19.7	68.6	0.85
chr20	25857553	25858058	CpG: 48	505	48	330	19.0	65.3	0.89
chr20	25861827	25862386	CpG: 47	559	47	366	16.8	65.5	0.78
chr20	25863528	25864002	CpG: 37	474	37	305	15.6	64.3	0.76
chr20	25865121	25867326	CpG: 149	2205	149	1378	13.5	62.5	0.69
chr20	25869382	25869825	CpG: 36	443	36	289	16.3	65.2	0.76
chr20	25871728	25872197	CpG: 35	469	35	306	14.9	65.2	0.70
chr20	25988806	25989236	CpG: 34	430	34	275	15.8	64.0	0.77
chr20	25990912	25991306	CpG: 33	394	33	259	16.8	65.7	0.78
chr20	26013472	26013822	CpG: 25	350	25	211	14.3	60.3	0.84
chr20	26060887	26061196	CpG: 31	309	31	204	20.1	66.0	0.92
chr20	26063126	26063670	CpG: 45	544	45	355	16.5	65.3	0.78
chr20	26067344	26067865	CpG: 44	521	44	330	16.9	63.3	0.85
chr20	26083900	26084140	CpG: 21	240	21	149	17.5	62.1	0.93
chr20	26084413	26084698	CpG: 24	285	24	177	16.8	62.1	0.89
chr20	26135988	26136266	CpG: 25	278	25	175	18.0	62.9	0.92
chr20	26172131	26172405	CpG: 25	274	25	172	18.2	62.8	0.94
chr20	26211752	26213601	CpG: 218	1849	218	1344	23.6	72.7	0.89
chr20	26254957	26255531	CpG: 43	574	43	366	15.0	63.8	0.74
chr20	26281149	26281357	CpG: 17	208	17	125	16.3	60.1	0.91
chr20	29561429	29562321	CpG: 81	892	81	580	18.2	65.0	0.86
chr20	29617838	29618707	CpG: 69	869	69	593	15.9	68.2	0.70
chr20	29619858	29620708	CpG: 70	850	70	585	16.5	68.8	0.70
chr20	29696807	29697034	CpG: 17	227	17	154	15.0	67.8	0.67
chr20	29698029	29698322	CpG: 24	293	24	199	16.4	67.9	0.78
chr20	29698769	29698979	CpG: 18	210	18	142	17.1	67.6	0.75
chr20	29699325	29699706	CpG: 32	381	32	238	16.8	62.5	0.86
chr20	29702887	29703226	CpG: 26	339	26	200	15.3	59.0	0.88
chr20	29703519	29703729	CpG: 19	210	19	139	18.1	66.2	0.87
chr20	29704273	29704478	CpG: 16	205	16	143	15.6	69.8	0.64
chr20	29707969	29708196	CpG: 17	227	17	138	15.0	60.8	0.82
chr20	29709374	29709586	CpG: 18	212	18	140	17.0	66.0	0.79
chr20	29715805	29716069	CpG: 21	264	21	155	15.9	58.7	0.95
chr20	29725356	29726636	CpG: 127	1280	127	909	19.8	71.0	0.79
chr20	29784155	29784436	CpG: 23	281	23	173	16.4	61.6	0.88
chr20	29928383	29928660	CpG: 20	277	20	172	14.4	62.1	0.76
chr20	29955326	29955750	CpG: 41	424	41	304	19.3	71.7	0.76
chr20	29959210	29961170	CpG: 182	1960	182	1382	18.6	70.5	0.75
chr20	29968145	29968510	CpG: 26	365	26	222	14.2	60.8	0.77
chr20	29977581	29977922	CpG: 26	341	26	178	15.2	52.2	1.12
chr20	29982627	29982915	CpG: 25	288	25	198	17.4	68.8	0.73
chr20	29984237	29984876	CpG: 45	639	45	432	14.1	67.6	0.62
chr20	30051431	30051632	CpG: 16	201	16	123	15.9	61.2	0.86
chr20	30056476	30057795	CpG: 107	1319	107	936	16.2	71.0	0.64
chr20	30064836	30065079	CpG: 19	243	19	176	15.6	72.4	0.61
chr20	30188711	30189587	CpG: 71	876	71	591	16.2	67.5	0.73
chr20	30189864	30190314	CpG: 30	450	30	298	13.3	66.2	0.62
chr20	30263263	30263493	CpG: 18	230	18	157	15.7	68.3	0.68
chr20	30288233	30288479	CpG: 27	246	27	175	22.0	71.1	0.89
chr20	30319398	30320759	CpG: 104	1361	104	949	15.3	69.7	0.63
chr20	30326793	30327037	CpG: 20	244	20	175	16.4	71.7	0.65
chr20	30355260	30356110	CpG: 70	850	70	584	16.5	68.7	0.70
chr20	30357497	30358066	CpG: 48	569	48	392	16.9	68.9	0.74
chr20	30360436	30360643	CpG: 21	207	21	153	20.3	73.9	0.74
chr20	30388739	30388985	CpG: 20	246	20	171	16.3	69.5	0.67
chr20	30415938	30416895	CpG: 76	957	76	626	15.9	65.4	0.75
chr20	30478866	30479872	CpG: 71	1006	71	629	14.1	62.5	0.72
chr20	30495512	30495810	CpG: 32	298	32	211	21.5	70.8	0.88
chr20	30503953	30504458	CpG: 45	505	45	389	17.8	77.0	0.60
chr20	30505261	30505463	CpG: 21	202	21	150	20.8	74.3	0.77
chr20	30511457	30511997	CpG: 48	540	48	350	17.8	64.8	0.85
chr20	30513897	30514407	CpG: 40	510	40	326	15.7	63.9	0.77
chr20	30627483	30628001	CpG: 41	518	41	339	15.8	65.4	0.74
chr20	30628174	30628401	CpG: 21	227	21	135	18.5	59.5	1.05
chr20	30926546	30927302	CpG: 55	756	55	510	14.6	67.5	0.64
chr20	30927751	30928529	CpG: 67	778	67	540	17.2	69.4	0.72
chr20	30929318	30929719	CpG: 31	401	31	214	15.5	53.4	1.09
chr20	30930485	30932401	CpG: 172	1916	172	1330	18.0	69.4	0.75
chr20	30937779	30938000	CpG: 17	221	17	123	15.4	55.7	1.00
chr20	30944025	30944274	CpG: 18	249	18	164	14.5	65.9	0.69
chr20	30950040	30950265	CpG: 18	225	18	151	16.0	67.1	0.73
chr20	30950725	30951007	CpG: 23	282	23	166	16.3	58.9	0.94
chr20	30954321	30954641	CpG: 24	320	24	195	15.0	60.9	0.81
chr20	30956274	30956682	CpG: 29	408	29	234	14.2	57.4	0.87
chr20	30957799	30958197	CpG: 28	398	28	252	14.1	63.3	0.72
chr20	31038376	31038820	CpG: 40	444	40	308	18.0	69.4	0.76
chr20	31040985	31042264	CpG: 97	1279	97	856	15.2	66.9	0.68
chr20	31042857	31043087	CpG: 18	230	18	138	15.7	60.0	0.87
chr20	31060129	31060667	CpG: 57	538	57	383	21.2	71.2	0.84
chr20	31077700	31078183	CpG: 36	483	36	312	14.9	64.6	0.73
chr20	31129092	31130022	CpG: 78	930	78	598	16.8	64.3	0.81
chr20	31177565	31177791	CpG: 20	226	20	124	17.7	54.9	1.19
chr20	31198082	31198601	CpG: 42	519	42	326	16.2	62.8	0.84
chr20	31198771	31199083	CpG: 23	312	23	203	14.7	65.1	0.71
chr20	31320633	31321176	CpG: 41	543	41	360	15.1	66.3	0.69
chr20	31368154	31371931	CpG: 353	3777	353	2636	18.7	69.8	0.77
chr20	31381167	31381637	CpG: 30	470	30	269	12.8	57.2	0.79
chr20	31389564	31390002	CpG: 34	438	34	286	15.5	65.3	0.73
chr20	31501263	31502133	CpG: 65	870	65	582	14.9	66.9	0.67
chr20	31503169	31503470	CpG: 21	301	21	189	14.0	62.8	0.75
chr20	31503747	31504054	CpG: 25	307	25	205	16.3	66.8	0.75
chr20	31506275	31506512	CpG: 18	237	18	164	15.2	69.2	0.63
chr20	31559423	31560222	CpG: 66	799	66	521	16.5	65.2	0.78
chr20	31604787	31605062	CpG: 24	275	24	170	17.5	61.8	0.92
chr20	31654502	31654724	CpG: 18	222	18	135	16.2	60.8	0.89
chr20	31726587	31726823	CpG: 20	236	20	142	16.9	60.2	0.96
chr20	33067588	33067862	CpG: 25	274	25	172	18.2	62.8	0.94
chr20	33142189	33142463	CpG: 24	274	24	172	17.5	62.8	0.90
chr20	33199415	33199727	CpG: 27	312	27	222	17.3	71.2	0.71
chr20	33208336	33208739	CpG: 42	403	42	281	20.8	69.7	0.87
chr20	33236438	33236672	CpG: 18	234	18	138	15.4	59.0	0.92
chr20	33238480	33239279	CpG: 83	799	83	546	20.8	68.3	0.91
chr20	33271497	33271713	CpG: 25	216	25	139	23.1	64.4	1.12
chr20	33297208	33297632	CpG: 47	424	47	329	22.2	77.6	0.74
chr20	33311103	33311526	CpG: 35	423	35	249	16.5	58.9	0.96
chr20	33311894	33312495	CpG: 71	601	71	450	23.6	74.9	0.86
chr20	33328442	33328709	CpG: 29	267	29	182	21.7	68.2	0.94
chr20	33329290	33330461	CpG: 106	1171	106	753	18.1	64.3	0.88
chr20	33332554	33333021	CpG: 40	467	40	329	17.1	70.4	0.69
chr20	33337515	33337781	CpG: 19	266	19	162	14.3	60.9	0.78
chr20	33337934	33338157	CpG: 18	223	18	133	16.1	59.6	0.95
chr20	33356859	33357127	CpG: 24	268	24	184	17.9	68.7	0.78
chr20	33362036	33362316	CpG: 32	280	32	212	22.9	75.7	0.80
chr20	33447312	33447516	CpG: 21	204	21	142	20.6	69.6	0.85
chr20	33447874	33448681	CpG: 83	807	83	575	20.6	71.3	0.81
chr20	33448970	33449208	CpG: 19	238	19	142	16.0	59.7	0.90
chr20	33463722	33464239	CpG: 47	517	47	318	18.2	61.5	0.98
chr20	33547352	33547637	CpG: 21	285	21	186	14.7	65.3	0.74
chr20	33569705	33570047	CpG: 30	342	30	232	17.5	67.8	0.78
chr20	33574090	33574539	CpG: 44	449	44	319	19.6	71.0	0.78
chr20	33585817	33586400	CpG: 67	583	67	435	23.0	74.6	0.83
chr20	33592314	33592551	CpG: 17	237	17	142	14.3	59.9	0.82
chr20	33594714	33595519	CpG: 92	805	92	609	22.9	75.7	0.80
chr20	33604335	33604757	CpG: 40	422	40	263	19.0	62.3	1.00
chr20	33665571	33665840	CpG: 21	269	21	163	15.6	60.6	0.86
chr20	33676357	33676793	CpG: 53	436	53	299	24.3	68.6	1.05
chr20	33692540	33693330	CpG: 90	790	90	580	22.8	73.4	0.85
chr20	33719617	33719928	CpG: 36	311	36	225	23.2	72.3	0.89
chr20	33721149	33721607	CpG: 36	458	36	282	15.7	61.6	0.84
chr20	33742573	33742925	CpG: 33	352	33	255	18.8	72.4	0.75
chr20	33743321	33744003	CpG: 93	682	93	537	27.3	78.7	0.91
chr20	33755622	33755967	CpG: 43	345	43	242	24.9	70.1	1.01
chr20	33776731	33777609	CpG: 71	878	71	594	16.2	67.7	0.74
chr20	33913641	33914449	CpG: 87	808	87	593	21.5	73.4	0.80
chr20	33931402	33931961	CpG: 88	559	88	448	31.5	80.1	0.98
chr20	34001221	34001934	CpG: 62	713	62	488	17.4	68.4	0.74
chr20	34082728	34084114	CpG: 153	1386	153	991	22.1	71.5	0.87
chr20	34087246	34087476	CpG: 19	230	19	138	16.5	60.0	0.94
chr20	34181000	34181201	CpG: 22	201	22	138	21.9	68.7	0.94
chr20	34207269	34209748	CpG: 255	2479	255	1820	20.6	73.4	0.76
chr20	34261055	34262332	CpG: 129	1277	129	916	20.2	71.7	0.79
chr20	34308471	34311373	CpG: 365	2902	365	2278	25.2	78.5	0.82
chr20	34324701	34324926	CpG: 18	225	18	133	16.0	59.1	0.94
chr20	34446709	34447038	CpG: 22	329	22	185	13.4	56.2	0.86
chr20	34469893	34470428	CpG: 67	535	67	408	25.0	76.3	0.91
chr20	34473427	34473655	CpG: 18	228	18	137	15.8	60.1	0.89
chr20	34488929	34490185	CpG: 128	1256	128	919	20.4	73.2	0.77
chr20	34546403	34546999	CpG: 84	596	84	453	28.2	76.0	1.02
chr20	34841849	34842646	CpG: 63	797	63	553	15.8	69.4	0.66
chr20	34912395	34913306	CpG: 70	911	70	645	15.4	70.8	0.61
chr20	35077752	35077969	CpG: 15	217	15	127	13.8	58.5	0.83
chr20	35115972	35116918	CpG: 78	946	78	671	16.5	70.9	0.66
chr20	35128474	35128840	CpG: 37	366	37	245	20.2	66.9	0.92
chr20	35170450	35171502	CpG: 121	1052	121	777	23.0	73.9	0.85
chr20	35216395	35217207	CpG: 122	812	122	614	30.0	75.6	1.11
chr20	35229367	35229612	CpG: 19	245	19	150	15.5	61.2	0.84
chr20	35262779	35263917	CpG: 89	1138	89	794	15.6	69.8	0.64
chr20	35370896	35371129	CpG: 17	233	17	155	14.6	66.5	0.67
chr20	35389848	35390557	CpG: 82	709	82	513	23.1	72.4	0.89
chr20	35393536	35394714	CpG: 130	1178	130	848	22.1	72.0	0.85
chr20	35400669	35401135	CpG: 71	466	71	368	30.5	79.0	0.98
chr20	35403321	35403538	CpG: 19	217	19	151	17.5	69.6	0.73
chr20	35412282	35413230	CpG: 137	948	137	737	28.9	77.7	0.96
chr20	35427203	35428195	CpG: 77	992	77	710	15.5	71.6	0.61
chr20	35443717	35443991	CpG: 24	274	24	170	17.5	62.0	0.92
chr20	35446367	35446670	CpG: 36	303	36	211	23.8	69.6	0.98
chr20	35458054	35459103	CpG: 120	1049	120	757	22.9	72.2	0.91
chr20	35459635	35459888	CpG: 21	253	21	144	16.6	56.9	1.05
chr20	35473691	35473965	CpG: 24	274	24	173	17.5	63.1	0.89
chr20	35517389	35517877	CpG: 38	488	38	336	15.6	68.9	0.66
chr20	35537498	35538101	CpG: 67	603	67	428	22.2	71.0	0.90
chr20	35588647	35589318	CpG: 51	671	51	428	15.2	63.8	0.75
chr20	35602820	35603089	CpG: 21	269	21	177	15.6	65.8	0.72
chr20	35630782	35631067	CpG: 23	285	23	178	16.1	62.5	0.84
chr20	35719344	35721135	CpG: 161	1791	161	1232	18.0	68.8	0.77
chr20	35730012	35730286	CpG: 21	274	21	168	15.3	61.3	0.82
chr20	35746174	35746440	CpG: 22	266	22	163	16.5	61.3	0.89
chr20	35837828	35838852	CpG: 96	1024	96	660	18.8	64.5	0.91
chr20	35848755	35848965	CpG: 23	210	23	161	21.9	76.7	0.83
chr20	35898948	35899221	CpG: 22	273	22	168	16.1	61.5	0.86
chr20	35911227	35911505	CpG: 24	278	24	174	17.3	62.6	0.89
chr20	35922589	35922857	CpG: 19	268	19	162	14.2	60.4	0.79
chr20	35942409	35942767	CpG: 48	358	48	259	26.8	72.3	1.03
chr20	35944013	35944256	CpG: 19	243	19	147	15.6	60.5	0.88
chr20	35949176	35950053	CpG: 65	877	65	616	14.8	70.2	0.60
chr20	35966869	35967109	CpG: 19	240	19	142	15.8	59.2	0.92
chr20	35991968	35992557	CpG: 54	589	54	400	18.3	67.9	0.80
chr20	36025864	36026683	CpG: 83	819	83	574	20.3	70.1	0.83
chr20	36028148	36028417	CpG: 20	269	20	158	14.9	58.7	0.87
chr20	36086306	36087291	CpG: 98	985	98	657	19.9	66.7	0.90
chr20	36177334	36177608	CpG: 23	274	23	169	16.8	61.7	0.89
chr20	36197908	36198710	CpG: 59	802	59	545	14.7	68.0	0.64
chr20	36239486	36239978	CpG: 47	492	47	337	19.1	68.5	0.82
chr20	36251208	36251486	CpG: 26	278	26	176	18.7	63.3	0.94
chr20	36281494	36282677	CpG: 129	1183	129	866	21.8	73.2	0.81
chr20	36282886	36283103	CpG: 16	217	16	142	14.7	65.4	0.69
chr20	36385925	36386191	CpG: 23	266	23	166	17.3	62.4	0.90
chr20	36387448	36387682	CpG: 17	234	17	137	14.5	58.5	0.87
chr20	36397440	36398078	CpG: 63	638	63	435	19.7	68.2	0.85
chr20	36421881	36422088	CpG: 15	207	15	124	14.5	59.9	0.83
chr20	36424677	36425430	CpG: 94	753	94	547	25.0	72.6	0.95
chr20	36429376	36431101	CpG: 147	1725	147	1206	17.0	69.9	0.70
chr20	36471729	36472014	CpG: 23	285	23	177	16.1	62.1	0.85
chr20	36545697	36546442	CpG: 105	745	105	594	28.2	79.7	0.89
chr20	36549308	36549581	CpG: 21	273	21	169	15.4	61.9	0.81
chr20	36563432	36563749	CpG: 24	317	24	189	15.1	59.6	0.85
chr20	36580018	36580343	CpG: 26	325	26	220	16.0	67.7	0.71
chr20	36583987	36584213	CpG: 30	226	30	157	26.5	69.5	1.11
chr20	36593268	36593704	CpG: 48	436	48	321	22.0	73.6	0.82
chr20	36596994	36597483	CpG: 53	489	53	345	21.7	70.6	0.89
chr20	36599566	36599840	CpG: 25	274	25	172	18.2	62.8	0.94
chr20	36675934	36676698	CpG: 63	764	63	489	16.5	64.0	0.81
chr20	36700267	36700632	CpG: 27	365	27	244	14.8	66.8	0.69
chr20	36717875	36718286	CpG: 43	411	43	304	20.9	74.0	0.85
chr20	36750335	36750568	CpG: 16	233	16	139	13.7	59.7	0.80
chr20	36790806	36791030	CpG: 18	224	18	137	16.1	61.2	0.88
chr20	36812588	36813562	CpG: 86	974	86	660	17.7	67.8	0.78
chr20	36867533	36868246	CpG: 54	713	54	445	15.1	62.4	0.78
chr20	36895320	36895937	CpG: 48	617	48	416	15.6	67.4	0.69
chr20	36899307	36899581	CpG: 22	274	22	168	16.1	61.3	0.87
chr20	36947319	36948189	CpG: 142	870	142	722	32.6	83.0	0.97
chr20	36998392	36999150	CpG: 76	758	76	547	20.1	72.2	0.77
chr20	37005014	37005797	CpG: 73	783	73	533	18.6	68.1	0.83
chr20	37012962	37013273	CpG: 29	311	29	232	18.6	74.6	0.69
chr20	37103426	37103660	CpG: 17	234	17	141	14.5	60.3	0.82
chr20	37155070	37155565	CpG: 40	495	40	326	16.2	65.9	0.75
chr20	37175923	37176654	CpG: 67	731	67	503	18.3	68.8	0.77
chr20	37176806	37177077	CpG: 20	271	20	161	14.8	59.4	0.84
chr20	37262601	37263102	CpG: 45	501	45	338	18.0	67.5	0.80
chr20	37321768	37323316	CpG: 149	1548	149	1063	19.3	68.7	0.83
chr20	37336732	37338323	CpG: 124	1591	124	1044	15.6	65.6	0.73
chr20	37340057	37340735	CpG: 54	678	54	448	15.9	66.1	0.73
chr20	37385609	37386688	CpG: 86	1079	86	646	15.9	59.9	0.89
chr20	37419874	37420754	CpG: 92	880	92	607	20.9	69.0	0.88
chr20	37462550	37463623	CpG: 86	1073	86	652	16.0	60.8	0.88
chr20	37492686	37493392	CpG: 85	706	85	511	24.1	72.4	0.95
chr20	37495100	37495312	CpG: 17	212	17	130	16.0	61.3	0.88
chr20	37535572	37535846	CpG: 20	274	20	166	14.6	60.6	0.80
chr20	37647290	37647532	CpG: 20	242	20	147	16.5	60.7	0.92
chr20	37674677	37676087	CpG: 146	1410	146	945	20.7	67.0	0.93
chr20	37691946	37692176	CpG: 20	230	20	142	17.4	61.7	0.92
chr20	37696000	37696439	CpG: 35	439	35	270	15.9	61.5	0.86
chr20	37722289	37723259	CpG: 78	970	78	686	16.1	70.7	0.64
chr20	37771307	37772041	CpG: 79	734	79	515	21.5	70.2	0.88
chr20	37785517	37786563	CpG: 85	1046	85	721	16.3	68.9	0.68
chr20	37813066	37814710	CpG: 200	1644	200	1195	24.3	72.7	0.95
chr20	37875393	37875881	CpG: 59	488	59	389	24.2	79.7	0.77
chr20	37957064	37957399	CpG: 29	335	29	216	17.3	64.5	0.83
chr20	38026593	38028002	CpG: 156	1409	156	1060	22.1	75.2	0.79
chr20	38049914	38050188	CpG: 23	274	23	170	16.8	62.0	0.88
chr20	38105991	38106202	CpG: 16	211	16	126	15.2	59.7	0.87
chr20	38155514	38155719	CpG: 20	205	20	150	19.5	73.2	0.76
chr20	38159973	38160720	CpG: 64	747	64	467	17.1	62.5	0.88
chr20	38184905	38185831	CpG: 128	926	128	716	27.6	77.3	0.95
chr20	38237127	38237408	CpG: 24	281	24	174	17.1	61.9	0.91
chr20	38264660	38265558	CpG: 68	898	68	641	15.1	71.4	0.61
chr20	38269092	38269326	CpG: 17	234	17	138	14.5	59.0	0.86
chr20	38296795	38298964	CpG: 214	2169	214	1507	19.7	69.5	0.83
chr20	38329277	38330230	CpG: 105	953	105	654	22.0	68.6	0.94
chr20	38384919	38385198	CpG: 25	279	25	177	17.9	63.4	0.90
chr20	38400296	38400573	CpG: 20	277	20	170	14.4	61.4	0.79
chr20	38407154	38407408	CpG: 19	254	19	142	15.0	55.9	0.96
chr20	38468234	38468472	CpG: 18	238	18	143	15.1	60.1	0.88
chr20	38469980	38470518	CpG: 74	538	74	419	27.5	77.9	0.94
chr20	38497706	38498338	CpG: 72	632	72	425	22.8	67.2	1.02
chr20	38518069	38518647	CpG: 38	578	38	368	13.1	63.7	0.65
chr20	38539816	38540487	CpG: 56	671	56	446	16.7	66.5	0.76
chr20	38563541	38563749	CpG: 20	208	20	136	19.2	65.4	0.91
chr20	38586895	38588938	CpG: 279	2043	279	1545	27.3	75.6	0.96
chr20	38675277	38676391	CpG: 90	1114	90	741	16.2	66.5	0.73
chr20	38736341	38737343	CpG: 77	1002	77	712	15.4	71.1	0.61
chr20	38793336	38794044	CpG: 49	708	49	476	13.8	67.2	0.61
chr20	38819913	38820607	CpG: 57	694	57	457	16.4	65.9	0.77
chr20	38849703	38850828	CpG: 92	1125	92	808	16.4	71.8	0.63
chr20	38851504	38851769	CpG: 24	265	24	165	18.1	62.3	0.94
chr20	38874614	38875733	CpG: 84	1119	84	769	15.0	68.7	0.64
chr20	38878078	38878344	CpG: 20	266	20	159	15.0	59.8	0.86
chr20	38902976	38903212	CpG: 17	236	17	140	14.4	59.3	0.84
chr20	38903354	38904109	CpG: 80	755	80	538	21.2	71.3	0.84
chr20	39013653	39013991	CpG: 40	338	40	238	23.7	70.4	0.98
chr20	39069801	39070838	CpG: 106	1037	106	788	20.4	76.0	0.71
chr20	39092644	39092917	CpG: 24	273	24	172	17.6	63.0	0.89
chr20	39108259	39109100	CpG: 97	841	97	630	23.1	74.9	0.82
chr20	39126483	39126706	CpG: 18	223	18	140	16.1	62.8	0.84
chr20	39127198	39127471	CpG: 20	273	20	188	14.7	68.9	0.62
chr20	39130646	39130864	CpG: 35	218	35	171	32.1	78.4	1.04
chr20	39244296	39245829	CpG: 120	1533	120	929	15.7	60.6	0.86
chr20	39246615	39246935	CpG: 25	320	25	225	15.6	70.3	0.64
chr20	39251716	39252363	CpG: 56	647	56	407	17.3	62.9	0.88
chr20	39288358	39288801	CpG: 41	443	41	303	18.5	68.4	0.80
chr20	39322313	39322538	CpG: 23	225	23	157	20.4	69.8	0.85
chr20	39417857	39418275	CpG: 41	418	41	275	19.6	65.8	0.91
chr20	39511439	39511713	CpG: 23	274	23	169	16.8	61.7	0.89
chr20	39625773	39626019	CpG: 18	246	18	167	14.6	67.9	0.69
chr20	39626697	39627806	CpG: 121	1109	121	817	21.8	73.7	0.80
chr20	39668326	39668674	CpG: 34	348	34	250	19.5	71.8	0.78
chr20	39757776	39758437	CpG: 67	661	67	444	20.3	67.2	0.91
chr20	39890250	39890568	CpG: 35	318	35	243	22.0	76.4	0.76
chr20	39986639	39987212	CpG: 64	573	64	427	22.3	74.5	0.80
chr20	40105896	40106956	CpG: 84	1060	84	766	15.8	72.3	0.61
chr20	40162469	40163050	CpG: 61	581	61	389	21.0	67.0	0.94
chr20	40174180	40174808	CpG: 55	628	55	437	17.5	69.6	0.72
chr20	40202200	40202771	CpG: 68	571	68	390	23.8	68.3	1.02
chr20	40240292	40240566	CpG: 23	274	23	170	16.8	62.0	0.89
chr20	40331524	40331743	CpG: 22	219	22	163	20.1	74.4	0.73
chr20	40375706	40376149	CpG: 39	443	39	301	17.6	67.9	0.77
chr20	40404321	40404896	CpG: 72	575	72	406	25.0	70.6	1.05
chr20	40453639	40458881	CpG: 389	5242	389	3313	14.8	63.2	0.76
chr20	40460649	40461362	CpG: 45	713	45	436	12.6	61.2	0.68
chr20	40478136	40478945	CpG: 107	809	107	580	26.5	71.7	1.06
chr20	40531659	40531933	CpG: 23	274	23	169	16.8	61.7	0.89
chr20	40535670	40537056	CpG: 126	1386	126	1001	18.2	72.2	0.70
chr20	40565971	40566316	CpG: 30	345	30	241	17.4	69.9	0.72
chr20	40595490	40595728	CpG: 19	238	19	141	16.0	59.2	0.92
chr20	40656163	40657244	CpG: 121	1081	121	755	22.4	69.8	0.92
chr20	40685230	40685827	CpG: 44	597	44	345	14.7	57.8	0.90
chr20	40692023	40692591	CpG: 58	568	58	398	20.4	70.1	0.83
chr20	40779967	40780493	CpG: 59	526	59	365	22.4	69.4	0.93
chr20	40808237	40808519	CpG: 20	282	20	167	14.2	59.2	0.81
chr20	41673602	41673875	CpG: 25	273	25	169	18.3	61.9	0.96
chr20	41867388	41867605	CpG: 19	217	19	129	17.5	59.4	1.02
chr20	41979791	41980029	CpG: 20	238	20	148	16.8	62.2	0.89
chr20	42113233	42113500	CpG: 21	267	21	164	15.7	61.4	0.84
chr20	42129831	42130065	CpG: 18	234	18	139	15.4	59.4	0.89
chr20	42179856	42180094	CpG: 17	238	17	141	14.3	59.2	0.84
chr20	42350848	42351184	CpG: 29	336	29	202	17.3	60.1	0.96
chr20	42398527	42398801	CpG: 24	274	24	170	17.5	62.0	0.92
chr20	42414224	42415281	CpG: 92	1057	92	701	17.4	66.3	0.79
chr20	42418885	42422833	CpG: 387	3948	387	2633	19.6	66.7	0.88
chr20	42424135	42424493	CpG: 36	358	36	231	20.1	64.5	0.99
chr20	42642675	42642910	CpG: 23	235	23	173	19.6	73.6	0.72
chr20	42643610	42643824	CpG: 17	214	17	122	15.9	57.0	1.02
chr20	42700729	42700936	CpG: 16	207	16	114	15.5	55.1	1.07
chr20	42740543	42740821	CpG: 24	278	24	174	17.3	62.6	0.89
chr20	42760110	42761461	CpG: 150	1351	150	948	22.2	70.2	0.90
chr20	42849122	42849358	CpG: 17	236	17	142	14.4	60.2	0.81
chr20	42868269	42869872	CpG: 194	1603	194	1193	24.2	74.4	0.87
chr20	42964442	42964666	CpG: 19	224	19	138	17.0	61.6	0.91
chr20	42998422	42998656	CpG: 17	234	17	138	14.5	59.0	0.85
chr20	43033588	43033854	CpG: 24	266	24	166	18.0	62.4	0.94
chr20	43048754	43049779	CpG: 121	1025	121	771	23.6	75.2	0.84
chr20	43071673	43072062	CpG: 28	389	28	246	14.4	63.2	0.73
chr20	43097703	43098968	CpG: 157	1265	157	965	24.8	76.3	0.85
chr20	43100202	43100476	CpG: 20	274	20	157	14.6	57.3	0.90
chr20	43123097	43123367	CpG: 22	270	22	164	16.3	60.7	0.90
chr20	43286755	43287943	CpG: 98	1188	98	866	16.5	72.9	0.62
chr20	43349503	43350999	CpG: 153	1496	153	1071	20.5	71.6	0.80
chr20	43424620	43425105	CpG: 37	485	37	302	15.3	62.3	0.79
chr20	43730455	43731307	CpG: 103	852	103	605	24.2	71.0	0.96
chr20	43938232	43938558	CpG: 27	326	27	193	16.6	59.2	0.95
chr20	44863682	44863952	CpG: 23	270	23	167	17.0	61.9	0.90
chr20	44922869	44924607	CpG: 200	1738	200	1244	23.0	71.6	0.90
chr20	44991975	44992209	CpG: 18	234	18	139	15.4	59.4	0.88
chr20	45072882	45073351	CpG: 35	469	35	306	14.9	65.2	0.70
chr20	45190577	45191951	CpG: 175	1374	175	919	25.5	66.9	1.14
chr20	45240390	45241687	CpG: 118	1297	118	837	18.2	64.5	0.88
chr20	45247181	45247390	CpG: 18	209	18	148	17.2	70.8	0.69
chr20	45247833	45248214	CpG: 35	381	35	272	18.4	71.4	0.75
chr20	45280333	45280607	CpG: 21	274	21	170	15.3	62.0	0.81
chr20	45324078	45324550	CpG: 52	472	52	320	22.0	67.8	0.97
chr20	45340362	45341223	CpG: 64	861	64	601	14.9	69.8	0.61
chr20	45381385	45381648	CpG: 19	263	19	159	14.4	60.5	0.81
chr20	45390520	45391094	CpG: 54	574	54	390	18.8	67.9	0.82
chr20	45399958	45400879	CpG: 99	921	99	681	21.5	73.9	0.79
chr20	45547674	45548147	CpG: 33	473	33	280	14.0	59.2	0.80
chr20	45585132	45585413	CpG: 24	281	24	175	17.1	62.3	0.89
chr20	45643359	45643595	CpG: 19	236	19	144	16.1	61.0	0.89
chr20	45647623	45649663	CpG: 216	2040	216	1446	21.2	70.9	0.85
chr20	45850236	45850937	CpG: 79	701	79	524	22.5	74.8	0.81
chr20	45894213	45895165	CpG: 122	952	122	683	25.6	71.7	1.00
chr20	45944850	45945884	CpG: 98	1034	98	701	19.0	67.8	0.83
chr20	45972396	45972672	CpG: 23	276	23	172	16.7	62.3	0.87
chr20	45981789	45982209	CpG: 33	420	33	292	15.7	69.5	0.65
chr20	46004858	46005132	CpG: 22	274	22	169	16.1	61.7	0.85
chr20	46033868	46034265	CpG: 38	397	38	289	19.1	72.8	0.72
chr20	46045546	46046139	CpG: 64	593	64	420	21.6	70.8	0.88
chr20	46050690	46050948	CpG: 19	258	19	158	14.7	61.2	0.79
chr20	46061423	46061826	CpG: 44	403	44	306	21.8	75.9	0.76
chr20	46104789	46105063	CpG: 22	274	22	169	16.1	61.7	0.86
chr20	46189809	46190039	CpG: 19	230	19	140	16.5	60.9	0.90
chr20	46211532	46211780	CpG: 37	248	37	187	29.8	75.4	1.05
chr20	46257424	46257904	CpG: 41	480	41	319	17.1	66.5	0.77
chr20	46267464	46267942	CpG: 64	478	64	357	26.8	74.7	0.96
chr20	46387195	46387861	CpG: 90	666	90	503	27.0	75.5	0.97
chr20	46402701	46402975	CpG: 24	274	24	171	17.5	62.4	0.91
chr20	46481445	46482085	CpG: 77	640	77	467	24.1	73.0	0.91
chr20	46485763	46486533	CpG: 79	770	79	546	20.5	70.9	0.82
chr20	46545968	46546777	CpG: 128	809	128	646	31.6	79.9	1.01
chr20	46591565	46591796	CpG: 19	231	19	140	16.5	60.6	0.91
chr20	46621394	46622107	CpG: 83	713	83	517	23.3	72.5	0.89
chr20	46645838	46646282	CpG: 50	444	50	318	22.5	71.6	0.88
chr20	46695968	46696478	CpG: 59	510	59	367	23.1	72.0	0.91
chr20	46702143	46702493	CpG: 43	350	43	248	24.6	70.9	0.98
chr20	46833560	46834635	CpG: 141	1075	141	752	26.2	70.0	1.07
chr20	46836778	46837054	CpG: 29	276	29	202	21.0	73.2	0.80
chr20	46950947	46951155	CpG: 18	208	18	129	17.3	62.0	0.96
chr20	47029171	47029864	CpG: 68	693	68	466	19.6	67.2	0.89
chr20	47033816	47034393	CpG: 53	577	53	383	18.4	66.4	0.85
chr20	47040135	47040623	CpG: 66	488	66	331	27.0	67.8	1.18
chr20	47042436	47042870	CpG: 39	434	39	310	18.0	71.4	0.71
chr20	47047543	47048348	CpG: 63	805	63	528	15.7	65.6	0.73
chr20	47052358	47052898	CpG: 56	540	56	380	20.7	70.4	0.84
chr20	47055787	47056023	CpG: 17	236	17	142	14.4	60.2	0.82
chr20	47083925	47084479	CpG: 67	554	67	409	24.2	73.8	0.89
chr20	47098850	47099611	CpG: 63	761	63	500	16.6	65.7	0.77
chr20	47140980	47141261	CpG: 22	281	22	172	15.7	61.2	0.85
chr20	47141680	47143176	CpG: 146	1496	146	1064	19.5	71.1	0.77
chr20	47151875	47152370	CpG: 46	495	46	321	18.6	64.8	0.89
chr20	47172649	47172933	CpG: 26	284	26	190	18.3	66.9	0.82
chr20	47205495	47206751	CpG: 94	1256	94	859	15.0	68.4	0.64
chr20	47223216	47223538	CpG: 26	322	26	229	16.1	71.1	0.67
chr20	47528386	47528767	CpG: 48	381	48	283	25.2	74.3	0.94
chr20	47548804	47549513	CpG: 62	709	62	444	17.5	62.6	0.89
chr20	47551338	47551619	CpG: 22	281	22	173	15.7	61.6	0.84
chr20	47559453	47559679	CpG: 19	226	19	161	16.8	71.2	0.68
chr20	47560428	47561014	CpG: 50	586	50	387	17.1	66.0	0.82
chr20	47570238	47571024	CpG: 86	786	86	581	21.9	73.9	0.81
chr20	47577153	47577429	CpG: 23	276	23	178	16.7	64.5	0.81
chr20	47626756	47628217	CpG: 145	1461	145	1008	19.8	69.0	0.84
chr20	47636632	47636895	CpG: 19	263	19	157	14.4	59.7	0.82
chr20	47647147	47648376	CpG: 86	1229	86	803	14.0	65.3	0.66
chr20	47648927	47649165	CpG: 19	238	19	147	16.0	61.8	0.86
chr20	47670310	47671638	CpG: 142	1328	142	898	21.4	67.6	0.94
chr20	47682239	47682440	CpG: 15	201	15	126	14.9	62.7	0.77
chr20	47707228	47708630	CpG: 124	1402	124	937	17.7	66.8	0.79
chr20	47720588	47720858	CpG: 23	270	23	168	17.0	62.2	0.89
chr20	47746523	47747376	CpG: 74	853	74	553	17.4	64.8	0.83
chr20	47747676	47748598	CpG: 63	922	63	585	13.7	63.4	0.69
chr20	47749482	47750499	CpG: 93	1017	93	672	18.3	66.1	0.84
chr20	47757635	47758276	CpG: 58	641	58	463	18.1	72.2	0.73
chr20	47758456	47758759	CpG: 20	303	20	195	13.2	64.4	0.67
chr20	47764842	47766618	CpG: 141	1776	141	1188	15.9	66.9	0.71
chr20	47767717	47768323	CpG: 61	606	61	423	20.1	69.8	0.83
chr20	47793147	47794986	CpG: 154	1839	154	1205	16.7	65.5	0.78
chr20	47825098	47826212	CpG: 141	1114	141	795	25.3	71.4	0.99
chr20	47827753	47828322	CpG: 53	569	53	418	18.6	73.5	0.69
chr20	47854224	47854462	CpG: 18	238	18	161	15.1	67.6	0.66
chr20	47889293	47889606	CpG: 28	313	28	219	17.9	70.0	0.73
chr20	47910478	47911076	CpG: 81	598	81	440	27.1	73.6	1.00
chr20	47914013	47914289	CpG: 19	276	19	181	13.8	65.6	0.68
chr20	47936124	47936337	CpG: 16	213	16	128	15.0	60.1	0.84
chr20	47936933	47937275	CpG: 40	342	40	237	23.4	69.3	0.97
chr20	47946222	47946631	CpG: 52	409	52	305	25.4	74.6	0.92
chr20	47963456	47963719	CpG: 26	263	26	190	19.8	72.2	0.77
chr20	47982645	47982846	CpG: 17	201	17	124	16.9	61.7	0.96
chr20	47987096	47987685	CpG: 77	589	77	446	26.1	75.7	0.91
chr20	48043322	48044702	CpG: 177	1380	177	1058	25.7	76.7	0.87
chr20	48048560	48049018	CpG: 43	458	43	319	18.8	69.7	0.78
chr20	48100067	48100678	CpG: 59	611	59	430	19.3	70.4	0.78
chr20	48141630	48142805	CpG: 95	1175	95	791	16.2	67.3	0.72
chr20	48154360	48154635	CpG: 22	275	22	171	16.0	62.2	0.85
chr20	48249493	48249830	CpG: 37	337	37	238	22.0	70.6	0.90
chr20	48277747	48277961	CpG: 25	214	25	163	23.4	76.2	0.84
chr20	48387325	48387713	CpG: 40	388	40	278	20.6	71.6	0.82
chr20	48425331	48426098	CpG: 83	767	83	516	21.6	67.3	0.97
chr20	48445709	48446462	CpG: 75	753	75	544	19.9	72.2	0.76
chr20	48465998	48466202	CpG: 20	204	20	126	19.6	61.8	1.06
chr20	48549450	48549863	CpG: 42	413	42	307	20.3	74.3	0.74
chr20	48632705	48633475	CpG: 97	770	97	580	25.2	75.3	0.89
chr20	48650816	48651097	CpG: 24	281	24	175	17.1	62.3	0.90
chr20	48662487	48662723	CpG: 16	236	16	139	13.6	58.9	0.80
chr20	48882240	48882477	CpG: 18	237	18	143	15.2	60.3	0.85
chr20	48977195	48977652	CpG: 38	457	38	275	16.6	60.2	0.92
chr20	49102163	49102407	CpG: 18	244	18	147	14.8	60.2	0.83
chr20	49128644	49128991	CpG: 28	347	28	213	16.1	61.4	0.87
chr20	49239892	49240521	CpG: 74	629	74	452	23.5	71.9	0.95
chr20	49260406	49260644	CpG: 18	238	18	141	15.1	59.2	0.87
chr20	49405180	49405408	CpG: 17	228	17	131	14.9	57.5	0.91
chr20	49409258	49409891	CpG: 48	633	48	480	15.2	75.8	1.41
chr20	49523685	49525870	CpG: 240	2185	240	1521	22.0	69.6	0.92
chr20	49719279	49719711	CpG: 34	432	34	299	15.7	69.2	0.66
chr20	49727366	49727603	CpG: 18	237	18	143	15.2	60.3	0.86
chr20	49985536	49985809	CpG: 21	273	21	163	15.4	59.7	0.87
chr20	50141775	50142038	CpG: 21	263	21	165	16.0	62.7	0.82
chr20	50153747	50154035	CpG: 22	288	22	188	15.3	65.3	0.72
chr20	50332777	50333002	CpG: 17	225	17	127	15.1	56.4	0.97
chr20	50359140	50359413	CpG: 23	273	23	173	16.8	63.4	0.85
chr20	50406213	50406497	CpG: 25	284	25	203	17.6	71.5	0.69
chr20	50434531	50434954	CpG: 28	423	28	234	13.2	55.3	0.94
chr20	50597023	50598470	CpG: 206	1447	206	1100	28.5	76.0	0.99
chr20	50690299	50691347	CpG: 98	1048	98	708	18.7	67.6	0.91
chr20	50697383	50697727	CpG: 30	344	30	211	17.4	61.3	0.93
chr20	50793067	50793341	CpG: 25	274	25	172	18.2	62.8	0.94
chr20	50815699	50816416	CpG: 80	717	80	505	22.3	70.4	0.91
chr20	50945302	50945577	CpG: 23	275	23	170	16.7	61.8	0.88
chr20	50955508	50955806	CpG: 22	298	22	173	14.8	58.1	0.88
chr20	50957264	50958099	CpG: 99	835	99	640	23.7	76.6	0.81
chr20	50958398	50958640	CpG: 21	242	21	147	17.4	60.7	0.96
chr20	50965645	50965918	CpG: 22	273	22	171	16.1	62.6	0.83
chr20	50988762	50989046	CpG: 29	284	29	176	20.4	62.0	1.08
chr20	50996409	50996687	CpG: 24	278	24	174	17.3	62.6	0.89
chr20	51047079	51048160	CpG: 110	1081	110	768	20.4	71.0	0.88
chr20	51087850	51088719	CpG: 85	869	85	604	19.6	69.5	0.88
chr20	51177842	51178116	CpG: 20	274	20	168	14.6	61.3	0.78
chr20	51251591	51254178	CpG: 232	2587	232	1759	17.9	68.0	0.78
chr20	51337228	51337886	CpG: 65	658	65	497	19.8	75.5	0.69
chr20	51380714	51380985	CpG: 32	271	32	190	23.6	70.1	0.96
chr20	51473996	51474236	CpG: 22	240	22	149	18.3	62.1	0.97
chr20	51482670	51483707	CpG: 133	1037	133	780	25.7	75.2	0.91
chr20	51505689	51505927	CpG: 19	238	19	146	16.0	61.3	0.88
chr20	51582153	51582634	CpG: 50	481	50	341	20.8	70.9	0.83
chr20	51675514	51676046	CpG: 40	532	40	348	15.0	65.4	0.71
chr20	51684513	51685533	CpG: 98	1020	98	686	19.2	67.3	0.85
chr20	51691014	51692006	CpG: 79	992	79	700	15.9	70.6	0.64
chr20	51705622	51706451	CpG: 79	829	79	545	19.1	65.7	0.88
chr20	51717283	51717556	CpG: 24	273	24	169	17.6	61.9	0.92
chr20	51751912	51752613	CpG: 89	701	89	508	25.4	72.5	0.98
chr20	51779406	51779946	CpG: 62	540	62	398	23.0	73.7	0.85
chr20	51829571	51829811	CpG: 18	240	18	146	15.0	60.8	0.83
chr20	51840962	51841335	CpG: 31	373	31	226	16.6	60.6	0.91
chr20	51882518	51883048	CpG: 58	530	58	402	21.9	75.8	0.80
chr20	51885709	51885918	CpG: 19	209	19	132	18.2	63.2	0.91
chr20	51923200	51923964	CpG: 99	764	99	571	25.9	74.7	0.93
chr20	51924611	51924847	CpG: 21	236	21	145	17.8	61.4	0.97
chr20	51941860	51942276	CpG: 33	416	33	271	15.9	65.1	0.75
chr20	51952869	51953084	CpG: 16	215	16	129	14.9	60.0	0.85
chr20	51959564	51961988	CpG: 289	2424	289	1733	23.8	71.5	0.93
chr20	52113245	52113454	CpG: 15	209	15	144	14.4	68.9	0.61
chr20	52265437	52265671	CpG: 17	234	17	137	14.5	58.5	0.86
chr20	52279712	52280530	CpG: 85	818	85	566	20.8	69.2	0.87
chr20	52379223	52379427	CpG: 23	204	23	152	22.5	74.5	0.81
chr20	52455674	52455911	CpG: 20	237	20	142	16.9	59.9	0.97
chr20	52501134	52502428	CpG: 164	1294	164	947	25.3	73.2	0.96
chr20	52525991	52526234	CpG: 18	243	18	147	14.8	60.5	0.82
chr20	52564744	52565076	CpG: 27	332	27	198	16.3	59.6	0.91
chr20	52565281	52566022	CpG: 92	741	92	570	24.8	76.9	0.84
chr20	52611022	52611345	CpG: 25	323	25	165	15.5	51.1	1.19
chr20	52701129	52702587	CpG: 175	1458	175	1076	24.0	73.8	0.91
chr20	52728882	52730353	CpG: 115	1471	115	874	15.6	59.4	0.89
chr20	52774486	52774720	CpG: 17	234	17	148	14.5	63.2	0.73
chr20	52774938	52775357	CpG: 47	419	47	291	22.4	69.5	0.93
chr20	52780106	52780886	CpG: 88	780	88	535	22.6	68.6	0.96
chr20	52793112	52794253	CpG: 150	1141	150	853	26.3	74.8	0.95
chr20	52938076	52938354	CpG: 22	278	22	171	15.8	61.5	0.84
chr20	53262755	53263416	CpG: 43	661	43	406	13.0	61.4	0.70
chr20	53293889	53294739	CpG: 74	850	74	586	17.4	68.9	0.75
chr20	53313122	53313728	CpG: 78	606	78	468	25.7	77.2	0.90
chr20	53332952	53333878	CpG: 83	926	83	599	17.9	64.7	0.86
chr20	53483693	53483917	CpG: 17	224	17	144	15.2	64.3	0.75
chr20	53523081	53523322	CpG: 19	241	19	148	15.8	61.4	0.86
chr20	53532916	53533189	CpG: 20	273	20	165	14.7	60.4	0.81
chr20	53538584	53540283	CpG: 199	1699	199	1220	23.4	71.8	0.92
chr20	53557125	53557398	CpG: 20	273	20	164	14.7	60.1	0.82
chr20	53572232	53573963	CpG: 135	1731	135	1089	15.6	62.9	0.79
chr20	53616703	53616972	CpG: 22	269	22	168	16.4	62.5	0.85
chr20	53635056	53635291	CpG: 16	235	16	141	13.6	60.0	0.78
chr20	53668093	53668325	CpG: 18	232	18	138	15.5	59.5	0.89
chr20	53711772	53712017	CpG: 20	245	20	148	16.3	60.4	0.92
chr20	53738764	53739087	CpG: 27	323	27	204	16.7	63.2	0.84
chr20	53756998	53757215	CpG: 17	217	17	131	15.7	60.4	0.87
chr20	53771836	53772107	CpG: 22	271	22	164	16.2	60.5	0.89
chr20	53856163	53856630	CpG: 35	467	35	299	15.0	64.0	0.73
chr20	53875719	53876913	CpG: 106	1194	106	795	17.8	66.6	0.81
chr20	53882439	53882746	CpG: 28	307	28	189	18.2	61.6	1.01
chr20	53923897	53924110	CpG: 19	213	19	145	17.8	68.1	0.78
chr20	53947965	53948250	CpG: 24	285	24	178	16.8	62.5	0.88
chr20	53962700	53963859	CpG: 123	1159	123	818	21.2	70.6	0.85
chr20	53981800	53982093	CpG: 29	293	29	176	19.8	60.1	1.10
chr20	54743389	54743793	CpG: 35	404	35	273	17.3	67.6	0.78
chr20	54744449	54744762	CpG: 27	313	27	214	17.3	68.4	0.74
chr20	55156981	55157195	CpG: 15	214	15	130	14.0	60.7	0.78
chr20	55233451	55233760	CpG: 24	309	24	189	15.5	61.2	0.83
chr20	55245059	55245301	CpG: 24	242	24	150	19.8	62.0	1.04
chr20	55353700	55354042	CpG: 26	342	26	206	15.2	60.2	0.84
chr20	55365221	55366991	CpG: 224	1770	224	1322	25.3	74.7	0.91
chr20	55380208	55381124	CpG: 61	916	61	553	13.3	60.4	0.73
chr20	55405481	55405722	CpG: 19	241	19	146	15.8	60.6	0.88
chr20	55432368	55432675	CpG: 34	307	34	187	22.1	60.9	1.20
chr20	55437721	55437995	CpG: 24	274	24	171	17.5	62.4	0.91
chr20	55460650	55460889	CpG: 19	239	19	143	15.9	59.8	0.91
chr20	55467106	55467343	CpG: 18	237	18	140	15.2	59.1	0.88
chr20	55474363	55474643	CpG: 24	280	24	172	17.1	61.4	0.91
chr20	55531658	55531886	CpG: 21	228	21	140	18.4	61.4	0.99
chr20	55579856	55580126	CpG: 22	270	22	164	16.3	60.7	0.90
chr20	55627352	55628076	CpG: 58	724	58	495	16.0	68.4	0.69
chr20	55660798	55661064	CpG: 22	266	22	163	16.5	61.3	0.89
chr20	55794918	55795213	CpG: 24	295	24	179	16.3	60.7	0.89
chr20	55840038	55840278	CpG: 18	240	18	147	15.0	61.2	0.81
chr20	55882649	55882927	CpG: 25	278	25	175	18.0	62.9	0.92
chr20	55947047	55948781	CpG: 138	1734	138	1151	15.9	66.4	0.73
chr20	55982117	55982835	CpG: 75	718	75	501	20.9	69.8	0.86
chr20	56083856	56084076	CpG: 17	220	17	135	15.5	61.4	0.84
chr20	56105165	56105395	CpG: 22	230	22	140	19.1	60.9	1.05
chr20	56226294	56226524	CpG: 18	230	18	136	15.7	59.1	0.91
chr20	56249532	56250794	CpG: 98	1262	98	803	15.5	63.6	0.77
chr20	56327573	56327847	CpG: 19	274	19	171	13.9	62.4	0.72
chr20	56450540	56450776	CpG: 20	236	20	144	16.9	61.0	0.93
chr20	56648869	56649099	CpG: 21	230	21	141	18.3	61.3	0.98
chr20	56667533	56667765	CpG: 16	232	16	138	13.8	59.5	0.80
chr20	56688459	56688726	CpG: 21	267	21	165	15.7	61.8	0.84
chr20	56693696	56693935	CpG: 19	239	19	142	15.9	59.4	0.91
chr20	56763019	56763255	CpG: 19	236	19	144	16.1	61.0	0.90
chr20	56858678	56858992	CpG: 26	314	26	190	16.6	60.5	0.91
chr20	56884458	56884732	CpG: 25	274	25	172	18.2	62.8	0.94
chr20	56898491	56898727	CpG: 17	236	17	138	14.4	58.5	0.88
chr20	56920058	56920336	CpG: 24	278	24	174	17.3	62.6	0.89
chr20	57026267	57026485	CpG: 20	218	20	129	18.3	59.2	1.38
chr20	57265913	57266143	CpG: 20	230	20	141	17.4	61.3	0.94
chr20	57469727	57469963	CpG: 18	236	18	140	15.3	59.3	0.90
chr20	57634968	57635260	CpG: 24	292	24	178	16.4	61.0	0.89
chr20	57663459	57663733	CpG: 25	274	25	172	18.2	62.8	0.94
chr20	57722385	57722611	CpG: 18	226	18	137	15.9	60.6	0.91
chr20	57770394	57770631	CpG: 19	237	19	142	16.0	59.9	0.92
chr20	57778524	57780599	CpG: 174	2075	174	1363	16.8	65.7	0.78
chr20	58024270	58024542	CpG: 22	272	22	159	16.2	58.5	0.96
chr20	58121530	58121851	CpG: 32	321	32	218	19.9	67.9	0.88
chr20	58136281	58137124	CpG: 89	843	89	622	21.1	73.8	0.78
chr20	58169474	58170439	CpG: 75	965	75	578	15.5	59.9	0.87
chr20	58180961	58181208	CpG: 20	247	20	144	16.2	58.3	0.96
chr20	58182758	58183010	CpG: 19	252	19	146	15.1	57.9	0.92
chr20	58245808	58246199	CpG: 47	391	47	269	24.0	68.8	1.02
chr20	58323507	58323832	CpG: 27	325	27	195	16.6	60.0	0.93
chr20	58402753	58409263	CpG: 490	6510	490	4147	15.1	63.7	0.74
chr20	58423449	58423724	CpG: 22	275	22	163	16.0	59.3	0.92
chr20	58455707	58455969	CpG: 20	262	20	160	15.3	61.1	0.84
chr20	58582016	58582381	CpG: 29	365	29	228	15.9	62.5	0.84
chr20	58651875	58652137	CpG: 24	262	24	167	18.3	63.7	0.90
chr20	58689267	58689533	CpG: 22	266	22	165	16.5	62.0	0.87
chr20	58702934	58704055	CpG: 102	1121	102	703	18.2	62.7	0.94
chr20	58869978	58870278	CpG: 28	300	28	202	18.7	67.3	0.83
chr20	58888152	58888566	CpG: 43	414	43	272	20.8	65.7	0.99
chr20	59041967	59044861	CpG: 255	2894	255	1901	17.6	65.7	0.82
chr20	59107359	59107667	CpG: 30	308	30	215	19.5	69.8	0.80
chr20	59126149	59126536	CpG: 36	387	36	288	18.6	74.4	0.67
chr20	59128587	59129284	CpG: 76	697	76	484	21.8	69.4	0.93
chr20	59166958	59169784	CpG: 271	2826	271	1961	19.2	69.4	0.80
chr20	59185333	59185776	CpG: 36	443	36	304	16.3	68.6	0.71
chr20	59302690	59303009	CpG: 32	319	32	235	20.1	73.7	0.74
chr20	59406706	59406924	CpG: 19	218	19	156	17.4	71.6	0.68
chr20	59430092	59430527	CpG: 41	435	41	307	18.9	70.6	0.79
chr20	59439794	59440045	CpG: 17	251	17	158	13.5	62.9	0.69
chr20	59442428	59442690	CpG: 21	262	21	161	16.0	61.5	0.85
chr20	59450167	59450569	CpG: 30	402	30	242	14.9	60.2	0.82
chr20	59486829	59488333	CpG: 201	1504	201	1130	26.7	75.1	0.95
chr20	59496501	59496795	CpG: 27	294	27	192	18.4	65.3	0.90
chr20	59526892	59527213	CpG: 26	321	26	195	16.2	60.7	0.89
chr20	59930201	59930457	CpG: 25	256	25	171	19.5	66.8	0.88
chr20	59959048	59959476	CpG: 40	428	40	305	18.7	71.3	0.74
chr20	59970570	59970804	CpG: 23	234	23	145	19.7	62.0	1.06
chr20	59986228	59987077	CpG: 83	849	83	586	19.6	69.0	1.05
chr20	60009229	60010059	CpG: 99	830	99	601	23.9	72.4	0.93
chr20	60090294	60091110	CpG: 87	816	87	637	21.3	78.1	0.70
chr20	60169910	60170716	CpG: 102	806	102	596	25.3	73.9	0.94
chr20	60194696	60196075	CpG: 118	1379	118	1040	17.1	75.4	0.60
chr20	60242298	60242600	CpG: 24	302	24	214	15.9	70.9	0.66
chr20	60247445	60247662	CpG: 17	217	17	142	15.7	65.4	0.74
chr20	60248162	60248761	CpG: 63	599	63	438	21.0	73.1	0.79
chr20	60295457	60296234	CpG: 71	777	71	544	18.3	70.0	0.75
chr20	60431703	60433330	CpG: 163	1627	163	1095	20.0	67.3	0.88
chr20	60474530	60475423	CpG: 129	893	129	738	28.9	82.6	0.85
chr20	60538790	60538994	CpG: 16	204	16	120	15.7	58.8	1.01
chr20	60599905	60600117	CpG: 18	212	18	148	17.0	69.8	0.75
chr20	60622680	60622981	CpG: 24	301	24	201	15.9	66.8	0.76
chr20	60623187	60625238	CpG: 180	2051	180	1323	17.6	64.5	0.85
chr20	60634793	60635111	CpG: 26	318	26	201	16.4	63.2	0.84
chr20	60635755	60636059	CpG: 27	304	27	197	17.8	64.8	0.85
chr20	60636372	60636580	CpG: 17	208	17	131	16.3	63.0	0.83
chr20	60637088	60639303	CpG: 190	2215	190	1475	17.2	66.6	0.77
chr20	60665247	60665463	CpG: 21	216	21	136	19.4	63.0	1.02
chr20	60671716	60675814	CpG: 504	4098	504	2983	24.6	72.8	0.93
chr20	60763798	60764824	CpG: 121	1026	121	728	23.6	71.0	0.94
chr20	60789951	60790651	CpG: 83	700	83	549	23.7	78.4	0.79
chr20	60815103	60815840	CpG: 94	737	94	536	25.5	72.7	0.96
chr20	60825478	60826270	CpG: 91	792	91	574	23.0	72.5	0.88
chr20	60838188	60838450	CpG: 20	262	20	162	15.3	61.8	0.81
chr20	60916082	60916376	CpG: 20	294	20	167	13.6	56.8	0.84
chr20	60931699	60931976	CpG: 24	277	24	171	17.3	61.7	0.92
chr20	60974626	60976126	CpG: 121	1500	121	1040	16.1	69.3	0.67
chr20	61005445	61006068	CpG: 46	623	46	394	14.8	63.2	0.74
chr20	61023799	61024074	CpG: 20	275	20	171	14.5	62.2	0.76
chr20	61083584	61084393	CpG: 90	809	90	591	22.2	73.1	0.83
chr20	61187812	61188097	CpG: 32	285	32	209	22.5	73.3	0.86
chr20	61361392	61362009	CpG: 90	617	90	489	29.2	79.3	0.93
chr20	61388965	61389944	CpG: 102	979	102	679	20.8	69.4	0.87
chr20	61637201	61637491	CpG: 24	290	24	179	16.6	61.7	0.89
chr20	61716806	61718734	CpG: 198	1928	198	1344	20.5	69.7	0.85
chr20	61723288	61724853	CpG: 176	1565	176	1078	22.5	68.9	0.95
chr20	61773494	61773779	CpG: 26	285	26	180	18.2	63.2	0.93
chr20	61871689	61872207	CpG: 82	518	82	375	31.7	72.4	1.22
chr20	62136894	62137175	CpG: 23	281	23	173	16.4	61.6	0.88
chr20	62230538	62230816	CpG: 25	278	25	175	18.0	62.9	0.92
chr20	62584409	62584683	CpG: 22	274	22	167	16.1	60.9	0.87
chr20	62751636	62751901	CpG: 41	265	41	202	30.9	76.2	1.28
chr20	62807996	62808458	CpG: 45	462	45	355	19.5	76.8	0.74
chr20	63037098	63039099	CpG: 286	2001	286	1557	28.6	77.8	0.96
chr20	63068241	63069025	CpG: 88	784	88	456	22.4	58.2	1.61
chr20	63075212	63075502	CpG: 20	290	20	150	13.8	51.7	1.05
chr20	63083220	63083447	CpG: 17	227	17	127	15.0	55.9	0.96
chr20	63114857	63115071	CpG: 16	214	16	142	15.0	66.4	0.72
chr20	63179122	63179336	CpG: 16	214	16	124	15.0	57.9	0.90
chr20	63333505	63333710	CpG: 15	205	15	129	14.6	62.9	0.75
chr20	63442482	63442894	CpG: 36	412	36	302	17.5	73.3	0.65
chr20	63475488	63475840	CpG: 28	352	28	178	15.9	50.6	1.44
chr20	63561963	63562293	CpG: 33	330	33	213	20.0	64.5	0.96
chr20	63633529	63633814	CpG: 21	285	21	174	14.7	61.1	0.80
chr20	63664121	63664409	CpG: 25	288	25	189	17.4	65.6	0.81
chr20	63671629	63671956	CpG: 22	327	22	206	13.5	63.0	0.68
chr20	63685530	63685785	CpG: 19	255	19	168	14.9	65.9	0.70
chr20	63710263	63711107	CpG: 59	844	59	436	14.0	51.7	1.63
chr20	63717968	63718175	CpG: 18	207	18	124	17.4	59.9	0.97
chr20	63719258	63719504	CpG: 25	246	25	159	20.3	64.6	1.01
chr20	63727722	63728097	CpG: 29	375	29	235	15.5	62.7	0.79
chr20	63734039	63737608	CpG: 312	3569	312	2316	17.5	64.9	0.86
chr20	63753805	63754508	CpG: 59	703	59	523	16.8	74.4	0.64
chr20	63758221	63758436	CpG: 25	215	25	163	23.3	75.8	0.90
chr20	63759168	63759860	CpG: 45	692	45	382	13.0	55.2	0.86
chr20	63765411	63765662	CpG: 35	251	35	188	27.9	74.9	1.08
chr20	63766446	63767110	CpG: 58	664	58	455	17.5	68.5	0.76
chr20	63767824	63768949	CpG: 87	1125	87	756	15.5	67.2	0.69
chr20	63784921	63785202	CpG: 23	281	23	175	16.4	62.3	0.86
chr20	63795789	63796143	CpG: 31	354	31	248	17.5	70.1	0.74
chr20	63801545	63801769	CpG: 19	224	19	145	17.0	64.7	0.82
chr20	63842581	63842922	CpG: 25	341	25	219	14.7	64.2	0.71
chr20	63844506	63844709	CpG: 18	203	18	122	17.7	60.1	0.99
chr20	63854366	63854736	CpG: 26	370	26	243	14.1	65.7	0.66
chr20	63855026	63857555	CpG: 378	2529	378	2028	29.9	80.2	0.95
chr20	63912383	63914154	CpG: 219	1771	219	1334	24.7	75.3	0.87
chr20	63933409	63935478	CpG: 314	2069	314	1593	30.4	77.0	1.02
chr20	63949430	63949645	CpG: 19	215	19	130	17.7	60.5	0.97
chr20	63954132	63954548	CpG: 35	416	35	289	16.8	69.5	0.72
chr20	63956266	63956473	CpG: 21	207	21	129	20.3	62.3	1.04
chr20	63960746	63961308	CpG: 36	562	36	336	12.8	59.8	0.72
chr20	63973429	63974198	CpG: 91	769	91	564	23.7	73.3	0.89
chr20	63991561	63991971	CpG: 30	410	30	249	14.6	60.7	0.79
chr20	63996980	63997281	CpG: 26	301	26	202	17.3	67.1	0.77
chr20	64007383	64007792	CpG: 35	409	35	295	17.1	72.1	0.66
chr20	64010253	64012195	CpG: 195	1942	195	1433	20.1	73.8	0.74
chr20	64029408	64030284	CpG: 106	876	106	674	24.2	76.9	0.82
chr20	64093392	64094901	CpG: 176	1509	176	1086	23.3	72.0	0.90
chr20	64098486	64098793	CpG: 23	307	23	212	15.0	69.1	0.65
chr20	64101903	64102116	CpG: 20	213	20	151	18.8	70.9	0.79
chr20	64103117	64105187	CpG: 141	2070	141	1401	13.6	67.7	0.61
chr20	64125714	64126337	CpG: 48	623	48	435	15.4	69.8	0.69
chr20	64131913	64132467	CpG: 47	554	47	326	17.0	58.8	1.05
chr20	64141490	64141839	CpG: 26	349	26	239	14.9	68.5	0.64
chr20	64147369	64148105	CpG: 60	736	60	501	16.3	68.1	0.71
chr20	64162280	64163345	CpG: 138	1065	138	837	25.9	78.6	0.84
chr20	64169143	64169416	CpG: 36	273	36	174	26.4	63.7	1.33
chr20	64173904	64174158	CpG: 19	254	19	177	15.0	69.7	0.62
chr20	64183015	64184198	CpG: 121	1183	121	817	20.5	69.1	0.86
chr20	64190445	64190731	CpG: 23	286	23	188	16.1	65.7	0.75
chr20	64191212	64191556	CpG: 25	344	25	231	14.5	67.2	0.65
chr20	64192980	64193221	CpG: 20	241	20	161	16.6	66.8	0.74
chr20	64203396	64204268	CpG: 120	872	120	681	27.5	78.1	0.90
chr20	64213946	64214574	CpG: 46	628	46	408	14.6	65.0	0.83
chr20	64244014	64244448	CpG: 30	434	30	242	13.8	55.8	0.89
chr20	64263192	64263691	CpG: 44	499	44	348	17.6	69.7	0.73
chr20	64271217	64273816	CpG: 276	2599	276	1843	21.2	70.9	0.85
chr20	64326392	64326608	CpG: 17	216	17	143	15.7	66.2	0.72
chr20	64336538	64336902	CpG: 26	364	26	239	14.3	65.7	0.66
chr20	64348767	64349097	CpG: 25	330	25	230	15.2	69.7	0.63
chr20	64349399	64350308	CpG: 81	909	81	650	17.8	71.5	0.70
chr20	64351755	64351964	CpG: 20	209	20	149	19.1	71.3	0.82
chr20	64352904	64353221	CpG: 26	317	26	223	16.4	70.3	0.69
chr20	64379914	64380318	CpG: 31	404	31	304	15.3	75.2	0.61
chr20	64402483	64402748	CpG: 20	265	20	182	15.1	68.7	0.65
chr20	64413275	64413541	CpG: 21	266	21	154	15.8	57.9	0.96
chr20	64440645	64442285	CpG: 184	1640	184	1209	22.4	73.7	0.84
chr20	64450601	64450850	CpG: 18	249	18	171	14.5	68.7	0.67
chr20	64451458	64451721	CpG: 18	263	18	173	13.7	65.8	0.63
chr20	64455309	64455792	CpG: 42	483	42	325	17.4	67.3	0.77
chr20	64481968	64482169	CpG: 16	201	16	135	15.9	67.2	0.72
chr20	64482390	64482880	CpG: 55	490	55	291	22.4	59.4	1.42
chr20	64507229	64508591	CpG: 165	1362	165	1001	24.2	73.5	0.90
chr20	64570946	64571232	CpG: 22	286	22	195	15.4	68.2	0.66
chr20	64593108	64595895	CpG: 266	2787	266	1806	19.1	64.8	0.91
chr20	64596040	64596254	CpG: 16	214	16	135	15.0	63.1	0.78
chr20	64603448	64604763	CpG: 155	1315	155	992	23.6	75.4	0.83
chr20	64610448	64610658	CpG: 18	210	18	143	17.1	68.1	0.74
chr20	64611093	64611536	CpG: 36	443	36	307	16.3	69.3	0.68
chr20	64615290	64616623	CpG: 153	1333	153	986	23.0	74.0	0.84
chr20	64623020	64623349	CpG: 28	329	28	240	17.0	72.9	0.64
chr20	64623941	64624524	CpG: 48	583	48	485	16.5	83.2	0.63
chr20	64635794	64636333	CpG: 38	539	38	351	14.1	65.1	0.67
chr20	64640112	64640465	CpG: 29	353	29	239	16.4	67.7	0.73
chr20	64660330	64661845	CpG: 222	1515	222	1182	29.3	78.0	0.98
chr20	64674951	64675229	CpG: 19	278	19	228	13.7	82.0	1.33
chr20	64677176	64677438	CpG: 22	262	22	185	16.8	70.6	0.68
chr20	64679295	64682468	CpG: 220	3173	220	2056	13.9	64.8	0.66
chr20	64711116	64711639	CpG: 39	523	39	342	14.9	65.4	0.70
chr20	64725789	64726976	CpG: 141	1187	141	832	23.8	70.1	0.98
chr20	64729195	64729716	CpG: 50	521	50	356	19.2	68.3	0.82
chr20	64736700	64736971	CpG: 19	271	19	167	14.0	61.6	0.75
chr20	64737440	64739052	CpG: 176	1612	176	1111	21.8	68.9	0.92
chr20	64752662	64752993	CpG: 29	331	29	242	17.5	73.1	0.66
chr20	64757835	64758296	CpG: 31	461	31	257	13.4	55.7	0.95
chr20	64759591	64759985	CpG: 29	394	29	263	14.7	66.8	0.66
chr20	64772392	64773494	CpG: 77	1102	77	730	14.0	66.2	0.65
chr20	64781000	64781217	CpG: 26	217	26	163	24.0	75.1	0.87
chr20	64790270	64790600	CpG: 27	330	27	223	16.4	67.6	0.72
chr20	64805159	64808043	CpG: 323	2884	323	2056	22.4	71.3	0.88
chr20	64809468	64810156	CpG: 48	688	48	465	14.0	67.6	0.61
chr20	64811120	64811392	CpG: 22	272	22	166	16.2	61.0	0.88
chr20	64828358	64828865	CpG: 41	507	41	416	16.2	82.1	0.77
chr20	64829570	64832118	CpG: 237	2548	237	1812	18.6	71.1	0.74
chr20	64836040	64836269	CpG: 20	229	20	136	17.5	59.4	0.99
chr20	64836466	64836707	CpG: 18	241	18	164	14.9	68.0	0.65
chr20	64840475	64840718	CpG: 20	243	20	151	16.5	62.1	0.86
chr20	64845279	64846021	CpG: 72	742	72	501	19.4	67.5	0.91
chr20	64874868	64875575	CpG: 82	707	82	545	23.2	77.1	0.78
chr20	64889273	64889512	CpG: 16	239	16	155	13.4	64.9	0.64
chr20	64890357	64890597	CpG: 17	240	17	156	14.2	65.0	0.68
chr20	64890668	64890884	CpG: 17	216	17	127	15.7	58.8	0.93
chr20	64904437	64905776	CpG: 151	1339	151	935	22.6	69.8	0.93
chr20	64921374	64921655	CpG: 24	281	24	177	17.1	63.0	0.86
chr20	64926560	64926775	CpG: 15	215	15	138	14.0	64.2	0.68
chr20	64931474	64931794	CpG: 30	320	30	210	18.8	65.6	0.87
chr20	64959179	64959498	CpG: 22	319	22	189	13.8	59.2	0.94
chr20	64980208	64984821	CpG: 470	4613	470	3261	20.4	70.7	0.82
chr20	64996258	64996475	CpG: 16	217	16	144	14.7	66.4	0.69
chr20	65020803	65022063	CpG: 160	1260	160	929	25.4	73.7	0.94
chr20	65039686	65040015	CpG: 27	329	27	234	16.4	71.1	1.03
chr20	65045444	65045841	CpG: 31	397	31	275	15.6	69.3	0.66
chr20	65048818	65049060	CpG: 19	242	19	174	15.7	71.9	0.62
chr20	65052516	65053094	CpG: 40	578	40	371	13.8	64.2	0.68
chr20	65059467	65061000	CpG: 178	1533	178	1136	23.2	74.1	0.86
chr20	65068276	65068770	CpG: 36	494	36	315	14.6	63.8	0.72
chr20	65072537	65072852	CpG: 34	315	34	236	21.6	74.9	0.81
chr20	65078022	65079229	CpG: 130	1207	130	911	21.5	75.5	0.79
chr20	65090465	65090821	CpG: 25	356	25	236	14.0	66.3	0.64
chr20	65092030	65092299	CpG: 21	269	21	173	15.6	64.3	0.76
chr20	65093555	65094334	CpG: 56	779	56	501	14.4	64.3	0.70
chr20	65101973	65102261	CpG: 21	288	21	194	14.6	67.4	0.64
chr20	65112341	65112597	CpG: 21	256	21	154	16.4	60.2	0.92
chr20	65126202	65126405	CpG: 16	203	16	147	15.8	72.4	0.60
chr20	65128759	65129261	CpG: 39	502	39	329	15.5	65.5	0.73
chr20	65148658	65149193	CpG: 46	535	46	340	17.2	63.6	0.85
chr20	65152814	65153093	CpG: 24	279	24	196	17.2	70.3	0.71
chr20	65154054	65154372	CpG: 23	318	23	202	14.5	63.5	0.72
chr20	65155363	65157644	CpG: 162	2281	162	1496	14.2	65.6	0.66
chr20	65166101	65166570	CpG: 37	469	37	311	15.8	66.3	0.72
chr20	65167459	65168014	CpG: 76	555	76	427	27.4	76.9	0.93
chr20	65179306	65179590	CpG: 21	284	21	179	14.8	63.0	0.75
chr20	65202534	65202752	CpG: 17	218	17	144	15.6	66.1	0.73
chr20	65204994	65205213	CpG: 19	219	19	142	17.4	64.8	0.83
chr20	65207728	65208734	CpG: 68	1006	68	623	13.5	61.9	0.71
chr20	65213769	65214030	CpG: 20	261	20	184	15.3	70.5	0.64
chr20	65214240	65214988	CpG: 73	748	73	529	19.5	70.7	0.79
chr20	65219574	65219895	CpG: 29	321	29	210	18.1	65.4	0.86
chr20	65222580	65223184	CpG: 48	604	48	426	15.9	70.5	0.65
chr20	65228260	65228605	CpG: 27	345	27	226	15.7	65.5	0.73
chr20	65229226	65229645	CpG: 30	419	30	288	14.3	68.7	0.61
chr20	65233615	65233834	CpG: 21	219	21	145	19.2	66.2	0.89
chr20	65235710	65235925	CpG: 17	215	17	144	15.8	67.0	0.73
chr20	65242223	65242453	CpG: 22	230	22	163	19.1	70.9	0.81
chr20	65254013	65254216	CpG: 18	203	18	135	17.7	66.5	0.80
chr20	65257791	65258088	CpG: 24	297	24	192	16.2	64.6	0.80
chr20	65264029	65264465	CpG: 36	436	36	289	16.5	66.3	0.75
chr20	65265125	65265506	CpG: 29	381	29	254	15.2	66.7	0.69
chr20	65269703	65270163	CpG: 31	460	31	290	13.5	63.0	0.68
chr20	65271854	65272114	CpG: 18	260	18	147	13.8	56.5	0.88
chr20	65276719	65277780	CpG: 99	1061	99	707	18.7	66.6	0.86
chr20	65282067	65283603	CpG: 177	1536	177	1169	23.0	76.1	0.80
chr20	65294253	65294597	CpG: 33	344	33	221	19.2	64.2	0.94
chr20	65295113	65295348	CpG: 17	235	17	161	14.5	68.5	0.64
chr20	65299339	65300759	CpG: 138	1420	138	1021	19.4	71.9	0.75
chr20	65301997	65302218	CpG: 20	221	20	142	18.1	64.3	0.90
chr20	65307259	65307790	CpG: 44	531	44	358	16.6	67.4	0.73
chr20	65308572	65309064	CpG: 39	492	39	331	15.9	67.3	0.70
chr20	65311439	65312620	CpG: 139	1181	139	907	23.5	76.8	0.80
chr20	65320771	65321034	CpG: 20	263	20	151	15.2	57.4	0.94
chr20	65332384	65334186	CpG: 200	1802	200	1332	22.2	73.9	0.81
chr20	65334405	65334659	CpG: 19	254	19	181	15.0	71.3	0.62
chr20	65346811	65347059	CpG: 23	248	23	175	18.5	70.6	0.75
chr20	65349676	65349928	CpG: 22	252	22	177	17.5	70.2	0.72
chr20	65359474	65360427	CpG: 73	953	73	660	15.3	69.3	0.64
chr20	65361726	65361929	CpG: 23	203	23	161	22.7	79.3	1.22
chr20	65366317	65366905	CpG: 56	588	56	435	19.0	74.0	0.70
chr20	65368369	65369140	CpG: 58	771	58	495	15.0	64.2	0.73
chr20	65370384	65370588	CpG: 24	204	24	158	23.5	77.5	0.86
chr20	65372625	65372871	CpG: 21	246	21	174	17.1	70.7	0.69
chr20	65375210	65380367	CpG: 391	5157	391	3548	15.2	68.8	0.64
chr20	65381467	65381702	CpG: 18	235	18	161	15.3	68.5	0.65
chr20	65382034	65382335	CpG: 28	301	28	210	18.6	69.8	0.77
chr20	65385747	65386675	CpG: 68	928	68	646	14.7	69.6	0.60
chr20	65387305	65387983	CpG: 60	678	60	500	17.7	73.7	0.67
chr20	65391482	65391738	CpG: 20	256	20	153	15.6	59.8	0.89
chr20	65403429	65404151	CpG: 54	722	54	505	15.0	69.9	0.61
chr20	65405325	65405700	CpG: 27	375	27	239	14.4	63.7	0.71
chr20	65431328	65431615	CpG: 34	287	34	208	23.7	72.5	0.90
chr20	65440109	65441996	CpG: 230	1887	230	1425	24.4	75.5	0.86
chr20	65444014	65444292	CpG: 26	278	26	176	18.7	63.3	0.94
chr20	65447984	65448261	CpG: 26	277	26	177	18.8	63.9	0.92
chr20	65454849	65456965	CpG: 213	2116	213	1608	20.1	76.0	0.73
chr20	65466279	65467601	CpG: 158	1322	158	1002	23.9	75.8	0.84
chr20	65471704	65473230	CpG: 118	1526	118	993	15.5	65.1	0.75
chr20	65480994	65481260	CpG: 18	266	18	161	13.5	60.5	0.75
chr20	65497485	65497796	CpG: 23	311	23	184	14.8	59.2	0.85
chr20	65500198	65500468	CpG: 22	270	22	186	16.3	68.9	0.69
chr20	65501052	65501351	CpG: 25	299	25	190	16.7	63.5	0.84
chr20	65503751	65503957	CpG: 19	206	19	146	18.4	70.9	0.73
chr20	65516966	65517511	CpG: 49	545	49	381	18.0	69.9	0.74
chr20	65527456	65529378	CpG: 204	1922	204	1386	21.2	72.1	0.82
chr20	65545318	65545552	CpG: 17	234	17	141	14.5	60.3	0.82
chr20	65555173	65555459	CpG: 22	286	22	199	15.4	69.6	0.67
chr20	65557878	65560875	CpG: 318	2997	318	2266	21.2	75.6	0.74
chr20	65562974	65563266	CpG: 23	292	23	204	15.8	69.9	0.65
chr20	65567092	65567525	CpG: 44	433	44	315	20.3	72.7	0.77
chr20	65571870	65573240	CpG: 99	1370	99	951	14.5	69.4	0.61
chr20	65586772	65587052	CpG: 27	280	27	176	19.3	62.9	0.99
chr20	65589609	65589899	CpG: 26	290	26	194	17.9	66.9	0.81
chr20	65590405	65591460	CpG: 85	1055	85	708	16.1	67.1	0.72
chr20	65594460	65595545	CpG: 86	1085	86	688	15.9	63.4	0.80
chr20	65609457	65610751	CpG: 100	1294	100	807	15.5	62.4	0.79
chr20	65620294	65620524	CpG: 24	230	24	169	20.9	73.5	0.81
chr20	65622268	65622654	CpG: 40	386	40	283	20.7	73.3	0.82
chr20	65627531	65629091	CpG: 105	1560	105	1019	13.5	65.3	0.63
chr20	65650246	65652684	CpG: 379	2438	379	1943	31.1	79.7	0.98
chr20	65669215	65669577	CpG: 25	362	25	209	13.8	57.7	0.83
chr20	65669725	65670439	CpG: 50	714	50	413	14.0	57.8	0.85
chr20	65681339	65685686	CpG: 328	4347	328	2778	15.1	63.9	0.74
chr20	65697655	65697861	CpG: 21	206	21	142	20.4	68.9	0.92
chr20	65706227	65706490	CpG: 26	263	26	165	19.8	62.7	1.02
chr20	65714290	65715533	CpG: 155	1243	155	926	24.9	74.5	0.90
chr20	65739209	65740019	CpG: 72	810	72	573	17.8	70.7	0.71
chr20	65740118	65740410	CpG: 21	292	21	199	14.4	68.2	0.65
chr20	65749071	65749589	CpG: 52	518	52	340	20.1	65.6	0.93
chr20	65751041	65751358	CpG: 28	317	28	216	17.7	68.1	0.78
chr20	65758293	65759272	CpG: 93	979	93	704	19.0	71.9	0.74
chr20	65760235	65761053	CpG: 66	818	66	557	16.1	68.1	0.70
chr20	65761833	65762284	CpG: 31	451	31	312	13.7	69.2	0.83
chr20	65764221	65764549	CpG: 25	328	25	222	15.2	67.7	0.67
chr20	65776527	65777826	CpG: 143	1299	143	918	22.0	70.7	0.88
chr20	65783401	65784574	CpG: 84	1173	84	808	14.3	68.9	0.60
chr20	65788984	65790007	CpG: 144	1023	144	806	28.2	78.8	0.93
chr20	65793645	65793871	CpG: 22	226	22	163	19.5	72.1	0.76
chr20	65798535	65799572	CpG: 130	1037	130	779	25.1	75.1	0.89
chr20	65800709	65801196	CpG: 58	487	58	328	23.8	67.4	1.05
chr20	65837166	65837628	CpG: 46	462	46	340	19.9	73.6	0.74
chr20	65841616	65841830	CpG: 15	214	15	127	14.0	59.3	0.80
chr20	65845919	65846191	CpG: 21	272	21	179	15.4	65.8	0.74
chr20	65849554	65849945	CpG: 28	391	28	252	14.3	64.5	0.69
chr20	65857897	65859323	CpG: 154	1426	154	1027	21.6	72.0	0.83
chr20	65862385	65863175	CpG: 99	790	99	612	25.1	77.5	0.97
chr20	65868095	65870004	CpG: 269	1909	269	1470	28.2	77.0	0.96
chr20	65877225	65877467	CpG: 20	242	20	155	16.5	64.0	0.81
chr20	65882617	65883957	CpG: 135	1340	135	963	20.1	71.9	0.78
chr20	65893786	65894649	CpG: 58	863	58	575	13.4	66.6	0.61
chr20	65899471	65900447	CpG: 116	976	116	741	23.8	75.9	0.82
chr20	65903465	65904463	CpG: 129	998	129	757	25.9	75.9	0.90
chr20	65904990	65905235	CpG: 20	245	20	168	16.3	68.6	0.70
chr20	65907174	65907718	CpG: 44	544	44	290	16.2	53.3	1.16
chr20	65920503	65920949	CpG: 36	446	36	291	16.1	65.2	0.76
chr20	65924252	65925111	CpG: 74	859	74	613	17.2	71.4	0.68
chr20	65928127	65928816	CpG: 51	689	51	441	14.8	64.0	0.72
chr20	65998539	65999380	CpG: 57	841	57	464	13.6	55.2	0.90
chr20	66007103	66007875	CpG: 59	772	59	464	15.3	60.1	0.85
chr20	66018374	66018650	CpG: 26	276	26	172	18.8	62.3	0.98
chr20	66076111	66076886	CpG: 99	775	99	592	25.5	76.4	0.88
chr20	66090571	66091337	CpG: 59	766	59	488	15.4	63.7	1.05
chr20	66106830	66107147	CpG: 42	317	42	232	26.5	73.2	1.02
chr20	66136757	66137566	CpG: 101	809	101	626	25.0	77.4	0.83
chr20	66147999	66148539	CpG: 65	540	65	407	24.1	75.4	0.85
chr20	66187541	66188411	CpG: 104	870	104	641	23.9	73.7	0.89
chr20	66205912	66206757	CpG: 145	845	145	655	34.3	77.5	1.15
chr21	49616	50401	CpG: 66	785	66	505	16.8	64.3	0.81
chr21	231956	232283	CpG: 26	327	26	214	15.9	65.4	0.74
chr21	236555	236851	CpG: 31	296	31	215	20.9	72.6	0.79
chr21	369958	370298	CpG: 28	340	28	236	16.5	69.4	0.72
chr21	523678	524208	CpG: 42	530	42	355	15.8	67.0	0.72
chr21	529585	530999	CpG: 108	1414	108	939	15.3	66.4	0.69
chr21	535697	536862	CpG: 86	1165	86	788	14.8	67.6	0.65
chr21	542772	542977	CpG: 17	205	17	137	16.6	66.8	0.79
chr21	543586	544715	CpG: 82	1129	82	755	14.5	66.9	0.65
chr21	553882	555234	CpG: 97	1352	97	894	14.3	66.1	0.66
chr21	966695	967874	CpG: 78	1179	78	758	13.2	64.3	0.65
chr21	970356	970587	CpG: 18	231	18	138	15.6	59.7	0.89
chr21	973343	974521	CpG: 94	1178	94	799	16.0	67.8	0.69
chr21	979219	980384	CpG: 83	1165	83	785	14.2	67.4	0.63
chr21	994391	994597	CpG: 17	206	17	140	16.5	68.0	0.73
chr21	994752	996322	CpG: 115	1570	115	1044	14.6	66.5	0.66
chr21	1002146	1004072	CpG: 139	1926	139	1296	14.4	67.3	0.64
chr21	1043591	1043815	CpG: 20	224	20	156	17.9	69.6	0.78
chr21	1045142	1046137	CpG: 66	995	66	631	13.3	63.4	0.67
chr21	1050519	1050786	CpG: 21	267	21	176	15.7	65.9	0.77
chr21	1051392	1052225	CpG: 75	833	75	593	18.0	71.2	0.71
chr21	1063158	1063453	CpG: 27	295	27	199	18.3	67.5	0.80
chr21	1073629	1075008	CpG: 100	1379	100	924	14.5	67.0	0.65
chr21	1083038	1083639	CpG: 46	601	46	424	15.3	70.5	0.62
chr21	1098297	1098512	CpG: 15	215	15	152	14.0	70.7	0.63
chr21	1953146	1953433	CpG: 25	287	25	195	17.4	67.9	0.81
chr21	1975009	1975551	CpG: 42	542	42	362	15.5	66.8	0.71
chr21	2196343	2196605	CpG: 26	262	26	167	19.8	63.7	0.99
chr21	2208826	2209313	CpG: 38	487	38	330	15.6	67.8	0.69
chr21	2212147	2212429	CpG: 22	282	22	174	15.6	61.7	0.84
chr21	2303819	2304098	CpG: 24	279	24	172	17.2	61.6	0.91
chr21	2334462	2334774	CpG: 34	312	34	231	21.8	74.0	0.80
chr21	2335029	2335249	CpG: 17	220	17	154	15.5	70.0	0.64
chr21	2339112	2339448	CpG: 35	336	35	235	20.8	69.9	0.85
chr21	2455181	2455468	CpG: 28	287	28	205	19.5	71.4	0.80
chr21	2544892	2545107	CpG: 17	215	17	155	15.8	72.1	0.65
chr21	2551054	2551479	CpG: 42	425	42	297	19.8	69.9	0.82
chr21	2563215	2563418	CpG: 17	203	17	122	16.7	60.1	0.93
chr21	2573268	2573511	CpG: 19	243	19	144	15.6	59.3	0.89
chr21	2573665	2573972	CpG: 28	307	28	201	18.2	65.5	0.85
chr21	2628490	2629385	CpG: 81	895	81	593	18.1	66.3	0.83
chr21	2768341	2768559	CpG: 19	218	19	128	17.4	58.7	1.01
chr21	2780395	2780696	CpG: 23	301	23	183	15.3	60.8	0.84
chr21	2787626	2787959	CpG: 26	333	26	214	15.6	64.3	0.76
chr21	2946961	2947234	CpG: 22	273	22	169	16.1	61.9	0.86
chr21	3102986	3103770	CpG: 52	784	52	484	13.3	61.7	0.70
chr21	3108404	3108659	CpG: 19	255	19	131	14.9	51.4	1.14
chr21	3110778	5579967	CpG: 183537	2469189	183537	1437068	14.9	58.2	0.88
chr21	5580907	5581218	CpG: 23	311	23	183	14.8	58.8	0.86
chr21	5584499	5584825	CpG: 28	326	28	188	17.2	57.7	1.03
chr21	5585337	5585648	CpG: 23	311	23	183	14.8	58.8	0.86
chr21	5588834	5589119	CpG: 24	285	24	160	16.8	56.1	1.07
chr21	5589649	5589945	CpG: 24	296	24	176	16.2	59.5	0.92
chr21	5592955	5593572	CpG: 47	617	47	354	15.2	57.4	0.93
chr21	5593929	5594245	CpG: 22	316	22	197	13.9	62.3	0.72
chr21	5596558	5597034	CpG: 36	476	36	308	15.1	64.7	0.74
chr21	5598342	5598572	CpG: 20	230	20	142	17.4	61.7	0.93
chr21	5601575	5601975	CpG: 27	400	27	239	13.5	59.8	0.76
chr21	5602956	5603249	CpG: 23	293	23	173	15.7	59.0	0.91
chr21	5604767	5605022	CpG: 18	255	18	131	14.1	51.4	1.08
chr21	5607230	5612655	CpG: 805	5425	805	4096	29.7	75.5	1.04
chr21	5626896	5627170	CpG: 23	274	23	170	16.8	62.0	0.88
chr21	5662154	5662469	CpG: 21	315	21	207	13.3	65.7	0.62
chr21	5663960	5664288	CpG: 24	328	24	213	14.6	64.9	0.70
chr21	5664366	5664608	CpG: 17	242	17	150	14.0	62.0	0.73
chr21	5667140	5667750	CpG: 54	610	54	416	17.7	68.2	0.76
chr21	5694428	5694635	CpG: 20	207	20	143	19.3	69.1	0.81
chr21	5694932	5695176	CpG: 19	244	19	170	15.6	69.7	0.68
chr21	5697457	5697828	CpG: 30	371	30	248	16.2	66.8	0.72
chr21	5707898	5708162	CpG: 24	264	24	187	18.2	70.8	0.72
chr21	5711944	5712609	CpG: 57	665	57	441	17.1	66.3	0.83
chr21	5753682	5754038	CpG: 30	356	30	249	16.9	69.9	0.72
chr21	5804280	5804563	CpG: 23	283	23	173	16.3	61.1	0.88
chr21	5829033	5829352	CpG: 23	319	23	201	14.4	63.0	0.73
chr21	5829524	5829794	CpG: 25	270	25	205	18.5	75.9	0.64
chr21	5969083	5969315	CpG: 19	232	19	138	16.4	59.5	0.95
chr21	6028363	6029747	CpG: 93	1384	93	925	13.4	66.8	0.60
chr21	6034798	6035639	CpG: 55	841	55	546	13.1	64.9	0.62
chr21	6044447	6045330	CpG: 71	883	71	585	16.1	66.3	0.73
chr21	6055102	6055952	CpG: 62	850	62	588	14.6	69.2	0.61
chr21	6060390	6060607	CpG: 16	217	16	142	14.7	65.4	0.77
chr21	6064518	6064891	CpG: 32	373	32	245	17.2	65.7	0.80
chr21	6071379	6071625	CpG: 19	246	19	163	15.4	66.3	0.74
chr21	6074105	6074455	CpG: 24	350	24	231	13.7	66.0	0.67
chr21	6075149	6076414	CpG: 87	1265	87	846	13.8	66.9	0.62
chr21	6080554	6081106	CpG: 37	552	37	373	13.4	67.6	0.61
chr21	6081409	6082087	CpG: 50	678	50	466	14.7	68.7	0.62
chr21	6086819	6087895	CpG: 74	1076	74	708	13.8	65.8	0.64
chr21	6088068	6088485	CpG: 29	417	29	284	13.9	68.1	0.60
chr21	6094614	6095779	CpG: 85	1165	85	783	14.6	67.2	0.65
chr21	6107152	6107377	CpG: 17	225	17	135	15.1	60.0	0.84
chr21	6108840	6109322	CpG: 32	482	32	319	13.3	66.2	0.61
chr21	6116036	6117594	CpG: 113	1558	113	1055	14.5	67.7	0.64
chr21	6117928	6118194	CpG: 20	266	20	173	15.0	65.0	0.76
chr21	6126142	6127283	CpG: 81	1141	81	776	14.2	68.0	0.61
chr21	6131179	6132320	CpG: 81	1141	81	764	14.2	67.0	0.63
chr21	6140598	6141108	CpG: 40	510	40	352	15.7	69.0	0.67
chr21	6145255	6145635	CpG: 28	380	28	256	14.7	67.4	0.69
chr21	6146005	6147806	CpG: 124	1801	124	1187	13.8	65.9	0.64
chr21	6153048	6153257	CpG: 19	209	19	144	18.2	68.9	0.81
chr21	6161987	6162584	CpG: 44	597	44	408	14.7	68.3	0.63
chr21	6162663	6162866	CpG: 15	203	15	138	14.8	68.0	0.74
chr21	6166688	6167812	CpG: 80	1124	80	751	14.2	66.8	0.64
chr21	6168576	6168862	CpG: 24	286	24	181	16.8	63.3	0.84
chr21	6177766	6178932	CpG: 80	1166	80	782	13.7	67.1	0.61
chr21	6182913	6183347	CpG: 29	434	29	279	13.4	64.3	0.69
chr21	6213562	6214596	CpG: 71	1034	71	663	13.7	64.1	0.68
chr21	6220776	6222189	CpG: 97	1413	97	948	13.7	67.1	0.61
chr21	6227084	6228932	CpG: 134	1848	134	1238	14.5	67.0	0.65
chr21	6243516	6244618	CpG: 78	1102	78	739	14.2	67.1	0.63
chr21	6245266	6245569	CpG: 21	303	21	199	13.9	65.7	0.68
chr21	6248803	6249453	CpG: 46	650	46	425	14.2	65.4	0.66
chr21	6251758	6251984	CpG: 19	226	19	136	16.8	60.2	0.94
chr21	6263037	6264089	CpG: 73	1052	73	706	13.9	67.1	0.62
chr21	6294648	6295452	CpG: 60	804	60	566	14.9	70.4	0.60
chr21	6304837	6305544	CpG: 48	707	48	472	13.6	66.8	0.62
chr21	6371750	6372901	CpG: 123	1151	123	832	21.4	72.3	0.82
chr21	6549723	6550110	CpG: 35	387	35	263	18.1	68.0	0.78
chr21	6553746	6553994	CpG: 18	248	18	167	14.5	67.3	0.64
chr21	6554354	6554650	CpG: 27	296	27	213	18.2	72.0	0.71
chr21	7089514	7090666	CpG: 123	1152	123	829	21.4	72.0	0.82
chr21	7468304	7468686	CpG: 29	382	29	266	15.2	69.6	0.65
chr21	7617970	7618266	CpG: 31	296	31	218	20.9	73.6	0.77
chr21	7622553	7623066	CpG: 44	513	44	341	17.2	66.5	0.78
chr21	7679196	7679446	CpG: 18	250	18	168	14.4	67.2	0.65
chr21	7873464	7873939	CpG: 41	475	41	321	17.3	67.6	0.81
chr21	7974163	7975354	CpG: 132	1191	132	847	22.2	71.1	0.88
chr21	8012787	8014505	CpG: 199	1718	199	1106	23.2	64.4	1.19
chr21	8045784	8047097	CpG: 134	1313	134	869	20.4	66.2	0.94
chr21	8073597	8074347	CpG: 83	750	83	515	22.1	68.7	0.99
chr21	8623583	8624479	CpG: 68	896	68	574	15.2	64.1	0.74
chr21	8677565	8677818	CpG: 18	253	18	173	14.2	68.4	0.61
chr21	8680022	8680909	CpG: 70	887	70	603	15.8	68.0	0.71
chr21	8681933	8682915	CpG: 81	982	81	665	16.5	67.7	0.72
chr21	8761761	8762116	CpG: 23	355	23	217	13.0	61.1	0.71
chr21	8764059	8764372	CpG: 27	313	27	214	17.3	68.4	0.80
chr21	8769512	8769737	CpG: 21	225	21	148	18.7	65.8	0.90
chr21	8781789	8782028	CpG: 17	239	17	145	14.2	60.7	0.81
chr21	8791469	8797309	CpG: 408	5840	408	3691	14.0	63.2	0.70
chr21	9145995	9146725	CpG: 57	730	57	510	15.6	69.9	0.64
chr21	9159318	9159747	CpG: 31	429	31	280	14.5	65.3	0.68
chr21	9160598	9160867	CpG: 21	269	21	188	15.6	69.9	0.64
chr21	9181052	9181390	CpG: 25	338	25	244	14.8	72.2	0.88
chr21	9271216	9272137	CpG: 127	921	127	635	27.6	68.9	1.44
chr21	9275195	9275479	CpG: 23	284	23	172	16.2	60.6	0.89
chr21	9332995	9333316	CpG: 22	321	22	212	13.7	66.0	0.68
chr21	9376467	9376991	CpG: 42	524	42	339	16.0	64.7	0.77
chr21	9377873	9444629	CpG: 3814	66756	3814	40321	11.4	60.4	0.63
chr21	9444946	9445158	CpG: 17	212	17	125	16.0	59.0	0.95
chr21	9445507	9445984	CpG: 41	477	41	307	17.2	64.4	0.83
chr21	9446934	9447435	CpG: 43	501	43	329	17.2	65.7	0.80
chr21	9448318	9448851	CpG: 47	533	47	349	17.6	65.5	0.82
chr21	9449142	9449350	CpG: 16	208	16	122	15.4	58.7	0.91
chr21	9449735	9450259	CpG: 48	524	48	348	18.3	66.4	0.83
chr21	9451144	9451666	CpG: 42	522	42	333	16.1	63.8	0.79
chr21	9610554	9610827	CpG: 22	273	22	166	16.1	60.8	0.88
chr21	9623300	9623581	CpG: 26	281	26	178	18.5	63.3	0.94
chr21	9657666	9657945	CpG: 25	279	25	175	17.9	62.7	0.92
chr21	9732079	9733918	CpG: 149	1839	149	1197	16.2	65.1	0.77
chr21	9734106	9734332	CpG: 18	226	18	135	15.9	59.7	0.90
chr21	9734734	9735024	CpG: 26	290	26	200	17.9	69.0	0.75
chr21	9737599	9738138	CpG: 38	539	38	345	14.1	64.0	0.69
chr21	9790135	9790401	CpG: 20	266	20	163	15.0	61.3	0.81
chr21	9804725	9804961	CpG: 19	236	19	143	16.1	60.6	0.89
chr21	9814011	9815465	CpG: 123	1454	123	1027	16.9	70.6	0.68
chr21	9821499	9821744	CpG: 19	245	19	175	15.5	71.4	0.63
chr21	9850043	9850890	CpG: 76	847	76	589	17.9	69.5	0.74
chr21	9852046	9852696	CpG: 45	650	45	427	13.8	65.7	0.68
chr21	9855148	9855396	CpG: 21	248	21	176	16.9	71.0	0.67
chr21	9908329	9909225	CpG: 74	896	74	577	16.5	64.4	0.80
chr21	10021927	10022208	CpG: 22	281	22	171	15.7	60.9	0.86
chr21	10499049	10499404	CpG: 42	355	42	234	23.7	65.9	1.13
chr21	10509846	10510057	CpG: 23	211	23	146	21.8	69.2	1.00
chr21	10604246	10605729	CpG: 173	1483	173	1077	23.3	72.6	0.89
chr21	10620575	10620841	CpG: 19	266	19	160	14.3	60.2	0.80
chr21	10721838	10722294	CpG: 40	456	40	313	17.5	68.6	0.79
chr21	11364479	11364712	CpG: 20	233	20	141	17.2	60.5	0.95
chr21	11381386	11382475	CpG: 73	1089	73	727	13.4	66.8	0.60
chr21	11540596	11540893	CpG: 27	297	27	213	18.2	71.7	0.71
chr21	11540958	11541207	CpG: 17	249	17	147	13.7	59.0	0.79
chr21	11552505	11552779	CpG: 23	274	23	169	16.8	61.7	0.89
chr21	11897958	11898194	CpG: 19	236	19	142	16.1	60.2	0.91
chr21	11953923	11954170	CpG: 39	247	39	166	31.6	67.2	1.44
chr21	12007954	12008247	CpG: 24	293	24	217	16.4	74.1	0.62
chr21	12010206	12010826	CpG: 45	620	45	414	14.5	66.8	0.65
chr21	12024420	12024654	CpG: 17	234	17	155	14.5	66.2	0.69
chr21	12024949	12025370	CpG: 33	421	33	290	15.7	68.9	0.72
chr21	12040844	12042137	CpG: 86	1293	86	851	13.3	65.8	0.62
chr21	12049034	12049838	CpG: 94	804	94	586	23.4	72.9	0.88
chr21	12067668	12068496	CpG: 80	828	80	607	19.3	73.3	0.72
chr21	12106537	12107322	CpG: 74	785	74	547	18.9	69.7	0.78
chr21	12120389	12120622	CpG: 21	233	21	152	18.0	65.2	0.87
chr21	12169755	12169984	CpG: 23	229	23	162	20.1	70.7	0.82
chr21	12281439	12281653	CpG: 19	214	19	153	17.8	71.5	0.72
chr21	12323655	12325799	CpG: 144	2144	144	1421	13.4	66.3	0.65
chr21	12355280	12355563	CpG: 22	283	22	197	15.5	69.6	0.65
chr21	12371685	12371991	CpG: 23	306	23	204	15.0	66.7	0.68
chr21	12406541	12406876	CpG: 26	335	26	228	15.5	68.1	0.69
chr21	12407331	12408661	CpG: 109	1330	109	892	16.4	67.1	0.76
chr21	12414610	12414814	CpG: 21	204	21	153	20.6	75.0	0.78
chr21	12416790	12417411	CpG: 42	621	42	404	13.5	65.1	0.65
chr21	12422820	12423201	CpG: 33	381	33	231	17.3	60.6	0.95
chr21	12427968	12428984	CpG: 80	1016	80	658	15.7	64.8	0.75
chr21	12558696	12559295	CpG: 53	599	53	403	17.7	67.3	0.78
chr21	12599227	12599457	CpG: 19	230	19	141	16.5	61.3	0.89
chr21	12725792	12726507	CpG: 50	715	50	418	14.0	58.5	0.82
chr21	13239963	13240244	CpG: 24	281	24	174	17.1	61.9	0.91
chr21	13282434	13282658	CpG: 18	224	18	134	16.1	59.8	0.90
chr21	13419358	13420726	CpG: 177	1368	177	1031	25.9	75.4	0.92
chr21	13444652	13444882	CpG: 20	230	20	140	17.4	60.9	0.95
chr21	13573107	13573360	CpG: 20	253	20	148	15.8	58.5	0.94
chr21	13574165	13574421	CpG: 22	256	22	188	17.2	73.4	0.64
chr21	13622556	13622791	CpG: 20	235	20	143	17.0	60.9	0.95
chr21	13759371	13759649	CpG: 25	278	25	175	18.0	62.9	0.92
chr21	14008195	14008425	CpG: 17	230	17	140	14.8	60.9	0.81
chr21	14028994	14029228	CpG: 17	234	17	136	14.5	58.1	0.89
chr21	14084950	14086097	CpG: 155	1147	155	864	27.0	75.3	0.95
chr21	14211894	14212168	CpG: 19	274	19	168	13.9	61.3	0.75
chr21	14316287	14316562	CpG: 19	275	19	165	13.8	60.0	0.78
chr21	14350118	14350355	CpG: 17	237	17	139	14.3	58.6	0.87
chr21	14381681	14381956	CpG: 19	275	19	163	13.8	59.3	0.80
chr21	14401633	14401911	CpG: 21	278	21	168	15.1	60.4	0.84
chr21	14505338	14505616	CpG: 25	278	25	174	18.0	62.6	0.93
chr21	14645884	14646165	CpG: 24	281	24	176	17.1	62.6	0.89
chr21	14651632	14651908	CpG: 25	276	25	172	18.1	62.3	0.94
chr21	14690738	14690950	CpG: 15	212	15	121	14.2	57.1	0.90
chr21	14708712	14708983	CpG: 22	271	22	169	16.2	62.4	0.84
chr21	14716917	14717190	CpG: 21	273	21	168	15.4	61.5	0.83
chr21	14972120	14972355	CpG: 21	235	21	139	17.9	59.1	1.05
chr21	15023325	15023557	CpG: 20	232	20	140	17.2	60.3	0.97
chr21	15045013	15045242	CpG: 17	229	17	137	14.8	59.8	0.85
chr21	15083654	15083928	CpG: 24	274	24	170	17.5	62.0	0.92
chr21	15085632	15085839	CpG: 16	207	16	122	15.5	58.9	0.92
chr21	15731012	15731288	CpG: 22	276	22	168	15.9	60.9	0.87
chr21	15824373	15824605	CpG: 18	232	18	137	15.5	59.1	0.91
chr21	15840208	15840444	CpG: 17	236	17	142	14.4	60.2	0.82
chr21	15840972	15841193	CpG: 16	221	16	132	14.5	59.7	0.83
chr21	15861597	15861958	CpG: 24	361	24	207	13.3	57.3	0.81
chr21	15867537	15868842	CpG: 139	1305	139	917	21.3	70.3	0.88
chr21	15966703	15966996	CpG: 22	293	22	164	15.0	56.0	0.96
chr21	15967233	15968395	CpG: 154	1162	154	854	26.5	73.5	0.98
chr21	16017532	16017806	CpG: 23	274	23	173	16.8	63.1	0.86
chr21	16089521	16089759	CpG: 18	238	18	142	15.1	59.7	0.87
chr21	16178136	16179098	CpG: 124	962	124	689	25.8	71.6	1.01
chr21	16261579	16261849	CpG: 24	270	24	169	17.8	62.6	0.92
chr21	16297893	16298163	CpG: 20	270	20	167	14.8	61.9	0.78
chr21	16337796	16338056	CpG: 20	260	20	146	15.4	56.2	1.01
chr21	16362216	16362493	CpG: 24	277	24	175	17.3	63.2	0.88
chr21	16504500	16504736	CpG: 18	236	18	144	15.3	61.0	0.84
chr21	16530586	16530868	CpG: 24	282	24	175	17.0	62.1	0.90
chr21	16540920	16541178	CpG: 19	258	19	155	14.7	60.1	0.82
chr21	16604263	16605039	CpG: 77	776	77	519	19.8	66.9	0.89
chr21	16641625	16641858	CpG: 18	233	18	142	15.5	60.9	0.86
chr21	16665025	16665261	CpG: 20	236	20	146	16.9	61.9	0.91
chr21	16681051	16681297	CpG: 19	246	19	149	15.4	60.6	0.86
chr21	16733862	16734143	CpG: 24	281	24	175	17.1	62.3	0.90
chr21	16799731	16799966	CpG: 21	235	21	142	17.9	60.4	1.00
chr21	17151431	17151638	CpG: 16	207	16	129	15.5	62.3	0.82
chr21	17287052	17287269	CpG: 19	217	19	134	17.5	61.8	0.93
chr21	17348027	17348259	CpG: 18	232	18	139	15.5	59.9	0.89
chr21	17381134	17381345	CpG: 17	211	17	132	16.1	62.6	0.85
chr21	17480865	17481138	CpG: 24	273	24	169	17.6	61.9	0.93
chr21	17573663	17573941	CpG: 23	278	23	170	16.5	61.2	0.90
chr21	17641652	17641901	CpG: 21	249	21	149	16.9	59.8	0.95
chr21	17687878	17688153	CpG: 22	275	22	170	16.0	61.8	0.85
chr21	17690838	17691119	CpG: 21	281	21	173	14.9	61.6	0.80
chr21	17853875	17854397	CpG: 51	522	51	386	19.5	73.9	0.71
chr21	17921807	17922044	CpG: 18	237	18	142	15.2	59.9	0.88
chr21	18239710	18239943	CpG: 18	233	18	139	15.5	59.7	0.90
chr21	18301688	18301955	CpG: 21	267	21	164	15.7	61.4	0.84
chr21	18312600	18312877	CpG: 25	277	25	175	18.1	63.2	0.92
chr21	18375169	18375380	CpG: 17	211	17	128	16.1	60.7	0.90
chr21	18422115	18422385	CpG: 20	270	20	162	14.8	60.0	0.82
chr21	18452298	18452537	CpG: 17	239	17	146	14.2	61.1	0.78
chr21	18460507	18460781	CpG: 23	274	23	171	16.8	62.4	0.87
chr21	18677444	18677725	CpG: 24	281	24	173	17.1	61.6	0.92
chr21	18735885	18736122	CpG: 18	237	18	144	15.2	60.8	0.84
chr21	18804323	18804547	CpG: 18	224	18	137	16.1	61.2	0.89
chr21	18908945	18909254	CpG: 21	309	21	176	13.6	57.0	0.85
chr21	19003086	19003360	CpG: 19	274	19	163	13.9	59.5	0.79
chr21	19179398	19179635	CpG: 20	237	20	146	16.9	61.6	0.91
chr21	19195228	19195503	CpG: 23	275	23	170	16.7	61.8	0.89
chr21	19270807	19271042	CpG: 20	235	20	143	17.0	60.9	0.93
chr21	19276640	19276868	CpG: 19	228	19	138	16.7	60.5	0.93
chr21	19337480	19337724	CpG: 20	244	20	140	16.4	57.4	1.02
chr21	19348644	19348880	CpG: 22	236	22	145	18.6	61.4	1.02
chr21	19359491	19360883	CpG: 127	1392	127	915	18.2	65.7	0.85
chr21	19781480	19781716	CpG: 18	236	18	143	15.3	60.6	0.85
chr21	19852094	19852335	CpG: 20	241	20	148	16.6	61.4	0.90
chr21	20088572	20088813	CpG: 18	241	18	139	14.9	57.7	0.91
chr21	20270042	20270366	CpG: 27	324	27	235	16.7	72.5	0.63
chr21	20271111	20271358	CpG: 20	247	20	143	16.2	57.9	1.00
chr21	20323411	20323673	CpG: 23	262	23	162	17.6	61.8	0.92
chr21	20551452	20551725	CpG: 21	273	21	165	15.4	60.4	0.85
chr21	20574895	20575125	CpG: 20	230	20	141	17.4	61.3	0.94
chr21	20577761	20578036	CpG: 23	275	23	167	16.7	60.7	0.91
chr21	20718016	20718301	CpG: 24	285	24	178	16.8	62.5	0.88
chr21	20740831	20741067	CpG: 19	236	19	139	16.1	58.9	0.96
chr21	20818152	20818389	CpG: 19	237	19	147	16.0	62.0	0.84
chr21	21128429	21128713	CpG: 24	284	24	174	16.9	61.3	0.92
chr21	21156007	21156277	CpG: 25	270	25	168	18.5	62.2	0.97
chr21	21175699	21176041	CpG: 30	342	30	249	17.5	72.8	0.66
chr21	21377719	21378064	CpG: 35	345	35	252	20.3	73.0	0.77
chr21	21418000	21418270	CpG: 27	270	27	169	20.0	62.6	1.03
chr21	21658308	21658516	CpG: 16	208	16	126	15.4	60.6	0.84
chr21	21700230	21700441	CpG: 18	211	18	126	17.1	59.7	0.98
chr21	21813837	21814423	CpG: 42	586	42	338	14.3	57.7	0.88
chr21	21915258	21915490	CpG: 18	232	18	139	15.5	59.9	0.89
chr21	22010574	22010803	CpG: 17	229	17	136	14.8	59.4	0.87
chr21	22013123	22013397	CpG: 22	274	22	165	16.1	60.2	0.90
chr21	22049026	22049301	CpG: 20	275	20	167	14.5	60.7	0.80
chr21	22164377	22164767	CpG: 37	390	37	285	19.0	73.1	0.71
chr21	22165320	22165569	CpG: 20	249	20	145	16.1	58.2	0.98
chr21	22271421	22271698	CpG: 25	277	25	173	18.1	62.5	0.93
chr21	22306609	22306883	CpG: 25	274	25	172	18.2	62.8	0.93
chr21	22337014	22337286	CpG: 22	272	22	169	16.2	62.1	0.85
chr21	22484632	22484885	CpG: 20	253	20	142	15.8	56.1	1.02
chr21	22566721	22567283	CpG: 52	562	52	415	18.5	73.8	0.68
chr21	22884492	22884705	CpG: 16	213	16	127	15.0	59.6	0.85
chr21	23197837	23198083	CpG: 26	246	26	186	21.1	75.6	0.75
chr21	23212176	23212450	CpG: 24	274	24	169	17.5	61.7	0.94
chr21	23339396	23339674	CpG: 26	278	26	177	18.7	63.7	0.93
chr21	23383879	23384158	CpG: 23	279	23	174	16.5	62.4	0.86
chr21	23719653	23720030	CpG: 28	377	28	228	14.9	60.5	0.82
chr21	23722520	23722776	CpG: 18	256	18	154	14.1	60.2	0.80
chr21	23919687	23920069	CpG: 51	382	51	281	26.7	73.6	0.99
chr21	23964690	23965507	CpG: 70	817	70	543	17.1	66.5	0.79
chr21	23996853	23997627	CpG: 64	774	64	552	16.5	71.3	0.67
chr21	24052982	24053822	CpG: 68	840	68	580	16.2	69.0	0.68
chr21	24056978	24057229	CpG: 21	251	21	157	16.7	62.5	0.87
chr21	24092066	24093464	CpG: 121	1398	121	923	17.3	66.0	0.79
chr21	24135773	24136245	CpG: 46	472	46	350	19.5	74.2	0.71
chr21	24136957	24137159	CpG: 16	202	16	109	15.8	54.0	1.09
chr21	24185944	24186219	CpG: 24	275	24	173	17.5	62.9	0.89
chr21	24230290	24230528	CpG: 20	238	20	140	16.8	58.8	0.99
chr21	24276469	24276828	CpG: 29	359	29	214	16.2	59.6	0.91
chr21	24416920	24417194	CpG: 24	274	24	171	17.5	62.4	0.91
chr21	24442405	24442655	CpG: 23	250	23	152	18.4	60.8	1.02
chr21	24460222	24460497	CpG: 21	275	21	169	15.3	61.5	0.82
chr21	24527741	24529336	CpG: 166	1595	166	1105	20.8	69.3	0.87
chr21	24531110	24531335	CpG: 18	225	18	136	16.0	60.4	0.88
chr21	24643158	24643362	CpG: 15	204	15	122	14.7	59.8	0.84
chr21	24874954	24875228	CpG: 25	274	25	172	18.2	62.8	0.94
chr21	24930834	24931470	CpG: 61	636	61	443	19.2	69.7	0.79
chr21	25128644	25128918	CpG: 22	274	22	165	16.1	60.2	0.89
chr21	25202330	25203889	CpG: 156	1559	156	1049	20.0	67.3	0.88
chr21	25204339	25204573	CpG: 17	234	17	141	14.5	60.3	0.80
chr21	25207163	25207441	CpG: 24	278	24	178	17.3	64.0	0.85
chr21	25323924	25326305	CpG: 192	2381	192	1495	16.1	62.8	0.82
chr21	25373777	25374017	CpG: 16	240	16	138	13.3	57.5	0.83
chr21	25474651	25474921	CpG: 23	270	23	163	17.0	60.4	0.95
chr21	25501891	25502395	CpG: 47	504	47	336	18.7	66.7	0.84
chr21	25581996	25582272	CpG: 25	276	25	173	18.1	62.7	0.93
chr21	25638793	25639055	CpG: 18	262	18	158	13.7	60.3	0.77
chr21	25701494	25701770	CpG: 22	276	22	170	15.9	61.6	0.85
chr21	25829799	25830084	CpG: 22	285	22	171	15.4	60.0	0.86
chr21	26248149	26248476	CpG: 30	327	30	230	18.3	70.3	0.74
chr21	26283315	26283589	CpG: 24	274	24	171	17.5	62.4	0.91
chr21	26311545	26311756	CpG: 15	211	15	124	14.2	58.8	0.83
chr21	26333520	26333778	CpG: 19	258	19	158	14.7	61.2	0.80
chr21	26480344	26480581	CpG: 17	237	17	143	14.3	60.3	0.81
chr21	26765038	26765320	CpG: 21	282	21	177	14.9	62.8	0.76
chr21	26776813	26777094	CpG: 23	281	23	170	16.4	60.5	0.90
chr21	26795238	26795512	CpG: 23	274	23	169	16.8	61.7	0.89
chr21	26847677	26847923	CpG: 19	246	19	149	15.4	60.6	0.85
chr21	26926327	26926963	CpG: 48	636	48	419	15.1	65.9	0.70
chr21	27248322	27248668	CpG: 42	346	42	238	24.3	68.8	1.05
chr21	27355363	27355740	CpG: 33	377	33	248	17.5	65.8	0.87
chr21	27362852	27363335	CpG: 42	483	42	351	17.4	72.7	0.66
chr21	27365378	27365622	CpG: 26	244	26	157	21.3	64.3	1.03
chr21	27382397	27382888	CpG: 44	491	44	319	17.9	65.0	0.85
chr21	27387195	27387518	CpG: 26	323	26	179	16.1	55.4	1.06
chr21	27387979	27388541	CpG: 40	562	40	347	14.2	61.7	0.75
chr21	27436537	27437374	CpG: 68	837	68	503	16.2	60.1	0.92
chr21	27440619	27441081	CpG: 41	462	41	335	17.7	72.5	0.68
chr21	27451085	27451328	CpG: 18	243	18	144	14.8	59.3	0.86
chr21	27463288	27463518	CpG: 19	230	19	140	16.5	60.9	0.90
chr21	27571783	27572021	CpG: 17	238	17	145	14.3	60.9	0.79
chr21	27664332	27665374	CpG: 144	1042	144	796	27.6	76.4	0.95
chr21	27930037	27930315	CpG: 24	278	24	173	17.3	62.2	0.91
chr21	27940579	27940860	CpG: 24	281	24	171	17.1	60.9	0.93
chr21	28147538	28147819	CpG: 23	281	23	175	16.4	62.3	0.86
chr21	28304965	28305685	CpG: 61	720	61	482	16.9	66.9	0.76
chr21	28786711	28786978	CpG: 25	267	25	169	18.7	63.3	0.95
chr21	28829147	28829386	CpG: 18	239	18	143	15.1	59.8	0.87
chr21	28858853	28859078	CpG: 18	225	18	134	16.0	59.6	0.92
chr21	29456182	29456476	CpG: 34	294	34	222	23.1	75.5	0.81
chr21	29565118	29565399	CpG: 22	281	22	166	15.7	59.1	0.91
chr21	29619488	29619726	CpG: 24	238	24	169	20.2	71.0	0.81
chr21	29711404	29711845	CpG: 40	441	40	277	18.1	62.8	0.94
chr21	29779624	29779911	CpG: 23	287	23	178	16.0	62.0	0.85
chr21	29855558	29855839	CpG: 23	281	23	174	16.4	61.9	0.87
chr21	29925595	29927685	CpG: 254	2090	254	1492	24.3	71.4	0.96
chr21	30009131	30009408	CpG: 24	277	24	177	17.3	63.9	0.86
chr21	30027405	30028328	CpG: 111	923	111	668	24.1	72.4	0.93
chr21	30099135	30100654	CpG: 188	1519	188	1110	24.8	73.1	0.93
chr21	30113058	30113292	CpG: 16	234	16	138	13.7	59.0	0.81
chr21	30240920	30242622	CpG: 201	1702	201	1259	23.6	74.0	0.87
chr21	30323503	30323778	CpG: 20	275	20	166	14.5	60.4	0.81
chr21	30465231	30465512	CpG: 23	281	23	176	16.4	62.6	0.85
chr21	30611575	30611851	CpG: 22	276	22	173	15.9	62.7	0.82
chr21	30648257	30648862	CpG: 63	605	63	418	20.8	69.1	0.89
chr21	30669974	30670665	CpG: 66	691	66	385	19.1	55.7	1.23
chr21	30762552	30763257	CpG: 69	705	69	494	19.6	70.1	0.80
chr21	30781413	30783216	CpG: 189	1803	189	1242	21.0	68.9	0.89
chr21	30847679	30848148	CpG: 47	469	47	359	20.0	76.5	1.50
chr21	30939603	30940220	CpG: 47	617	47	384	15.2	62.2	0.79
chr21	30949307	30949585	CpG: 26	278	26	177	18.7	63.7	0.93
chr21	30978058	30979141	CpG: 93	1083	93	692	17.2	63.9	0.84
chr21	31093424	31094504	CpG: 110	1080	110	772	20.4	71.5	0.80
chr21	31095288	31095566	CpG: 22	278	22	171	15.8	61.5	0.85
chr21	31104438	31104668	CpG: 20	230	20	141	17.4	61.3	0.94
chr21	31137448	31138260	CpG: 107	812	107	577	26.4	71.1	1.04
chr21	31199269	31199528	CpG: 21	259	21	157	16.2	60.6	0.89
chr21	31301271	31301496	CpG: 19	225	19	137	16.9	60.9	0.92
chr21	31346544	31346779	CpG: 17	235	17	137	14.5	58.3	0.89
chr21	31388027	31388521	CpG: 54	494	54	364	21.9	73.7	0.81
chr21	31390993	31396110	CpG: 373	5117	373	3152	14.6	61.6	0.77
chr21	31401353	31402403	CpG: 90	1050	90	696	17.1	66.3	0.78
chr21	31438110	31440447	CpG: 240	2337	240	1587	20.5	67.9	0.90
chr21	31475224	31475454	CpG: 17	230	17	136	14.8	59.1	0.86
chr21	31504574	31504807	CpG: 17	233	17	139	14.6	59.7	0.84
chr21	31545500	31545778	CpG: 23	278	23	172	16.5	61.9	0.88
chr21	31591692	31591973	CpG: 23	281	23	174	16.4	61.9	0.87
chr21	31598479	31599718	CpG: 127	1239	127	855	20.5	69.0	0.87
chr21	31635005	31635565	CpG: 54	560	54	396	19.3	70.7	0.77
chr21	31696471	31697689	CpG: 110	1218	110	789	18.1	64.8	0.88
chr21	31705927	31706134	CpG: 17	207	17	124	16.4	59.9	0.95
chr21	31735483	31735717	CpG: 17	234	17	141	14.5	60.3	0.83
chr21	31745143	31745424	CpG: 21	281	21	158	14.9	56.2	0.96
chr21	31759939	31760179	CpG: 20	240	20	146	16.7	60.8	0.92
chr21	31775392	31776448	CpG: 121	1056	121	798	22.9	75.6	0.81
chr21	31860754	31862293	CpG: 162	1539	162	1037	21.1	67.4	0.93
chr21	31873169	31873793	CpG: 54	624	54	410	17.3	65.7	0.81
chr21	31874822	31875033	CpG: 17	211	17	129	16.1	61.1	0.88
chr21	31923836	31925440	CpG: 124	1604	124	974	15.5	60.7	0.85
chr21	31936831	31937064	CpG: 28	233	28	164	24.0	70.4	1.03
chr21	31969871	31970735	CpG: 111	864	111	637	25.7	73.7	0.95
chr21	31985810	31986021	CpG: 18	211	18	126	17.1	59.7	0.97
chr21	32002747	32003024	CpG: 23	277	23	176	16.6	63.5	0.83
chr21	32018977	32019246	CpG: 21	269	21	162	15.6	60.2	0.88
chr21	32023384	32025300	CpG: 182	1916	182	1276	19.0	66.6	0.86
chr21	32054549	32054829	CpG: 19	280	19	164	13.6	58.6	0.79
chr21	32160381	32160655	CpG: 24	274	24	170	17.5	62.0	0.92
chr21	32187723	32187967	CpG: 17	244	17	140	13.9	57.4	0.86
chr21	32189705	32189988	CpG: 22	283	22	173	15.5	61.1	0.84
chr21	32201502	32201783	CpG: 24	281	24	175	17.1	62.3	0.90
chr21	32249515	32249761	CpG: 18	246	18	139	14.6	56.5	0.94
chr21	32250099	32250489	CpG: 39	390	39	288	20.0	73.8	0.73
chr21	32277084	32277438	CpG: 28	354	28	192	15.8	54.2	1.41
chr21	32297211	32297616	CpG: 36	405	36	265	17.8	65.4	0.83
chr21	32312945	32313270	CpG: 29	325	29	196	17.8	60.3	0.99
chr21	32393205	32393479	CpG: 24	274	24	171	17.5	62.4	0.91
chr21	32454857	32456337	CpG: 223	1480	223	1147	30.1	77.5	1.00
chr21	32584109	32584336	CpG: 29	227	29	158	25.6	69.6	1.05
chr21	32757077	32757873	CpG: 74	796	74	529	18.6	66.5	0.84
chr21	32841964	32842448	CpG: 46	484	46	344	19.0	71.1	0.75
chr21	32996901	32998076	CpG: 153	1175	153	867	26.0	73.8	0.97
chr21	33026752	33027030	CpG: 24	278	24	174	17.3	62.6	0.89
chr21	33051590	33053509	CpG: 204	1919	204	1401	21.3	73.0	0.84
chr21	33065414	33065684	CpG: 20	270	20	159	14.8	58.9	0.86
chr21	33169892	33170153	CpG: 21	261	21	155	16.1	59.4	0.93
chr21	33174452	33175242	CpG: 99	790	99	590	25.1	74.7	0.93
chr21	33269513	33270033	CpG: 53	520	53	365	20.4	70.2	0.83
chr21	33271011	33274249	CpG: 337	3238	337	2208	20.8	68.2	0.90
chr21	33409458	33409757	CpG: 31	299	31	184	20.7	61.5	1.10
chr21	33779937	33780207	CpG: 22	270	22	167	16.3	61.9	0.86
chr21	33882316	33882558	CpG: 23	242	23	151	19.0	62.4	0.98
chr21	33895814	33896052	CpG: 22	238	22	146	18.5	61.3	1.01
chr21	33937284	33937568	CpG: 23	284	23	175	16.2	61.6	0.87
chr21	33972411	33972685	CpG: 22	274	22	171	16.1	62.4	0.83
chr21	34171424	34171699	CpG: 23	275	23	170	16.7	61.8	0.89
chr21	34248398	34248672	CpG: 25	274	25	171	18.2	62.4	0.95
chr21	34269938	34270349	CpG: 42	411	42	265	20.4	64.5	0.98
chr21	34442883	34443910	CpG: 90	1027	90	657	17.5	64.0	0.87
chr21	34447790	34448012	CpG: 20	222	20	134	18.0	60.4	1.03
chr21	34452901	34453539	CpG: 70	638	70	445	21.9	69.7	0.90
chr21	34513071	34513555	CpG: 51	484	51	365	21.1	75.4	0.74
chr21	34517925	34518986	CpG: 104	1061	104	711	19.6	67.0	0.87
chr21	34538760	34540405	CpG: 168	1645	168	1198	20.4	72.8	0.78
chr21	34583175	34583452	CpG: 21	277	21	175	15.2	63.2	0.76
chr21	34627759	34628164	CpG: 31	405	31	259	15.3	64.0	0.75
chr21	34678065	34678344	CpG: 39	279	39	197	28.0	70.6	1.14
chr21	34691914	34692193	CpG: 24	279	24	172	17.2	61.6	0.92
chr21	34700778	34701035	CpG: 20	257	20	156	15.6	60.7	0.86
chr21	34702498	34703349	CpG: 99	851	99	616	23.3	72.4	0.89
chr21	34767781	34768398	CpG: 75	617	75	475	24.3	77.0	0.82
chr21	34774969	34775665	CpG: 52	696	52	475	14.9	68.2	0.64
chr21	34924737	34924959	CpG: 19	222	19	155	17.1	69.8	0.72
chr21	35075066	35076072	CpG: 93	1006	93	681	18.5	67.7	0.81
chr21	35078080	35083779	CpG: 458	5699	458	3733	16.1	65.5	0.75
chr21	35086655	35087578	CpG: 71	923	71	598	15.4	64.8	0.74
chr21	35089834	35091751	CpG: 155	1917	155	1302	16.2	67.9	0.71
chr21	35129662	35130635	CpG: 135	973	135	733	27.7	75.3	0.98
chr21	35251397	35251648	CpG: 19	251	19	150	15.1	59.8	0.88
chr21	35348245	35349196	CpG: 124	951	124	747	26.1	78.5	0.85
chr21	35362765	35363187	CpG: 44	422	44	310	20.9	73.5	0.79
chr21	35371794	35372783	CpG: 113	989	113	702	22.9	71.0	0.92
chr21	35376586	35376946	CpG: 35	360	35	224	19.4	62.2	1.01
chr21	35387849	35389349	CpG: 154	1500	154	1050	20.5	70.0	0.84
chr21	35454742	35456471	CpG: 185	1729	185	1212	21.4	70.1	0.87
chr21	35464099	35464340	CpG: 18	241	18	144	14.9	59.8	0.87
chr21	35599387	35599634	CpG: 19	247	19	147	15.4	59.5	0.89
chr21	35602911	35603598	CpG: 61	687	61	456	17.8	66.4	0.82
chr21	35639957	35640714	CpG: 56	757	56	473	14.8	62.5	0.76
chr21	35649139	35650397	CpG: 121	1258	121	864	19.2	68.7	0.82
chr21	35664593	35664803	CpG: 16	210	16	119	15.2	56.7	0.97
chr21	35665387	35665778	CpG: 37	391	37	283	18.9	72.4	0.72
chr21	35748239	35750591	CpG: 315	2352	315	1778	26.8	75.6	0.94
chr21	35945927	35946625	CpG: 75	698	75	463	21.5	66.3	0.98
chr21	35971811	35972041	CpG: 17	230	17	139	14.8	60.4	0.82
chr21	36057635	36057938	CpG: 31	303	31	211	20.5	69.6	0.84
chr21	36104041	36104326	CpG: 25	285	25	179	17.5	62.8	0.90
chr21	36299157	36300478	CpG: 107	1321	107	822	16.2	62.2	0.84
chr21	36409303	36409575	CpG: 21	272	21	168	15.4	61.8	0.82
chr21	36688124	36688348	CpG: 16	224	16	130	14.3	58.0	0.86
chr21	36852140	36852376	CpG: 16	236	16	137	13.6	58.1	0.83
chr21	36912241	36912516	CpG: 19	275	19	167	13.8	60.7	0.76
chr21	36987726	36988006	CpG: 21	280	21	169	15.0	60.4	0.83
chr21	37044076	37045498	CpG: 174	1422	174	991	24.5	69.7	1.02
chr21	37050456	37050691	CpG: 22	235	22	145	18.7	61.7	1.00
chr21	37117374	37117598	CpG: 17	224	17	130	15.2	58.0	0.91
chr21	37188872	37190537	CpG: 163	1665	163	1166	19.6	70.0	0.80
chr21	37206477	37206682	CpG: 21	205	21	131	20.5	63.9	1.00
chr21	37220237	37220510	CpG: 21	273	21	173	15.4	63.4	0.78
chr21	37258077	37258350	CpG: 22	273	22	172	16.1	63.0	0.82
chr21	37357053	37357334	CpG: 24	281	24	177	17.1	63.0	0.88
chr21	37373719	37373984	CpG: 19	265	19	140	14.3	52.8	1.06
chr21	37541329	37542266	CpG: 72	937	72	666	15.4	71.1	0.61
chr21	37567408	37568763	CpG: 137	1355	137	913	20.2	67.4	0.90
chr21	37674258	37674495	CpG: 18	237	18	139	15.2	58.6	0.90
chr21	37696961	37698912	CpG: 237	1951	237	1416	24.3	72.6	0.93
chr21	37721586	37721861	CpG: 24	275	24	165	17.5	60.0	0.98
chr21	37722541	37722767	CpG: 17	226	17	136	15.0	60.2	0.85
chr21	37732833	37734412	CpG: 177	1579	177	1096	22.4	69.4	0.93
chr21	37764747	37765485	CpG: 64	738	64	465	17.3	63.0	0.88
chr21	37770262	37770560	CpG: 27	298	27	199	18.1	66.8	0.81
chr21	37773286	37773489	CpG: 19	203	19	148	18.7	72.9	0.70
chr21	37780835	37781070	CpG: 17	235	17	141	14.5	60.0	0.83
chr21	37829999	37830670	CpG: 80	671	80	481	23.8	71.7	0.94
chr21	37870336	37870615	CpG: 21	279	21	173	15.1	62.0	0.79
chr21	37880852	37881133	CpG: 22	281	22	173	15.7	61.6	0.84
chr21	37894594	37894864	CpG: 22	270	22	165	16.3	61.1	0.88
chr21	37997152	37997671	CpG: 74	519	74	399	28.5	76.9	0.96
chr21	38415755	38416038	CpG: 21	283	21	164	14.8	58.0	0.89
chr21	38420436	38420745	CpG: 21	309	21	176	13.6	57.0	0.84
chr21	38530697	38530933	CpG: 19	236	19	143	16.1	60.6	0.89
chr21	38531495	38531730	CpG: 17	235	17	158	14.5	67.2	0.66
chr21	38569906	38571402	CpG: 90	1496	90	957	12.0	64.0	0.69
chr21	38767446	38767722	CpG: 24	276	24	171	17.4	62.0	0.92
chr21	38769617	38769891	CpG: 24	274	24	176	17.5	64.2	0.86
chr21	38873864	38874140	CpG: 24	276	24	175	17.4	63.4	0.88
chr21	38878097	38878372	CpG: 24	275	24	172	17.5	62.5	0.90
chr21	38900310	38900550	CpG: 18	240	18	144	15.0	60.0	0.86
chr21	38948665	38948883	CpG: 18	218	18	132	16.5	60.6	0.91
chr21	39005444	39005680	CpG: 21	236	21	143	17.8	60.6	1.00
chr21	39206263	39206551	CpG: 25	288	25	182	17.4	63.2	0.89
chr21	39230025	39230461	CpG: 34	436	34	269	15.6	61.7	0.82
chr21	39235000	39235733	CpG: 93	733	93	544	25.4	74.2	0.93
chr21	39419412	39419687	CpG: 24	275	24	170	17.5	61.8	0.92
chr21	39555772	39557588	CpG: 193	1816	193	1300	21.3	71.6	0.83
chr21	39634179	39634382	CpG: 16	203	16	130	15.8	64.0	0.77
chr21	39692563	39692863	CpG: 31	300	31	218	20.7	72.7	0.79
chr21	39705204	39705752	CpG: 52	548	52	405	19.0	73.9	0.70
chr21	39808839	39809432	CpG: 46	593	46	379	15.5	63.9	0.76
chr21	39814708	39815612	CpG: 86	904	86	597	19.0	66.0	0.89
chr21	39896357	39898280	CpG: 167	1923	167	1356	17.4	70.5	0.70
chr21	39943371	39943652	CpG: 23	281	23	173	16.4	61.6	0.88
chr21	40079379	40079754	CpG: 35	375	35	280	18.7	74.7	0.70
chr21	40131137	40132003	CpG: 71	866	71	592	16.4	68.4	0.70
chr21	40146893	40147125	CpG: 17	232	17	149	14.7	64.2	0.71
chr21	40156507	40157663	CpG: 130	1156	130	810	22.5	70.1	0.93
chr21	40168434	40168940	CpG: 38	506	38	352	15.0	69.6	0.62
chr21	40191681	40192049	CpG: 24	368	24	228	13.0	62.0	0.73
chr21	40199305	40199519	CpG: 20	214	20	132	18.7	61.7	1.00
chr21	40200470	40200728	CpG: 22	258	22	168	17.1	65.1	0.81
chr21	40202099	40202327	CpG: 18	228	18	137	15.8	60.1	0.90
chr21	40206028	40206513	CpG: 35	485	35	327	14.4	67.4	0.64
chr21	40210358	40210593	CpG: 16	235	16	151	13.6	64.3	0.66
chr21	40212244	40212475	CpG: 18	231	18	129	15.6	55.8	1.03
chr21	40225711	40225957	CpG: 28	246	28	164	22.8	66.7	1.03
chr21	40244903	40245191	CpG: 24	288	24	188	16.7	65.3	0.79
chr21	40268820	40270112	CpG: 184	1292	184	997	28.5	77.2	0.97
chr21	40297849	40298139	CpG: 25	290	25	191	17.2	65.9	0.80
chr21	40343249	40344597	CpG: 162	1348	162	1010	24.0	74.9	0.86
chr21	40399288	40401619	CpG: 278	2331	278	1629	23.9	69.9	0.98
chr21	40496540	40496787	CpG: 18	247	18	159	14.6	64.4	0.70
chr21	40517841	40518059	CpG: 16	218	16	116	14.7	53.2	1.04
chr21	40608895	40610079	CpG: 124	1184	124	862	20.9	72.8	0.79
chr21	40624793	40625412	CpG: 75	619	75	447	24.2	72.2	0.94
chr21	40695245	40695686	CpG: 37	441	37	280	16.8	63.5	0.88
chr21	40885885	40886507	CpG: 58	622	58	430	18.6	69.1	0.78
chr21	40886653	40886875	CpG: 16	222	16	135	14.4	60.8	0.89
chr21	40903180	40904423	CpG: 147	1243	147	920	23.7	74.0	0.87
chr21	40959561	40959852	CpG: 22	291	22	194	15.1	66.7	0.69
chr21	40977063	40978029	CpG: 87	966	87	590	18.0	61.1	1.15
chr21	41005539	41005741	CpG: 17	202	17	141	16.8	69.8	0.69
chr21	41025854	41026146	CpG: 22	292	22	164	15.1	56.2	0.96
chr21	41041533	41042990	CpG: 139	1457	139	1027	19.1	70.5	0.79
chr21	41057162	41057369	CpG: 19	207	19	139	18.4	67.1	0.82
chr21	41073577	41074886	CpG: 90	1309	90	757	13.8	57.8	0.83
chr21	41081844	41082068	CpG: 17	224	17	135	15.2	60.3	0.86
chr21	41226389	41226722	CpG: 27	333	27	235	16.2	70.6	0.65
chr21	41236838	41237556	CpG: 97	718	97	468	27.0	65.2	1.48
chr21	41267372	41268069	CpG: 78	697	78	484	22.4	69.4	0.93
chr21	41281176	41282123	CpG: 94	947	94	675	19.9	71.3	0.78
chr21	41315255	41315529	CpG: 22	274	22	168	16.1	61.3	0.86
chr21	41354369	41354650	CpG: 24	281	24	172	17.1	61.2	0.93
chr21	41362857	41364629	CpG: 233	1772	233	1317	26.3	74.3	0.96
chr21	41444848	41445092	CpG: 20	244	20	157	16.4	64.3	0.79
chr21	41448663	41449074	CpG: 29	411	29	260	14.1	63.3	0.71
chr21	41451568	41451781	CpG: 19	213	19	140	17.8	65.7	0.83
chr21	41457149	41457474	CpG: 29	325	29	227	17.8	69.8	0.73
chr21	41465630	41467995	CpG: 251	2365	251	1679	21.2	71.0	0.85
chr21	41486214	41486512	CpG: 25	298	25	198	16.8	66.4	0.77
chr21	41498124	41499037	CpG: 120	913	120	671	26.3	73.5	0.99
chr21	41544700	41545047	CpG: 33	347	33	241	19.0	69.5	0.83
chr21	41561597	41561811	CpG: 19	214	19	133	17.8	62.1	0.95
chr21	41563167	41563369	CpG: 18	202	18	135	17.8	66.8	0.84
chr21	41563704	41564628	CpG: 69	924	69	645	14.9	69.8	0.62
chr21	41653900	41654469	CpG: 49	569	49	356	17.2	62.6	1.16
chr21	41656298	41656527	CpG: 20	229	20	160	17.5	69.9	0.72
chr21	41717610	41717963	CpG: 31	353	31	238	17.6	67.4	0.83
chr21	41748031	41748740	CpG: 46	709	46	471	13.0	66.4	0.61
chr21	41754255	41754807	CpG: 40	552	40	380	14.5	68.8	0.61
chr21	41766221	41766612	CpG: 33	391	33	263	16.9	67.3	0.75
chr21	41772105	41772582	CpG: 40	477	40	347	16.8	72.7	0.65
chr21	41775494	41775825	CpG: 27	331	27	235	16.3	71.0	0.65
chr21	41781206	41783295	CpG: 285	2089	285	1619	27.3	77.5	0.93
chr21	41799294	41799985	CpG: 52	691	52	481	15.1	69.6	0.62
chr21	41811987	41812211	CpG: 21	224	21	156	18.8	69.6	0.84
chr21	41840633	41840931	CpG: 22	298	22	191	14.8	64.1	0.72
chr21	41920734	41921137	CpG: 38	403	38	248	18.9	61.5	1.00
chr21	42013333	42015483	CpG: 199	2150	199	1389	18.5	64.6	0.89
chr21	42015827	42016101	CpG: 22	274	22	166	16.1	60.6	0.89
chr21	42049623	42049926	CpG: 21	303	21	189	13.9	62.4	0.76
chr21	42050060	42050266	CpG: 17	206	17	135	16.5	65.5	0.78
chr21	42073954	42075492	CpG: 195	1538	195	1146	25.4	74.5	0.92
chr21	42084114	42084922	CpG: 57	808	57	541	14.1	67.0	0.63
chr21	42096431	42097103	CpG: 83	672	83	539	24.7	80.2	0.87
chr21	42113249	42113456	CpG: 14	207	14	138	13.5	66.7	0.61
chr21	42131407	42132486	CpG: 125	1079	125	800	23.2	74.1	0.85
chr21	42142309	42142781	CpG: 35	472	35	281	14.8	59.5	0.86
chr21	42143960	42144203	CpG: 20	243	20	149	16.5	61.3	0.89
chr21	42144690	42145610	CpG: 99	920	99	642	21.5	69.8	0.89
chr21	42157043	42157347	CpG: 24	304	24	177	15.8	58.2	0.94
chr21	42159192	42159454	CpG: 19	262	19	183	14.5	69.8	0.61
chr21	42177287	42178036	CpG: 54	749	54	512	14.4	68.4	0.62
chr21	42181996	42182235	CpG: 21	239	21	151	17.6	63.2	0.89
chr21	42219893	42221640	CpG: 248	1747	248	1410	28.4	80.7	0.87
chr21	42253044	42253627	CpG: 42	583	42	386	14.4	66.2	0.66
chr21	42299212	42299538	CpG: 23	326	23	216	14.1	66.3	0.66
chr21	42315256	42315556	CpG: 24	300	24	205	16.0	68.3	0.69
chr21	42329132	42329362	CpG: 19	230	19	141	16.5	61.3	0.94
chr21	42338224	42338582	CpG: 28	358	28	219	15.6	61.2	0.84
chr21	42367389	42368815	CpG: 182	1426	182	1050	25.5	73.6	0.94
chr21	42462546	42463735	CpG: 126	1189	126	826	21.2	69.5	0.91
chr21	42471897	42472127	CpG: 16	230	16	152	13.9	66.1	0.66
chr21	42488754	42489770	CpG: 101	1016	101	705	19.9	69.4	0.83
chr21	42496394	42496731	CpG: 29	337	29	221	17.2	65.6	0.80
chr21	42513626	42513834	CpG: 16	208	16	139	15.4	66.8	0.69
chr21	42517414	42517714	CpG: 29	300	29	233	19.3	77.7	0.76
chr21	42520055	42520337	CpG: 38	282	38	198	27.0	70.2	1.10
chr21	42522542	42522779	CpG: 20	237	20	175	16.9	73.8	0.64
chr21	42523845	42524073	CpG: 19	228	19	127	16.7	55.7	1.10
chr21	42556435	42556717	CpG: 21	282	21	179	14.9	63.5	0.74
chr21	42570696	42570970	CpG: 23	274	23	172	16.8	62.8	0.86
chr21	42583223	42583519	CpG: 21	296	21	197	14.2	66.6	0.64
chr21	42594384	42597350	CpG: 284	2966	284	2159	19.2	72.8	0.72
chr21	42611463	42611736	CpG: 21	273	21	167	15.4	61.2	0.83
chr21	42612467	42612721	CpG: 24	254	24	177	18.9	69.7	0.78
chr21	42639601	42640217	CpG: 66	616	66	449	21.4	72.9	0.81
chr21	42647682	42647986	CpG: 30	304	30	215	19.7	70.7	0.79
chr21	42653510	42654738	CpG: 152	1228	152	946	24.8	77.0	0.84
chr21	42664394	42664618	CpG: 21	224	21	163	18.8	72.8	0.71
chr21	42673813	42674101	CpG: 21	288	21	194	14.6	67.4	0.64
chr21	42676710	42676999	CpG: 22	289	22	193	15.2	66.8	0.69
chr21	42678487	42679021	CpG: 37	534	37	359	13.9	67.2	0.61
chr21	42686556	42686772	CpG: 18	216	18	152	16.7	70.4	0.67
chr21	42687812	42688651	CpG: 58	839	58	573	13.8	68.3	0.60
chr21	42692732	42693736	CpG: 124	1004	124	777	24.7	77.4	0.86
chr21	42703992	42705152	CpG: 141	1160	141	877	24.3	75.6	0.90
chr21	42723379	42723813	CpG: 34	434	34	305	15.7	70.3	0.74
chr21	42724431	42724797	CpG: 24	366	24	229	13.1	62.6	0.67
chr21	42725031	42725409	CpG: 32	378	32	273	16.9	72.2	0.75
chr21	42745255	42745460	CpG: 26	205	26	148	25.4	72.2	0.98
chr21	42785580	42786281	CpG: 49	701	49	457	14.0	65.2	0.66
chr21	42790915	42791200	CpG: 24	285	24	177	16.8	62.1	0.89
chr21	42794720	42794971	CpG: 21	251	21	174	16.7	69.3	0.84
chr21	42815784	42817896	CpG: 165	2112	165	1464	15.6	69.3	0.66
chr21	42824159	42824477	CpG: 28	318	28	210	17.6	66.0	0.81
chr21	42845204	42845442	CpG: 35	238	35	183	29.4	76.9	1.43
chr21	42867041	42867264	CpG: 19	223	19	143	17.0	64.1	0.83
chr21	42870976	42871315	CpG: 28	339	28	236	16.5	69.6	0.69
chr21	42894085	42894369	CpG: 23	284	23	198	16.2	69.7	0.68
chr21	42975599	42975818	CpG: 21	219	21	137	19.2	62.6	0.98
chr21	43021431	43021656	CpG: 17	225	17	138	15.1	61.3	0.82
chr21	43066709	43067131	CpG: 43	422	43	282	20.4	66.8	1.01
chr21	43067418	43067908	CpG: 34	490	34	336	13.9	68.6	0.61
chr21	43069910	43070208	CpG: 30	298	30	202	20.1	67.8	0.88
chr21	43083618	43084354	CpG: 56	736	56	463	15.2	62.9	0.77
chr21	43110426	43110671	CpG: 22	245	22	185	18.0	75.5	0.73
chr21	43161741	43162809	CpG: 113	1068	113	757	21.2	70.9	0.85
chr21	43177095	43179493	CpG: 289	2398	289	1794	24.1	74.8	0.90
chr21	43194112	43194348	CpG: 18	236	18	142	15.3	60.2	0.87
chr21	43204803	43205042	CpG: 18	239	18	141	15.1	59.0	0.88
chr21	43209817	43210184	CpG: 27	367	27	250	14.7	68.1	0.64
chr21	43233548	43235646	CpG: 242	2098	242	1431	23.1	68.2	0.99
chr21	43247274	43247561	CpG: 22	287	22	189	15.3	65.9	0.71
chr21	43262170	43262417	CpG: 18	247	18	152	14.6	61.5	0.77
chr21	43264433	43264725	CpG: 21	292	21	191	14.4	65.4	0.69
chr21	43269723	43269926	CpG: 16	203	16	138	15.8	68.0	0.70
chr21	43279505	43279750	CpG: 17	245	17	168	13.9	68.6	0.64
chr21	43292162	43293745	CpG: 152	1583	152	1141	19.2	72.1	0.74
chr21	43300309	43301256	CpG: 118	947	118	670	24.9	70.7	1.00
chr21	43308920	43309209	CpG: 36	289	36	208	24.9	72.0	1.08
chr21	43319147	43319514	CpG: 27	367	27	248	14.7	67.6	0.65
chr21	43327921	43328172	CpG: 18	251	18	177	14.3	70.5	0.61
chr21	43331923	43332329	CpG: 30	406	30	282	14.8	69.5	0.62
chr21	43332996	43333280	CpG: 20	284	20	183	14.1	64.4	0.68
chr21	43338885	43339595	CpG: 80	710	80	524	22.5	73.8	1.02
chr21	43349785	43350003	CpG: 16	218	16	150	14.7	68.8	0.62
chr21	43352202	43352525	CpG: 30	323	30	210	18.6	65.0	0.88
chr21	43362848	43363155	CpG: 22	307	22	177	14.3	57.7	0.87
chr21	43363483	43363799	CpG: 25	316	25	223	15.8	70.6	0.64
chr21	43366701	43366969	CpG: 19	268	19	173	14.2	64.6	0.69
chr21	43380253	43381724	CpG: 165	1471	165	1111	22.4	75.5	0.81
chr21	43390461	43390972	CpG: 38	511	38	348	14.9	68.1	0.67
chr21	43435308	43435549	CpG: 19	241	19	151	15.8	62.7	0.82
chr21	43436121	43437840	CpG: 254	1719	254	1344	29.6	78.2	0.98
chr21	43463163	43463663	CpG: 55	500	55	361	22.0	72.2	0.85
chr21	43471336	43471543	CpG: 31	207	31	123	30.0	59.4	1.99
chr21	43495889	43496748	CpG: 87	859	87	597	20.3	69.5	0.91
chr21	43514657	43514867	CpG: 17	210	17	133	16.2	63.3	0.85
chr21	43594951	43595194	CpG: 18	243	18	149	14.8	61.3	0.81
chr21	43621835	43622040	CpG: 21	205	21	144	20.5	70.2	0.83
chr21	43629235	43629499	CpG: 25	264	25	184	18.9	69.7	0.78
chr21	43630994	43631208	CpG: 22	214	22	151	20.6	70.6	0.85
chr21	43640628	43640873	CpG: 18	245	18	155	14.7	63.3	0.75
chr21	43641010	43641252	CpG: 24	242	24	162	19.8	66.9	0.92
chr21	43650731	43652791	CpG: 181	2060	181	1520	17.6	73.8	0.66
chr21	43659024	43659246	CpG: 16	222	16	137	14.4	61.7	0.79
chr21	43666622	43666847	CpG: 17	225	17	154	15.1	68.4	0.65
chr21	43692574	43692837	CpG: 19	263	19	177	14.4	67.3	0.65
chr21	43710614	43711215	CpG: 39	601	39	344	13.0	57.2	0.81
chr21	43713430	43713682	CpG: 17	252	17	147	13.5	58.3	0.80
chr21	43731171	43731380	CpG: 19	209	19	144	18.2	68.9	0.77
chr21	43735051	43735271	CpG: 20	220	20	140	18.2	63.6	0.90
chr21	43736998	43737200	CpG: 14	202	14	121	13.9	59.9	0.78
chr21	43745799	43746596	CpG: 74	797	74	517	18.6	64.9	1.13
chr21	43758870	43759142	CpG: 25	272	25	186	18.4	68.4	0.79
chr21	43770395	43772076	CpG: 229	1681	229	1330	27.2	79.1	0.88
chr21	43785013	43785263	CpG: 23	250	23	137	18.4	54.8	1.37
chr21	43793426	43793694	CpG: 19	268	19	181	14.2	67.5	0.65
chr21	43796495	43796763	CpG: 19	268	19	176	14.2	65.7	0.66
chr21	43805061	43805948	CpG: 77	887	77	570	17.4	64.3	0.85
chr21	43806245	43806682	CpG: 31	437	31	288	14.2	65.9	0.66
chr21	43808381	43808615	CpG: 18	234	18	169	15.4	72.2	0.70
chr21	43836664	43836931	CpG: 25	267	25	196	18.7	73.4	0.77
chr21	43840452	43842378	CpG: 144	1926	144	1287	15.0	66.8	0.67
chr21	43843905	43844331	CpG: 31	426	31	287	14.6	67.4	0.68
chr21	43844629	43845057	CpG: 30	428	30	255	14.0	59.6	0.80
chr21	43858432	43858679	CpG: 21	247	21	156	17.0	63.2	0.86
chr21	43864247	43864469	CpG: 26	222	26	171	23.4	77.0	0.92
chr21	43877476	43878462	CpG: 78	986	78	714	15.8	72.4	0.61
chr21	43880278	43880584	CpG: 28	306	28	214	18.3	69.9	0.75
chr21	43898690	43900610	CpG: 162	1920	162	1350	16.9	70.3	0.70
chr21	43905632	43906260	CpG: 53	628	53	453	16.9	72.1	0.72
chr21	43910117	43911527	CpG: 159	1410	159	1091	22.6	77.4	0.78
chr21	43922755	43925448	CpG: 224	2693	224	1947	16.6	72.3	0.65
chr21	43958884	43960269	CpG: 132	1385	132	978	19.1	70.6	0.77
chr21	43975150	43976065	CpG: 64	915	64	499	14.0	54.5	0.95
chr21	43984801	43985067	CpG: 20	266	20	164	15.0	61.7	0.80
chr21	44002250	44004283	CpG: 240	2033	240	1378	23.6	67.8	1.03
chr21	44007345	44007591	CpG: 23	246	23	180	18.7	73.2	0.70
chr21	44011545	44014078	CpG: 316	2533	316	1890	25.0	74.6	0.91
chr21	44115682	44116900	CpG: 123	1218	123	708	20.2	58.1	1.20
chr21	44159687	44159980	CpG: 21	293	21	171	14.3	58.4	0.86
chr21	44239701	44240115	CpG: 36	414	36	260	17.4	62.8	0.89
chr21	44241149	44241416	CpG: 20	267	20	180	15.0	67.4	0.66
chr21	44247668	44247911	CpG: 24	243	24	183	19.8	75.3	0.70
chr21	44271659	44271962	CpG: 24	303	24	214	15.8	70.6	0.87
chr21	44287736	44288238	CpG: 33	502	33	303	13.1	60.4	0.73
chr21	44297406	44300977	CpG: 307	3571	307	1953	17.2	54.7	1.27
chr21	44343835	44344109	CpG: 24	274	24	171	17.5	62.4	0.91
chr21	44346958	44349002	CpG: 152	2044	152	1367	14.9	66.9	0.67
chr21	44358661	44358978	CpG: 33	317	33	214	20.8	67.5	0.91
chr21	44361412	44363571	CpG: 166	2159	166	1513	15.4	70.1	0.69
chr21	44365354	44365707	CpG: 25	353	25	239	14.2	67.7	0.99
chr21	44366396	44366702	CpG: 24	306	24	221	15.7	72.2	0.62
chr21	44376643	44376906	CpG: 23	263	23	178	17.5	67.7	0.78
chr21	44377352	44379391	CpG: 160	2039	160	1384	15.7	67.9	0.68
chr21	44381019	44382099	CpG: 92	1080	92	799	17.0	74.0	0.65
chr21	44385963	44386404	CpG: 34	441	34	301	15.4	68.3	0.66
chr21	44408395	44409609	CpG: 97	1214	97	881	16.0	72.6	0.61
chr21	44409906	44410272	CpG: 28	366	28	249	15.3	68.0	0.67
chr21	44411473	44411732	CpG: 19	259	19	166	14.7	64.1	0.72
chr21	44412361	44412941	CpG: 48	580	48	377	16.6	65.0	0.79
chr21	44475818	44477167	CpG: 161	1349	161	1068	23.9	79.2	0.76
chr21	44490057	44490979	CpG: 75	922	75	612	16.3	66.4	0.75
chr21	44503352	44504377	CpG: 85	1025	85	663	16.6	64.7	0.80
chr21	44507111	44507600	CpG: 39	489	39	328	16.0	67.1	0.73
chr21	44510010	44510802	CpG: 89	792	89	553	22.5	69.8	0.93
chr21	44520698	44520922	CpG: 22	224	22	140	19.6	62.5	1.01
chr21	44524511	44525845	CpG: 109	1334	109	998	16.3	74.8	0.61
chr21	44539999	44541966	CpG: 167	1967	167	1426	17.0	72.5	0.68
chr21	44562849	44563058	CpG: 16	209	16	141	15.3	67.5	0.67
chr21	44564260	44564569	CpG: 28	309	28	220	18.1	71.2	0.72
chr21	44584430	44584930	CpG: 36	500	36	294	14.4	58.8	0.83
chr21	44610835	44612263	CpG: 156	1428	156	1062	21.8	74.4	0.80
chr21	44668310	44669294	CpG: 114	984	114	692	23.2	70.3	0.97
chr21	44678832	44680047	CpG: 78	1215	78	693	12.8	57.0	0.80
chr21	44682672	44683504	CpG: 83	832	83	552	20.0	66.3	0.91
chr21	44688090	44688327	CpG: 36	237	36	190	30.4	80.2	0.95
chr21	44708027	44710790	CpG: 285	2763	285	1873	20.6	67.8	0.90
chr21	44745137	44745521	CpG: 24	384	24	219	12.5	57.0	0.78
chr21	44767378	44770721	CpG: 215	3343	215	1725	12.9	51.6	1.01
chr21	44774632	44775082	CpG: 34	450	34	294	15.1	65.3	0.71
chr21	44777088	44777309	CpG: 17	221	17	154	15.4	69.7	0.70
chr21	44779209	44779420	CpG: 16	211	16	137	15.2	64.9	0.74
chr21	44789480	44790323	CpG: 75	843	75	502	17.8	59.5	1.12
chr21	44793545	44793779	CpG: 18	234	18	142	15.4	60.7	0.85
chr21	44797765	44798163	CpG: 35	398	35	275	17.6	69.1	0.74
chr21	44799111	44799489	CpG: 29	378	29	276	15.3	73.0	0.65
chr21	44811884	44812153	CpG: 20	269	20	177	14.9	65.8	0.69
chr21	44815341	44815601	CpG: 24	260	24	189	18.5	72.7	0.73
chr21	44817659	44817894	CpG: 18	235	18	150	15.3	63.8	0.75
chr21	44821955	44822355	CpG: 29	400	29	252	14.5	63.0	0.73
chr21	44844282	44845788	CpG: 173	1506	173	1114	23.0	74.0	0.85
chr21	44884755	44884986	CpG: 19	231	19	155	16.5	67.1	0.77
chr21	44984483	44985103	CpG: 42	620	42	375	13.5	60.5	0.74
chr21	44997487	44997724	CpG: 17	237	17	140	14.3	59.1	0.84
chr21	45021549	45022410	CpG: 93	861	93	613	21.6	71.2	0.86
chr21	45034955	45035246	CpG: 24	291	24	181	16.5	62.2	0.89
chr21	45047680	45048663	CpG: 91	983	91	682	18.5	69.4	0.78
chr21	45053652	45054558	CpG: 93	906	93	607	20.5	67.0	0.92
chr21	45083699	45083984	CpG: 23	285	23	175	16.1	61.4	0.87
chr21	45084837	45085760	CpG: 138	923	138	686	29.9	74.3	1.09
chr22	51455	52077	CpG: 57	622	57	408	18.3	65.6	0.85
chr22	230163	230489	CpG: 25	326	25	213	15.3	65.3	0.72
chr22	234755	235051	CpG: 30	296	30	213	20.3	72.0	0.78
chr22	383243	383583	CpG: 29	340	29	237	17.1	69.7	0.74
chr22	1249167	1249594	CpG: 31	427	31	255	14.5	59.7	0.82
chr22	1885864	1887219	CpG: 94	1355	94	906	13.9	66.9	0.62
chr22	1894934	1895139	CpG: 15	205	15	138	14.6	67.3	0.67
chr22	1895777	1896956	CpG: 89	1179	89	798	15.1	67.7	0.66
chr22	1901653	1902815	CpG: 85	1162	85	787	14.6	67.7	0.64
chr22	1908788	1910674	CpG: 124	1886	124	1249	13.1	66.2	0.60
chr22	1919841	1921193	CpG: 97	1352	97	894	14.3	66.1	0.66
chr22	1928388	1930315	CpG: 130	1927	130	1291	13.5	67.0	0.60
chr22	2243508	2244687	CpG: 80	1179	80	758	13.6	64.3	0.66
chr22	2247171	2247402	CpG: 19	231	19	139	16.5	60.2	0.92
chr22	2250158	2251336	CpG: 94	1178	94	799	16.0	67.8	0.69
chr22	2256034	2257199	CpG: 80	1165	80	783	13.7	67.2	0.61
chr22	2263715	2265052	CpG: 90	1337	90	889	13.5	66.5	0.61
chr22	2271207	2271413	CpG: 17	206	17	140	16.5	68.0	0.73
chr22	2271568	2273138	CpG: 114	1570	114	1046	14.5	66.6	0.66
chr22	2278962	2280888	CpG: 139	1926	139	1296	14.4	67.3	0.64
chr22	2320408	2320632	CpG: 20	224	20	156	17.9	69.6	0.78
chr22	2321959	2322956	CpG: 67	997	67	634	13.4	63.6	0.68
chr22	2327338	2327605	CpG: 20	267	20	176	15.0	65.9	0.74
chr22	2328211	2329334	CpG: 91	1123	91	776	16.2	69.1	0.68
chr22	2340876	2341884	CpG: 80	1008	80	679	15.9	67.4	0.70
chr22	2351228	2351438	CpG: 16	210	16	141	15.2	67.1	0.73
chr22	2352070	2352843	CpG: 54	773	54	527	14.0	68.2	0.61
chr22	2360630	2362432	CpG: 123	1802	123	1215	13.7	67.4	0.60
chr22	2367809	2370886	CpG: 206	3077	206	2049	13.4	66.6	0.60
chr22	2372451	2372712	CpG: 26	261	26	194	19.9	74.3	0.72
chr22	2383905	2385085	CpG: 79	1180	79	788	13.4	66.8	0.60
chr22	3502736	3503023	CpG: 25	287	25	195	17.4	67.9	0.81
chr22	3522185	3522402	CpG: 15	217	15	149	13.8	68.7	0.67
chr22	3524669	3525386	CpG: 54	717	54	474	15.1	66.1	0.69
chr22	3710668	3711155	CpG: 38	487	38	330	15.6	67.8	0.69
chr22	3805549	3805828	CpG: 25	279	25	174	17.9	62.4	0.93
chr22	3836179	3836572	CpG: 34	393	34	289	17.3	73.5	0.64
chr22	3836723	3836963	CpG: 17	240	17	166	14.2	69.2	0.60
chr22	3840743	3841130	CpG: 36	387	36	261	18.6	67.4	0.82
chr22	4212584	4212871	CpG: 28	287	28	205	19.5	71.4	0.80
chr22	4312504	4312778	CpG: 21	274	21	162	15.3	59.1	0.88
chr22	4312901	4313208	CpG: 28	307	28	199	18.2	64.8	0.87
chr22	4367513	4368432	CpG: 80	919	80	610	17.4	66.4	0.80
chr22	4454179	4454413	CpG: 20	234	20	140	17.1	59.8	0.96
chr22	4466256	4466556	CpG: 21	300	21	182	14.0	60.7	0.77
chr22	4632386	4632667	CpG: 24	281	24	175	17.1	62.3	0.90
chr22	4699781	4700015	CpG: 17	234	17	141	14.5	60.3	0.81
chr22	4723504	4723721	CpG: 22	217	22	159	20.3	73.3	0.76
chr22	4788482	4789266	CpG: 52	784	52	484	13.3	61.7	0.70
chr22	4793900	4794155	CpG: 19	255	19	132	14.9	51.8	1.12
chr22	4796391	5720680	CpG: 67869	924289	67869	537936	14.7	58.2	0.87
chr22	5772652	5773077	CpG: 29	425	29	271	13.6	63.8	0.67
chr22	5775488	5776099	CpG: 53	611	53	416	17.3	68.1	0.75
chr22	5802779	5802986	CpG: 20	207	20	143	19.3	69.1	0.81
chr22	5805809	5806131	CpG: 24	322	24	216	14.9	67.1	0.66
chr22	5814778	5815013	CpG: 18	235	18	139	15.3	59.1	0.89
chr22	5815983	5816522	CpG: 41	539	41	377	15.2	69.9	0.62
chr22	5820256	5820515	CpG: 29	259	29	191	22.4	73.7	0.82
chr22	5820810	5821021	CpG: 17	211	17	140	16.1	66.4	0.74
chr22	5862052	5862434	CpG: 31	382	31	268	16.2	70.2	0.68
chr22	5912727	5913010	CpG: 23	283	23	174	16.3	61.5	0.87
chr22	5937958	5938228	CpG: 24	270	24	204	17.8	75.6	0.62
chr22	6013115	6015022	CpG: 130	1907	130	1266	13.6	66.4	0.62
chr22	6019125	6020976	CpG: 131	1851	131	1251	14.2	67.6	0.62
chr22	6026336	6029804	CpG: 230	3468	230	2289	13.3	66.0	0.61
chr22	6047591	6048516	CpG: 69	925	69	635	14.9	68.6	0.63
chr22	6064111	6065303	CpG: 84	1192	84	806	14.1	67.6	0.62
chr22	6068294	6068564	CpG: 20	270	20	174	14.8	64.4	0.71
chr22	6074969	6075323	CpG: 34	354	34	233	19.2	65.8	0.89
chr22	6081219	6082535	CpG: 101	1316	101	894	15.3	67.9	0.67
chr22	6093031	6093292	CpG: 20	261	20	169	15.3	64.8	0.78
chr22	6100786	6102287	CpG: 104	1501	104	1012	13.9	67.4	0.61
chr22	6124191	6124696	CpG: 34	505	34	313	13.5	62.0	0.72
chr22	6124876	6126352	CpG: 104	1476	104	1001	14.1	67.8	0.61
chr22	6126639	6126896	CpG: 20	257	20	165	15.6	64.2	0.78
chr22	6132345	6133062	CpG: 50	717	50	479	13.9	66.8	0.63
chr22	6139199	6140716	CpG: 125	1517	125	1038	16.5	68.4	0.71
chr22	6150361	6151628	CpG: 96	1267	96	860	15.2	67.9	0.66
chr22	6154573	6154817	CpG: 21	244	21	166	17.2	68.0	0.77
chr22	6155379	6156537	CpG: 80	1158	80	780	13.8	67.4	0.61
chr22	6181477	6183550	CpG: 150	2073	150	1339	14.5	64.6	0.69
chr22	6183699	6183918	CpG: 16	219	16	155	14.6	70.8	0.70
chr22	6192698	6194931	CpG: 164	2233	164	1514	14.7	67.8	0.64
chr22	6196953	6197410	CpG: 35	457	35	297	15.3	65.0	0.73
chr22	6205038	6206372	CpG: 98	1334	98	904	14.7	67.8	0.64
chr22	6211488	6212308	CpG: 67	820	67	578	16.3	70.5	0.66
chr22	6212873	6213133	CpG: 21	260	21	172	16.2	66.2	0.79
chr22	6218452	6220089	CpG: 121	1637	121	1110	14.8	67.8	0.64
chr22	6226499	6226961	CpG: 29	462	29	301	12.6	65.2	0.62
chr22	6227097	6228923	CpG: 130	1826	130	1229	14.2	67.3	0.63
chr22	6234658	6237218	CpG: 181	2560	181	1741	14.1	68.0	0.61
chr22	6333105	6334048	CpG: 107	943	107	681	22.7	72.2	0.89
chr22	6371503	6371715	CpG: 17	212	17	125	16.0	59.0	0.93
chr22	6393571	6393942	CpG: 56	371	56	264	30.2	71.2	1.31
chr22	6396065	6396357	CpG: 24	292	24	179	16.4	61.3	0.89
chr22	6417779	6418008	CpG: 18	229	18	142	15.7	62.0	0.83
chr22	6418195	6419925	CpG: 181	1730	181	1145	20.9	66.2	0.98
chr22	6453064	6454597	CpG: 165	1533	165	983	21.5	64.1	1.12
chr22	6489672	6490747	CpG: 121	1075	121	783	22.5	72.8	0.85
chr22	6493670	6493944	CpG: 22	274	22	168	16.1	61.3	0.86
chr22	7469611	7469874	CpG: 19	263	19	159	14.4	60.5	0.81
chr22	7551577	7551873	CpG: 28	296	28	215	18.9	72.6	0.72
chr22	7556129	7556516	CpG: 34	387	34	262	17.6	67.7	0.77
chr22	7681610	7681992	CpG: 32	382	32	268	16.8	70.2	0.71
chr22	7747714	7747999	CpG: 21	285	21	173	14.7	60.7	0.81
chr22	7871821	7873003	CpG: 86	1182	86	799	14.6	67.6	0.64
chr22	7893681	7893962	CpG: 23	281	23	172	16.4	61.2	0.89
chr22	7905422	7906918	CpG: 107	1496	107	1017	14.3	68.0	0.62
chr22	7913295	7913512	CpG: 16	217	16	151	14.7	69.6	0.67
chr22	7913695	7914850	CpG: 82	1155	82	772	14.2	66.8	0.64
chr22	7915411	7915680	CpG: 21	269	21	178	15.6	66.2	0.74
chr22	7923821	7925974	CpG: 147	2153	147	1443	13.7	67.0	0.61
chr22	7929426	7930589	CpG: 78	1163	78	772	13.4	66.4	0.61
chr22	7934961	7936465	CpG: 106	1504	106	1011	14.1	67.2	0.63
chr22	7941837	7942390	CpG: 39	553	39	366	14.1	66.2	0.66
chr22	7943707	7943970	CpG: 23	263	23	177	17.5	67.3	0.81
chr22	7952809	7953903	CpG: 81	1094	81	740	14.8	67.6	0.65
chr22	7964777	7965969	CpG: 86	1192	86	809	14.4	67.9	0.63
chr22	9124694	9125167	CpG: 40	473	40	320	16.9	67.7	0.75
chr22	9222311	9222943	CpG: 54	632	54	420	17.1	66.5	0.79
chr22	9315480	9315955	CpG: 47	475	47	329	19.8	69.3	0.83
chr22	9318888	9319266	CpG: 33	378	33	248	17.5	65.6	0.81
chr22	9337291	9337758	CpG: 47	467	47	334	20.1	71.5	0.79
chr22	9395303	9395563	CpG: 22	260	22	172	16.9	66.2	0.78
chr22	9407948	9409771	CpG: 129	1823	129	1234	14.2	67.7	0.62
chr22	9413981	9415961	CpG: 135	1980	135	1315	13.6	66.4	0.62
chr22	9427371	9429179	CpG: 120	1808	120	1193	13.3	66.0	0.61
chr22	9436283	9436686	CpG: 26	403	26	264	12.9	65.5	0.66
chr22	9447617	9448648	CpG: 82	1031	82	697	15.9	67.6	0.70
chr22	9452361	9453562	CpG: 82	1201	82	808	13.7	67.3	0.60
chr22	9464509	9464718	CpG: 17	209	17	131	16.3	62.7	0.83
chr22	9464877	9465161	CpG: 25	284	25	211	17.6	74.3	0.64
chr22	9465537	9465794	CpG: 20	257	20	183	15.6	71.2	0.64
chr22	9478884	9480064	CpG: 82	1180	82	784	13.9	66.4	0.63
chr22	9485554	9486089	CpG: 43	535	43	391	16.1	73.1	0.60
chr22	9486335	9486700	CpG: 25	365	25	233	13.7	63.8	0.67
chr22	9490961	9492234	CpG: 88	1273	88	858	13.8	67.4	0.61
chr22	9496955	9497413	CpG: 36	458	36	293	15.7	64.0	0.77
chr22	9497695	9497962	CpG: 20	267	20	168	15.0	62.9	0.76
chr22	9510747	9511107	CpG: 31	360	31	239	17.2	66.4	0.78
chr22	9513750	9513977	CpG: 17	227	17	148	15.0	65.2	0.74
chr22	9514614	9515750	CpG: 85	1136	85	761	15.0	67.0	0.67
chr22	9519115	9519438	CpG: 23	323	23	210	14.2	65.0	0.67
chr22	9543113	9543723	CpG: 45	610	45	407	14.8	66.7	0.66
chr22	9556114	9557872	CpG: 126	1758	126	1190	14.3	67.7	0.63
chr22	9564212	9565600	CpG: 100	1388	100	923	14.4	66.5	0.65
chr22	9565955	9566158	CpG: 18	203	18	139	17.7	68.5	0.79
chr22	9573698	9575565	CpG: 129	1867	129	1260	13.8	67.5	0.61
chr22	9583046	9583257	CpG: 16	211	16	132	15.2	62.6	0.78
chr22	9596544	9597707	CpG: 92	1163	92	793	15.8	68.2	0.68
chr22	9598296	9598600	CpG: 29	304	29	196	19.1	64.5	0.95
chr22	9606278	9607430	CpG: 88	1152	88	783	15.3	68.0	0.66
chr22	9613783	9615554	CpG: 119	1771	119	1178	13.4	66.5	0.61
chr22	9639713	9639920	CpG: 15	207	15	143	14.5	69.1	0.70
chr22	9650176	9650977	CpG: 62	801	62	535	15.5	66.8	0.69
chr22	9656063	9656712	CpG: 58	649	58	428	17.9	65.9	0.82
chr22	9665137	9665844	CpG: 50	707	50	466	14.1	65.9	0.65
chr22	9667955	9668209	CpG: 25	254	25	186	19.7	73.2	0.79
chr22	9676114	9677307	CpG: 92	1193	92	809	15.4	67.8	0.67
chr22	9677834	9678142	CpG: 27	308	27	202	17.5	65.6	0.82
chr22	9678938	9680085	CpG: 79	1147	79	777	13.8	67.7	0.60
chr22	9684851	9685456	CpG: 40	605	40	388	13.2	64.1	0.64
chr22	9807321	9807628	CpG: 28	307	28	211	18.2	68.7	0.77
chr22	9811966	9812273	CpG: 29	307	29	224	18.9	73.0	0.71
chr22	9876163	9876650	CpG: 45	487	45	335	18.5	68.8	0.80
chr22	10500994	10501350	CpG: 27	356	27	248	15.2	69.7	0.66
chr22	10650734	10651030	CpG: 31	296	31	217	20.9	73.3	0.78
chr22	10655378	10655856	CpG: 44	478	44	326	18.4	68.2	0.79
chr22	10711922	10712172	CpG: 18	250	18	168	14.4	67.2	0.65
chr22	11091855	11092167	CpG: 30	312	30	220	19.2	70.5	0.80
chr22	11190109	11191300	CpG: 130	1191	130	844	21.8	70.9	0.87
chr22	11228082	11229880	CpG: 205	1798	205	1154	22.8	64.2	1.17
chr22	11261429	11262631	CpG: 128	1202	128	795	21.3	66.1	0.99
chr22	11288815	11289080	CpG: 22	265	22	165	16.6	62.3	0.87
chr22	11353824	11354192	CpG: 63	368	63	285	34.2	77.4	1.20
chr22	11411004	11412407	CpG: 203	1403	203	981	28.9	69.9	1.30
chr22	11456152	11458169	CpG: 261	2017	261	1345	25.9	66.7	1.20
chr22	11505487	11506086	CpG: 46	599	46	421	15.4	70.3	0.62
chr22	11526275	11528137	CpG: 237	1862	237	1262	25.5	67.8	1.16
chr22	11555999	11556876	CpG: 102	877	102	600	23.3	68.4	1.03
chr22	12227578	12228469	CpG: 76	891	76	581	17.1	65.2	0.80
chr22	12245985	12246263	CpG: 24	278	24	174	17.3	62.6	0.89
chr22	12282658	12282939	CpG: 24	281	24	174	17.1	61.9	0.90
chr22	12286627	12286935	CpG: 27	308	27	210	17.5	68.2	0.77
chr22	12287211	12287473	CpG: 19	262	19	165	14.5	63.0	0.77
chr22	12288393	12289476	CpG: 84	1083	84	725	15.5	66.9	0.69
chr22	12406764	12407135	CpG: 27	371	27	230	14.6	62.0	0.76
chr22	12411035	12411932	CpG: 59	897	59	573	13.2	63.9	0.65
chr22	12556666	12562531	CpG: 469	5865	469	3759	16.0	64.1	0.78
chr22	12571974	12572236	CpG: 17	262	17	153	13.0	58.4	0.79
chr22	12578510	12578723	CpG: 17	213	17	142	16.0	66.7	0.73
chr22	12579857	12580122	CpG: 19	265	19	162	14.3	61.1	0.78
chr22	12584845	12585127	CpG: 24	282	24	169	17.0	59.9	0.95
chr22	12588370	12589200	CpG: 55	830	55	530	13.3	63.9	0.65
chr22	12589672	12589982	CpG: 25	310	25	210	16.1	67.7	0.77
chr22	12590972	12591231	CpG: 18	259	18	173	13.9	66.8	0.64
chr22	12666324	12667111	CpG: 69	787	69	545	17.5	69.3	0.73
chr22	12668831	12669136	CpG: 33	305	33	215	21.6	70.5	0.88
chr22	12671528	12671731	CpG: 16	203	16	141	15.8	69.5	0.65
chr22	12725086	12725898	CpG: 71	812	71	535	17.5	65.9	0.81
chr22	15795441	15795717	CpG: 21	276	21	161	15.2	58.3	0.91
chr22	15818345	15818628	CpG: 24	283	24	174	17.0	61.5	0.91
chr22	16083914	16084288	CpG: 33	374	33	248	17.6	66.3	0.81
chr22	16084816	16085498	CpG: 65	682	65	506	19.1	74.2	0.70
chr22	16127854	16128129	CpG: 29	275	29	203	21.1	73.8	0.80
chr22	16147305	16147634	CpG: 36	329	36	245	21.9	74.5	0.86
chr22	16177068	16177462	CpG: 34	394	34	282	17.3	71.6	0.68
chr22	16263180	16263642	CpG: 62	462	62	303	26.8	65.6	1.25
chr22	16323028	16323637	CpG: 43	609	43	405	14.1	66.5	0.64
chr22	16334172	16334561	CpG: 32	389	32	271	16.5	69.7	0.70
chr22	16351148	16351706	CpG: 38	558	38	377	13.6	67.6	0.60
chr22	16358758	16359202	CpG: 37	444	37	297	16.7	66.9	0.75
chr22	16393851	16396117	CpG: 206	2266	206	1554	18.2	68.6	0.77
chr22	16429076	16429377	CpG: 41	301	41	234	27.2	77.7	0.90
chr22	16454253	16454567	CpG: 23	314	23	202	14.6	64.3	0.71
chr22	16741150	16741425	CpG: 25	275	25	171	18.2	62.2	0.95
chr22	16760029	16760312	CpG: 21	283	21	160	14.8	56.5	0.93
chr22	16950940	16952988	CpG: 222	2048	222	1354	21.7	66.1	1.01
chr22	17062509	17063274	CpG: 96	765	96	531	25.1	69.4	1.19
chr22	17196152	17197212	CpG: 113	1060	113	750	21.3	70.8	0.87
chr22	17277589	17279281	CpG: 231	1692	231	1266	27.3	74.8	0.98
chr22	17286143	17286912	CpG: 85	769	85	549	22.1	71.4	0.87
chr22	17354241	17354515	CpG: 24	274	24	170	17.5	62.0	0.92
chr22	17414663	17414886	CpG: 18	223	18	136	16.1	61.0	0.89
chr22	17424938	17425512	CpG: 42	574	42	371	14.6	64.6	0.70
chr22	17461717	17461928	CpG: 17	211	17	125	16.1	59.2	0.94
chr22	17526268	17526476	CpG: 18	208	18	126	17.3	60.6	0.96
chr22	17559138	17559374	CpG: 20	236	20	145	16.9	61.4	0.92
chr22	17596363	17596648	CpG: 21	285	21	176	14.7	61.8	0.78
chr22	17684062	17684983	CpG: 67	921	67	629	14.5	68.3	0.63
chr22	17712714	17714301	CpG: 110	1587	110	1071	13.9	67.5	0.61
chr22	17760496	17760889	CpG: 29	393	29	241	14.8	61.3	0.86
chr22	17761411	17762884	CpG: 156	1473	156	1066	21.2	72.4	0.82
chr22	17773397	17773633	CpG: 19	236	19	144	16.1	61.0	0.89
chr22	17785430	17786277	CpG: 77	847	77	593	18.2	70.0	0.74
chr22	17796556	17798604	CpG: 243	2048	243	1540	23.7	75.2	0.85
chr22	17822908	17824421	CpG: 128	1513	128	949	16.9	62.7	1.01
chr22	17835171	17836409	CpG: 144	1238	144	874	23.3	70.6	0.94
chr22	17847861	17848676	CpG: 87	815	87	598	21.3	73.4	0.80
chr22	18015881	18016156	CpG: 27	275	27	171	19.6	62.2	1.04
chr22	18023103	18023384	CpG: 20	281	20	171	14.2	60.9	0.78
chr22	18036291	18038508	CpG: 249	2217	249	1618	22.5	73.0	0.84
chr22	18072114	18072384	CpG: 22	270	22	165	16.3	61.1	0.88
chr22	18086526	18086959	CpG: 33	433	33	303	15.2	70.0	0.62
chr22	18089055	18089329	CpG: 21	274	21	167	15.3	60.9	0.84
chr22	18132738	18132984	CpG: 18	246	18	150	14.6	61.0	0.80
chr22	18172240	18172485	CpG: 22	245	22	149	18.0	60.8	1.00
chr22	18197169	18197439	CpG: 20	270	20	158	14.8	58.5	0.87
chr22	18213953	18214217	CpG: 20	264	20	157	15.2	59.5	0.86
chr22	18226468	18226698	CpG: 20	230	20	138	17.4	60.0	0.98
chr22	18228521	18229219	CpG: 55	698	55	484	15.8	69.3	0.66
chr22	18236814	18237046	CpG: 18	232	18	140	15.5	60.3	0.88
chr22	18248918	18249155	CpG: 17	237	17	164	14.3	69.2	0.61
chr22	18249837	18250107	CpG: 26	270	26	169	19.3	62.6	0.99
chr22	18259282	18259523	CpG: 19	241	19	145	15.8	60.2	0.88
chr22	18284513	18284787	CpG: 22	274	22	169	16.1	61.7	0.86
chr22	18295758	18296650	CpG: 60	892	60	538	13.5	60.3	0.74
chr22	18306272	18307001	CpG: 69	729	69	478	18.9	65.6	0.88
chr22	18415516	18416181	CpG: 43	665	43	383	12.9	57.6	0.79
chr22	18416357	18416558	CpG: 22	201	22	145	21.9	72.1	0.85
chr22	18417579	18417784	CpG: 16	205	16	142	15.6	69.3	0.67
chr22	18418811	18419092	CpG: 24	281	24	174	17.1	61.9	0.91
chr22	18425104	18425375	CpG: 20	271	20	161	14.8	59.4	0.84
chr22	18441534	18442286	CpG: 95	752	95	591	25.3	78.6	0.82
chr22	18460589	18460832	CpG: 21	243	21	164	17.3	67.5	0.76
chr22	18468850	18469125	CpG: 25	275	25	172	18.2	62.5	0.94
chr22	18509458	18509698	CpG: 20	240	20	166	16.7	69.2	0.70
chr22	18524307	18524592	CpG: 23	285	23	176	16.1	61.8	0.86
chr22	18671850	18673167	CpG: 146	1317	146	948	22.2	72.0	0.86
chr22	18695070	18696063	CpG: 91	993	91	669	18.3	67.4	0.81
chr22	18712913	18713683	CpG: 57	770	57	541	14.8	70.3	0.60
chr22	18719872	18720161	CpG: 27	289	27	176	18.7	60.9	1.04
chr22	18724801	18725155	CpG: 40	354	40	270	22.6	76.3	0.78
chr22	18749215	18750067	CpG: 80	852	80	561	18.8	65.8	0.87
chr22	18782257	18783341	CpG: 100	1084	100	758	18.5	69.9	0.77
chr22	18794742	18795015	CpG: 20	273	20	168	14.7	61.5	0.78
chr22	18808285	18808508	CpG: 20	223	20	136	17.9	61.0	0.99
chr22	18814921	18815132	CpG: 15	211	15	125	14.2	59.2	0.83
chr22	18821546	18822141	CpG: 51	595	51	367	17.1	61.7	0.90
chr22	18827447	18827794	CpG: 34	347	34	255	19.6	73.5	0.73
chr22	18857526	18858591	CpG: 111	1065	111	600	20.8	56.3	1.32
chr22	18892148	18892595	CpG: 41	447	41	352	18.3	78.7	0.61
chr22	18925999	18927070	CpG: 139	1071	139	724	26.0	67.6	1.14
chr22	18953136	18954396	CpG: 86	1260	86	733	13.7	58.2	0.81
chr22	18955402	18955636	CpG: 20	234	20	142	17.1	60.7	0.94
chr22	18967420	18967747	CpG: 41	327	41	236	25.1	72.2	0.99
chr22	19050984	19051947	CpG: 98	963	98	528	20.4	54.8	1.36
chr22	19087570	19088017	CpG: 43	447	43	353	19.2	79.0	0.63
chr22	19122768	19123758	CpG: 101	990	101	546	20.4	55.2	1.35
chr22	19206999	19207326	CpG: 41	327	41	236	25.1	72.2	0.99
chr22	19220350	19221580	CpG: 80	1230	80	708	13.0	57.6	0.79
chr22	19247694	19248744	CpG: 116	1050	116	608	22.1	57.9	1.33
chr22	19275628	19276197	CpG: 44	569	44	407	15.5	71.5	0.61
chr22	19281096	19282136	CpG: 114	1040	114	729	21.9	70.1	0.90
chr22	19311346	19311767	CpG: 63	421	63	333	29.9	79.1	0.96
chr22	19345472	19346602	CpG: 129	1130	129	862	22.8	76.3	0.79
chr22	19364981	19365198	CpG: 18	217	18	128	16.6	59.0	0.98
chr22	19373381	19373582	CpG: 18	201	18	112	17.9	55.7	1.16
chr22	19404667	19405771	CpG: 150	1104	150	851	27.2	77.1	0.92
chr22	19459219	19460201	CpG: 78	982	78	689	15.9	70.2	0.65
chr22	19496161	19497435	CpG: 138	1274	138	924	21.7	72.5	0.83
chr22	19509554	19509774	CpG: 15	220	15	151	13.6	68.6	0.60
chr22	19519020	19519325	CpG: 34	305	34	203	22.3	66.6	1.01
chr22	19523320	19525539	CpG: 253	2219	253	1627	22.8	73.3	0.85
chr22	19545396	19545832	CpG: 45	436	45	277	20.6	63.5	1.02
chr22	19547123	19548181	CpG: 95	1058	95	740	18.0	69.9	0.74
chr22	19553498	19555253	CpG: 209	1755	209	1329	23.8	75.7	0.83
chr22	19578335	19579221	CpG: 64	886	64	624	14.4	70.4	1.18
chr22	19628188	19628412	CpG: 16	224	16	133	14.3	59.4	0.82
chr22	19653439	19653680	CpG: 17	241	17	143	14.1	59.3	0.82
chr22	19667855	19668758	CpG: 102	903	102	677	22.6	75.0	0.81
chr22	19669050	19669265	CpG: 17	215	17	122	15.8	56.7	1.00
chr22	19755896	19756146	CpG: 20	250	20	152	16.0	60.8	0.88
chr22	19808053	19809545	CpG: 197	1492	197	1101	26.4	73.8	0.97
chr22	19809790	19810048	CpG: 20	258	20	156	15.5	60.5	0.86
chr22	19824102	19824861	CpG: 97	759	97	536	25.6	70.6	1.03
chr22	19855618	19857121	CpG: 118	1503	118	915	15.7	60.9	0.85
chr22	19900189	19901572	CpG: 151	1383	151	974	21.8	70.4	0.88
chr22	19943329	19943728	CpG: 38	399	38	267	19.0	66.9	0.85
chr22	20004557	20004829	CpG: 23	272	23	163	16.9	59.9	0.95
chr22	20033367	20033571	CpG: 16	204	16	146	15.7	71.6	0.61
chr22	20072411	20072749	CpG: 26	338	26	208	15.4	61.5	0.82
chr22	20090782	20091737	CpG: 133	955	133	747	27.9	78.2	0.91
chr22	20094576	20104643	CpG: 831	10067	831	6835	16.5	67.9	0.73
chr22	20107559	20108083	CpG: 45	524	45	369	17.2	70.4	0.71
chr22	20113623	20113856	CpG: 19	233	19	162	16.3	69.5	0.72
chr22	20132012	20144343	CpG: 868	12331	868	8138	14.1	66.0	0.65
chr22	20165543	20165801	CpG: 25	258	25	175	19.4	67.8	0.85
chr22	20231229	20232356	CpG: 122	1127	122	792	21.7	70.3	0.88
chr22	20283733	20285057	CpG: 86	1324	86	851	13.0	64.3	0.68
chr22	20319264	20319636	CpG: 55	372	55	290	29.6	78.0	0.99
chr22	20350628	20351432	CpG: 67	804	67	549	16.7	68.3	0.72
chr22	20357383	20357912	CpG: 49	529	49	372	18.5	70.3	0.75
chr22	20364378	20364992	CpG: 68	614	68	476	22.1	77.5	0.74
chr22	20393616	20394898	CpG: 171	1282	171	959	26.7	74.8	0.96
chr22	20398442	20399195	CpG: 82	753	82	546	21.8	72.5	0.84
chr22	20454156	20454435	CpG: 21	279	21	169	15.1	60.6	0.83
chr22	20458692	20459685	CpG: 137	993	137	733	27.6	73.8	1.01
chr22	20464851	20465419	CpG: 38	568	38	334	13.4	58.8	0.77
chr22	20480307	20480571	CpG: 18	264	18	159	13.6	60.2	0.76
chr22	20483188	20483482	CpG: 24	294	24	181	16.3	61.6	0.87
chr22	20495175	20495450	CpG: 21	275	21	181	15.3	65.8	0.71
chr22	20495901	20497256	CpG: 164	1355	164	976	24.2	72.0	0.94
chr22	20510020	20511283	CpG: 166	1263	166	990	26.3	78.4	0.86
chr22	20521906	20522808	CpG: 71	902	71	634	15.7	70.3	0.66
chr22	20525972	20526215	CpG: 21	243	21	182	17.3	74.9	0.62
chr22	20534328	20534563	CpG: 21	235	21	167	17.9	71.1	0.73
chr22	20618858	20619173	CpG: 26	315	26	225	16.5	71.4	0.66
chr22	20621230	20622544	CpG: 90	1314	90	878	13.7	66.8	0.62
chr22	20648485	20649866	CpG: 187	1381	187	1077	27.1	78.0	0.89
chr22	20680120	20681432	CpG: 144	1312	144	970	22.0	73.9	0.85
chr22	20700909	20701826	CpG: 108	917	108	653	23.6	71.2	0.93
chr22	20709664	20709894	CpG: 18	230	18	139	15.7	60.4	0.86
chr22	20757842	20766596	CpG: 1346	8754	1346	5935	30.8	67.8	1.34
chr22	20796681	20798843	CpG: 160	2162	160	1401	14.8	64.8	0.71
chr22	20809754	20810934	CpG: 105	1180	105	787	17.8	66.7	0.80
chr22	20822631	20823050	CpG: 37	419	37	284	17.7	67.8	0.77
chr22	20829382	20830559	CpG: 153	1177	153	883	26.0	75.0	0.93
chr22	20833451	20836186	CpG: 252	2735	252	1884	18.4	68.9	0.78
chr22	20840623	20842650	CpG: 209	2027	209	1472	20.6	72.6	0.80
chr22	20872000	20872234	CpG: 18	234	18	140	15.4	59.8	0.88
chr22	20880768	20881108	CpG: 24	340	24	198	14.1	58.2	0.85
chr22	20885190	20885433	CpG: 20	243	20	146	16.5	60.1	0.95
chr22	20899395	20900440	CpG: 137	1045	137	795	26.2	76.1	0.91
chr22	20916001	20916574	CpG: 54	573	54	389	18.8	67.9	0.82
chr22	20993459	20993710	CpG: 18	251	18	168	14.3	66.9	0.69
chr22	21076437	21077171	CpG: 77	734	77	518	21.0	70.6	0.84
chr22	21079166	21080050	CpG: 86	884	86	640	19.5	72.4	0.74
chr22	21097168	21098368	CpG: 82	1200	82	690	13.7	57.5	0.83
chr22	21110679	21113214	CpG: 222	2535	222	1777	17.5	70.1	0.72
chr22	21251549	21251811	CpG: 18	262	18	156	13.7	59.5	0.78
chr22	21267143	21268127	CpG: 117	984	117	718	23.8	73.0	0.90
chr22	21324489	21324725	CpG: 21	236	21	145	17.8	61.4	0.96
chr22	21325796	21327049	CpG: 138	1253	138	867	22.0	69.2	0.92
chr22	21365870	21366735	CpG: 82	865	82	619	19.0	71.6	0.75
chr22	21373709	21374444	CpG: 87	735	87	577	23.7	78.5	0.77
chr22	21388062	21388460	CpG: 33	398	33	272	16.6	68.3	0.73
chr22	21390702	21391460	CpG: 91	758	91	537	24.0	70.8	0.97
chr22	21408749	21409006	CpG: 19	257	19	174	14.8	67.7	0.65
chr22	21410280	21411607	CpG: 134	1327	134	847	20.2	63.8	0.99
chr22	21422682	21423256	CpG: 53	574	53	391	18.5	68.1	0.80
chr22	21440963	21441470	CpG: 50	507	50	371	19.7	73.2	0.77
chr22	21454477	21454768	CpG: 31	291	31	197	21.3	67.7	0.93
chr22	21537708	21537941	CpG: 26	233	26	147	22.3	63.1	1.12
chr22	21538527	21538984	CpG: 35	457	35	275	15.3	60.2	0.85
chr22	21539988	21540225	CpG: 19	237	19	143	16.0	60.3	0.89
chr22	21552035	21552362	CpG: 41	327	41	236	25.1	72.2	0.99
chr22	21561059	21561506	CpG: 43	447	43	353	19.2	79.0	0.63
chr22	21593050	21594418	CpG: 190	1368	190	941	27.8	68.8	1.19
chr22	21677515	21677842	CpG: 41	327	41	236	25.1	72.2	0.99
chr22	21689624	21689858	CpG: 19	234	19	142	16.2	60.7	0.89
chr22	21690853	21692132	CpG: 88	1279	88	746	13.8	58.3	0.81
chr22	21718197	21719133	CpG: 116	936	116	617	24.8	65.9	1.15
chr22	21753551	21753998	CpG: 42	447	42	351	18.8	78.5	0.63
chr22	21773076	21774254	CpG: 154	1178	154	899	26.1	76.3	0.90
chr22	21797232	21799438	CpG: 232	2206	232	1557	21.0	70.6	0.85
chr22	21829149	21829422	CpG: 22	273	22	171	16.1	62.6	0.83
chr22	21830097	21831643	CpG: 183	1546	183	1177	23.7	76.1	0.83
chr22	21841906	21842144	CpG: 19	238	19	141	16.0	59.2	0.93
chr22	21862571	21862896	CpG: 22	325	22	183	13.5	56.3	0.88
chr22	21878530	21881068	CpG: 225	2538	225	1777	17.7	70.0	0.73
chr22	21883549	21883782	CpG: 18	233	18	140	15.5	60.1	0.87
chr22	21901578	21902218	CpG: 49	640	49	412	15.3	64.4	0.74
chr22	21919716	21919954	CpG: 19	238	19	142	16.0	59.7	0.92
chr22	21930213	21931759	CpG: 183	1546	183	1177	23.7	76.1	0.83
chr22	21932434	21932707	CpG: 22	273	22	171	16.1	62.6	0.83
chr22	21962419	21964622	CpG: 232	2203	232	1555	21.1	70.6	0.85
chr22	21980783	21981902	CpG: 107	1119	107	747	19.1	66.8	0.86
chr22	22025864	22026104	CpG: 19	240	19	144	15.8	60.0	0.92
chr22	22041981	22043679	CpG: 173	1698	173	1202	20.4	70.8	0.81
chr22	22052443	22052738	CpG: 26	295	26	182	17.6	61.7	0.94
chr22	22055452	22056543	CpG: 115	1091	115	762	21.1	69.8	0.89
chr22	22065281	22066250	CpG: 83	969	83	636	17.1	65.6	0.80
chr22	22070754	22071705	CpG: 103	951	103	678	21.7	71.3	0.86
chr22	22079312	22080353	CpG: 92	1041	92	638	17.7	61.3	0.95
chr22	22090410	22091050	CpG: 51	640	51	448	15.9	70.0	0.65
chr22	22148816	22150101	CpG: 166	1285	166	952	25.8	74.1	0.95
chr22	22187919	22188191	CpG: 18	272	18	162	13.2	59.6	0.76
chr22	22260531	22261493	CpG: 76	962	76	659	15.8	68.5	0.67
chr22	22279625	22279903	CpG: 22	278	22	163	15.8	58.6	0.92
chr22	22280281	22281593	CpG: 166	1312	166	917	25.3	69.9	1.04
chr22	22291751	22292038	CpG: 24	287	24	177	16.7	61.7	0.89
chr22	22351688	22352035	CpG: 31	347	31	247	17.9	71.2	0.72
chr22	22365713	22366561	CpG: 72	848	72	611	17.0	72.1	0.67
chr22	22370723	22370978	CpG: 21	255	21	169	16.5	66.3	0.75
chr22	22396084	22396469	CpG: 48	385	48	271	24.9	70.4	1.02
chr22	22418152	22418427	CpG: 23	275	23	168	16.7	61.1	0.91
chr22	22528257	22529079	CpG: 80	822	80	579	19.5	70.4	0.78
chr22	22531021	22531921	CpG: 93	900	93	663	20.7	73.7	0.76
chr22	22617790	22618028	CpG: 19	238	19	148	16.0	62.2	0.84
chr22	22636818	22637073	CpG: 21	255	21	169	16.5	66.3	0.75
chr22	22695969	22696186	CpG: 18	217	18	128	16.6	59.0	0.95
chr22	22711290	22711909	CpG: 97	619	97	467	31.3	75.4	1.13
chr22	22931150	22931747	CpG: 69	597	69	428	23.1	71.7	0.90
chr22	22940822	22941045	CpG: 22	223	22	141	19.7	63.2	1.00
chr22	22981839	22982151	CpG: 25	312	25	205	16.0	65.7	0.76
chr22	23019569	23019809	CpG: 19	240	19	145	15.8	60.4	0.89
chr22	23038644	23038866	CpG: 19	222	19	136	17.1	61.3	0.92
chr22	23067154	23067440	CpG: 29	286	29	179	20.3	62.6	1.06
chr22	23251250	23251531	CpG: 24	281	24	175	17.1	62.3	0.90
chr22	23439855	23440396	CpG: 50	541	50	409	18.5	75.6	0.65
chr22	23492909	23494282	CpG: 166	1373	166	1022	24.2	74.4	0.89
chr22	23518606	23519116	CpG: 43	510	43	326	16.9	63.9	0.84
chr22	23564674	23564986	CpG: 28	312	28	212	17.9	67.9	0.78
chr22	23568034	23568636	CpG: 57	602	57	414	18.9	68.8	0.82
chr22	23603221	23605140	CpG: 241	1919	241	1409	25.1	73.4	0.93
chr22	23685492	23686242	CpG: 62	750	62	525	16.5	70.0	0.74
chr22	23744679	23744950	CpG: 20	271	20	154	14.8	56.8	0.92
chr22	23748825	23749053	CpG: 19	228	19	136	16.7	59.6	0.95
chr22	23811032	23811285	CpG: 22	253	22	174	17.4	68.8	0.76
chr22	23825094	23825663	CpG: 74	569	74	439	26.0	77.2	0.89
chr22	23881622	23882203	CpG: 56	581	56	374	19.3	64.4	0.93
chr22	23883065	23883498	CpG: 30	433	30	295	13.9	68.1	0.61
chr22	23943419	23944156	CpG: 70	737	70	456	19.0	61.9	1.01
chr22	23954542	23954772	CpG: 18	230	18	139	15.7	60.4	0.88
chr22	23968533	23969798	CpG: 111	1265	111	832	17.5	65.8	0.81
chr22	23977430	23977711	CpG: 23	281	23	175	16.4	62.3	0.85
chr22	24013352	24014208	CpG: 89	856	89	622	20.8	72.7	0.81
chr22	24164029	24164656	CpG: 73	627	73	442	23.3	70.5	0.94
chr22	24198032	24198627	CpG: 76	595	76	451	25.5	75.8	0.89
chr22	24210580	24211022	CpG: 32	442	32	288	14.5	65.2	0.70
chr22	24214593	24216001	CpG: 115	1408	115	986	16.3	70.0	0.67
chr22	24219880	24220472	CpG: 72	592	72	451	24.3	76.2	0.84
chr22	24234112	24234789	CpG: 93	677	93	486	27.5	71.8	1.07
chr22	24244222	24244495	CpG: 20	273	20	171	14.7	62.6	0.75
chr22	24255352	24255758	CpG: 28	406	28	238	13.8	58.6	0.81
chr22	24285488	24286663	CpG: 108	1175	108	778	18.4	66.2	0.85
chr22	24296555	24297205	CpG: 54	650	54	450	16.6	69.2	0.70
chr22	24300612	24300884	CpG: 22	272	22	166	16.2	61.0	0.88
chr22	24301484	24302636	CpG: 98	1152	98	751	17.0	65.2	0.80
chr22	24338669	24339951	CpG: 136	1282	136	894	21.2	69.7	0.88
chr22	24358421	24358809	CpG: 35	388	35	266	18.0	68.6	0.77
chr22	24381222	24382160	CpG: 88	938	88	628	18.8	67.0	0.84
chr22	24382516	24382752	CpG: 17	236	17	140	14.4	59.3	0.84
chr22	24387078	24387804	CpG: 55	726	55	491	15.2	67.6	0.68
chr22	24388545	24388938	CpG: 31	393	31	245	15.8	62.3	0.84
chr22	24399147	24399416	CpG: 22	269	22	168	16.4	62.5	0.85
chr22	24438078	24438891	CpG: 73	813	73	527	18.0	64.8	0.86
chr22	24439165	24439424	CpG: 22	259	22	155	17.0	59.8	0.96
chr22	24449291	24449562	CpG: 23	271	23	175	17.0	64.6	0.81
chr22	24472741	24473328	CpG: 66	587	66	408	22.5	69.5	0.94
chr22	24526700	24527508	CpG: 65	808	65	548	16.1	67.8	0.70
chr22	24556148	24556429	CpG: 23	281	23	174	16.4	61.9	0.87
chr22	24617459	24618342	CpG: 106	883	106	653	24.0	74.0	0.88
chr22	24647278	24647773	CpG: 39	495	39	331	15.8	66.9	0.72
chr22	24649824	24650030	CpG: 18	206	18	136	17.5	66.0	0.80
chr22	24712211	24712421	CpG: 15	210	15	125	14.3	59.5	0.82
chr22	24713010	24713243	CpG: 24	233	24	145	20.6	62.2	1.07
chr22	24732222	24733117	CpG: 101	895	101	654	22.6	73.1	0.85
chr22	24884773	24886455	CpG: 187	1682	187	1213	22.2	72.1	0.89
chr22	24956061	24957102	CpG: 98	1041	98	720	18.8	69.2	0.79
chr22	25016437	25017713	CpG: 108	1276	108	852	16.9	66.8	0.76
chr22	25054227	25054913	CpG: 90	686	90	529	26.2	77.1	0.91
chr22	25098859	25099121	CpG: 26	262	26	164	19.8	62.6	1.03
chr22	25120586	25121787	CpG: 83	1201	83	692	13.8	57.6	0.84
chr22	25147317	25147579	CpG: 33	262	33	199	25.2	76.0	0.88
chr22	25225351	25225698	CpG: 33	347	33	230	19.0	66.3	0.89
chr22	25244873	25245140	CpG: 19	267	19	163	14.2	61.0	0.77
chr22	25267375	25267975	CpG: 75	600	75	453	25.0	75.5	0.88
chr22	25376502	25376781	CpG: 23	279	23	168	16.5	60.2	0.93
chr22	25401546	25402148	CpG: 43	602	43	354	14.3	58.8	0.83
chr22	25403675	25403878	CpG: 14	203	14	121	13.8	59.6	0.79
chr22	25413770	25415363	CpG: 147	1593	147	1121	18.5	70.4	0.75
chr22	25489305	25489562	CpG: 20	257	20	173	15.6	67.3	0.69
chr22	25572625	25572853	CpG: 20	228	20	164	17.5	71.9	0.68
chr22	25640170	25640836	CpG: 62	666	62	450	18.6	67.6	0.82
chr22	25666706	25666949	CpG: 17	243	17	146	14.0	60.1	0.79
chr22	25721850	25722128	CpG: 21	278	21	170	15.1	61.2	0.82
chr22	25733110	25733383	CpG: 19	273	19	161	13.9	59.0	0.81
chr22	25743778	25744475	CpG: 89	697	89	516	25.5	74.0	0.94
chr22	25821135	25821358	CpG: 17	223	17	134	15.2	60.1	0.84
chr22	25865775	25866783	CpG: 143	1008	143	798	28.4	79.2	0.91
chr22	25882103	25882730	CpG: 77	627	77	467	24.6	74.5	0.89
chr22	25978896	25979174	CpG: 20	278	20	170	14.4	61.2	0.78
chr22	26025670	26026552	CpG: 121	882	121	684	27.4	77.6	0.94
chr22	26213397	26213671	CpG: 22	274	22	167	16.1	60.9	0.87
chr22	26213909	26214434	CpG: 51	525	51	383	19.4	73.0	0.73
chr22	26214703	26214922	CpG: 16	219	16	122	14.6	55.7	0.94
chr22	26631508	26632295	CpG: 97	787	97	596	24.7	75.7	0.87
chr22	26670208	26670488	CpG: 23	280	23	167	16.4	59.6	0.93
chr22	26831787	26832019	CpG: 19	232	19	141	16.4	60.8	0.91
chr22	26891434	26892160	CpG: 116	726	116	578	32.0	79.6	1.01
chr22	26896197	26896607	CpG: 30	410	30	266	14.6	64.9	0.72
chr22	26945902	26946473	CpG: 71	571	71	414	24.9	72.5	0.95
chr22	26961623	26961898	CpG: 19	275	19	171	13.8	62.2	0.72
chr22	26974652	26974980	CpG: 32	328	32	214	19.5	65.2	0.93
chr22	27003398	27004074	CpG: 57	676	57	462	16.9	68.3	0.72
chr22	27031283	27031513	CpG: 16	230	16	136	13.9	59.1	0.82
chr22	27051884	27052632	CpG: 100	748	100	582	26.7	77.8	0.90
chr22	27064035	27064309	CpG: 24	274	24	171	17.5	62.4	0.91
chr22	27074159	27074444	CpG: 23	285	23	177	16.1	62.1	0.85
chr22	27119705	27120253	CpG: 54	548	54	386	19.7	70.4	0.81
chr22	27158849	27159115	CpG: 19	266	19	160	14.3	60.2	0.80
chr22	27166438	27166675	CpG: 20	237	20	144	16.9	60.8	0.93
chr22	27219367	27219820	CpG: 46	453	46	315	20.3	69.5	0.85
chr22	27807319	27807556	CpG: 18	237	18	140	15.2	59.1	0.91
chr22	27899360	27899565	CpG: 16	205	16	124	15.6	60.5	0.89
chr22	28075005	28075407	CpG: 50	402	50	294	24.9	73.1	0.93
chr22	28083364	28083604	CpG: 20	240	20	146	16.7	60.8	0.93
chr22	28099803	28100126	CpG: 22	323	22	190	13.6	58.8	0.79
chr22	28138760	28139084	CpG: 23	324	23	179	14.2	55.2	0.95
chr22	28258120	28263919	CpG: 523	5799	523	4007	18.0	69.1	0.76
chr22	28380016	28381386	CpG: 121	1370	121	914	17.7	66.7	0.80
chr22	28765428	28765694	CpG: 18	266	18	161	13.5	60.5	0.75
chr22	28847427	28847700	CpG: 24	273	24	171	17.6	62.6	0.90
chr22	28888805	28889080	CpG: 20	275	20	160	14.5	58.2	0.86
chr22	28997781	28998059	CpG: 25	278	25	174	18.0	62.6	0.93
chr22	29014368	29015226	CpG: 65	858	65	595	15.2	69.3	0.63
chr22	29117030	29117241	CpG: 18	211	18	136	17.1	64.5	0.83
chr22	29124879	29125103	CpG: 20	224	20	135	17.9	60.3	0.98
chr22	29140548	29141667	CpG: 146	1119	146	807	26.1	72.1	1.03
chr22	29184813	29185049	CpG: 18	236	18	142	15.3	60.2	0.88
chr22	29203544	29204207	CpG: 51	663	51	420	15.4	63.3	0.80
chr22	29234259	29234962	CpG: 90	703	90	516	25.6	73.4	0.95
chr22	29261394	29262369	CpG: 99	975	99	663	20.3	68.0	0.88
chr22	29266357	29266568	CpG: 19	211	19	127	18.0	60.2	1.01
chr22	29339627	29339853	CpG: 17	226	17	133	15.0	58.8	0.89
chr22	29344445	29345659	CpG: 181	1214	181	941	29.8	77.5	1.01
chr22	29491798	29492131	CpG: 27	333	27	227	16.2	68.2	0.79
chr22	29532531	29533057	CpG: 54	526	54	380	20.5	72.2	0.82
chr22	29533879	29535473	CpG: 160	1594	160	1178	20.1	73.9	0.75
chr22	29555910	29556185	CpG: 24	275	24	173	17.5	62.9	0.89
chr22	29572600	29572838	CpG: 17	238	17	142	14.3	59.7	0.83
chr22	29618052	29618265	CpG: 20	213	20	144	18.8	67.6	0.86
chr22	29669002	29669812	CpG: 95	810	95	616	23.5	76.0	0.82
chr22	29731120	29732405	CpG: 133	1285	133	879	20.7	68.4	0.88
chr22	29769666	29772144	CpG: 191	2478	191	1660	15.4	67.0	0.69
chr22	29773921	29774131	CpG: 15	210	15	147	14.3	70.0	0.60
chr22	29774900	29775219	CpG: 30	319	30	240	18.8	75.2	0.67
chr22	29776703	29779484	CpG: 263	2781	263	1880	18.9	67.6	0.84
chr22	29851587	29852197	CpG: 61	610	61	427	20.0	70.0	0.82
chr22	29860323	29860600	CpG: 20	277	20	167	14.4	60.3	0.80
chr22	29869220	29869505	CpG: 23	285	23	177	16.1	62.1	0.85
chr22	29888308	29888578	CpG: 20	270	20	166	14.8	61.5	0.79
chr22	29933694	29934200	CpG: 46	506	46	337	18.2	66.6	0.82
chr22	29943279	29944602	CpG: 181	1323	181	976	27.4	73.8	1.00
chr22	30015269	30016043	CpG: 59	774	59	545	15.2	70.4	0.62
chr22	30016849	30017195	CpG: 30	346	30	238	17.3	68.8	0.73
chr22	30044294	30044829	CpG: 49	535	49	349	18.3	65.2	0.87
chr22	30053014	30053295	CpG: 23	281	23	173	16.4	61.6	0.88
chr22	30061382	30061921	CpG: 53	539	53	391	19.7	72.5	0.75
chr22	30063406	30063647	CpG: 18	241	18	148	14.9	61.4	0.81
chr22	30066038	30067526	CpG: 125	1488	125	927	16.8	62.3	0.87
chr22	30107227	30108158	CpG: 76	931	76	658	16.3	70.7	0.65
chr22	30183219	30184534	CpG: 186	1315	186	1038	28.3	78.9	0.92
chr22	30192726	30193039	CpG: 25	313	25	209	16.0	66.8	0.75
chr22	30230226	30230922	CpG: 54	696	54	391	15.5	56.2	0.99
chr22	30301304	30301780	CpG: 46	476	46	331	19.3	69.5	0.80
chr22	30321194	30322212	CpG: 81	1018	81	727	15.9	71.4	0.62
chr22	30346363	30347243	CpG: 95	880	95	655	21.6	74.4	0.79
chr22	30543053	30543893	CpG: 71	840	71	554	16.9	66.0	0.78
chr22	30664761	30665038	CpG: 21	277	21	173	15.2	62.5	0.78
chr22	30707058	30707323	CpG: 19	265	19	169	14.3	63.8	0.73
chr22	30709526	30710000	CpG: 53	474	53	332	22.4	70.0	0.93
chr22	30752545	30753254	CpG: 82	709	82	517	23.1	72.9	0.88
chr22	30789926	30790572	CpG: 86	646	86	486	26.6	75.2	0.96
chr22	30819817	30820565	CpG: 91	748	91	521	24.3	69.7	1.00
chr22	30850353	30850963	CpG: 86	610	86	484	28.2	79.3	0.91
chr22	30851333	30851569	CpG: 22	236	22	147	18.6	62.3	0.97
chr22	30860228	30860653	CpG: 43	425	43	310	20.2	72.9	0.76
chr22	30886751	30887650	CpG: 66	899	66	574	14.7	63.8	0.72
chr22	30888980	30889381	CpG: 46	401	46	279	22.9	69.6	0.97
chr22	30968660	30969162	CpG: 38	502	38	354	15.1	70.5	0.61
chr22	30969403	30969638	CpG: 19	235	19	142	16.2	60.4	0.92
chr22	30976258	30976532	CpG: 23	274	23	170	16.8	62.0	0.88
chr22	31005434	31006063	CpG: 60	629	60	447	19.1	71.1	0.77
chr22	31018282	31019495	CpG: 113	1213	113	801	18.6	66.0	0.87
chr22	31037859	31038304	CpG: 66	445	66	362	29.7	81.3	0.95
chr22	31055022	31055801	CpG: 54	779	54	439	13.9	56.4	0.88
chr22	31060118	31060469	CpG: 32	351	32	258	18.2	73.5	0.68
chr22	31095164	31095968	CpG: 62	804	62	550	15.4	68.4	0.66
chr22	31098953	31099654	CpG: 68	701	68	517	19.4	73.8	0.73
chr22	31131014	31131936	CpG: 82	922	82	605	17.8	65.6	0.85
chr22	31157812	31158945	CpG: 130	1133	130	828	22.9	73.1	0.86
chr22	31266117	31266807	CpG: 75	690	75	499	21.7	72.3	0.83
chr22	31285847	31286514	CpG: 84	667	84	471	25.2	70.6	1.01
chr22	31369281	31369714	CpG: 43	433	43	314	19.9	72.5	0.78
chr22	31376728	31376967	CpG: 17	239	17	140	14.2	58.6	0.86
chr22	31385807	31386068	CpG: 28	261	28	158	21.5	60.5	1.17
chr22	31432136	31433280	CpG: 138	1144	138	808	24.1	70.6	0.97
chr22	31544408	31545024	CpG: 57	616	57	423	18.5	68.7	0.80
chr22	31548293	31548892	CpG: 70	599	70	434	23.4	72.5	0.89
chr22	31562176	31562693	CpG: 41	517	41	350	15.9	67.7	0.71
chr22	31567909	31568752	CpG: 64	843	64	549	15.2	65.1	0.72
chr22	31570749	31571396	CpG: 67	647	67	465	20.7	71.9	0.80
chr22	31609751	31610021	CpG: 21	270	21	165	15.6	61.1	0.85
chr22	31623442	31623968	CpG: 42	526	42	325	16.0	61.8	0.85
chr22	31675582	31676103	CpG: 53	521	53	369	20.3	70.8	0.82
chr22	31740415	31740812	CpG: 58	397	58	323	29.2	81.4	0.89
chr22	31754630	31755365	CpG: 87	735	87	519	23.7	70.6	0.95
chr22	31809019	31811715	CpG: 274	2696	274	1866	20.3	69.2	0.85
chr22	31819924	31820539	CpG: 46	615	46	360	15.0	58.5	0.87
chr22	31829257	31829527	CpG: 24	270	24	169	17.8	62.6	0.92
chr22	31863868	31864576	CpG: 69	708	69	470	19.5	66.4	0.88
chr22	31953781	31955016	CpG: 156	1235	156	923	25.3	74.7	0.91
chr22	31960678	31961739	CpG: 100	1061	100	694	18.9	65.4	0.88
chr22	32094316	32094893	CpG: 53	577	53	422	18.4	73.1	0.70
chr22	32125931	32126332	CpG: 38	401	38	256	19.0	63.8	0.95
chr22	32127708	32127945	CpG: 19	237	19	141	16.0	59.5	0.93
chr22	32140550	32140992	CpG: 34	442	34	272	15.4	61.5	0.82
chr22	32213697	32214262	CpG: 58	565	58	390	20.5	69.0	0.87
chr22	32217819	32218122	CpG: 43	303	43	231	28.4	76.2	1.04
chr22	32408068	32409320	CpG: 155	1252	155	925	24.8	73.9	0.91
chr22	32431933	32432161	CpG: 17	228	17	136	14.9	59.6	0.87
chr22	32434608	32435177	CpG: 43	569	43	389	15.1	68.4	0.65
chr22	32435670	32435930	CpG: 22	260	22	158	16.9	60.8	0.94
chr22	32507209	32507605	CpG: 29	396	29	258	14.6	65.2	0.69
chr22	32639952	32640619	CpG: 65	667	65	477	19.5	71.5	0.77
chr22	32640815	32641055	CpG: 19	240	19	142	15.8	59.2	0.94
chr22	32652020	32652265	CpG: 21	245	21	149	17.1	60.8	0.95
chr22	32666966	32668730	CpG: 113	1764	113	1161	12.8	65.8	0.64
chr22	32669134	32669600	CpG: 32	466	32	307	13.7	65.9	0.67
chr22	32700844	32701080	CpG: 20	236	20	139	16.9	58.9	1.01
chr22	32743090	32743364	CpG: 21	274	21	168	15.3	61.3	0.83
chr22	32817242	32817749	CpG: 38	507	38	341	15.0	67.3	0.68
chr22	32875754	32876214	CpG: 36	460	36	289	15.7	62.8	0.80
chr22	32907132	32907368	CpG: 19	236	19	141	16.1	59.7	0.92
chr22	32938457	32939271	CpG: 95	814	95	597	23.3	73.3	0.88
chr22	33106662	33106886	CpG: 18	224	18	134	16.1	59.8	0.93
chr22	33265825	33266712	CpG: 93	887	93	653	21.0	73.6	0.77
chr22	33479099	33479319	CpG: 22	220	22	130	20.0	59.1	1.17
chr22	33522344	33522957	CpG: 82	613	82	468	26.8	76.3	0.94
chr22	33561087	33561327	CpG: 21	240	21	150	17.5	62.5	0.92
chr22	33580898	33581137	CpG: 18	239	18	139	15.1	58.2	0.91
chr22	33597072	33597345	CpG: 26	273	26	171	19.0	62.6	0.98
chr22	33599196	33599406	CpG: 15	210	15	122	14.3	58.1	0.87
chr22	33770798	33771019	CpG: 17	221	17	133	15.4	60.2	0.89
chr22	33824418	33824725	CpG: 26	307	26	176	16.9	57.3	1.09
chr22	34107897	34108140	CpG: 20	243	20	167	16.5	68.7	0.70
chr22	34377179	34379989	CpG: 302	2810	302	2026	21.5	72.1	0.83
chr22	34491982	34492268	CpG: 23	286	23	173	16.1	60.5	0.89
chr22	34645514	34645756	CpG: 23	242	23	148	19.0	61.2	1.04
chr22	35013642	35014057	CpG: 29	415	29	244	14.0	58.8	0.82
chr22	35075766	35076041	CpG: 20	275	20	164	14.5	59.6	0.84
chr22	35143049	35143954	CpG: 68	905	68	623	15.0	68.8	0.63
chr22	35715285	35715952	CpG: 80	667	80	503	24.0	75.4	0.85
chr22	35757529	35757995	CpG: 48	466	48	329	20.6	70.6	0.83
chr22	35797553	35797833	CpG: 22	280	22	161	15.7	57.5	0.96
chr22	35829890	35830801	CpG: 64	911	64	556	14.1	61.0	0.76
chr22	35838987	35839246	CpG: 38	259	38	194	29.3	74.9	1.05
chr22	35857882	35858676	CpG: 73	794	73	524	18.4	66.0	0.85
chr22	35882096	35882303	CpG: 20	207	20	137	19.3	66.2	0.91
chr22	35998827	36000383	CpG: 161	1556	161	1155	20.7	74.2	0.75
chr22	36010550	36010843	CpG: 30	293	30	192	20.5	65.5	0.96
chr22	36188061	36188276	CpG: 17	215	17	130	15.8	60.5	0.88
chr22	36264760	36265033	CpG: 22	273	22	168	16.1	61.5	0.86
chr22	36473926	36474151	CpG: 18	225	18	136	16.0	60.4	0.91
chr22	36487916	36488999	CpG: 149	1083	149	836	27.5	77.2	0.92
chr22	36505433	36505718	CpG: 23	285	23	178	16.1	62.5	0.85
chr22	36525547	36526101	CpG: 47	554	47	353	17.0	63.7	0.84
chr22	36552953	36553187	CpG: 19	234	19	141	16.2	60.3	0.93
chr22	36583425	36583662	CpG: 18	237	18	139	15.2	58.6	0.90
chr22	36659996	36660268	CpG: 22	272	22	161	16.2	59.2	0.92
chr22	36750824	36751272	CpG: 38	448	38	327	17.0	73.0	0.64
chr22	36782612	36782922	CpG: 24	310	24	208	15.5	67.1	0.69
chr22	36784152	36784407	CpG: 18	255	18	174	14.1	68.2	0.61
chr22	36847095	36848622	CpG: 165	1527	165	1132	21.6	74.1	0.79
chr22	36850015	36850288	CpG: 24	273	24	170	17.6	62.3	0.91
chr22	36862166	36862440	CpG: 24	274	24	171	17.5	62.4	0.91
chr22	36870152	36870760	CpG: 48	608	48	375	15.8	61.7	0.84
chr22	36915019	36915592	CpG: 63	573	63	414	22.0	72.3	0.85
chr22	36941628	36942368	CpG: 65	740	65	470	17.6	63.5	0.87
chr22	36945480	36945744	CpG: 19	264	19	164	14.4	62.1	0.75
chr22	36958103	36958359	CpG: 18	256	18	164	14.1	64.1	0.71
chr22	36966151	36967425	CpG: 128	1274	128	891	20.1	69.9	0.82
chr22	36989057	36989762	CpG: 77	705	77	456	21.8	64.7	1.04
chr22	37024453	37025174	CpG: 57	721	57	462	15.8	64.1	0.80
chr22	37037529	37037807	CpG: 20	278	20	171	14.4	61.5	0.77
chr22	37163733	37164450	CpG: 71	717	71	487	19.8	67.9	0.86
chr22	37231659	37232562	CpG: 63	903	63	564	14.0	62.5	0.72
chr22	37272575	37273273	CpG: 70	698	70	485	20.1	69.5	0.83
chr22	37312289	37312523	CpG: 24	234	24	150	20.5	64.1	1.00
chr22	37348185	37348491	CpG: 29	306	29	188	19.0	61.4	1.01
chr22	37477876	37479669	CpG: 179	1793	179	1269	20.0	70.8	0.80
chr22	37483685	37484458	CpG: 95	773	95	554	24.6	71.7	0.97
chr22	37511179	37511796	CpG: 76	617	76	471	24.6	76.3	0.87
chr22	37528614	37528889	CpG: 34	275	34	198	24.7	72.0	0.96
chr22	37557203	37558062	CpG: 77	859	77	609	17.9	70.9	0.77
chr22	37642112	37642540	CpG: 33	428	33	256	15.4	59.8	0.86
chr22	37658545	37659790	CpG: 105	1245	105	838	16.9	67.3	0.75
chr22	37666880	37667632	CpG: 65	752	65	508	17.3	67.6	0.76
chr22	37683036	37683273	CpG: 18	237	18	141	15.2	59.5	0.90
chr22	37720052	37720286	CpG: 19	234	19	139	16.2	59.4	0.93
chr22	37785192	37785709	CpG: 53	517	53	365	20.5	70.6	0.83
chr22	37794951	37795974	CpG: 90	1023	90	697	17.6	68.1	0.76
chr22	37833644	37836061	CpG: 185	2417	185	1564	15.3	64.7	0.74
chr22	37880239	37880913	CpG: 83	674	83	504	24.6	74.8	0.89
chr22	37887452	37888560	CpG: 131	1108	131	835	23.6	75.4	0.85
chr22	37976664	37976943	CpG: 22	279	22	191	15.8	68.5	0.70
chr22	37979453	37980568	CpG: 146	1115	146	863	26.2	77.4	0.89
chr22	37990192	37990473	CpG: 22	281	22	173	15.7	61.6	0.84
chr22	38021388	38023212	CpG: 197	1824	197	1335	21.6	73.2	0.81
chr22	38027757	38028095	CpG: 23	338	23	231	13.6	68.3	0.61
chr22	38068363	38068566	CpG: 19	203	19	134	18.7	66.0	0.86
chr22	38069716	38070544	CpG: 91	828	91	590	22.0	71.3	0.87
chr22	38100627	38101205	CpG: 59	578	59	434	20.4	75.1	0.74
chr22	38119683	38120732	CpG: 150	1049	150	763	28.6	72.7	1.08
chr22	38136233	38136450	CpG: 16	217	16	152	14.7	70.0	0.60
chr22	38138281	38138656	CpG: 30	375	30	259	16.0	69.1	0.67
chr22	38147547	38148041	CpG: 48	494	48	329	19.4	66.6	0.88
chr22	38179100	38179490	CpG: 35	390	35	291	17.9	74.6	0.65
chr22	38207266	38208527	CpG: 155	1261	155	944	24.6	74.9	0.88
chr22	38231641	38231942	CpG: 23	301	23	183	15.3	60.8	0.83
chr22	38247876	38248693	CpG: 68	817	68	573	16.6	70.1	0.68
chr22	38253130	38253351	CpG: 18	221	18	131	16.3	59.3	0.97
chr22	38263927	38264420	CpG: 49	493	49	357	19.9	72.4	0.76
chr22	38266305	38267312	CpG: 103	1007	103	729	20.5	72.4	0.78
chr22	38269208	38269838	CpG: 64	630	64	435	20.3	69.0	0.85
chr22	38280173	38280801	CpG: 69	628	69	443	22.0	70.5	0.89
chr22	38286205	38287235	CpG: 149	1030	149	784	28.9	76.1	1.00
chr22	38305399	38306478	CpG: 121	1079	121	727	22.4	67.4	0.99
chr22	38310144	38310437	CpG: 22	293	22	151	15.0	51.5	1.17
chr22	38310651	38311279	CpG: 53	628	53	404	16.9	64.3	0.82
chr22	38351452	38351724	CpG: 20	272	20	165	14.7	60.7	0.81
chr22	38367465	38368492	CpG: 152	1027	152	817	29.6	79.6	0.94
chr22	38415102	38415569	CpG: 45	467	45	307	19.3	65.7	0.92
chr22	38444708	38445579	CpG: 95	871	95	628	21.8	72.1	0.84
chr22	38500407	38500812	CpG: 41	405	41	304	20.2	75.1	0.73
chr22	38518688	38519119	CpG: 37	431	37	276	17.2	64.0	0.84
chr22	38535884	38536105	CpG: 20	221	20	154	18.1	69.7	0.75
chr22	38542455	38544501	CpG: 190	2046	190	1451	18.6	70.9	0.74
chr22	38550195	38551301	CpG: 116	1106	116	852	21.0	77.0	0.72
chr22	38583904	38584199	CpG: 20	295	20	187	13.6	63.4	0.67
chr22	38595979	38596243	CpG: 27	264	27	182	20.5	68.9	0.86
chr22	38644823	38645216	CpG: 36	393	36	261	18.3	66.4	0.83
chr22	38663870	38664096	CpG: 19	226	19	134	16.8	59.3	1.00
chr22	38666130	38667333	CpG: 156	1203	156	884	25.9	73.5	0.98
chr22	38678678	38679298	CpG: 79	620	79	449	25.5	72.4	0.97
chr22	38736727	38737565	CpG: 108	838	108	637	25.8	76.0	0.90
chr22	38738482	38738759	CpG: 20	277	20	163	14.4	58.8	0.85
chr22	38780984	38781909	CpG: 132	925	132	724	28.5	78.3	0.95
chr22	38800441	38800770	CpG: 42	329	42	254	25.5	77.2	0.86
chr22	38817530	38817928	CpG: 33	398	33	281	16.6	70.6	0.67
chr22	38861465	38861737	CpG: 25	272	25	184	18.4	67.6	0.89
chr22	38862018	38863629	CpG: 189	1611	189	1178	23.5	73.1	0.88
chr22	38874130	38874792	CpG: 55	662	55	464	16.6	70.1	0.68
chr22	38877048	38877281	CpG: 28	233	28	183	24.0	78.5	0.81
chr22	38891142	38892456	CpG: 103	1314	103	851	15.7	64.8	0.75
chr22	38919024	38920605	CpG: 229	1581	229	1254	29.0	79.3	0.95
chr22	38925836	38926249	CpG: 45	413	45	261	21.8	63.2	1.09
chr22	38932143	38932525	CpG: 52	382	52	289	27.2	75.7	0.95
chr22	38969149	38969464	CpG: 23	315	23	190	14.6	60.3	0.80
chr22	38969807	38971159	CpG: 149	1352	149	883	22.0	65.3	1.04
chr22	39009711	39009932	CpG: 17	221	17	132	15.4	59.7	0.88
chr22	39016175	39016412	CpG: 17	237	17	145	14.3	61.2	0.78
chr22	39033983	39034978	CpG: 80	995	80	657	16.1	66.0	0.76
chr22	39116476	39116750	CpG: 23	274	23	170	16.8	62.0	0.88
chr22	39122689	39122936	CpG: 16	247	16	138	13.0	55.9	0.84
chr22	39126233	39127233	CpG: 83	1000	83	648	16.6	64.8	0.81
chr22	39152003	39152598	CpG: 63	595	63	414	21.2	69.6	0.88
chr22	39170579	39171960	CpG: 159	1381	159	958	23.0	69.4	0.96
chr22	39176023	39176866	CpG: 101	843	101	601	24.0	71.3	0.94
chr22	39225667	39226686	CpG: 133	1019	133	785	26.1	77.0	0.88
chr22	39264054	39264452	CpG: 37	398	37	290	18.6	72.9	0.72
chr22	39313382	39314798	CpG: 207	1416	207	1107	29.2	78.2	0.96
chr22	39336710	39337583	CpG: 89	873	89	624	20.4	71.5	0.82
chr22	39341911	39343532	CpG: 176	1621	176	1117	21.7	68.9	0.92
chr22	39383040	39383316	CpG: 21	276	21	168	15.2	60.9	0.84
chr22	39397568	39397893	CpG: 29	325	29	243	17.8	74.8	0.67
chr22	39594638	39594888	CpG: 17	250	17	169	13.6	67.6	0.65
chr22	39608289	39608561	CpG: 19	272	19	167	14.0	61.4	0.75
chr22	39615207	39616517	CpG: 136	1310	136	943	20.8	72.0	0.80
chr22	39622488	39624082	CpG: 187	1594	187	1148	23.5	72.0	0.91
chr22	39702259	39702480	CpG: 23	221	23	153	20.8	69.2	0.87
chr22	39712708	39715631	CpG: 316	2923	316	2096	21.6	71.7	0.84
chr22	39762774	39762995	CpG: 17	221	17	159	15.4	71.9	0.62
chr22	39790120	39791049	CpG: 81	929	81	548	17.4	59.0	1.01
chr22	39791209	39791421	CpG: 15	212	15	120	14.2	56.6	0.94
chr22	39791493	39791731	CpG: 19	238	19	134	16.0	56.3	1.02
chr22	39820332	39821300	CpG: 132	968	132	740	27.3	76.4	0.94
chr22	39828228	39828619	CpG: 36	391	36	285	18.4	72.9	0.69
chr22	39829117	39829364	CpG: 19	247	19	141	15.4	57.1	0.96
chr22	39844951	39845168	CpG: 19	217	19	138	17.5	63.6	0.88
chr22	39852281	39852506	CpG: 18	225	18	153	16.0	68.0	0.72
chr22	39858966	39859758	CpG: 64	792	64	524	16.2	66.2	0.74
chr22	39870241	39870784	CpG: 55	543	55	392	20.3	72.2	0.78
chr22	39926832	39928692	CpG: 234	1860	234	1423	25.2	76.5	0.86
chr22	39958130	39959625	CpG: 141	1495	141	1011	18.9	67.6	0.83
chr22	39972724	39973413	CpG: 60	689	60	492	17.4	71.4	0.68
chr22	39990247	39991819	CpG: 147	1572	147	1044	18.7	66.4	0.85
chr22	39994371	39994621	CpG: 20	250	20	151	16.0	60.4	0.89
chr22	40002833	40003696	CpG: 69	863	69	569	16.0	65.9	0.74
chr22	40005428	40005740	CpG: 29	312	29	224	18.6	71.8	0.72
chr22	40028088	40029306	CpG: 136	1218	136	885	22.3	72.7	0.85
chr22	40068961	40069178	CpG: 20	217	20	160	18.4	73.7	0.81
chr22	40070090	40070364	CpG: 23	274	23	170	16.8	62.0	0.88
chr22	40117510	40117831	CpG: 27	321	27	221	16.8	68.8	0.72
chr22	40120440	40120866	CpG: 39	426	39	304	18.3	71.4	0.73
chr22	40132846	40133749	CpG: 94	903	94	653	20.8	72.3	0.80
chr22	40135506	40135936	CpG: 37	430	37	302	17.2	70.2	0.72
chr22	40149982	40150346	CpG: 37	364	37	255	20.3	70.1	0.83
chr22	40156424	40157460	CpG: 106	1036	106	788	20.5	76.1	0.71
chr22	40465442	40466448	CpG: 133	1006	133	773	26.4	76.8	0.90
chr22	40492921	40493438	CpG: 36	517	36	347	13.9	67.1	0.62
chr22	40516411	40517369	CpG: 140	958	140	718	29.2	74.9	1.06
chr22	40602068	40602342	CpG: 21	274	21	166	15.3	60.6	0.85
chr22	40602529	40602733	CpG: 16	204	16	116	15.7	56.9	0.98
chr22	40817292	40818350	CpG: 80	1058	80	649	15.1	61.3	0.80
chr22	40841862	40842436	CpG: 73	574	73	417	25.4	72.6	0.97
chr22	40843126	40843408	CpG: 20	282	20	169	14.2	59.9	0.79
chr22	40889098	40889482	CpG: 29	384	29	268	15.1	69.8	0.62
chr22	41108089	41109610	CpG: 145	1521	145	1018	19.1	66.9	0.85
chr22	41110807	41111083	CpG: 22	276	22	172	15.9	62.3	0.83
chr22	41247672	41247957	CpG: 24	285	24	177	16.8	62.1	0.89
chr22	41253461	41253691	CpG: 19	230	19	139	16.5	60.4	0.93
chr22	41261386	41261605	CpG: 21	219	21	150	19.2	68.5	0.82
chr22	41291314	41291759	CpG: 43	445	43	304	19.3	68.3	0.83
chr22	41328334	41329428	CpG: 89	1094	89	701	16.3	64.1	0.80
chr22	41370456	41370741	CpG: 25	285	25	178	17.5	62.5	0.91
chr22	41407892	41408218	CpG: 24	326	24	189	14.7	58.0	0.88
chr22	41422825	41423948	CpG: 110	1123	110	766	19.6	68.2	0.85
chr22	41446983	41447262	CpG: 23	279	23	165	16.5	59.1	0.96
chr22	41493884	41495089	CpG: 122	1205	122	863	20.2	71.6	0.79
chr22	41538952	41539210	CpG: 20	258	20	149	15.5	57.8	0.94
chr22	41564332	41564557	CpG: 18	225	18	135	16.0	60.0	0.90
chr22	41566112	41568067	CpG: 207	1955	207	1363	21.2	69.7	0.87
chr22	41620553	41620795	CpG: 18	242	18	146	14.9	60.3	0.83
chr22	41638080	41638354	CpG: 22	274	22	169	16.1	61.7	0.85
chr22	41671955	41672847	CpG: 93	892	93	637	20.9	71.4	0.82
chr22	41680003	41680410	CpG: 34	407	34	249	16.7	61.2	0.89
chr22	41686831	41687098	CpG: 18	267	18	161	13.5	60.3	0.76
chr22	41712456	41713778	CpG: 135	1322	135	985	20.4	74.5	0.74
chr22	41752091	41752332	CpG: 21	241	21	149	17.4	61.8	0.93
chr22	41760497	41761491	CpG: 101	994	101	667	20.3	67.1	0.90
chr22	41766575	41766844	CpG: 20	269	20	162	14.9	60.2	0.83
chr22	41780216	41781429	CpG: 123	1213	123	854	20.3	70.4	0.82
chr22	41787874	41788147	CpG: 22	273	22	166	16.1	60.8	0.88
chr22	41800687	41800961	CpG: 23	274	23	170	16.8	62.0	0.88
chr22	41809754	41810255	CpG: 37	501	37	283	14.8	56.5	0.93
chr22	41824755	41824989	CpG: 20	234	20	147	17.1	62.8	0.87
chr22	41857847	41858122	CpG: 19	275	19	164	13.8	59.6	0.78
chr22	41859932	41861104	CpG: 125	1172	125	850	21.3	72.5	0.81
chr22	41874587	41874960	CpG: 30	373	30	235	16.1	63.0	0.81
chr22	41891807	41893082	CpG: 122	1275	122	868	19.1	68.1	0.83
chr22	41922268	41922762	CpG: 32	494	32	276	13.0	55.9	0.83
chr22	41925089	41926751	CpG: 177	1662	177	1158	21.3	69.7	0.88
chr22	41928883	41929318	CpG: 33	435	33	266	15.2	61.1	0.82
chr22	41947271	41948294	CpG: 69	1023	69	621	13.5	60.7	0.74
chr22	42014943	42015212	CpG: 21	269	21	165	15.6	61.3	0.84
chr22	42022179	42022408	CpG: 18	229	18	138	15.7	60.3	0.90
chr22	42022743	42023553	CpG: 86	810	86	564	21.2	69.6	0.88
chr22	42045585	42045803	CpG: 17	218	17	131	15.6	60.1	0.87
chr22	42068393	42069274	CpG: 68	881	68	580	15.4	65.8	0.73
chr22	42072280	42072788	CpG: 48	508	48	373	18.9	73.4	0.70
chr22	42073628	42073904	CpG: 24	276	24	160	17.4	58.0	1.04
chr22	42099227	42100710	CpG: 126	1483	126	967	17.0	65.2	0.80
chr22	42103648	42103922	CpG: 19	274	19	165	13.9	60.2	0.78
chr22	42145766	42145978	CpG: 27	212	27	148	25.5	69.8	1.05
chr22	42161032	42161521	CpG: 42	489	42	305	17.2	62.4	0.89
chr22	42167614	42168599	CpG: 77	985	77	583	15.6	59.2	0.89
chr22	42178388	42179163	CpG: 74	775	74	538	19.1	69.4	0.80
chr22	42264554	42264828	CpG: 25	274	25	172	18.2	62.8	0.94
chr22	42278555	42279563	CpG: 77	1008	77	656	15.3	65.1	0.72
chr22	42311114	42312591	CpG: 167	1477	167	1037	22.6	70.2	0.93
chr22	42338636	42338871	CpG: 18	235	18	141	15.3	60.0	0.88
chr22	42371194	42371423	CpG: 20	229	20	137	17.5	59.8	0.98
chr22	42388486	42394531	CpG: 462	6045	462	4123	15.3	68.2	0.66
chr22	42398363	42399270	CpG: 76	907	76	629	16.8	69.3	0.70
chr22	42404899	42405851	CpG: 101	952	101	722	21.2	75.8	0.74
chr22	42426016	42426887	CpG: 71	871	71	575	16.3	66.0	0.75
chr22	42437269	42437577	CpG: 34	308	34	216	22.1	70.1	0.90
chr22	42456059	42456904	CpG: 116	845	116	654	27.5	77.4	0.93
chr22	42478192	42478858	CpG: 68	666	68	452	20.4	67.9	0.89
chr22	42549986	42550700	CpG: 55	714	55	467	15.4	65.4	0.73
chr22	42553614	42554248	CpG: 66	634	66	466	20.8	73.5	0.78
chr22	42559059	42559679	CpG: 64	620	64	423	20.6	68.2	0.90
chr22	42569526	42570839	CpG: 111	1313	111	822	16.9	62.6	0.86
chr22	42593049	42593339	CpG: 25	290	25	181	17.2	62.4	0.90
chr22	42608220	42609397	CpG: 95	1177	95	799	16.1	67.9	0.72
chr22	42621962	42623067	CpG: 100	1105	100	766	18.1	69.3	0.77
chr22	42631641	42632696	CpG: 77	1055	77	712	14.6	67.5	0.66
chr22	42712042	42712266	CpG: 19	224	19	133	17.0	59.4	0.97
chr22	42748942	42750909	CpG: 213	1967	213	1446	21.7	73.5	0.81
chr22	42762823	42763413	CpG: 57	590	57	435	19.3	73.7	0.72
chr22	42769384	42769585	CpG: 21	201	21	123	20.9	61.2	1.16
chr22	42819453	42819713	CpG: 22	260	22	175	16.9	67.3	0.77
chr22	42824281	42825753	CpG: 166	1472	166	1105	22.6	75.1	0.80
chr22	42849386	42850373	CpG: 104	987	104	697	21.1	70.6	0.85
chr22	42972577	42972799	CpG: 20	222	20	138	18.0	62.2	0.96
chr22	42973901	42974150	CpG: 23	249	23	156	18.5	62.7	0.96
chr22	42981064	42982067	CpG: 87	1003	87	723	17.3	72.1	0.71
chr22	42994951	42995223	CpG: 20	272	20	186	14.7	68.4	0.63
chr22	43000488	43000975	CpG: 59	487	59	359	24.2	73.7	0.90
chr22	43033526	43033728	CpG: 16	202	16	114	15.8	56.4	1.06
chr22	43034042	43035164	CpG: 93	1122	93	762	16.6	67.9	0.73
chr22	43045822	43046125	CpG: 24	303	24	177	15.8	58.4	0.95
chr22	43048238	43048523	CpG: 23	285	23	175	16.1	61.4	0.87
chr22	43056659	43057065	CpG: 28	406	28	277	13.8	68.2	0.61
chr22	43062587	43063073	CpG: 62	486	62	359	25.5	73.9	0.95
chr22	43086053	43086288	CpG: 18	235	18	139	15.3	59.1	0.90
chr22	43088121	43088976	CpG: 64	855	64	581	15.0	68.0	0.65
chr22	43095155	43095923	CpG: 87	768	87	534	22.7	69.5	0.94
chr22	43099128	43099402	CpG: 23	274	23	170	16.8	62.0	0.88
chr22	43129805	43130729	CpG: 109	924	109	706	23.6	76.4	0.81
chr22	43131329	43131691	CpG: 28	362	28	211	15.5	58.3	0.92
chr22	43142998	43143630	CpG: 66	632	66	468	20.9	74.1	0.76
chr22	43148388	43148597	CpG: 16	209	16	123	15.3	58.9	0.91
chr22	43173989	43174526	CpG: 49	537	49	354	18.2	65.9	0.84
chr22	43201025	43202029	CpG: 132	1004	132	779	26.3	77.6	0.89
chr22	43222578	43222843	CpG: 19	265	19	159	14.3	60.0	0.81
chr22	43225541	43226097	CpG: 38	556	38	322	13.7	57.9	0.82
chr22	43231429	43232025	CpG: 47	596	47	407	15.8	68.3	0.68
chr22	43250893	43251206	CpG: 27	313	27	200	17.3	63.9	0.85
chr22	43259939	43260170	CpG: 18	231	18	138	15.6	59.7	0.89
chr22	43329146	43329420	CpG: 19	274	19	163	13.9	59.5	0.79
chr22	43337563	43338756	CpG: 147	1193	147	869	24.6	72.8	0.94
chr22	43350910	43351203	CpG: 26	293	26	187	17.7	63.8	0.88
chr22	43404433	43404669	CpG: 18	236	18	143	15.3	60.6	0.85
chr22	43461615	43463367	CpG: 147	1752	147	1302	16.8	74.3	0.61
chr22	43495420	43496509	CpG: 113	1089	113	770	20.8	70.7	0.88
chr22	43509928	43510170	CpG: 20	242	20	147	16.5	60.7	0.91
chr22	43540242	43540465	CpG: 17	223	17	143	15.2	64.1	0.77
chr22	43569563	43569869	CpG: 22	306	22	185	14.4	60.5	0.81
chr22	43570247	43570735	CpG: 56	488	56	347	23.0	71.1	0.91
chr22	43591111	43592770	CpG: 167	1659	167	1121	20.1	67.6	0.88
chr22	43623853	43624737	CpG: 100	884	100	599	22.6	67.8	0.99
chr22	43632415	43633319	CpG: 86	904	86	635	19.0	70.2	0.79
chr22	43654906	43655167	CpG: 20	261	20	175	15.3	67.0	0.69
chr22	43667464	43668653	CpG: 151	1189	151	954	25.4	80.2	0.87
chr22	43677569	43677804	CpG: 17	235	17	139	14.5	59.1	0.85
chr22	43690860	43691131	CpG: 21	271	21	172	15.5	63.5	0.77
chr22	43708256	43708555	CpG: 21	299	21	197	14.0	65.9	0.65
chr22	43823378	43825315	CpG: 219	1937	219	1422	22.6	73.4	0.85
chr22	43892309	43893533	CpG: 168	1224	168	979	27.5	80.0	0.86
chr22	43902173	43902545	CpG: 32	372	32	224	17.2	60.2	0.95
chr22	43905977	43906226	CpG: 23	249	23	178	18.5	71.5	0.73
chr22	43917272	43917535	CpG: 21	263	21	172	16.0	65.4	0.75
chr22	44294899	44295448	CpG: 57	549	57	369	20.8	67.2	0.92
chr22	44317123	44317761	CpG: 80	638	80	502	25.1	78.7	0.97
chr22	44321271	44321518	CpG: 18	247	18	145	14.6	58.7	0.86
chr22	44344631	44345462	CpG: 125	831	125	621	30.1	74.7	1.08
chr22	44374151	44374753	CpG: 64	602	64	429	21.3	71.3	0.84
chr22	44406664	44407764	CpG: 120	1100	120	811	21.8	73.7	0.80
chr22	44437969	44438982	CpG: 87	1013	87	665	17.2	65.6	0.80
chr22	44480222	44480443	CpG: 18	221	18	129	16.3	58.4	0.97
chr22	44507718	44508684	CpG: 126	966	126	740	26.1	76.6	0.89
chr22	44584900	44585169	CpG: 21	269	21	166	15.6	61.7	0.82
chr22	44593644	44593874	CpG: 21	230	21	141	18.3	61.3	0.98
chr22	44629293	44629678	CpG: 29	385	29	223	15.1	57.9	1.18
chr22	44814581	44815903	CpG: 185	1322	185	1036	28.0	78.4	0.94
chr22	44950272	44950501	CpG: 17	229	17	133	14.8	58.1	0.95
chr22	44980331	44982229	CpG: 168	1898	168	1279	17.7	67.4	0.79
chr22	45103780	45104335	CpG: 47	555	47	367	16.9	66.1	0.78
chr22	45152004	45152937	CpG: 125	933	125	735	26.8	78.8	0.86
chr22	45185626	45186779	CpG: 145	1153	145	867	25.2	75.2	0.89
chr22	45210963	45211221	CpG: 19	258	19	179	14.7	69.4	0.62
chr22	45212842	45213716	CpG: 57	874	57	570	13.0	65.2	0.62
chr22	45216445	45216747	CpG: 26	302	26	162	17.2	53.6	1.42
chr22	45220504	45221240	CpG: 54	736	54	487	14.7	66.2	0.67
chr22	45235829	45236559	CpG: 74	730	74	506	20.3	69.3	0.88
chr22	45352103	45352424	CpG: 26	321	26	183	16.2	57.0	1.00
chr22	45399506	45399763	CpG: 20	257	20	186	15.6	72.4	0.66
chr22	45418470	45418704	CpG: 19	234	19	143	16.2	61.1	0.89
chr22	45420860	45421062	CpG: 15	202	15	117	14.9	57.9	0.89
chr22	45490922	45494379	CpG: 398	3457	398	2492	23.0	72.1	0.89
chr22	45575945	45576174	CpG: 19	229	19	147	16.6	64.2	0.82
chr22	45647910	45649315	CpG: 157	1405	157	1007	22.3	71.7	0.88
chr22	45687252	45687611	CpG: 25	359	25	236	13.9	65.7	0.64
chr22	45725160	45726314	CpG: 153	1154	153	882	26.5	76.4	0.93
chr22	45753544	45754622	CpG: 94	1078	94	749	17.4	69.5	0.74
chr22	45769970	45770342	CpG: 42	372	42	284	22.6	76.3	0.79
chr22	45789835	45790097	CpG: 20	262	20	161	15.3	61.5	0.83
chr22	45794783	45795965	CpG: 124	1182	124	849	21.0	71.8	0.81
chr22	45897905	45898959	CpG: 92	1054	92	711	17.5	67.5	0.80
chr22	45921564	45921991	CpG: 46	427	46	322	21.5	75.4	0.76
chr22	45964035	45964313	CpG: 23	278	23	171	16.5	61.5	0.89
chr22	45987261	45988324	CpG: 123	1063	123	802	23.1	75.4	0.82
chr22	46130213	46130755	CpG: 48	542	48	385	17.7	71.0	0.71
chr22	46156298	46157337	CpG: 112	1039	112	756	21.6	72.8	0.83
chr22	46182387	46182608	CpG: 16	221	16	138	14.5	62.4	0.75
chr22	46350886	46352568	CpG: 178	1682	178	1206	21.2	71.7	0.83
chr22	46365196	46365895	CpG: 48	699	48	444	13.7	63.5	0.69
chr22	46374308	46376438	CpG: 165	2130	165	1451	15.5	68.1	0.67
chr22	46407454	46407848	CpG: 35	394	35	262	17.8	66.5	0.80
chr22	46415688	46416030	CpG: 39	342	39	230	22.8	67.3	1.01
chr22	46455446	46457446	CpG: 199	2000	199	1380	19.9	69.0	0.84
chr22	46460190	46463955	CpG: 369	3765	369	2700	19.6	71.7	0.76
chr22	46498147	46498923	CpG: 54	776	54	545	13.9	70.2	0.60
chr22	46511799	46512388	CpG: 83	589	83	448	28.2	76.1	0.98
chr22	46520239	46520926	CpG: 87	687	87	518	25.3	75.4	0.90
chr22	46529102	46529842	CpG: 89	740	89	526	24.1	71.1	0.95
chr22	46545795	46546728	CpG: 110	933	110	711	23.6	76.2	0.83
chr22	46554676	46557228	CpG: 363	2552	363	1947	28.4	76.3	0.98
chr22	46570504	46570713	CpG: 18	209	18	141	17.2	67.5	0.76
chr22	46607259	46607534	CpG: 23	275	23	195	16.7	70.9	0.67
chr22	46634276	46636208	CpG: 238	1932	238	1461	24.6	75.6	0.86
chr22	46698931	46699596	CpG: 54	665	54	413	16.2	62.1	1.07
chr22	46734390	46735761	CpG: 145	1371	145	979	21.2	71.4	0.83
chr22	46747200	46748135	CpG: 135	935	135	718	28.9	76.8	0.99
chr22	46752408	46752929	CpG: 63	521	63	383	24.2	73.5	0.90
chr22	46753406	46753683	CpG: 23	277	23	167	16.6	60.3	0.92
chr22	46774179	46774596	CpG: 27	417	27	264	12.9	63.3	0.65
chr22	46781010	46782149	CpG: 100	1139	100	764	17.6	67.1	0.78
chr22	46816181	46816506	CpG: 25	325	25	204	15.4	62.8	0.79
chr22	46820179	46821138	CpG: 104	959	104	671	21.7	70.0	0.89
chr22	46848734	46848956	CpG: 22	222	22	157	19.8	70.7	0.79
chr22	46849285	46849514	CpG: 18	229	18	161	15.7	70.3	0.64
chr22	46851691	46851926	CpG: 23	235	23	174	19.6	74.0	0.73
chr22	46852415	46852632	CpG: 19	217	19	147	17.5	67.7	0.76
chr22	46859396	46859834	CpG: 35	438	35	294	16.0	67.1	0.71
chr22	46866669	46866892	CpG: 24	223	24	163	21.5	73.1	0.81
chr22	46874105	46874348	CpG: 23	243	23	167	18.9	68.7	0.80
chr22	46894576	46894838	CpG: 24	262	24	169	18.3	64.5	0.89
chr22	46923985	46924370	CpG: 29	385	29	245	15.1	63.6	0.75
chr22	46939275	46939542	CpG: 19	267	19	166	14.2	62.2	0.74
chr22	46948705	46949319	CpG: 66	614	66	400	21.5	65.1	1.05
chr22	47016283	47016546	CpG: 21	263	21	163	16.0	62.0	0.85
chr22	47021048	47026593	CpG: 532	5545	532	3765	19.2	67.9	0.83
chr22	47063905	47065061	CpG: 198	1156	198	929	34.3	80.4	1.06
chr22	47084867	47085097	CpG: 17	230	17	140	14.8	60.9	0.81
chr22	47108151	47108378	CpG: 23	227	23	174	20.3	76.7	0.69
chr22	47113181	47113383	CpG: 14	202	14	139	13.9	68.8	0.67
chr22	47113476	47113934	CpG: 33	458	33	295	14.4	64.4	0.70
chr22	47118056	47118732	CpG: 43	676	43	430	12.7	63.6	0.64
chr22	47145929	47146172	CpG: 22	243	22	170	18.1	70.0	0.74
chr22	47150768	47151012	CpG: 20	244	20	170	16.4	69.7	0.68
chr22	47161411	47161688	CpG: 28	277	28	180	20.2	65.0	0.97
chr22	47166546	47166767	CpG: 20	221	20	149	18.1	67.4	0.80
chr22	47173811	47174106	CpG: 24	295	24	163	16.3	55.3	1.07
chr22	47189250	47189663	CpG: 37	413	37	277	17.9	67.1	0.81
chr22	47225586	47226657	CpG: 144	1071	144	850	26.9	79.4	0.85
chr22	47250141	47251054	CpG: 74	913	74	594	16.2	65.1	0.79
chr22	47281983	47282206	CpG: 19	223	19	158	17.0	70.9	0.68
chr22	47347436	47348947	CpG: 102	1511	102	922	13.5	61.0	0.74
chr22	47463499	47463730	CpG: 20	231	20	156	17.3	67.5	0.76
chr22	47489029	47489263	CpG: 17	234	17	142	14.5	60.7	0.81
chr22	47517600	47517861	CpG: 19	261	19	175	14.6	67.0	0.67
chr22	47550290	47550551	CpG: 20	261	20	164	15.3	62.8	0.80
chr22	47606581	47606964	CpG: 26	383	26	254	13.6	66.3	0.62
chr22	47652519	47652760	CpG: 18	241	18	166	14.9	68.9	0.78
chr22	47702914	47703541	CpG: 42	627	42	326	13.4	52.0	1.11
chr22	47869072	47870808	CpG: 244	1736	244	1377	28.1	79.3	1.48
chr22	47979530	47979971	CpG: 44	441	44	331	20.0	75.1	0.71
chr22	48031872	48032283	CpG: 30	411	30	235	14.6	57.2	0.89
chr22	48122940	48123313	CpG: 27	373	27	228	14.5	61.1	0.78
chr22	48702091	48702441	CpG: 25	350	25	205	14.3	58.6	0.84
chr22	48742208	48742438	CpG: 20	230	20	141	17.4	61.3	0.94
chr22	48826794	48827128	CpG: 22	334	22	215	13.2	64.4	0.64
chr22	48905592	48905861	CpG: 19	269	19	157	14.1	58.4	0.84
chr22	48981558	48983717	CpG: 248	2159	248	1600	23.0	74.1	0.84
chr22	48993049	48993265	CpG: 17	216	17	134	15.7	62.0	0.82
chr22	49052541	49052757	CpG: 15	216	15	139	13.9	64.4	0.68
chr22	49067509	49069597	CpG: 314	2088	314	1670	30.1	80.0	0.94
chr22	49073823	49074030	CpG: 16	207	16	128	15.5	61.8	0.84
chr22	49117219	49117658	CpG: 54	439	54	310	24.6	70.6	1.03
chr22	49135853	49136055	CpG: 18	202	18	144	17.8	71.3	0.92
chr22	49140865	49141126	CpG: 26	261	26	181	19.9	69.3	0.83
chr22	49172962	49173578	CpG: 50	616	50	448	16.2	72.7	0.95
chr22	49186780	49187004	CpG: 18	224	18	136	16.1	60.7	0.87
chr22	49236304	49236575	CpG: 25	271	25	189	18.5	69.7	0.85
chr22	49239102	49239414	CpG: 26	312	26	210	16.7	67.3	0.74
chr22	49243789	49245261	CpG: 102	1472	102	880	13.9	59.8	0.78
chr22	49288855	49289091	CpG: 35	236	35	155	29.7	65.7	1.74
chr22	49376189	49376554	CpG: 25	365	25	235	13.7	64.4	0.67
chr22	49396909	49397134	CpG: 19	225	19	151	16.9	67.1	0.76
chr22	49475829	49476094	CpG: 18	265	18	138	13.6	52.1	1.01
chr22	49494026	49494318	CpG: 23	292	23	177	15.8	60.6	0.86
chr22	49507215	49507442	CpG: 17	227	17	138	15.0	60.8	0.83
chr22	49555965	49556909	CpG: 63	944	63	604	13.3	64.0	0.66
chr22	49606773	49606988	CpG: 16	215	16	139	14.9	64.7	0.71
chr22	49672744	49673306	CpG: 39	562	39	344	13.9	61.2	0.75
chr22	49688485	49688743	CpG: 21	258	21	164	16.3	63.6	0.86
chr22	49735275	49735510	CpG: 19	235	19	142	16.2	60.4	0.90
chr22	49746601	49746947	CpG: 24	346	24	199	13.9	57.5	0.84
chr22	49808668	49809051	CpG: 34	383	34	232	17.8	60.6	0.97
chr22	49826039	49826455	CpG: 30	416	30	262	14.4	63.0	0.73
chr22	49838354	49838623	CpG: 20	269	20	156	14.9	58.0	0.89
chr22	49873449	49873726	CpG: 26	277	26	182	18.8	65.7	0.92
chr22	49907938	49908152	CpG: 17	214	17	133	15.9	62.1	0.83
chr22	49921376	49921847	CpG: 38	471	38	309	16.1	65.6	0.75
chr22	49952848	49953126	CpG: 31	278	31	199	22.3	71.6	1.06
chr22	49992436	49992864	CpG: 39	428	39	269	18.2	62.9	0.95
chr22	49997469	49997906	CpG: 28	437	28	330	12.8	75.5	0.61
chr22	50045053	50045772	CpG: 64	719	64	514	17.8	71.5	0.70
chr22	50079768	50080060	CpG: 20	292	20	194	13.7	66.4	0.64
chr22	50119321	50120075	CpG: 69	754	69	460	18.3	61.0	0.98
chr22	50135448	50136778	CpG: 94	1330	94	821	14.1	61.7	0.75
chr22	50141502	50141704	CpG: 17	202	17	144	16.8	71.3	0.67
chr22	50174202	50174839	CpG: 76	637	76	499	23.9	78.3	0.78
chr22	50175018	50175347	CpG: 23	329	23	218	14.0	66.3	0.64
chr22	50194728	50194957	CpG: 20	229	20	157	17.5	68.6	0.75
chr22	50208724	50208974	CpG: 18	250	18	173	14.4	69.2	0.60
chr22	50228475	50229473	CpG: 79	998	79	669	15.8	67.0	0.71
chr22	50255081	50255286	CpG: 18	205	18	155	17.6	75.6	0.70
chr22	50268590	50269017	CpG: 31	427	31	270	14.5	63.2	0.73
chr22	50275512	50276161	CpG: 64	649	64	459	19.7	70.7	0.80
chr22	50280260	50280512	CpG: 21	252	21	176	16.7	69.8	0.69
chr22	50281317	50281599	CpG: 26	282	26	190	18.4	67.4	0.82
chr22	50288368	50288869	CpG: 45	501	45	335	18.0	66.9	0.80
chr22	50306471	50307034	CpG: 38	563	38	354	13.5	62.9	0.79
chr22	50311015	50311231	CpG: 17	216	17	130	15.7	60.2	0.88
chr22	50327806	50328312	CpG: 44	506	44	328	17.4	64.8	0.83
chr22	50330767	50332318	CpG: 238	1551	238	1200	30.7	77.4	1.03
chr22	50342593	50342870	CpG: 26	277	26	171	18.8	61.7	1.00
chr22	50352383	50354565	CpG: 206	2182	206	1575	18.9	72.2	0.73
chr22	50357202	50358788	CpG: 226	1586	226	1205	28.5	76.0	0.99
chr22	50384842	50385074	CpG: 20	232	20	147	17.2	63.4	0.88
chr22	50390402	50391210	CpG: 66	808	66	504	16.3	62.4	0.84
chr22	50422602	50423787	CpG: 125	1185	125	856	21.1	72.2	0.81
chr22	50433583	50434464	CpG: 100	881	100	677	22.7	76.8	0.77
chr22	50439706	50441105	CpG: 111	1399	111	1060	15.9	75.8	0.61
chr22	50464609	50468228	CpG: 417	3619	417	2635	23.0	72.8	0.87
chr22	50475562	50477261	CpG: 141	1699	141	1232	16.6	72.5	0.63
chr22	50487915	50488870	CpG: 102	955	102	694	21.4	72.7	0.81
chr22	50494629	50494870	CpG: 20	241	20	172	16.6	71.4	0.65
chr22	50503959	50505004	CpG: 95	1045	95	762	18.2	72.9	0.69
chr22	50515047	50516000	CpG: 84	953	84	721	17.6	75.7	0.62
chr22	50519532	50520613	CpG: 119	1081	119	803	22.0	74.3	0.81
chr22	50535821	50537283	CpG: 112	1462	112	996	15.3	68.1	0.66
chr22	50537782	50538350	CpG: 39	568	39	381	13.7	67.1	0.61
chr22	50551278	50551507	CpG: 17	229	17	140	14.8	61.1	0.81
chr22	50558378	50558593	CpG: 15	215	15	137	14.0	63.7	0.69
chr22	50564682	50565634	CpG: 112	952	112	741	23.5	77.8	0.78
chr22	50596671	50597774	CpG: 114	1103	114	749	20.7	67.9	0.90
chr22	50598033	50598270	CpG: 18	237	18	153	15.2	64.6	0.73
chr22	50616312	50616586	CpG: 20	274	20	167	14.6	60.9	0.80
chr22	50667033	50667308	CpG: 20	275	20	163	14.5	59.3	0.84
chr22	50672746	50673429	CpG: 47	683	47	456	13.8	66.8	0.67
chr22	50676130	50677935	CpG: 221	1805	221	1386	24.5	76.8	0.83
chr22	50683586	50686208	CpG: 248	2622	248	1804	18.9	68.8	0.80
chr22	50686694	50686935	CpG: 21	241	21	163	17.4	67.6	0.79
chr22	50691472	50693534	CpG: 228	2062	228	1534	22.1	74.4	0.81
chr22	50697199	50697499	CpG: 25	300	25	198	16.7	66.0	0.77
chr22	50701039	50701373	CpG: 30	334	30	229	18.0	68.6	0.77
chr22	50704636	50705328	CpG: 59	692	59	487	17.1	70.4	0.69
chr22	50706978	50708721	CpG: 232	1743	232	1318	26.6	75.6	0.93
chr22	50713027	50713291	CpG: 25	264	25	165	18.9	62.5	0.97
chr22	50723678	50724344	CpG: 55	666	55	446	16.5	67.0	0.74
chr22	50725041	50725485	CpG: 30	444	30	297	13.5	66.9	0.61
chr22	50726013	50726470	CpG: 34	457	34	307	14.9	67.2	0.68
chr22	50727526	50727933	CpG: 28	407	28	257	13.8	63.1	0.69
chr22	50751673	50752575	CpG: 102	902	102	621	22.6	68.8	0.99
chr22	50757734	50758741	CpG: 101	1007	101	747	20.1	74.2	0.73
chr22	50768043	50768932	CpG: 127	889	127	702	28.6	79.0	0.92
chr22	50773980	50779064	CpG: 386	5084	386	3457	15.2	68.0	0.66
chr22	50782362	50782597	CpG: 20	235	20	158	17.0	67.2	0.78
chr22	50783242	50784211	CpG: 80	969	80	744	16.5	76.8	0.66
chr22	50785386	50786024	CpG: 46	638	46	411	14.4	64.4	0.70
chr22	50788204	50792002	CpG: 260	3798	260	2560	13.7	67.4	0.60
chr22	50793038	50793561	CpG: 36	523	36	389	13.8	74.4	0.62
chr22	50794795	50795144	CpG: 29	349	29	248	16.6	71.1	0.66
chr22	50795434	50795846	CpG: 35	412	35	293	17.0	71.1	0.67
chr22	50796767	50797980	CpG: 91	1213	91	799	15.0	65.9	0.69
chr22	50807071	50808441	CpG: 149	1370	149	1006	21.8	73.4	0.81
chr22	50814745	50815455	CpG: 95	710	95	555	26.8	78.2	0.88
chr22	50824677	50824985	CpG: 31	308	31	261	20.1	84.7	0.91
chr22	50834484	50835802	CpG: 166	1318	166	957	25.2	72.6	0.96
chr22	50849579	50849852	CpG: 23	273	23	173	16.8	63.4	0.85
chr22	50850625	50851444	CpG: 91	819	91	592	22.2	72.3	0.85
chr22	50910458	50910687	CpG: 18	229	18	132	15.7	57.6	0.99
chr22	50915918	50916197	CpG: 20	279	20	162	14.3	58.1	0.85
chr22	50933522	50933733	CpG: 27	211	27	135	25.6	64.0	1.35
chr22	50940429	50940658	CpG: 17	229	17	145	14.8	63.3	0.75
chr22	50944020	50944340	CpG: 25	320	25	220	15.6	68.8	0.67
chr22	50946270	50946525	CpG: 19	255	19	161	14.9	63.1	0.75
chr22	50956042	50956644	CpG: 46	602	46	404	15.3	67.1	0.68
chr22	50963593	50963799	CpG: 17	206	17	138	16.5	67.0	0.74
chr22	50968472	50968812	CpG: 28	340	28	232	16.5	68.2	0.72
chr22	50969101	50969367	CpG: 19	266	19	181	14.3	68.0	0.62
chr22	50970719	50971037	CpG: 27	318	27	225	17.0	70.8	0.69
chr22	50973807	50974110	CpG: 23	303	23	203	15.2	67.0	0.68
chr22	50983308	50984612	CpG: 146	1304	146	983	22.4	75.4	0.81
chr22	50989903	50991226	CpG: 138	1323	138	953	20.9	72.0	0.81
chr22	51016453	51016705	CpG: 20	252	20	169	15.9	67.1	0.71
chr22	51017958	51019109	CpG: 130	1151	130	861	22.6	74.8	0.83
chr22	51021965	51022166	CpG: 14	201	14	117	13.9	58.2	0.84
chr22	51034191	51034470	CpG: 20	279	20	168	14.3	60.2	0.80
chr22	51035744	51042900	CpG: 554	7156	554	4823	15.5	67.4	0.68
chr22	51053656	51053923	CpG: 23	267	23	166	17.2	62.2	0.91
chr22	51054511	51055132	CpG: 60	621	60	399	19.3	64.3	0.95
chr22	51072733	51073615	CpG: 67	882	67	633	15.2	71.8	0.82
chr22	51088352	51089119	CpG: 74	767	74	559	19.3	72.9	0.73
chr22	51092670	51093933	CpG: 148	1263	148	917	23.4	72.6	0.89
chr22	51104183	51104470	CpG: 22	287	22	176	15.3	61.3	0.82
chr22	51110118	51110369	CpG: 19	251	19	147	15.1	58.6	0.90
chr22	51110580	51115509	CpG: 376	4929	376	3342	15.3	67.8	0.66
chr22	51115919	51116228	CpG: 25	309	25	205	16.2	66.3	0.74
chr22	51138190	51139168	CpG: 96	978	96	685	19.6	70.0	0.81
chr22	51187474	51189279	CpG: 216	1805	216	1393	23.9	77.2	0.82
chr22	51210533	51211559	CpG: 149	1026	149	828	29.0	80.7	0.89
chr22	51217953	51218459	CpG: 38	506	38	328	15.0	64.8	0.72
chr22	51224440	51224877	CpG: 43	437	43	279	19.7	63.8	1.02
chr22	51233541	51235215	CpG: 192	1674	192	1257	22.9	75.1	0.83
chr22	51244179	51245171	CpG: 111	992	111	730	22.4	73.6	0.84
chr22	51256542	51257020	CpG: 40	478	40	299	16.7	62.6	0.86
chr22	51270378	51270671	CpG: 22	293	22	177	15.0	60.4	0.83
chr22	51281472	51281741	CpG: 19	269	19	162	14.1	60.2	0.79
chr22	51287413	51287693	CpG: 24	280	24	173	17.1	61.8	0.91
chr22	51296635	51297386	CpG: 76	751	76	526	20.2	70.0	0.83
chr22	51319507	51319792	CpG: 22	285	22	174	15.4	61.1	0.84
chr22	51320646	51321603	CpG: 148	957	148	716	30.9	74.8	1.12
chrX	5893	6651	CpG: 74	758	74	501	19.5	66.1	0.92
chrX	10648	10879	CpG: 16	231	16	179	13.9	77.5	0.70
chrX	11435	12783	CpG: 135	1348	135	902	20.0	66.9	0.90
chrX	65315	67792	CpG: 178	2477	178	1655	14.4	66.8	0.78
chrX	70500	70772	CpG: 27	272	27	180	19.9	66.2	0.93
chrX	71745	73329	CpG: 100	1584	100	920	12.6	58.1	0.75
chrX	78293	78500	CpG: 16	207	16	140	15.5	67.6	0.69
chrX	83007	83218	CpG: 17	211	17	129	16.1	61.1	0.87
chrX	84822	85098	CpG: 29	276	29	186	21.0	67.4	0.93
chrX	91506	92357	CpG: 53	851	53	522	12.5	61.3	0.68
chrX	103886	105284	CpG: 102	1398	102	958	14.6	68.5	0.63
chrX	111328	111962	CpG: 45	634	45	407	14.2	64.2	0.72
chrX	116882	117113	CpG: 19	231	19	146	16.5	63.2	0.82
chrX	118989	119227	CpG: 22	238	22	181	18.5	76.1	0.82
chrX	119735	120191	CpG: 30	456	30	289	13.2	63.4	0.67
chrX	121268	121510	CpG: 18	242	18	160	14.9	66.1	0.68
chrX	122419	122666	CpG: 21	247	21	151	17.0	61.1	0.93
chrX	123320	123634	CpG: 24	314	24	193	15.3	61.5	0.82
chrX	127274	127592	CpG: 34	318	34	207	21.4	65.1	1.01
chrX	133096	133390	CpG: 23	294	23	195	15.6	66.3	0.71
chrX	135581	136140	CpG: 47	559	47	382	16.8	68.3	0.72
chrX	139093	140118	CpG: 85	1025	85	695	16.6	67.8	0.73
chrX	140937	141565	CpG: 55	628	55	424	17.5	67.5	0.77
chrX	142500	143841	CpG: 105	1341	105	856	15.7	63.8	0.77
chrX	147774	148391	CpG: 44	617	44	397	14.3	64.3	0.69
chrX	149472	151240	CpG: 190	1768	190	1294	21.5	73.2	0.80
chrX	155170	155377	CpG: 16	207	16	142	15.5	68.6	0.68
chrX	158767	159209	CpG: 35	442	35	302	15.8	68.3	0.68
chrX	161765	178930	CpG: 1195	17165	1195	11380	13.9	66.3	0.64
chrX	181070	182036	CpG: 80	966	80	648	16.6	67.1	0.75
chrX	183021	183661	CpG: 53	640	53	405	16.6	63.3	0.83
chrX	188684	189924	CpG: 106	1240	106	825	17.1	66.5	0.78
chrX	192009	192389	CpG: 37	380	37	244	19.5	64.2	0.95
chrX	193968	195867	CpG: 124	1899	124	1217	13.1	64.1	0.85
chrX	201123	201501	CpG: 32	378	32	259	16.9	68.5	0.73
chrX	201885	202128	CpG: 19	243	19	169	15.6	69.5	0.65
chrX	202334	203247	CpG: 65	913	65	605	14.2	66.3	0.66
chrX	204632	205951	CpG: 147	1319	147	936	22.3	71.0	0.88
chrX	206244	206525	CpG: 19	281	19	163	13.5	58.0	0.82
chrX	207098	207438	CpG: 24	340	24	214	14.1	62.9	0.73
chrX	214811	215058	CpG: 22	247	22	151	17.8	61.1	0.98
chrX	217496	218732	CpG: 160	1236	160	899	25.9	72.7	0.99
chrX	227432	227682	CpG: 19	250	19	151	15.2	60.4	0.84
chrX	231153	231356	CpG: 17	203	17	126	16.7	62.1	0.88
chrX	236937	237463	CpG: 43	526	43	321	16.3	61.0	0.88
chrX	237863	239815	CpG: 164	1952	164	1148	16.8	58.8	0.98
chrX	244333	244550	CpG: 20	217	20	143	18.4	65.9	0.85
chrX	248569	248805	CpG: 17	236	17	142	14.4	60.2	0.82
chrX	249814	250701	CpG: 70	887	70	572	15.8	64.5	0.78
chrX	250976	251234	CpG: 18	258	18	161	14.0	62.4	0.72
chrX	251666	251921	CpG: 18	255	18	156	14.1	61.2	0.75
chrX	252133	252473	CpG: 25	340	25	207	14.7	60.9	0.80
chrX	258736	260119	CpG: 105	1383	105	896	15.2	64.8	0.73
chrX	264915	265184	CpG: 19	269	19	165	14.1	61.3	0.76
chrX	265527	265860	CpG: 27	333	27	201	16.2	60.4	0.90
chrX	269138	269662	CpG: 38	524	38	305	14.5	58.2	0.87
chrX	280551	280817	CpG: 21	266	21	169	15.8	63.5	0.79
chrX	292117	292555	CpG: 33	438	33	272	15.1	62.1	0.78
chrX	306538	306775	CpG: 19	237	19	141	16.0	59.5	0.93
chrX	308832	309165	CpG: 26	333	26	189	15.6	56.8	0.97
chrX	309585	309829	CpG: 20	244	20	140	16.4	57.4	1.00
chrX	311100	311311	CpG: 16	211	16	125	15.2	59.2	0.87
chrX	323403	323669	CpG: 20	266	20	163	15.0	61.3	0.81
chrX	330113	330339	CpG: 21	226	21	144	18.6	63.7	0.95
chrX	332892	333708	CpG: 55	816	55	472	13.5	57.8	0.81
chrX	335789	336016	CpG: 17	227	17	130	15.0	57.3	0.93
chrX	395146	395413	CpG: 23	267	23	172	17.2	64.4	0.84
chrX	428017	428927	CpG: 58	910	58	499	12.7	54.8	0.85
chrX	458847	460436	CpG: 122	1589	122	1093	15.4	68.8	0.65
chrX	463658	464424	CpG: 66	766	66	506	17.2	66.1	0.80
chrX	469860	472409	CpG: 222	2549	222	1611	17.4	63.2	0.87
chrX	474163	475140	CpG: 86	977	86	603	17.6	61.7	0.92
chrX	482065	482702	CpG: 51	637	51	420	16.0	65.9	0.75
chrX	484098	484912	CpG: 90	814	90	597	22.1	73.3	0.83
chrX	491711	491948	CpG: 22	237	22	153	18.6	64.6	0.90
chrX	501937	502172	CpG: 17	235	17	123	14.5	52.3	1.06
chrX	503470	503712	CpG: 19	242	19	138	15.7	57.0	0.99
chrX	533293	533528	CpG: 18	235	18	140	15.3	59.6	0.90
chrX	630635	630951	CpG: 23	316	23	183	14.6	57.9	0.87
chrX	717618	717862	CpG: 19	244	19	145	15.6	59.4	0.91
chrX	723710	723950	CpG: 17	240	17	142	14.2	59.2	0.84
chrX	741596	741824	CpG: 16	228	16	143	14.0	62.7	0.72
chrX	903500	903748	CpG: 18	248	18	142	14.5	57.3	0.92
chrX	955153	955419	CpG: 20	266	20	167	15.0	62.8	0.78
chrX	978681	978911	CpG: 18	230	18	140	15.7	60.9	0.86
chrX	1048145	1048376	CpG: 20	231	20	140	17.3	60.6	0.95
chrX	1053005	1053231	CpG: 17	226	17	133	15.0	58.8	0.88
chrX	1083134	1083477	CpG: 25	343	25	202	14.6	58.9	0.84
chrX	1108427	1108634	CpG: 17	207	17	127	16.4	61.4	0.88
chrX	1124752	1125016	CpG: 19	264	19	152	14.4	57.6	0.90
chrX	1143523	1143728	CpG: 17	205	17	125	16.6	61.0	0.89
chrX	1148829	1149076	CpG: 18	247	18	147	14.6	59.5	0.86
chrX	1150887	1151139	CpG: 18	252	18	149	14.3	59.1	0.85
chrX	1202329	1202926	CpG: 45	597	45	363	15.1	60.8	0.82
chrX	1215587	1218390	CpG: 419	2803	419	2226	29.9	79.4	1.23
chrX	1230011	1230462	CpG: 32	451	32	270	14.2	59.9	0.79
chrX	1230892	1231240	CpG: 36	348	36	240	20.7	69.0	0.88
chrX	1232834	1233179	CpG: 33	345	33	222	19.1	64.3	0.92
chrX	1235255	1236712	CpG: 180	1457	180	1084	24.7	74.4	0.92
chrX	1260570	1260830	CpG: 21	260	21	178	16.2	68.5	0.70
chrX	1269310	1269649	CpG: 31	339	31	229	18.3	67.6	0.81
chrX	1273689	1274216	CpG: 36	527	36	334	13.7	63.4	0.68
chrX	1274301	1274614	CpG: 21	313	21	185	13.4	59.1	0.77
chrX	1275483	1275765	CpG: 24	282	24	167	17.0	59.2	0.99
chrX	1277055	1277319	CpG: 20	264	20	158	15.2	59.8	0.85
chrX	1281157	1281556	CpG: 33	399	33	249	16.5	62.4	0.86
chrX	1282213	1282439	CpG: 20	226	20	145	17.7	64.2	0.87
chrX	1285137	1285373	CpG: 25	236	25	147	21.2	62.3	1.18
chrX	1285568	1285825	CpG: 18	257	18	153	14.0	59.5	0.86
chrX	1294588	1296367	CpG: 157	1779	157	1293	17.7	72.7	0.67
chrX	1338310	1338554	CpG: 19	244	19	156	15.6	63.9	0.77
chrX	1386537	1386775	CpG: 17	238	17	142	14.3	59.7	0.82
chrX	1392878	1393559	CpG: 83	681	83	516	24.4	75.8	0.92
chrX	1395191	1395688	CpG: 39	497	39	314	15.7	63.2	0.79
chrX	1399481	1403103	CpG: 253	3622	253	2391	14.0	66.0	0.64
chrX	1404303	1404533	CpG: 19	230	19	136	16.5	59.1	0.95
chrX	1425144	1425381	CpG: 17	237	17	135	14.3	57.0	0.90
chrX	1459085	1459292	CpG: 19	207	19	128	18.4	61.8	0.97
chrX	1469825	1470100	CpG: 24	275	24	171	17.5	62.2	0.92
chrX	1487896	1488128	CpG: 17	232	17	136	14.7	58.6	0.87
chrX	1506064	1506375	CpG: 22	311	22	185	14.1	59.5	0.80
chrX	1718361	1718593	CpG: 16	232	16	134	13.8	57.8	0.84
chrX	1836972	1837229	CpG: 19	257	19	159	14.8	61.9	0.78
chrX	1864348	1864553	CpG: 17	205	17	141	16.6	68.8	0.71
chrX	1937911	1938155	CpG: 17	244	17	137	13.9	56.1	0.89
chrX	1985431	1985667	CpG: 17	236	17	143	14.4	60.6	0.79
chrX	2046642	2046850	CpG: 17	208	17	123	16.3	59.1	0.95
chrX	2101485	2103418	CpG: 133	1933	133	1226	13.8	63.4	0.69
chrX	2103573	2103785	CpG: 17	212	17	131	16.0	61.8	0.85
chrX	2113086	2113896	CpG: 116	810	116	655	28.6	80.9	0.88
chrX	2196510	2197842	CpG: 157	1332	157	1006	23.6	75.5	0.84
chrX	2206584	2206872	CpG: 19	288	19	173	13.2	60.1	0.74
chrX	2222171	2222750	CpG: 70	579	70	452	24.2	78.1	0.79
chrX	2303902	2305052	CpG: 108	1150	108	777	18.8	67.6	0.82
chrX	2414675	2414948	CpG: 23	273	23	170	16.8	62.3	0.88
chrX	2441361	2443195	CpG: 166	1834	166	1298	18.1	70.8	0.77
chrX	2519884	2520092	CpG: 19	208	19	146	18.3	70.2	0.75
chrX	2530396	2530683	CpG: 21	287	21	181	14.6	63.1	0.74
chrX	2530955	2531185	CpG: 20	230	20	143	17.4	62.2	0.91
chrX	2540580	2542011	CpG: 127	1431	127	996	17.7	69.6	0.75
chrX	2572453	2572719	CpG: 22	266	22	166	16.5	62.4	0.86
chrX	2759617	2759891	CpG: 24	274	24	171	17.5	62.4	0.91
chrX	2923923	2924266	CpG: 25	343	25	220	14.6	64.1	0.71
chrX	2930516	2931289	CpG: 66	773	66	487	17.1	63.0	0.86
chrX	2946375	2946648	CpG: 21	273	21	168	15.4	61.5	0.83
chrX	2959619	2961613	CpG: 147	1994	147	1314	14.7	65.9	0.68
chrX	3331764	3331978	CpG: 17	214	17	120	15.9	56.1	1.01
chrX	3332090	3333320	CpG: 149	1230	149	945	24.2	76.8	0.82
chrX	3376652	3376918	CpG: 20	266	20	162	15.0	60.9	0.82
chrX	3433916	3435913	CpG: 174	1997	174	1348	17.4	67.5	0.77
chrX	3454325	3455155	CpG: 77	830	77	594	18.6	71.6	0.72
chrX	3457365	3458385	CpG: 87	1020	87	651	17.1	63.8	0.84
chrX	3462016	3463563	CpG: 170	1547	170	1118	22.0	72.3	0.84
chrX	3577407	3577685	CpG: 24	278	24	173	17.3	62.2	0.90
chrX	3639088	3639326	CpG: 16	238	16	140	13.4	58.8	0.80
chrX	4083858	4084093	CpG: 16	235	16	142	13.6	60.4	0.76
chrX	4247847	4248077	CpG: 20	230	20	141	17.4	61.3	0.94
chrX	4269565	4269843	CpG: 19	278	19	146	13.7	52.5	1.03
chrX	5032888	5033276	CpG: 30	388	30	236	15.5	60.8	0.84
chrX	5104566	5104767	CpG: 15	201	15	118	14.9	58.7	0.92
chrX	5338136	5338505	CpG: 27	369	27	216	14.6	58.5	0.86
chrX	5445222	5445519	CpG: 21	297	21	165	14.1	55.6	0.94
chrX	5455305	5455902	CpG: 46	597	46	343	15.4	57.5	0.94
chrX	5635261	5635555	CpG: 21	294	21	179	14.3	60.9	0.78
chrX	5739319	5739817	CpG: 43	498	43	294	17.3	59.0	1.02
chrX	5745441	5745703	CpG: 24	262	24	165	18.3	63.0	0.93
chrX	5748576	5748837	CpG: 19	261	19	159	14.6	60.9	0.80
chrX	5778375	5780161	CpG: 138	1786	138	1170	15.5	65.5	0.72
chrX	6070679	6070916	CpG: 25	237	25	151	21.1	63.7	1.06
chrX	6244370	6244760	CpG: 35	390	35	285	17.9	73.1	0.67
chrX	6252606	6252878	CpG: 23	272	23	166	16.9	61.0	0.92
chrX	6399916	6400123	CpG: 21	207	21	126	20.3	60.9	1.12
chrX	6486265	6486691	CpG: 34	426	34	259	16.0	60.8	0.87
chrX	6701437	6702232	CpG: 117	795	117	595	29.4	74.8	1.06
chrX	6800034	6800346	CpG: 22	312	22	185	14.1	59.3	0.80
chrX	7044904	7045178	CpG: 23	274	23	169	16.8	61.7	0.89
chrX	7082587	7082861	CpG: 22	274	22	165	16.1	60.2	0.90
chrX	7146978	7147407	CpG: 32	429	32	261	14.9	60.8	0.81
chrX	7236508	7236786	CpG: 22	278	22	174	15.8	62.6	0.82
chrX	7480670	7481201	CpG: 49	531	49	358	18.5	67.4	0.81
chrX	7792425	7792658	CpG: 20	233	20	144	17.2	61.8	0.92
chrX	7972988	7973266	CpG: 26	278	26	176	18.7	63.3	0.94
chrX	8019060	8019451	CpG: 32	391	32	280	16.4	71.6	0.64
chrX	8069287	8069524	CpG: 21	237	21	163	17.7	68.8	0.75
chrX	8297927	8299570	CpG: 163	1643	163	1140	19.8	69.4	0.83
chrX	8315539	8315782	CpG: 18	243	18	142	14.8	58.4	0.89
chrX	8350354	8350677	CpG: 24	323	24	208	14.9	64.4	0.72
chrX	8368237	8368619	CpG: 29	382	29	246	15.2	64.4	0.75
chrX	8482792	8483021	CpG: 17	229	17	140	14.8	61.1	0.83
chrX	8909720	8909931	CpG: 22	211	22	148	20.9	70.1	0.85
chrX	8951689	8951961	CpG: 21	272	21	169	15.4	62.1	0.81
chrX	8965716	8965993	CpG: 20	277	20	171	14.4	61.7	0.77
chrX	9047298	9049070	CpG: 209	1772	209	1318	23.6	74.4	0.86
chrX	9129422	9129696	CpG: 23	274	23	170	16.8	62.0	0.88
chrX	9347364	9348646	CpG: 112	1282	112	863	17.5	67.3	0.77
chrX	9368150	9369685	CpG: 213	1535	213	1200	27.8	78.2	0.91
chrX	9430801	9431082	CpG: 23	281	23	173	16.4	61.6	0.88
chrX	9447139	9447420	CpG: 23	281	23	170	16.4	60.5	0.90
chrX	9473181	9473719	CpG: 43	538	43	356	16.0	66.2	0.74
chrX	9478101	9478396	CpG: 23	295	23	204	15.6	69.2	0.65
chrX	9527149	9527532	CpG: 27	383	27	242	14.1	63.2	0.72
chrX	9574680	9574920	CpG: 22	240	22	171	18.3	71.2	0.75
chrX	9597005	9599076	CpG: 273	2071	273	1580	26.4	76.3	0.91
chrX	9696259	9696477	CpG: 19	218	19	133	17.4	61.0	0.96
chrX	9699685	9700261	CpG: 49	576	49	403	17.0	70.0	0.70
chrX	9708553	9708909	CpG: 26	356	26	214	14.6	60.1	0.82
chrX	9740837	9741399	CpG: 60	562	60	409	21.4	72.8	0.81
chrX	10192303	10192540	CpG: 21	237	21	143	17.7	60.3	0.99
chrX	10202687	10202974	CpG: 32	287	32	184	22.3	64.1	1.11
chrX	10251461	10251746	CpG: 23	285	23	176	16.1	61.8	0.86
chrX	10306103	10306362	CpG: 24	259	24	162	18.5	62.5	0.96
chrX	10313163	10313400	CpG: 18	237	18	138	15.2	58.2	0.92
chrX	10315423	10315691	CpG: 19	268	19	162	14.2	60.4	0.79
chrX	10660766	10661040	CpG: 24	274	24	170	17.5	62.0	0.92
chrX	10693634	10694116	CpG: 49	482	49	324	20.3	67.2	0.91
chrX	10711188	10711461	CpG: 20	273	20	163	14.7	59.7	0.83
chrX	10721300	10721922	CpG: 54	622	54	449	17.4	72.2	0.67
chrX	10922946	10923186	CpG: 19	240	19	145	15.8	60.4	0.90
chrX	11009911	11010569	CpG: 62	658	62	478	18.8	72.6	0.72
chrX	11246757	11248968	CpG: 168	2211	168	1466	15.2	66.3	0.70
chrX	11257469	11257742	CpG: 25	273	25	170	18.3	62.3	0.96
chrX	11289815	11290241	CpG: 33	426	33	255	15.5	59.9	0.87
chrX	11340214	11341366	CpG: 151	1152	151	862	26.2	74.8	0.94
chrX	11523426	11523852	CpG: 33	426	33	256	15.5	60.1	0.86
chrX	11721024	11721694	CpG: 71	670	71	468	21.2	69.9	0.87
chrX	11848494	11848773	CpG: 20	279	20	166	14.3	59.5	0.82
chrX	11857367	11857634	CpG: 20	267	20	165	15.0	61.8	0.79
chrX	11859480	11859754	CpG: 24	274	24	171	17.5	62.4	0.91
chrX	12143434	12143708	CpG: 23	274	23	169	16.8	61.7	0.89
chrX	12166005	12166355	CpG: 27	350	27	224	15.4	64.0	0.78
chrX	12372520	12373697	CpG: 131	1177	131	846	22.3	71.9	0.87
chrX	12438828	12439064	CpG: 21	236	21	145	17.8	61.4	0.96
chrX	12482438	12482662	CpG: 22	224	22	141	19.6	62.9	1.04
chrX	12556415	12557907	CpG: 114	1492	114	879	15.3	58.9	0.89
chrX	12606066	12606338	CpG: 21	272	21	165	15.4	60.7	0.85
chrX	12719519	12719744	CpG: 18	225	18	132	16.0	58.7	0.93
chrX	12872569	12872814	CpG: 23	245	23	163	18.8	66.5	0.92
chrX	12960206	12960812	CpG: 51	606	51	387	16.8	63.9	0.83
chrX	13039041	13039320	CpG: 24	279	24	175	17.2	62.7	0.88
chrX	13150939	13151512	CpG: 49	573	49	408	17.1	71.2	0.67
chrX	13193897	13194107	CpG: 16	210	16	149	15.2	71.0	0.61
chrX	13234354	13234874	CpG: 48	520	48	347	18.5	66.7	0.83
chrX	13253259	13253530	CpG: 21	271	21	164	15.5	60.5	0.86
chrX	13270319	13270819	CpG: 61	500	61	369	24.4	73.8	0.90
chrX	13315754	13316649	CpG: 77	895	77	571	17.2	63.8	0.85
chrX	13370947	13371171	CpG: 16	224	16	134	14.3	59.8	0.82
chrX	13518282	13519193	CpG: 109	911	109	670	23.9	73.5	0.90
chrX	13609886	13610452	CpG: 65	566	65	395	23.0	69.8	0.96
chrX	13689840	13690167	CpG: 25	327	25	192	15.3	58.7	0.89
chrX	13824120	13824475	CpG: 37	355	37	248	20.8	69.9	0.89
chrX	13882865	13883550	CpG: 51	685	51	464	14.9	67.7	0.65
chrX	13886635	13886917	CpG: 20	282	20	175	14.2	62.1	0.75
chrX	14453387	14454130	CpG: 76	743	76	512	20.5	68.9	0.86
chrX	14479733	14479963	CpG: 21	230	21	142	18.3	61.7	1.00
chrX	14730888	14731162	CpG: 26	274	26	172	19.0	62.8	0.97
chrX	14918133	14918772	CpG: 66	639	66	422	20.7	66.0	0.97
chrX	14934061	14934310	CpG: 21	249	21	153	16.9	61.4	0.92
chrX	14979716	14979952	CpG: 17	236	17	140	14.4	59.3	0.84
chrX	15076164	15076605	CpG: 39	441	39	294	17.7	66.7	0.80
chrX	15229599	15230036	CpG: 35	437	35	292	16.0	66.8	0.72
chrX	15257923	15258910	CpG: 88	987	88	628	17.8	63.6	0.99
chrX	15320872	15321457	CpG: 47	585	47	402	16.1	68.7	0.77
chrX	15372999	15373633	CpG: 52	634	52	387	16.4	61.0	0.90
chrX	15437006	15438553	CpG: 167	1547	167	1060	21.6	68.5	0.92
chrX	15844334	15844615	CpG: 25	281	25	176	17.8	62.6	0.92
chrX	16116844	16117068	CpG: 17	224	17	131	15.2	58.5	0.93
chrX	16123045	16123289	CpG: 18	244	18	143	14.8	58.6	0.88
chrX	16130835	16131090	CpG: 20	255	20	155	15.7	60.8	0.87
chrX	16146189	16146411	CpG: 19	222	19	135	17.1	60.8	0.93
chrX	16157918	16158307	CpG: 38	389	38	291	19.5	74.8	0.70
chrX	16255377	16255655	CpG: 24	278	24	175	17.3	62.9	0.88
chrX	16284138	16284372	CpG: 19	234	19	139	16.2	59.4	0.95
chrX	16294280	16295293	CpG: 95	1013	95	720	18.8	71.1	0.74
chrX	16295577	16295789	CpG: 15	212	15	122	14.2	57.5	0.86
chrX	16301977	16302458	CpG: 46	481	46	330	19.1	68.6	0.83
chrX	16368266	16369816	CpG: 148	1550	148	1025	19.1	66.1	0.88
chrX	16452134	16453642	CpG: 188	1508	188	1080	24.9	71.6	0.97
chrX	16529003	16529872	CpG: 107	869	107	673	24.6	77.4	0.84
chrX	16582369	16582644	CpG: 23	275	23	170	16.7	61.8	0.88
chrX	16679007	16679282	CpG: 25	275	25	172	18.2	62.5	0.94
chrX	16700600	16700878	CpG: 24	278	24	174	17.3	62.6	0.89
chrX	16827332	16827923	CpG: 54	591	54	427	18.3	72.3	0.70
chrX	16930660	16930961	CpG: 24	301	24	186	15.9	61.8	0.84
chrX	16957635	16960293	CpG: 237	2658	237	1778	17.8	66.9	0.80
chrX	17085103	17085377	CpG: 25	274	25	173	18.2	63.1	0.93
chrX	17179783	17180021	CpG: 17	238	17	135	14.3	56.7	0.91
chrX	17237870	17238969	CpG: 84	1099	84	711	15.3	64.7	0.73
chrX	17247958	17248187	CpG: 18	229	18	143	15.7	62.4	0.82
chrX	17319549	17321138	CpG: 118	1589	118	939	14.9	59.1	0.85
chrX	17369548	17369843	CpG: 22	295	22	178	14.9	60.3	0.82
chrX	17442928	17444189	CpG: 161	1261	161	955	25.5	75.7	0.90
chrX	17462618	17462879	CpG: 21	261	21	158	16.1	60.5	0.90
chrX	17592382	17592615	CpG: 19	233	19	140	16.3	60.1	0.93
chrX	17666419	17666806	CpG: 32	387	32	279	16.5	72.1	0.64
chrX	17687065	17687357	CpG: 21	292	21	176	14.4	60.3	0.79
chrX	17802737	17803575	CpG: 64	838	64	530	15.3	63.2	0.77
chrX	17900166	17900442	CpG: 24	276	24	172	17.4	62.3	0.90
chrX	17936391	17937642	CpG: 147	1251	147	867	23.5	69.3	0.99
chrX	17938682	17939219	CpG: 35	537	35	310	13.0	57.7	0.78
chrX	17976678	17976952	CpG: 25	274	25	169	18.2	61.7	0.97
chrX	18007615	18008921	CpG: 132	1306	132	919	20.2	70.4	0.82
chrX	18025131	18025409	CpG: 21	278	21	167	15.1	60.1	0.85
chrX	18087255	18087531	CpG: 24	276	24	169	17.4	61.2	0.94
chrX	18114338	18114611	CpG: 22	273	22	169	16.1	61.9	0.85
chrX	18257637	18258084	CpG: 55	447	55	326	24.6	72.9	0.94
chrX	18370662	18370887	CpG: 18	225	18	135	16.0	60.0	0.92
chrX	18442909	18443185	CpG: 22	276	22	170	15.9	61.6	0.85
chrX	18445662	18445936	CpG: 24	274	24	171	17.5	62.4	0.91
chrX	18566599	18567840	CpG: 130	1241	130	890	21.0	71.7	0.82
chrX	18704559	18705716	CpG: 151	1157	151	883	26.1	76.3	0.90
chrX	18725545	18725855	CpG: 26	310	26	193	16.8	62.3	0.87
chrX	18825833	18826112	CpG: 25	279	25	175	17.9	62.7	0.92
chrX	18926326	18927079	CpG: 78	753	78	537	20.7	71.3	0.81
chrX	19030345	19030626	CpG: 24	281	24	175	17.1	62.3	0.89
chrX	19097679	19098528	CpG: 106	849	106	653	25.0	76.9	0.84
chrX	19469816	19471348	CpG: 174	1532	174	1109	22.7	72.4	0.87
chrX	19528824	19529183	CpG: 30	359	30	217	16.7	60.4	0.92
chrX	19573304	19574220	CpG: 120	916	120	705	26.2	77.0	0.92
chrX	19586273	19586547	CpG: 23	274	23	171	16.8	62.4	0.87
chrX	19698962	19700109	CpG: 139	1147	139	802	24.2	69.9	1.00
chrX	19700471	19700776	CpG: 25	305	25	182	16.4	59.7	0.92
chrX	19724195	19725732	CpG: 125	1537	125	938	16.3	61.0	0.87
chrX	19848903	19851587	CpG: 233	2684	233	1801	17.4	67.1	0.78
chrX	19949725	19950109	CpG: 30	384	30	276	15.6	71.9	0.61
chrX	20088980	20089261	CpG: 24	281	24	174	17.1	61.9	0.91
chrX	20261371	20261601	CpG: 16	230	16	135	13.9	58.7	0.83
chrX	20361343	20361636	CpG: 24	293	24	177	16.4	60.4	0.91
chrX	20493122	20493377	CpG: 19	255	19	157	14.9	61.6	0.80
chrX	20536525	20536806	CpG: 24	281	24	174	17.1	61.9	0.90
chrX	20768299	20768580	CpG: 24	281	24	174	17.1	61.9	0.91
chrX	20957055	20958631	CpG: 175	1576	175	1113	22.2	70.6	0.89
chrX	21239222	21242270	CpG: 271	3048	271	2067	17.8	67.8	0.77
chrX	21422774	21423387	CpG: 56	613	56	413	18.3	67.4	0.81
chrX	21433044	21433323	CpG: 23	279	23	164	16.5	58.8	0.97
chrX	21439444	21440008	CpG: 45	564	45	339	16.0	60.1	0.91
chrX	21440561	21440821	CpG: 19	260	19	143	14.6	55.0	0.98
chrX	21445875	21446107	CpG: 18	232	18	142	15.5	61.2	0.85
chrX	21472738	21473017	CpG: 24	279	24	167	17.2	59.9	0.97
chrX	21497281	21497555	CpG: 25	274	25	171	18.2	62.4	0.95
chrX	21523821	21525171	CpG: 167	1350	167	976	24.7	72.3	0.95
chrX	21606060	21606275	CpG: 16	215	16	130	14.9	60.5	0.83
chrX	21839187	21839461	CpG: 24	274	24	172	17.5	62.8	0.90
chrX	21968287	21968528	CpG: 21	241	21	150	17.4	62.2	0.91
chrX	21993450	21993682	CpG: 16	232	16	135	13.8	58.2	0.84
chrX	22001520	22001745	CpG: 19	225	19	136	16.9	60.4	0.93
chrX	22039849	22040123	CpG: 22	274	22	164	16.1	59.9	0.92
chrX	22265674	22265958	CpG: 24	284	24	173	16.9	60.9	0.92
chrX	22420528	22420758	CpG: 18	230	18	140	15.7	60.9	0.86
chrX	22598696	22598914	CpG: 15	218	15	128	13.8	58.7	0.81
chrX	22659885	22660166	CpG: 24	281	24	175	17.1	62.3	0.90
chrX	22698563	22698971	CpG: 33	408	33	245	16.2	60.0	0.90
chrX	22776991	22777275	CpG: 24	284	24	180	16.9	63.4	0.85
chrX	22822222	22822515	CpG: 23	293	23	178	15.7	60.8	0.85
chrX	22915734	22916046	CpG: 25	312	25	195	16.0	62.5	0.83
chrX	22916592	22919089	CpG: 251	2497	251	1715	20.1	68.7	0.85
chrX	22958876	22959144	CpG: 25	268	25	167	18.7	62.3	0.98
chrX	23041429	23041703	CpG: 23	274	23	170	16.8	62.0	0.88
chrX	23064811	23065051	CpG: 21	240	21	149	17.5	62.1	0.93
chrX	23083565	23083844	CpG: 22	279	22	160	15.8	57.3	0.97
chrX	23250856	23251496	CpG: 67	640	67	449	20.9	70.2	0.87
chrX	23326561	23327101	CpG: 61	540	61	369	22.6	68.3	0.97
chrX	23366621	23367290	CpG: 58	669	58	435	17.3	65.0	0.82
chrX	23491150	23491875	CpG: 82	725	82	511	22.6	70.5	0.92
chrX	23531308	23531542	CpG: 17	234	17	142	14.5	60.7	0.80
chrX	23540012	23540243	CpG: 17	231	17	136	14.7	58.9	0.87
chrX	23556401	23556691	CpG: 23	290	23	167	15.9	57.6	0.98
chrX	23583780	23584010	CpG: 18	230	18	135	15.7	58.7	0.92
chrX	23606475	23606728	CpG: 18	253	18	144	14.2	56.9	0.88
chrX	23607140	23607410	CpG: 20	270	20	153	14.8	56.7	0.92
chrX	23609141	23610400	CpG: 158	1259	158	947	25.1	75.2	0.90
chrX	23617918	23618204	CpG: 20	286	20	173	14.0	60.5	0.78
chrX	23620417	23620680	CpG: 24	263	24	166	18.3	63.1	0.93
chrX	23631405	23631647	CpG: 21	242	21	146	17.4	60.3	1.00
chrX	23638016	23638299	CpG: 22	283	22	168	15.5	59.4	0.89
chrX	23638845	23639462	CpG: 51	617	51	383	16.5	62.1	0.87
chrX	23677429	23677921	CpG: 35	492	35	284	14.2	57.7	0.86
chrX	23733397	23734880	CpG: 201	1483	201	1143	27.1	77.1	0.92
chrX	23858790	23859064	CpG: 25	274	25	172	18.2	62.8	0.94
chrX	23897713	23898499	CpG: 69	786	69	494	17.6	62.8	0.89
chrX	23946346	23946707	CpG: 31	361	31	237	17.2	65.7	0.80
chrX	24049190	24050121	CpG: 108	931	108	658	23.2	70.7	0.93
chrX	24065411	24065631	CpG: 17	220	17	133	15.5	60.5	0.86
chrX	24148704	24148940	CpG: 17	236	17	143	14.4	60.6	0.80
chrX	24265286	24265507	CpG: 18	221	18	135	16.3	61.1	0.88
chrX	24277792	24278446	CpG: 70	654	70	441	21.4	67.4	0.94
chrX	24586358	24590327	CpG: 303	3969	303	2461	15.3	62.0	0.80
chrX	24591331	24591835	CpG: 58	504	58	374	23.0	74.2	0.84
chrX	24596581	24598173	CpG: 172	1592	172	1121	21.6	70.4	0.88
chrX	24599784	24600832	CpG: 74	1048	74	648	14.1	61.8	0.74
chrX	24601942	24602243	CpG: 28	301	28	190	18.6	63.1	0.95
chrX	24605010	24605324	CpG: 34	314	34	230	21.7	73.2	0.81
chrX	24606998	24607482	CpG: 52	484	52	353	21.5	72.9	0.81
chrX	25473258	25473539	CpG: 21	281	21	172	14.9	61.2	0.81
chrX	25493199	25494133	CpG: 67	934	67	646	14.3	69.2	0.60
chrX	25532056	25532334	CpG: 25	278	25	175	18.0	62.9	0.92
chrX	25792121	25792431	CpG: 26	310	26	226	16.8	72.9	0.63
chrX	25907391	25907750	CpG: 26	359	26	212	14.5	59.1	0.83
chrX	25932908	25933138	CpG: 21	230	21	142	18.3	61.7	0.97
chrX	26144975	26145389	CpG: 30	414	30	284	14.5	68.6	0.63
chrX	26208951	26209199	CpG: 20	248	20	143	16.1	57.7	0.99
chrX	26460958	26461307	CpG: 32	349	32	253	18.3	72.5	0.70
chrX	26464950	26465201	CpG: 23	251	23	159	18.3	63.3	0.93
chrX	26995530	26995800	CpG: 23	270	23	167	17.0	61.9	0.90
chrX	27104685	27104963	CpG: 24	278	24	173	17.3	62.2	0.90
chrX	27132997	27133227	CpG: 20	230	20	142	17.4	61.7	0.92
chrX	27212647	27212870	CpG: 18	223	18	135	16.1	60.5	0.89
chrX	27226344	27226710	CpG: 30	366	30	229	16.4	62.6	0.85
chrX	27311180	27311465	CpG: 23	285	23	178	16.1	62.5	0.84
chrX	27400247	27400488	CpG: 29	241	29	206	24.1	85.5	0.88
chrX	27454637	27454855	CpG: 28	218	28	151	25.7	69.3	1.07
chrX	27493632	27493904	CpG: 21	272	21	165	15.4	60.7	0.85
chrX	27527307	27527540	CpG: 18	233	18	139	15.5	59.7	0.88
chrX	27797556	27797967	CpG: 32	411	32	250	15.6	60.8	0.85
chrX	27882406	27882659	CpG: 19	253	19	147	15.0	58.1	0.90
chrX	28076502	28076733	CpG: 18	231	18	139	15.6	60.2	0.87
chrX	28158758	28159001	CpG: 17	243	17	141	14.0	58.0	0.85
chrX	28384484	28384721	CpG: 17	237	17	139	14.3	58.6	0.86
chrX	28577678	28577962	CpG: 23	284	23	176	16.2	62.0	0.85
chrX	28985220	28985438	CpG: 20	218	20	136	18.3	62.4	0.97
chrX	29142541	29142765	CpG: 19	224	19	138	17.0	61.6	0.91
chrX	29158249	29158514	CpG: 21	265	21	164	15.8	61.9	0.84
chrX	29375271	29375515	CpG: 21	244	21	149	17.2	61.1	0.94
chrX	29750286	29750522	CpG: 20	236	20	146	16.9	61.9	0.91
chrX	29839406	29839682	CpG: 23	276	23	175	16.7	63.4	0.83
chrX	29900584	29901813	CpG: 116	1229	116	841	18.9	68.4	0.81
chrX	29937772	29938047	CpG: 21	275	21	167	15.3	60.7	0.84
chrX	30140216	30140455	CpG: 19	239	19	142	15.9	59.4	0.92
chrX	30145424	30145660	CpG: 17	236	17	143	14.4	60.6	0.80
chrX	30170230	30170508	CpG: 23	278	23	175	16.5	62.9	0.85
chrX	30191745	30192019	CpG: 23	274	23	171	16.8	62.4	0.87
chrX	30205195	30205466	CpG: 20	271	20	164	14.8	60.5	0.82
chrX	30213789	30214066	CpG: 26	277	26	174	18.8	62.8	0.96
chrX	30246509	30247639	CpG: 99	1130	99	751	17.5	66.5	0.80
chrX	30260776	30261046	CpG: 20	270	20	161	14.8	59.6	0.85
chrX	30279060	30279292	CpG: 21	232	21	141	18.1	60.8	0.99
chrX	30347878	30348608	CpG: 53	730	53	494	14.5	67.7	0.63
chrX	30367298	30367693	CpG: 29	395	29	241	14.7	61.0	0.79
chrX	30408420	30408661	CpG: 18	241	18	149	14.9	61.8	0.79
chrX	30471448	30471714	CpG: 27	266	27	170	20.3	63.9	1.01
chrX	30486982	30487809	CpG: 94	827	94	589	22.7	71.2	0.90
chrX	30603325	30603655	CpG: 23	330	23	187	13.9	56.7	0.89
chrX	30669916	30670465	CpG: 49	549	49	347	17.9	63.2	0.98
chrX	30813111	30813351	CpG: 18	240	18	143	15.0	59.6	0.86
chrX	30864506	30865144	CpG: 70	638	70	446	21.9	69.9	0.90
chrX	30994358	30994594	CpG: 20	236	20	145	16.9	61.4	0.92
chrX	31157515	31157788	CpG: 24	273	24	168	17.6	61.5	0.94
chrX	31313429	31313702	CpG: 24	273	24	170	17.6	62.3	0.91
chrX	31326195	31326479	CpG: 23	284	23	175	16.2	61.6	0.87
chrX	31412394	31412666	CpG: 23	272	23	170	16.9	62.5	0.88
chrX	31741835	31742054	CpG: 17	219	17	127	15.5	58.0	0.94
chrX	31828414	31828689	CpG: 22	275	22	166	16.0	60.4	0.89
chrX	32112514	32112786	CpG: 23	272	23	171	16.9	62.9	0.86
chrX	32122043	32122281	CpG: 19	238	19	144	16.0	60.5	0.90
chrX	32262292	32262528	CpG: 19	236	19	140	16.1	59.3	0.94
chrX	32533039	32533283	CpG: 22	244	22	152	18.0	62.3	0.95
chrX	32631844	32632125	CpG: 20	281	20	164	14.2	58.4	0.84
chrX	32714044	32714292	CpG: 18	248	18	144	14.5	58.1	0.87
chrX	32716605	32716879	CpG: 24	274	24	173	17.5	63.1	0.89
chrX	32729085	32729322	CpG: 16	237	16	145	13.5	61.2	0.73
chrX	32962409	32962690	CpG: 22	281	22	173	15.7	61.6	0.85
chrX	33113104	33113366	CpG: 26	262	26	166	19.8	63.4	1.00
chrX	33324410	33324931	CpG: 36	521	36	329	13.8	63.1	0.69
chrX	33728746	33728963	CpG: 25	217	25	141	23.0	65.0	1.14
chrX	33729270	33729492	CpG: 20	222	20	147	18.0	66.2	0.85
chrX	33745039	33745364	CpG: 29	325	29	211	17.8	64.9	0.87
chrX	33822440	33822677	CpG: 21	237	21	144	17.7	60.8	0.99
chrX	33829639	33829920	CpG: 24	281	24	175	17.1	62.3	0.90
chrX	33852355	33852707	CpG: 25	352	25	208	14.2	59.1	0.81
chrX	33986632	33987101	CpG: 37	469	37	279	15.8	59.5	0.90
chrX	34110415	34110651	CpG: 18	236	18	139	15.3	58.9	0.89
chrX	34138614	34138879	CpG: 21	265	21	159	15.8	60.0	0.89
chrX	34251033	34252253	CpG: 131	1220	131	874	21.5	71.6	0.84
chrX	34537970	34538245	CpG: 23	275	23	179	16.7	65.1	0.82
chrX	34604657	34604906	CpG: 21	249	21	152	16.9	61.0	0.93
chrX	34640212	34640425	CpG: 19	213	19	130	17.8	61.0	0.98
chrX	34816572	34816800	CpG: 20	228	20	135	17.5	59.2	1.00
chrX	35012990	35013264	CpG: 21	274	21	168	15.3	61.3	0.82
chrX	35076104	35076346	CpG: 19	242	19	148	15.7	61.2	0.86
chrX	35094091	35094690	CpG: 55	599	55	449	18.4	75.0	0.66
chrX	35163126	35163362	CpG: 17	236	17	136	14.4	57.6	0.88
chrX	35220792	35221239	CpG: 37	447	37	279	16.6	62.4	0.88
chrX	35857544	35857748	CpG: 19	204	19	151	18.6	74.0	0.68
chrX	35924283	35924556	CpG: 20	273	20	168	14.7	61.5	0.80
chrX	36066625	36066961	CpG: 25	336	25	199	14.9	59.2	0.85
chrX	36553212	36554056	CpG: 90	844	90	618	21.3	73.2	0.80
chrX	36559274	36559902	CpG: 98	628	98	518	31.2	82.5	0.92
chrX	36581217	36582254	CpG: 119	1037	119	740	23.0	71.4	0.90
chrX	36604055	36604413	CpG: 29	358	29	230	16.2	64.2	0.79
chrX	36606228	36606482	CpG: 18	254	18	162	14.2	63.8	0.74
chrX	36639322	36639713	CpG: 38	391	38	280	19.4	71.6	0.85
chrX	36752522	36753610	CpG: 82	1088	82	696	15.1	64.0	0.75
chrX	36895282	36895792	CpG: 45	510	45	349	17.6	68.4	0.80
chrX	36908620	36909119	CpG: 46	499	46	336	18.4	67.3	0.85
chrX	36948652	36948909	CpG: 23	257	23	171	17.9	66.5	0.81
chrX	36975009	36976087	CpG: 128	1078	128	775	23.7	71.9	0.92
chrX	37085681	37085911	CpG: 21	230	21	142	18.3	61.7	0.97
chrX	37089108	37089723	CpG: 86	615	86	454	28.0	73.8	1.03
chrX	37110777	37111278	CpG: 42	501	42	370	16.8	73.9	0.62
chrX	37250625	37251302	CpG: 66	677	66	483	19.5	71.3	0.77
chrX	37292257	37292476	CpG: 16	219	16	128	14.6	58.4	0.88
chrX	37309352	37309592	CpG: 24	240	24	174	20.0	72.5	0.80
chrX	37414942	37415181	CpG: 18	239	18	139	15.1	58.2	0.91
chrX	37518803	37519077	CpG: 24	274	24	171	17.5	62.4	0.91
chrX	37602769	37602991	CpG: 18	222	18	135	16.2	60.8	0.89
chrX	37624036	37624495	CpG: 51	459	51	328	22.2	71.5	0.87
chrX	37659680	37659915	CpG: 27	235	27	175	23.0	74.5	0.83
chrX	37730372	37731350	CpG: 86	978	86	627	17.6	64.1	0.86
chrX	37845508	37845781	CpG: 22	273	22	167	16.1	61.2	0.87
chrX	37964855	37965845	CpG: 98	990	98	643	19.8	64.9	0.94
chrX	38136414	38136656	CpG: 20	242	20	144	16.5	59.5	0.95
chrX	38161139	38161375	CpG: 19	236	19	142	16.1	60.2	0.92
chrX	38203136	38204994	CpG: 155	1858	155	1234	16.7	66.4	0.76
chrX	38297336	38297617	CpG: 23	281	23	174	16.4	61.9	0.87
chrX	38474165	38474405	CpG: 19	240	19	143	15.8	59.6	0.92
chrX	38562401	38562871	CpG: 40	470	40	313	17.0	66.6	0.79
chrX	39013741	39014137	CpG: 29	396	29	248	14.6	62.6	0.75
chrX	39088753	39089610	CpG: 105	857	105	643	24.5	75.0	0.87
chrX	39115527	39115808	CpG: 23	281	23	174	16.4	61.9	0.87
chrX	39221067	39222345	CpG: 141	1278	141	898	22.1	70.3	0.89
chrX	39405520	39410101	CpG: 319	4581	319	2808	13.9	61.3	0.74
chrX	39412527	39415753	CpG: 290	3226	290	2155	18.0	66.8	0.81
chrX	39484742	39485405	CpG: 65	663	65	456	19.6	68.8	0.84
chrX	39491358	39491962	CpG: 58	604	58	428	19.2	70.9	0.77
chrX	39492885	39493651	CpG: 75	766	75	536	19.6	70.0	0.80
chrX	39495420	39511233	CpG: 1233	15813	1233	9962	15.6	63.0	0.79
chrX	39534568	39534968	CpG: 27	400	27	231	13.5	57.8	0.83
chrX	39546290	39549051	CpG: 217	2761	217	1781	15.7	64.5	0.76
chrX	39552904	39558188	CpG: 426	5284	426	3493	16.1	66.1	0.74
chrX	39559357	39559869	CpG: 64	512	64	381	25.0	74.4	0.90
chrX	39560614	39560884	CpG: 22	270	22	161	16.3	59.6	0.93
chrX	39568577	39570361	CpG: 132	1784	132	1083	14.8	60.7	0.81
chrX	39570910	39571300	CpG: 30	390	30	265	15.4	67.9	0.69
chrX	39572803	39578493	CpG: 413	5690	413	3482	14.5	61.2	0.78
chrX	39606729	39606979	CpG: 25	250	25	161	20.0	64.4	0.97
chrX	39612407	39612955	CpG: 46	548	46	407	16.8	74.3	0.61
chrX	39668685	39669069	CpG: 36	384	36	261	18.8	68.0	0.81
chrX	39900966	39901196	CpG: 20	230	20	141	17.4	61.3	0.94
chrX	39982049	39983015	CpG: 103	966	103	657	21.3	68.0	0.92
chrX	40024667	40025506	CpG: 81	839	81	518	19.3	61.7	1.01
chrX	40048142	40048948	CpG: 82	806	82	565	20.3	70.1	0.83
chrX	40071700	40071973	CpG: 22	273	22	168	16.1	61.5	0.87
chrX	40136482	40137424	CpG: 104	942	104	652	22.1	69.2	0.92
chrX	40173217	40173461	CpG: 18	244	18	142	14.8	58.2	0.88
chrX	40233914	40234400	CpG: 50	486	50	346	20.6	71.2	0.82
chrX	40235470	40235953	CpG: 56	483	56	332	23.2	68.7	0.99
chrX	40263279	40264422	CpG: 99	1143	99	830	17.3	72.6	0.66
chrX	40314904	40315187	CpG: 20	283	20	167	14.1	59.0	0.82
chrX	40394848	40395121	CpG: 20	273	20	162	14.7	59.3	0.85
chrX	40446742	40447013	CpG: 21	271	21	163	15.5	60.1	0.86
chrX	40451265	40451535	CpG: 20	270	20	158	14.8	58.5	0.89
chrX	40478803	40479042	CpG: 27	239	27	157	22.6	65.7	1.08
chrX	40486444	40488692	CpG: 224	2248	224	1560	19.9	69.4	0.83
chrX	40655605	40655926	CpG: 34	321	34	205	21.2	63.9	1.04
chrX	40657014	40657215	CpG: 16	201	16	116	15.9	57.7	0.98
chrX	40660766	40661027	CpG: 19	261	19	154	14.6	59.0	0.85
chrX	40677227	40677496	CpG: 23	269	23	166	17.1	61.7	0.90
chrX	40677954	40678548	CpG: 46	594	46	396	15.5	66.7	0.70
chrX	40734806	40737230	CpG: 207	2424	207	1549	17.1	63.9	0.84
chrX	40784226	40784455	CpG: 19	229	19	141	16.6	61.6	0.89
chrX	40819015	40819316	CpG: 23	301	23	174	15.3	57.8	0.92
chrX	40846276	40846809	CpG: 51	533	51	375	19.1	70.4	0.77
chrX	40852391	40852623	CpG: 17	232	17	139	14.7	59.9	0.83
chrX	40877573	40878961	CpG: 166	1388	166	1010	23.9	72.8	0.91
chrX	41327807	41328959	CpG: 171	1152	171	871	29.7	75.6	1.04
chrX	41367545	41367821	CpG: 22	276	22	173	15.9	62.7	0.82
chrX	41612723	41612966	CpG: 22	243	22	149	18.1	61.3	0.96
chrX	41639677	41639911	CpG: 21	234	21	142	17.9	60.7	0.99
chrX	41835754	41836049	CpG: 22	295	22	178	14.9	60.3	0.82
chrX	42136582	42136856	CpG: 22	274	22	169	16.1	61.7	0.85
chrX	42183771	42184434	CpG: 54	663	54	380	16.3	57.3	1.00
chrX	42294405	42294748	CpG: 28	343	28	207	16.3	60.3	0.90
chrX	42318875	42319152	CpG: 23	277	23	170	16.6	61.4	0.89
chrX	42685803	42686016	CpG: 32	213	32	163	30.0	76.5	1.03
chrX	42997496	42997771	CpG: 23	275	23	169	16.7	61.5	0.89
chrX	43027301	43027541	CpG: 22	240	22	149	18.3	62.1	0.98
chrX	43060614	43061750	CpG: 93	1136	93	767	16.4	67.5	0.76
chrX	43062282	43062638	CpG: 28	356	28	227	15.7	63.8	0.78
chrX	43216187	43216453	CpG: 23	266	23	167	17.3	62.8	0.89
chrX	43288250	43288778	CpG: 55	528	55	390	20.8	73.9	0.78
chrX	43386437	43386717	CpG: 24	280	24	174	17.1	62.1	0.91
chrX	43435381	43435857	CpG: 36	476	36	255	15.1	53.6	1.08
chrX	43486909	43487175	CpG: 23	266	23	166	17.3	62.4	0.90
chrX	43538428	43538642	CpG: 15	214	15	127	14.0	59.3	0.81
chrX	43689729	43689935	CpG: 17	206	17	113	16.5	54.9	1.10
chrX	43716578	43716833	CpG: 24	255	24	174	18.8	68.2	0.82
chrX	43749802	43750105	CpG: 29	303	29	215	19.1	71.0	0.77
chrX	43852057	43852331	CpG: 23	274	23	170	16.8	62.0	0.88
chrX	43972371	43972644	CpG: 24	273	24	169	17.6	61.9	0.92
chrX	44103723	44103997	CpG: 21	274	21	172	15.3	62.8	0.79
chrX	44152679	44152910	CpG: 18	231	18	141	15.6	61.0	0.86
chrX	44183287	44183561	CpG: 20	274	20	162	14.6	59.1	0.84
chrX	44188163	44188434	CpG: 21	271	21	165	15.5	60.9	0.84
chrX	44251058	44251467	CpG: 30	409	30	219	14.7	53.5	1.06
chrX	44255717	44255983	CpG: 20	266	20	162	15.0	60.9	0.83
chrX	44256127	44256339	CpG: 15	212	15	121	14.2	57.1	0.89
chrX	44279177	44280928	CpG: 211	1751	211	1240	24.1	70.8	0.96
chrX	44317794	44318747	CpG: 75	953	75	660	15.7	69.3	0.66
chrX	44566653	44566854	CpG: 20	201	20	137	19.9	68.2	0.90
chrX	44625538	44625806	CpG: 20	268	20	162	14.9	60.4	0.82
chrX	44791079	44791658	CpG: 51	579	51	365	17.6	63.0	0.89
chrX	44914083	44914347	CpG: 18	264	18	168	13.6	63.6	0.68
chrX	45229355	45229592	CpG: 17	237	17	143	14.3	60.3	0.81
chrX	45260327	45261360	CpG: 104	1033	104	742	20.1	71.8	0.79
chrX	45319158	45319404	CpG: 23	246	23	153	18.7	62.2	0.99
chrX	45328319	45328593	CpG: 20	274	20	167	14.6	60.9	0.80
chrX	45690774	45691010	CpG: 19	236	19	144	16.1	61.0	0.89
chrX	45853796	45854373	CpG: 52	577	52	369	18.0	64.0	0.89
chrX	45946933	45947161	CpG: 16	228	16	139	14.0	61.0	0.78
chrX	45952167	45952698	CpG: 44	531	44	339	16.6	63.8	0.84
chrX	45980588	45982436	CpG: 232	1848	232	1314	25.1	71.1	0.99
chrX	46165594	46166550	CpG: 117	956	117	708	24.5	74.1	0.89
chrX	46243672	46244606	CpG: 80	934	80	590	17.1	63.2	0.87
chrX	46285097	46285366	CpG: 22	269	22	166	16.4	61.7	0.87
chrX	46319109	46320527	CpG: 178	1418	178	1049	25.1	74.0	0.95
chrX	46341339	46341575	CpG: 17	236	17	139	14.4	58.9	0.84
chrX	46485226	46485744	CpG: 45	518	45	367	17.4	70.8	0.70
chrX	46520719	46521148	CpG: 33	429	33	306	15.4	71.3	0.61
chrX	46538492	46538727	CpG: 18	235	18	138	15.3	58.7	0.92
chrX	46553727	46553944	CpG: 15	217	15	113	13.8	52.1	1.03
chrX	46554071	46555313	CpG: 103	1242	103	794	16.6	63.9	0.81
chrX	46589641	46589867	CpG: 18	226	18	155	15.9	68.6	0.68
chrX	46600385	46600637	CpG: 21	252	21	159	16.7	63.1	0.84
chrX	46603400	46603902	CpG: 46	502	46	338	18.3	67.3	0.84
chrX	46627455	46628929	CpG: 141	1474	141	957	19.1	64.9	0.91
chrX	46642574	46643545	CpG: 87	971	87	622	17.9	64.1	0.96
chrX	46878912	46879186	CpG: 23	274	23	170	16.8	62.0	0.88
chrX	46892369	46893189	CpG: 84	820	84	555	20.5	67.7	0.90
chrX	46922966	46923532	CpG: 67	566	67	397	23.7	70.1	0.98
chrX	46933311	46934075	CpG: 68	764	68	530	17.8	69.4	0.74
chrX	46970893	46971590	CpG: 62	697	62	448	17.8	64.3	0.87
chrX	46983905	46984615	CpG: 59	710	59	539	16.6	75.9	0.62
chrX	47029171	47030016	CpG: 106	845	106	618	25.1	73.1	0.95
chrX	47033543	47033865	CpG: 29	322	29	213	18.0	66.1	0.83
chrX	47047684	47047895	CpG: 20	211	20	154	19.0	73.0	0.71
chrX	47060096	47061012	CpG: 72	916	72	605	15.7	66.0	0.73
chrX	47068519	47069354	CpG: 66	835	66	530	15.8	63.5	0.79
chrX	47199156	47199583	CpG: 29	427	29	253	13.6	59.3	0.78
chrX	47213048	47213278	CpG: 19	230	19	142	16.5	61.7	0.88
chrX	47246568	47246840	CpG: 26	272	26	165	19.1	60.7	1.04
chrX	47414157	47414375	CpG: 20	218	20	144	18.3	66.1	0.84
chrX	47426620	47427294	CpG: 53	674	53	449	15.7	66.6	0.71
chrX	47437272	47437556	CpG: 21	284	21	173	14.8	60.9	0.80
chrX	47481407	47481915	CpG: 37	508	37	310	14.6	61.0	0.79
chrX	47548869	47549663	CpG: 59	794	59	559	14.9	70.4	0.60
chrX	47884819	47885654	CpG: 82	835	82	520	19.6	62.3	1.02
chrX	47917789	47918366	CpG: 59	577	59	421	20.5	73.0	0.78
chrX	47930521	47931261	CpG: 63	740	63	463	17.0	62.6	0.87
chrX	47948385	47949155	CpG: 68	770	68	521	17.7	67.7	0.81
chrX	47983435	47983942	CpG: 55	507	55	311	21.7	61.3	1.16
chrX	47990802	47991110	CpG: 22	308	22	190	14.3	61.7	0.75
chrX	48006553	48007205	CpG: 53	652	53	430	16.3	66.0	0.81
chrX	48007721	48007949	CpG: 22	228	22	151	19.3	66.2	0.89
chrX	48039489	48039737	CpG: 19	248	19	150	15.3	60.5	0.86
chrX	48068327	48069505	CpG: 103	1178	103	855	17.5	72.6	0.66
chrX	48086681	48087337	CpG: 64	656	64	462	19.5	70.4	0.79
chrX	48106991	48107653	CpG: 101	662	101	499	30.5	75.4	1.10
chrX	48143314	48143536	CpG: 16	222	16	133	14.4	59.9	0.81
chrX	48147596	48148067	CpG: 42	471	42	289	17.8	61.4	0.95
chrX	48211798	48212715	CpG: 101	917	101	613	22.0	66.8	1.00
chrX	48236730	48238149	CpG: 140	1419	140	1042	19.7	73.4	0.74
chrX	48241674	48242912	CpG: 126	1238	126	885	20.4	71.5	0.80
chrX	48245413	48246175	CpG: 87	762	87	542	22.8	71.1	0.92
chrX	48295437	48295808	CpG: 26	371	26	212	14.0	57.1	0.87
chrX	48301595	48302570	CpG: 91	975	91	711	18.7	72.9	0.70
chrX	48307698	48308527	CpG: 75	829	75	512	18.1	61.8	0.95
chrX	48309340	48309556	CpG: 15	216	15	122	13.9	56.5	0.91
chrX	48321914	48322673	CpG: 62	759	62	468	16.3	61.7	0.88
chrX	48328963	48330013	CpG: 82	1050	82	667	15.6	63.5	0.77
chrX	48367468	48369095	CpG: 187	1627	187	1105	23.0	67.9	1.01
chrX	48379832	48380649	CpG: 61	817	61	496	14.9	60.7	0.81
chrX	48389666	48389940	CpG: 20	274	20	167	14.6	60.9	0.81
chrX	48395211	48395447	CpG: 18	236	18	138	15.3	58.5	0.91
chrX	48413531	48413849	CpG: 25	318	25	177	15.7	55.7	1.02
chrX	48425114	48425349	CpG: 18	235	18	141	15.3	60.0	0.87
chrX	48454588	48455547	CpG: 90	959	90	643	18.8	67.0	0.86
chrX	48465003	48465591	CpG: 75	588	75	437	25.5	74.3	0.92
chrX	48483704	48484429	CpG: 60	725	60	481	16.6	66.3	0.76
chrX	48485491	48486022	CpG: 51	531	51	347	19.2	65.3	0.90
chrX	48491503	48492044	CpG: 46	541	46	369	17.0	68.2	0.73
chrX	48502602	48502822	CpG: 16	220	16	131	14.5	59.5	0.86
chrX	48503135	48503498	CpG: 29	363	29	217	16.0	59.8	0.90
chrX	48503600	48503822	CpG: 15	222	15	133	13.5	59.9	0.77
chrX	48512004	48512280	CpG: 21	276	21	168	15.2	60.9	0.83
chrX	48512574	48513405	CpG: 75	831	75	546	18.1	65.7	0.84
chrX	48535236	48535658	CpG: 38	422	38	259	18.0	61.4	0.96
chrX	48568057	48568379	CpG: 37	322	37	229	23.0	71.1	0.92
chrX	48568983	48569269	CpG: 23	286	23	194	16.1	67.8	0.70
chrX	48574477	48575707	CpG: 99	1230	99	843	16.1	68.5	0.71
chrX	48577806	48578471	CpG: 53	665	53	442	15.9	66.5	0.72
chrX	48583491	48584512	CpG: 84	1021	84	698	16.5	68.4	0.71
chrX	48587662	48587968	CpG: 28	306	28	210	18.3	68.6	0.85
chrX	48598077	48598460	CpG: 48	383	48	283	25.1	73.9	0.93
chrX	48603236	48603806	CpG: 46	570	46	375	16.1	65.8	0.75
chrX	48611749	48612288	CpG: 59	539	59	389	21.9	72.2	0.84
chrX	48642610	48642921	CpG: 26	311	26	195	16.7	62.7	0.89
chrX	48645728	48646356	CpG: 58	628	58	428	18.5	68.2	0.81
chrX	48647334	48647633	CpG: 26	299	26	194	17.4	64.9	0.89
chrX	48681022	48682577	CpG: 167	1555	167	1079	21.5	69.4	0.90
chrX	48733814	48734429	CpG: 44	615	44	424	14.3	68.9	0.62
chrX	48743337	48743951	CpG: 46	614	46	427	15.0	69.5	0.64
chrX	48752859	48753473	CpG: 46	614	46	426	15.0	69.4	0.64
chrX	48762385	48762999	CpG: 46	614	46	426	15.0	69.4	0.64
chrX	48771910	48772524	CpG: 46	614	46	426	15.0	69.4	0.64
chrX	48781436	48782050	CpG: 45	614	45	425	14.7	69.2	0.63
chrX	48790961	48791575	CpG: 46	614	46	426	15.0	69.4	0.64
chrX	48800471	48801085	CpG: 46	614	46	427	15.0	69.5	0.64
chrX	48809981	48810595	CpG: 45	614	45	426	14.7	69.4	0.63
chrX	48819489	48820103	CpG: 46	614	46	427	15.0	69.5	0.64
chrX	48828999	48829613	CpG: 46	614	46	427	15.0	69.5	0.64
chrX	48838506	48839120	CpG: 46	614	46	424	15.0	69.1	0.65
chrX	48848065	48848678	CpG: 43	613	43	424	14.0	69.2	0.60
chrX	48857585	48858120	CpG: 38	535	38	365	14.2	68.2	0.63
chrX	48867112	48867647	CpG: 38	535	38	365	14.2	68.2	0.63
chrX	48876633	48877168	CpG: 38	535	38	366	14.2	68.4	0.62
chrX	48886175	48886710	CpG: 37	535	37	364	13.8	68.0	0.62
chrX	48895728	48896341	CpG: 43	613	43	424	14.0	69.2	0.60
chrX	48905249	48905862	CpG: 43	613	43	424	14.0	69.2	0.60
chrX	48914805	48915380	CpG: 41	575	41	396	14.3	68.9	0.63
chrX	49194622	49194941	CpG: 23	319	23	210	14.4	65.8	0.67
chrX	49195193	49195883	CpG: 86	690	86	529	24.9	76.7	0.85
chrX	49238355	49239322	CpG: 91	967	91	636	18.8	65.8	0.87
chrX	49340982	49341409	CpG: 33	427	33	257	15.5	60.2	0.86
chrX	49377825	49378252	CpG: 33	427	33	258	15.5	60.4	0.85
chrX	49479807	49480013	CpG: 15	206	15	115	14.6	55.8	0.97
chrX	49481041	49481357	CpG: 31	316	31	234	19.6	74.1	0.72
chrX	49552756	49552976	CpG: 16	220	16	134	14.5	60.9	0.79
chrX	49679833	49680112	CpG: 23	279	23	172	16.5	61.6	0.88
chrX	49700842	49701080	CpG: 21	238	21	146	17.6	61.3	0.96
chrX	49740860	49741097	CpG: 21	237	21	169	17.7	71.3	0.70
chrX	49741958	49742416	CpG: 42	458	42	318	18.3	69.4	0.76
chrX	49742887	49743107	CpG: 21	220	21	142	19.1	64.5	0.92
chrX	49882653	49882885	CpG: 20	232	20	140	17.2	60.3	0.97
chrX	50084504	50085545	CpG: 82	1041	82	695	15.8	66.8	0.71
chrX	50176232	50176466	CpG: 18	234	18	134	15.4	57.3	0.95
chrX	50270212	50270491	CpG: 23	279	23	173	16.5	62.0	0.87
chrX	50330810	50331087	CpG: 24	277	24	176	17.3	63.5	0.87
chrX	50603704	50604763	CpG: 107	1059	107	717	20.2	67.7	0.88
chrX	50606325	50606586	CpG: 19	261	19	156	14.6	59.8	0.82
chrX	50667386	50667688	CpG: 28	302	28	202	18.5	66.9	0.83
chrX	50678094	50679344	CpG: 96	1250	96	832	15.4	66.6	0.70
chrX	50767147	50768531	CpG: 152	1384	152	913	22.0	66.0	1.01
chrX	50889225	50890151	CpG: 107	926	107	668	23.1	72.1	0.89
chrX	50953383	50954315	CpG: 107	932	107	674	23.0	72.3	0.88
chrX	50982105	50983037	CpG: 107	932	107	675	23.0	72.4	0.88
chrX	51014975	51015571	CpG: 60	596	60	398	20.1	66.8	0.90
chrX	51166430	51166676	CpG: 19	246	19	166	15.4	67.5	0.82
chrX	51340838	51341223	CpG: 36	385	36	269	18.7	69.9	0.78
chrX	51456354	51456739	CpG: 36	385	36	269	18.7	69.9	0.78
chrX	51493884	51494278	CpG: 28	394	28	235	14.2	59.6	0.80
chrX	51533534	51534075	CpG: 42	541	42	361	15.5	66.7	0.71
chrX	52111670	52112577	CpG: 69	907	69	644	15.2	71.0	0.60
chrX	52121518	52121756	CpG: 16	238	16	140	13.4	58.8	0.80
chrX	52181756	52182638	CpG: 96	882	96	585	21.8	66.3	0.99
chrX	52205591	52206834	CpG: 101	1243	101	753	16.3	60.6	0.89
chrX	52219335	52220080	CpG: 62	745	62	475	16.6	63.8	0.83
chrX	52242600	52243482	CpG: 96	882	96	585	21.8	66.3	0.99
chrX	52279932	52280299	CpG: 28	367	28	223	15.3	60.8	0.83
chrX	52285042	52285427	CpG: 32	385	32	235	16.6	61.0	0.89
chrX	52307278	52307508	CpG: 19	230	19	142	16.5	61.7	0.88
chrX	52356351	52356649	CpG: 21	298	21	171	14.1	57.4	0.95
chrX	52368335	52369070	CpG: 84	735	84	518	22.9	70.5	0.93
chrX	52374524	52375087	CpG: 44	563	44	361	15.6	64.1	0.77
chrX	52380365	52380831	CpG: 53	466	53	323	22.7	69.3	0.96
chrX	52392126	52392388	CpG: 18	262	18	158	13.7	60.3	0.77
chrX	52474051	52474264	CpG: 16	213	16	125	15.0	58.7	0.89
chrX	52489112	52489375	CpG: 21	263	21	161	16.0	61.2	0.87
chrX	52510865	52511908	CpG: 92	1043	92	648	17.6	62.1	0.92
chrX	52540908	52541117	CpG: 16	209	16	127	15.3	60.8	0.83
chrX	52606732	52607929	CpG: 137	1197	137	903	22.9	75.4	0.81
chrX	52646787	52647029	CpG: 20	242	20	147	16.5	60.7	0.91
chrX	52708361	52709166	CpG: 81	805	81	523	20.1	65.0	0.98
chrX	52720573	52720858	CpG: 33	285	33	190	23.2	66.7	1.05
chrX	52727973	52728418	CpG: 36	445	36	293	16.2	65.8	0.75
chrX	52789898	52790986	CpG: 80	1088	80	754	14.7	69.3	0.61
chrX	52957910	52958142	CpG: 19	232	19	140	16.4	60.3	0.90
chrX	52969897	52970859	CpG: 90	962	90	597	18.7	62.1	0.99
chrX	52972470	52973207	CpG: 64	737	64	523	17.4	71.0	0.71
chrX	53007636	53008276	CpG: 50	640	50	446	15.6	69.7	0.64
chrX	53035158	53035390	CpG: 17	232	17	137	14.7	59.1	0.86
chrX	53097775	53098048	CpG: 21	273	21	163	15.4	59.7	0.87
chrX	53102658	53102894	CpG: 19	236	19	141	16.1	59.7	0.92
chrX	53126743	53127017	CpG: 23	274	23	171	16.8	62.4	0.88
chrX	53311357	53311631	CpG: 23	274	23	171	16.8	62.4	0.87
chrX	53333767	53334766	CpG: 102	999	102	650	20.4	65.1	0.97
chrX	53355220	53355494	CpG: 24	274	24	171	17.5	62.4	0.91
chrX	53367841	53368119	CpG: 25	278	25	175	18.0	62.9	0.92
chrX	53414189	53414481	CpG: 23	292	23	177	15.8	60.6	0.86
chrX	53418935	53419804	CpG: 67	869	67	604	15.4	69.5	0.64
chrX	53472395	53473247	CpG: 90	852	90	611	21.1	71.7	0.83
chrX	53505227	53505725	CpG: 42	498	42	326	16.9	65.5	0.79
chrX	53533022	53533306	CpG: 21	284	21	169	14.8	59.5	0.85
chrX	53634551	53634926	CpG: 28	375	28	222	14.9	59.2	0.86
chrX	53647327	53648935	CpG: 136	1608	136	1019	16.9	63.4	0.85
chrX	53665040	53665384	CpG: 24	344	24	208	14.0	60.5	0.78
chrX	53669558	53669794	CpG: 18	236	18	146	15.3	61.9	0.80
chrX	53785870	53787174	CpG: 135	1304	135	968	20.7	74.2	0.76
chrX	53820853	53821386	CpG: 50	533	50	338	18.8	63.4	0.93
chrX	53930217	53930710	CpG: 36	493	36	287	14.6	58.2	0.86
chrX	54060907	54061266	CpG: 27	359	27	211	15.0	58.8	0.87
chrX	54099211	54099460	CpG: 18	249	18	161	14.5	64.7	0.74
chrX	54099670	54099975	CpG: 24	305	24	196	15.7	64.3	0.82
chrX	54107674	54107948	CpG: 23	274	23	170	16.8	62.0	0.88
chrX	54293052	54293678	CpG: 52	626	52	380	16.6	60.7	0.91
chrX	54445054	54445328	CpG: 23	274	23	170	16.8	62.0	0.88
chrX	54454030	54454846	CpG: 70	816	70	535	17.2	65.6	0.81
chrX	54573989	54574263	CpG: 24	274	24	171	17.5	62.4	0.91
chrX	54584606	54584873	CpG: 23	267	23	166	17.2	62.2	0.90
chrX	54777255	54777959	CpG: 64	704	64	486	18.2	69.0	0.76
chrX	54821120	54821394	CpG: 25	274	25	172	18.2	62.8	0.93
chrX	55328018	55328258	CpG: 21	240	21	148	17.5	61.7	0.94
chrX	55515953	55516253	CpG: 26	300	26	219	17.3	73.0	0.66
chrX	55525849	55526057	CpG: 17	208	17	128	16.3	61.5	0.86
chrX	55673783	55674061	CpG: 19	278	19	186	13.7	66.9	0.61
chrX	55774911	55775185	CpG: 23	274	23	167	16.8	60.9	0.91
chrX	55856826	55857395	CpG: 61	569	61	392	21.4	68.9	0.90
chrX	55989202	55989629	CpG: 31	427	31	255	14.5	59.7	0.82
chrX	56060740	56060978	CpG: 27	238	27	174	22.7	73.1	0.85
chrX	56213809	56214090	CpG: 23	281	23	173	16.4	61.6	0.88
chrX	56267165	56267398	CpG: 16	233	16	140	13.7	60.1	0.78
chrX	56293984	56294437	CpG: 39	453	39	290	17.2	64.0	0.84
chrX	56420119	56420437	CpG: 32	318	32	216	20.1	67.9	0.87
chrX	56429974	56430259	CpG: 25	285	25	179	17.5	62.8	0.90
chrX	56436087	56436309	CpG: 22	222	22	144	19.8	64.9	0.96
chrX	56890778	56891704	CpG: 111	926	111	697	24.0	75.3	0.85
chrX	57208915	57210170	CpG: 122	1255	122	895	19.4	71.3	0.77
chrX	57566415	57566643	CpG: 17	228	17	141	14.9	61.8	0.79
chrX	57695501	57695776	CpG: 22	275	22	169	16.0	61.5	0.86
chrX	60593368	60593794	CpG: 32	426	32	254	15.0	59.6	0.85
chrX	60938149	60938376	CpG: 20	227	20	135	17.6	59.5	1.00
chrX	61409655	61409891	CpG: 20	236	20	145	16.9	61.4	0.92
chrX	61556697	61556971	CpG: 23	274	23	170	16.8	62.0	0.88
chrX	61671637	61671911	CpG: 23	274	23	170	16.8	62.0	0.88
chrX	61776342	61776816	CpG: 51	474	51	324	21.5	68.4	0.92
chrX	62180107	62180612	CpG: 43	505	43	320	17.0	63.4	0.87
chrX	62444189	62444548	CpG: 27	359	27	212	15.0	59.1	0.86
chrX	62469204	62469723	CpG: 42	519	42	336	16.2	64.7	0.82
chrX	62629593	62631585	CpG: 136	1992	136	1303	13.7	65.4	0.64
chrX	62683201	62683628	CpG: 31	427	31	255	14.5	59.7	0.82
chrX	62692530	62692764	CpG: 20	234	20	143	17.1	61.1	0.94
chrX	62727495	62727854	CpG: 28	359	28	210	15.6	58.5	0.91
chrX	62820356	62820822	CpG: 34	466	34	286	14.6	61.4	0.78
chrX	62823788	62824066	CpG: 25	278	25	175	18.0	62.9	0.92
chrX	63319585	63319924	CpG: 25	339	25	196	14.7	57.8	0.89
chrX	63427731	63428014	CpG: 26	283	26	220	18.4	77.7	0.61
chrX	63459949	63460832	CpG: 78	883	78	604	17.7	68.4	0.76
chrX	63729856	63730071	CpG: 17	215	17	126	15.8	58.6	0.95
chrX	63832123	63833756	CpG: 191	1633	191	1140	23.4	69.8	0.96
chrX	63960881	63961370	CpG: 43	489	43	303	17.6	62.0	0.97
chrX	63977965	63978752	CpG: 62	787	62	534	15.8	67.9	0.69
chrX	64046795	64047012	CpG: 22	217	22	136	20.3	62.7	1.03
chrX	64093911	64094398	CpG: 48	487	48	347	19.7	71.3	0.78
chrX	64213719	64214019	CpG: 24	300	24	183	16.0	61.0	0.87
chrX	64248526	64248934	CpG: 45	408	45	296	22.1	72.5	0.87
chrX	64334817	64335041	CpG: 16	224	16	136	14.3	60.7	0.80
chrX	64978086	64978360	CpG: 25	274	25	172	18.2	62.8	0.94
chrX	65176233	65176515	CpG: 26	282	26	177	18.4	62.8	0.95
chrX	65973673	65974456	CpG: 56	783	56	521	14.3	66.5	0.65
chrX	65976026	65976475	CpG: 53	449	53	326	23.6	72.6	0.90
chrX	66515882	66516163	CpG: 23	281	23	174	16.4	61.9	0.87
chrX	66565622	66565895	CpG: 27	273	27	190	19.8	69.6	0.86
chrX	66649740	66650168	CpG: 34	428	34	254	15.9	59.3	0.91
chrX	66761319	66761895	CpG: 42	576	42	346	14.6	60.1	0.82
chrX	66827447	66827683	CpG: 22	236	22	146	18.6	61.9	1.00
chrX	66866590	66867551	CpG: 71	961	71	613	14.8	63.8	0.73
chrX	66908548	66908829	CpG: 22	281	22	173	15.7	61.6	0.84
chrX	66930796	66931073	CpG: 23	277	23	171	16.6	61.7	0.88
chrX	66932042	66932686	CpG: 60	644	60	427	18.6	66.3	0.88
chrX	67119719	67120083	CpG: 41	364	41	264	22.5	72.5	0.86
chrX	67126909	67127744	CpG: 79	835	79	585	18.9	70.1	0.77
chrX	67216826	67217186	CpG: 30	360	30	227	16.7	63.1	0.84
chrX	67236305	67236541	CpG: 17	236	17	143	14.4	60.6	0.81
chrX	67262157	67263750	CpG: 154	1593	154	1098	19.3	68.9	0.83
chrX	67273682	67274062	CpG: 27	380	27	239	14.2	62.9	0.73
chrX	67327958	67328228	CpG: 20	270	20	179	14.8	66.3	0.69
chrX	67386498	67386745	CpG: 22	247	22	144	17.8	58.3	1.07
chrX	67561936	67562312	CpG: 37	376	37	263	19.7	69.9	0.81
chrX	67583355	67583622	CpG: 22	267	22	198	16.5	74.2	0.70
chrX	67598450	67598941	CpG: 47	491	47	331	19.1	67.4	0.86
chrX	67654915	67655224	CpG: 24	309	24	219	15.5	70.9	0.71
chrX	67739100	67739441	CpG: 27	341	27	219	15.8	64.2	0.77
chrX	67803891	67804165	CpG: 22	274	22	170	16.1	62.0	0.84
chrX	67855226	67855449	CpG: 17	223	17	153	15.2	68.6	0.65
chrX	67937303	67939623	CpG: 255	2320	255	1666	22.0	71.8	0.86
chrX	67971770	67972226	CpG: 44	456	44	320	19.3	70.2	0.79
chrX	68006850	68007119	CpG: 22	269	22	158	16.4	58.7	0.96
chrX	68019427	68019694	CpG: 26	267	26	171	19.5	64.0	0.96
chrX	68049217	68050632	CpG: 111	1415	111	962	15.7	68.0	0.68
chrX	68115880	68116107	CpG: 17	227	17	131	15.0	57.7	0.90
chrX	68277119	68277355	CpG: 17	236	17	141	14.4	59.7	0.83
chrX	68495885	68496786	CpG: 76	901	76	560	16.9	62.2	0.87
chrX	68556362	68556725	CpG: 30	363	30	266	16.5	73.3	0.62
chrX	68566609	68567409	CpG: 62	800	62	475	15.5	59.4	0.88
chrX	68616047	68616316	CpG: 20	269	20	165	14.9	61.3	0.80
chrX	68723113	68723431	CpG: 34	318	34	213	21.4	67.0	0.96
chrX	68781024	68781298	CpG: 24	274	24	171	17.5	62.4	0.91
chrX	68782320	68783871	CpG: 114	1551	114	1081	14.7	69.7	0.61
chrX	68805012	68805990	CpG: 75	978	75	684	15.3	69.9	0.63
chrX	68867169	68868123	CpG: 81	954	81	628	17.0	65.8	0.78
chrX	68878231	68878830	CpG: 61	599	61	448	20.4	74.8	0.73
chrX	68885727	68886067	CpG: 33	340	33	258	19.4	75.9	0.70
chrX	68888274	68888780	CpG: 45	506	45	363	17.8	71.7	0.71
chrX	69017379	69017664	CpG: 23	285	23	173	16.1	60.7	0.89
chrX	69063387	69063617	CpG: 17	230	17	135	14.8	58.7	0.88
chrX	69072386	69072634	CpG: 20	248	20	151	16.1	60.9	0.87
chrX	69112425	69113386	CpG: 81	961	81	685	16.9	71.3	0.66
chrX	69294420	69294694	CpG: 23	274	23	170	16.8	62.0	0.88
chrX	69342932	69343322	CpG: 27	390	27	223	13.8	57.2	0.85
chrX	69364874	69365201	CpG: 27	327	27	210	16.5	64.2	0.80
chrX	69487242	69487488	CpG: 19	246	19	149	15.4	60.6	0.84
chrX	69502133	69502602	CpG: 56	469	56	322	23.9	68.7	1.02
chrX	69529742	69530917	CpG: 79	1175	79	724	13.4	61.6	0.74
chrX	69548922	69549195	CpG: 22	273	22	165	16.1	60.4	0.89
chrX	69552533	69553119	CpG: 51	586	51	386	17.4	65.9	0.80
chrX	69568034	69568272	CpG: 19	238	19	141	16.0	59.2	0.94
chrX	69603775	69604040	CpG: 19	265	19	182	14.3	68.7	0.62
chrX	69616104	69616455	CpG: 27	351	27	201	15.4	57.3	1.05
chrX	69652698	69652931	CpG: 17	233	17	135	14.6	57.9	0.88
chrX	69658277	69658501	CpG: 18	224	18	144	16.1	64.3	0.82
chrX	69688066	69688541	CpG: 43	475	43	324	18.1	68.2	0.78
chrX	69691506	69691780	CpG: 19	274	19	151	13.9	55.1	0.93
chrX	69717513	69718222	CpG: 57	709	57	410	16.1	57.8	0.96
chrX	69746595	69746873	CpG: 20	278	20	170	14.4	61.2	0.79
chrX	69775353	69776526	CpG: 92	1173	92	843	15.7	71.9	0.61
chrX	69791020	69791235	CpG: 16	215	16	129	14.9	60.0	0.85
chrX	69799967	69801315	CpG: 88	1348	88	807	13.1	59.9	0.73
chrX	69886148	69887053	CpG: 69	905	69	626	15.2	69.2	0.64
chrX	69926283	69927055	CpG: 80	772	80	530	20.7	68.7	0.88
chrX	69953127	69953402	CpG: 19	275	19	166	13.8	60.4	0.78
chrX	69966039	69966366	CpG: 32	327	32	189	19.6	57.8	1.17
chrX	70011155	70011754	CpG: 45	599	45	347	15.0	57.9	0.90
chrX	70036913	70037503	CpG: 55	590	55	305	18.6	51.7	1.40
chrX	70078106	70079003	CpG: 71	897	71	633	15.8	70.6	0.64
chrX	70099673	70100210	CpG: 37	537	37	352	13.8	65.5	0.64
chrX	70101062	70101358	CpG: 24	296	24	199	16.2	67.2	0.74
chrX	70149529	70149741	CpG: 15	212	15	135	14.2	63.7	0.74
chrX	70150930	70152943	CpG: 142	2013	142	1327	14.1	65.9	0.65
chrX	70195693	70197706	CpG: 142	2013	142	1327	14.1	65.9	0.65
chrX	70198895	70199107	CpG: 15	212	15	135	14.2	63.7	0.74
chrX	70306398	70307122	CpG: 49	724	49	479	13.5	66.2	0.62
chrX	70310547	70311009	CpG: 39	462	39	345	16.9	74.7	0.61
chrX	70344403	70345544	CpG: 132	1141	132	831	23.1	72.8	0.88
chrX	70451943	70452443	CpG: 60	500	60	361	24.0	72.2	0.92
chrX	70531912	70532149	CpG: 19	237	19	141	16.0	59.5	0.92
chrX	70564697	70565893	CpG: 130	1196	130	835	21.7	69.8	0.90
chrX	70615170	70615435	CpG: 21	265	21	157	15.8	59.2	0.91
chrX	70617763	70618047	CpG: 20	284	20	172	14.1	60.6	0.77
chrX	70671612	70672589	CpG: 79	977	79	596	16.2	61.0	0.87
chrX	70697886	70698093	CpG: 16	207	16	128	15.5	61.8	0.83
chrX	70709747	70710274	CpG: 48	527	48	351	18.2	66.6	0.83
chrX	70719406	70719643	CpG: 19	237	19	147	16.0	62.0	0.85
chrX	70737901	70740345	CpG: 233	2444	233	1645	19.1	67.3	0.84
chrX	70904995	70905269	CpG: 23	274	23	170	16.8	62.0	0.88
chrX	71007427	71007629	CpG: 16	202	16	123	15.8	60.9	0.89
chrX	71087743	71088017	CpG: 24	274	24	170	17.5	62.0	0.92
chrX	71144385	71144659	CpG: 25	274	25	172	18.2	62.8	0.94
chrX	71147214	71147923	CpG: 76	709	76	481	21.4	67.8	0.95
chrX	71153572	71153811	CpG: 18	239	18	145	15.1	60.7	0.84
chrX	71210559	71211037	CpG: 39	478	39	332	16.3	69.5	0.69
chrX	71254030	71254271	CpG: 19	241	19	152	15.8	63.1	0.81
chrX	71276984	71277260	CpG: 27	276	27	176	19.6	63.8	0.97
chrX	71310567	71310843	CpG: 27	276	27	176	19.6	63.8	0.97
chrX	71333556	71333797	CpG: 19	241	19	152	15.8	63.1	0.81
chrX	71376790	71377268	CpG: 39	478	39	332	16.3	69.5	0.69
chrX	71436080	71437742	CpG: 164	1662	164	1137	19.7	68.4	0.84
chrX	71512294	71513956	CpG: 164	1662	164	1137	19.7	68.4	0.84
chrX	71539689	71540116	CpG: 32	427	32	255	15.0	59.7	0.84
chrX	71814515	71814807	CpG: 23	292	23	176	15.8	60.3	0.87
chrX	71880704	71881137	CpG: 34	433	34	283	15.7	65.4	0.74
chrX	71996471	71996929	CpG: 42	458	42	290	18.3	63.3	0.92
chrX	72318761	72318974	CpG: 17	213	17	126	16.0	59.2	0.93
chrX	72377719	72377963	CpG: 26	244	26	162	21.3	66.4	0.98
chrX	72538869	72539227	CpG: 41	358	41	246	22.9	68.7	0.98
chrX	72724681	72724942	CpG: 20	261	20	155	15.3	59.4	0.87
chrX	72725863	72726239	CpG: 29	376	29	226	15.4	60.1	1.04
chrX	72737594	72737800	CpG: 17	206	17	122	16.5	59.2	0.96
chrX	72845995	72846706	CpG: 56	711	56	503	15.8	70.7	0.63
chrX	72853523	72855636	CpG: 143	2113	143	1416	13.5	67.0	0.60
chrX	72856119	72856391	CpG: 27	272	27	197	19.9	72.4	0.76
chrX	72944839	72945119	CpG: 21	280	21	167	15.0	59.6	0.85
chrX	72969447	72970586	CpG: 88	1139	88	751	15.5	65.9	0.72
chrX	73047808	73048406	CpG: 56	598	56	380	18.7	63.5	0.94
chrX	73312277	73312529	CpG: 18	252	18	148	14.3	58.7	0.83
chrX	73357661	73359063	CpG: 153	1402	153	945	21.8	67.4	0.97
chrX	73611879	73612104	CpG: 18	225	18	123	16.0	54.7	1.07
chrX	73622259	73622563	CpG: 21	304	21	183	13.8	60.2	0.78
chrX	73638759	73639047	CpG: 25	288	25	179	17.4	62.2	0.91
chrX	73650443	73650720	CpG: 18	277	18	169	13.0	61.0	0.70
chrX	73688458	73688739	CpG: 22	281	22	174	15.7	61.9	0.83
chrX	73794136	73794413	CpG: 26	277	26	175	18.8	63.2	0.95
chrX	73876381	73876655	CpG: 20	274	20	169	14.6	61.7	0.78
chrX	73956607	73956959	CpG: 31	352	31	234	17.6	66.5	0.80
chrX	74180583	74180894	CpG: 52	311	52	248	33.4	79.7	1.07
chrX	74441030	74441325	CpG: 26	295	26	180	17.6	61.0	0.95
chrX	74463118	74463418	CpG: 26	300	26	218	17.3	72.7	0.67
chrX	74526300	74526587	CpG: 24	287	24	180	16.7	62.7	0.87
chrX	74578411	74579081	CpG: 54	670	54	400	16.1	59.7	0.91
chrX	74582692	74583362	CpG: 54	670	54	400	16.1	59.7	0.91
chrX	74678215	74678600	CpG: 30	385	30	217	15.6	56.4	0.99
chrX	74762272	74762582	CpG: 25	310	25	184	16.1	59.4	0.92
chrX	74861622	74862940	CpG: 92	1318	92	903	14.0	68.5	0.62
chrX	75121675	75121960	CpG: 24	285	24	177	16.8	62.1	0.89
chrX	75159502	75159728	CpG: 19	226	19	129	16.8	57.1	1.03
chrX	75307905	75308186	CpG: 22	281	22	173	15.7	61.6	0.84
chrX	75331828	75332069	CpG: 19	241	19	147	15.8	61.0	0.88
chrX	75480207	75480450	CpG: 19	243	19	145	15.6	59.7	0.88
chrX	75791480	75791758	CpG: 26	278	26	175	18.7	62.9	0.95
chrX	75885025	75885737	CpG: 84	712	84	510	23.6	71.6	0.92
chrX	76203811	76204662	CpG: 67	851	67	580	15.7	68.2	0.68
chrX	76211944	76212206	CpG: 18	262	18	158	13.7	60.3	0.76
chrX	76223071	76223793	CpG: 55	722	55	445	15.2	61.6	0.85
chrX	76330398	76330808	CpG: 32	410	32	223	15.6	54.4	1.07
chrX	76331185	76331436	CpG: 19	251	19	153	15.1	61.0	0.82
chrX	76333640	76334023	CpG: 28	383	28	225	14.6	58.7	0.86
chrX	76345483	76345854	CpG: 32	371	32	240	17.3	64.7	0.86
chrX	76507470	76507756	CpG: 24	286	24	179	16.8	62.6	0.87
chrX	76538887	76539563	CpG: 76	676	76	440	22.5	65.1	1.06
chrX	76574415	76574876	CpG: 43	461	43	314	18.7	68.1	0.80
chrX	77682009	77682288	CpG: 23	279	23	172	16.5	61.6	0.88
chrX	77941369	77941644	CpG: 23	275	23	170	16.7	61.8	0.88
chrX	77986864	77987157	CpG: 21	293	21	165	14.3	56.3	0.92
chrX	78014683	78014889	CpG: 17	206	17	113	16.5	54.9	1.14
chrX	78359070	78359542	CpG: 31	472	31	275	13.1	58.3	0.78
chrX	78632977	78633223	CpG: 23	246	23	151	18.7	61.4	1.00
chrX	78767931	78768218	CpG: 27	287	27	191	18.8	66.6	0.89
chrX	78774443	78774717	CpG: 24	274	24	172	17.5	62.8	0.90
chrX	78825243	78825524	CpG: 24	281	24	175	17.1	62.3	0.89
chrX	78838944	78839168	CpG: 21	224	21	134	18.8	59.8	1.05
chrX	79007059	79007348	CpG: 21	289	21	178	14.5	61.6	0.77
chrX	79008383	79008828	CpG: 50	445	50	301	22.5	67.6	0.99
chrX	79146090	79146931	CpG: 64	841	64	584	15.2	69.4	0.63
chrX	79243186	79243399	CpG: 21	213	21	141	19.7	66.2	0.90
chrX	79247298	79247535	CpG: 19	237	19	139	16.0	58.6	0.95
chrX	79276620	79276894	CpG: 23	274	23	166	16.8	60.6	0.93
chrX	79305953	79306234	CpG: 24	281	24	175	17.1	62.3	0.89
chrX	79437339	79437743	CpG: 42	404	42	280	20.8	69.3	0.87
chrX	79645024	79645261	CpG: 18	237	18	143	15.2	60.3	0.87
chrX	79783753	79784033	CpG: 24	280	24	175	17.1	62.5	0.89
chrX	79816208	79816444	CpG: 19	236	19	142	16.1	60.2	0.91
chrX	80151867	80152071	CpG: 16	204	16	122	15.7	59.8	0.88
chrX	80169907	80170182	CpG: 24	275	24	170	17.5	61.8	0.92
chrX	80245618	80245899	CpG: 23	281	23	173	16.4	61.6	0.88
chrX	80276862	80277255	CpG: 30	393	30	236	15.3	60.1	0.85
chrX	80595814	80596095	CpG: 24	281	24	175	17.1	62.3	0.90
chrX	80853712	80853936	CpG: 21	224	21	139	18.8	62.1	1.00
chrX	81169304	81169562	CpG: 20	258	20	186	15.5	72.1	0.60
chrX	81263831	81264067	CpG: 18	236	18	141	15.3	59.7	0.87
chrX	81328244	81328445	CpG: 16	201	16	123	15.9	61.2	0.86
chrX	81749513	81749794	CpG: 23	281	23	174	16.4	61.9	0.87
chrX	81830139	81830413	CpG: 23	274	23	170	16.8	62.0	0.88
chrX	81942138	81943029	CpG: 63	891	63	536	14.1	60.2	0.78
chrX	81944010	81944344	CpG: 28	334	28	208	16.8	62.3	0.87
chrX	81974225	81974465	CpG: 18	240	18	139	15.0	57.9	0.92
chrX	81975992	81976419	CpG: 32	427	32	256	15.0	60.0	0.84
chrX	82074039	82074309	CpG: 20	270	20	168	14.8	62.2	0.78
chrX	82165159	82165433	CpG: 22	274	22	169	16.1	61.7	0.85
chrX	82183395	82183671	CpG: 21	276	21	180	15.2	65.2	0.74
chrX	82295861	82296103	CpG: 18	242	18	141	14.9	58.3	0.89
chrX	82599856	82600141	CpG: 25	285	25	180	17.5	63.2	0.90
chrX	82623876	82624992	CpG: 103	1116	103	764	18.5	68.5	0.79
chrX	82743779	82744009	CpG: 20	230	20	143	17.4	62.2	0.92
chrX	82793032	82793267	CpG: 17	235	17	139	14.5	59.1	0.85
chrX	82821595	82821869	CpG: 22	274	22	170	16.1	62.0	0.85
chrX	82975025	82975303	CpG: 22	278	22	167	15.8	60.1	0.88
chrX	83284301	83284507	CpG: 17	206	17	116	16.5	56.3	1.09
chrX	83304672	83304906	CpG: 20	234	20	143	17.1	61.1	0.93
chrX	83362527	83363053	CpG: 46	526	46	358	17.5	68.1	0.77
chrX	83431568	83431843	CpG: 25	275	25	169	18.2	61.5	0.98
chrX	83515228	83515468	CpG: 21	240	21	143	17.5	59.6	1.01
chrX	83524506	83524780	CpG: 25	274	25	171	18.2	62.4	0.94
chrX	83672615	83673727	CpG: 97	1112	97	711	17.4	63.9	0.86
chrX	83683090	83683325	CpG: 20	235	20	140	17.0	59.6	0.96
chrX	83727830	83728100	CpG: 23	270	23	167	17.0	61.9	0.90
chrX	84402522	84402769	CpG: 18	247	18	141	14.6	57.1	0.93
chrX	84403559	84403960	CpG: 35	401	35	293	17.5	73.1	0.65
chrX	84579164	84580098	CpG: 69	934	69	580	14.8	62.1	0.78
chrX	85049995	85050272	CpG: 24	277	24	171	17.3	61.7	0.92
chrX	85329024	85329302	CpG: 25	278	25	177	18.0	63.7	0.90
chrX	85460379	85460985	CpG: 42	606	42	397	13.9	65.5	0.65
chrX	85932957	85933232	CpG: 24	275	24	169	17.5	61.5	0.94
chrX	86027246	86027473	CpG: 16	227	16	134	14.1	59.0	0.82
chrX	86234963	86235212	CpG: 17	249	17	136	13.7	54.6	0.96
chrX	86236027	86236258	CpG: 24	231	24	175	20.8	75.8	0.73
chrX	86248512	86248871	CpG: 25	359	25	210	13.9	58.5	0.82
chrX	86272803	86273077	CpG: 21	274	21	166	15.3	60.6	0.85
chrX	86537392	86537607	CpG: 15	215	15	127	14.0	59.1	0.82
chrX	86727100	86727381	CpG: 24	281	24	175	17.1	62.3	0.89
chrX	86732039	86732289	CpG: 24	250	24	158	19.2	63.2	0.98
chrX	86924894	86925130	CpG: 19	236	19	138	16.1	58.5	0.98
chrX	86942463	86942737	CpG: 20	274	20	164	14.6	59.9	0.82
chrX	87169723	87169997	CpG: 24	274	24	171	17.5	62.4	0.91
chrX	87172191	87172404	CpG: 18	213	18	118	16.9	55.4	1.16
chrX	87290680	87290926	CpG: 23	246	23	182	18.7	74.0	0.69
chrX	87658096	87658370	CpG: 24	274	24	171	17.5	62.4	0.91
chrX	87666655	87666933	CpG: 25	278	25	174	18.0	62.6	0.93
chrX	88137986	88138216	CpG: 20	230	20	142	17.4	61.7	0.93
chrX	88143967	88144202	CpG: 17	235	17	139	14.5	59.1	0.83
chrX	88323448	88323678	CpG: 18	230	18	138	15.7	60.0	0.88
chrX	88406907	88407136	CpG: 20	229	20	159	17.5	69.4	0.72
chrX	88766206	88766466	CpG: 22	260	22	161	16.9	61.9	0.90
chrX	88974103	88974492	CpG: 32	389	32	281	16.5	72.2	0.63
chrX	88992793	88993033	CpG: 19	240	19	143	15.8	59.6	0.92
chrX	89277446	89277661	CpG: 15	215	15	126	14.0	58.6	0.82
chrX	89417898	89418152	CpG: 18	254	18	148	14.2	58.3	0.84
chrX	89458708	89458989	CpG: 24	281	24	175	17.1	62.3	0.90
chrX	89667167	89667445	CpG: 25	278	25	175	18.0	62.9	0.92
chrX	89886720	89887237	CpG: 46	517	46	335	17.8	64.8	0.86
chrX	90001471	90001701	CpG: 18	230	18	140	15.7	60.9	0.86
chrX	90012096	90012372	CpG: 21	276	21	164	15.2	59.4	0.88
chrX	90078157	90078393	CpG: 20	236	20	145	16.9	61.4	0.92
chrX	90079349	90079574	CpG: 18	225	18	135	16.0	60.0	0.89
chrX	90101506	90101775	CpG: 22	269	22	166	16.4	61.7	0.88
chrX	90120553	90120827	CpG: 23	274	23	171	16.8	62.4	0.87
chrX	90205036	90205330	CpG: 22	294	22	177	15.0	60.2	0.83
chrX	90231073	90231703	CpG: 45	630	45	412	14.3	65.4	0.67
chrX	90233743	90234349	CpG: 55	606	55	387	18.2	63.9	0.89
chrX	90241004	90241239	CpG: 18	235	18	136	15.3	57.9	0.92
chrX	90243958	90244220	CpG: 22	262	22	164	16.8	62.6	0.87
chrX	90277401	90277644	CpG: 20	243	20	142	16.5	58.4	0.97
chrX	90298406	90298643	CpG: 18	237	18	139	15.2	58.6	0.90
chrX	90335595	90335831	CpG: 17	236	17	143	14.4	60.6	0.81
chrX	90570928	90571156	CpG: 17	228	17	137	14.9	60.1	0.85
chrX	90607776	90608044	CpG: 19	268	19	163	14.2	60.8	0.78
chrX	90667160	90667368	CpG: 15	208	15	120	14.4	57.7	0.89
chrX	90684867	90685140	CpG: 23	273	23	165	16.8	60.4	0.93
chrX	90807339	90807617	CpG: 24	278	24	172	17.3	61.9	0.91
chrX	90824579	90824833	CpG: 20	254	20	164	15.7	64.6	0.76
chrX	90925192	90925466	CpG: 24	274	24	172	17.5	62.8	0.90
chrX	91335878	91336151	CpG: 21	273	21	165	15.4	60.4	0.85
chrX	92034278	92034546	CpG: 20	268	20	164	14.9	61.2	0.80
chrX	92046490	92046701	CpG: 16	211	16	125	15.2	59.2	0.87
chrX	92118504	92118956	CpG: 41	452	41	290	18.1	64.2	0.88
chrX	92141782	92142022	CpG: 18	240	18	145	15.0	60.4	0.84
chrX	92268631	92268909	CpG: 26	278	26	175	18.7	62.9	0.95
chrX	92385050	92385277	CpG: 19	227	19	135	16.7	59.5	0.95
chrX	92755182	92755467	CpG: 24	285	24	175	16.8	61.4	0.91
chrX	92788638	92788849	CpG: 18	211	18	131	17.1	62.1	0.90
chrX	93065318	93065592	CpG: 21	274	21	168	15.3	61.3	0.83
chrX	93160417	93160634	CpG: 20	217	20	136	18.4	62.7	0.97
chrX	94156617	94156898	CpG: 21	281	21	174	14.9	61.9	0.79
chrX	94215253	94215481	CpG: 17	228	17	135	14.9	59.2	0.86
chrX	94962709	94962983	CpG: 25	274	25	173	18.2	63.1	0.92
chrX	95020413	95020679	CpG: 22	266	22	164	16.5	61.7	0.88
chrX	95053925	95054202	CpG: 22	277	22	172	15.9	62.1	0.84
chrX	95123951	95124687	CpG: 68	736	68	500	18.5	67.9	0.82
chrX	95190975	95191253	CpG: 24	278	24	172	17.3	61.9	0.91
chrX	95221661	95221901	CpG: 18	240	18	141	15.0	58.8	0.89
chrX	95257306	95257507	CpG: 17	201	17	125	16.9	62.2	0.88
chrX	95276055	95276329	CpG: 24	274	24	171	17.5	62.4	0.91
chrX	95379008	95379281	CpG: 25	273	25	170	18.3	62.3	0.95
chrX	95464693	95464894	CpG: 15	201	15	119	14.9	59.2	0.89
chrX	95610970	95611211	CpG: 19	241	19	148	15.8	61.4	0.85
chrX	95714610	95715613	CpG: 78	1003	78	720	15.6	71.8	0.60
chrX	95762741	95762975	CpG: 21	234	21	145	17.9	62.0	0.96
chrX	95895547	95895786	CpG: 22	239	22	148	18.4	61.9	0.98
chrX	95954615	95954858	CpG: 22	243	22	147	18.1	60.5	0.99
chrX	96023273	96023497	CpG: 18	224	18	135	16.1	60.3	0.89
chrX	96066014	96066284	CpG: 21	270	21	162	15.6	60.0	0.87
chrX	96154723	96154996	CpG: 24	273	24	168	17.6	61.5	0.94
chrX	96282919	96283183	CpG: 22	264	22	168	16.7	63.6	0.83
chrX	96288340	96288648	CpG: 22	308	22	182	14.3	59.1	0.87
chrX	96347807	96348081	CpG: 24	274	24	171	17.5	62.4	0.91
chrX	96871777	96872001	CpG: 20	224	20	130	17.9	58.0	1.06
chrX	97134862	97135256	CpG: 30	394	30	237	15.2	60.2	0.85
chrX	97204051	97204325	CpG: 22	274	22	172	16.1	62.8	0.83
chrX	97332523	97332755	CpG: 18	232	18	137	15.5	59.1	0.91
chrX	97620449	97620730	CpG: 24	281	24	175	17.1	62.3	0.90
chrX	97814267	97814791	CpG: 52	524	52	390	19.8	74.4	0.72
chrX	98287914	98288171	CpG: 19	257	19	158	14.8	61.5	0.80
chrX	98381585	98381849	CpG: 23	264	23	165	17.4	62.5	0.90
chrX	98547390	98547664	CpG: 24	274	24	170	17.5	62.0	0.92
chrX	98837308	98837582	CpG: 23	274	23	172	16.8	62.8	0.86
chrX	98849054	98853791	CpG: 402	4737	402	2975	17.0	62.8	0.87
chrX	98854310	98854634	CpG: 23	324	23	183	14.2	56.5	0.92
chrX	98950021	98950308	CpG: 22	287	22	170	15.3	59.2	0.88
chrX	98992837	98993191	CpG: 27	354	27	212	15.3	59.9	0.86
chrX	99078734	99079229	CpG: 47	495	47	316	19.0	63.8	0.95
chrX	99173888	99174650	CpG: 61	762	61	515	16.0	67.6	0.72
chrX	99262777	99263104	CpG: 33	327	33	202	20.2	61.8	1.06
chrX	99323749	99323971	CpG: 19	222	19	136	17.1	61.3	0.93
chrX	99371569	99372036	CpG: 37	467	37	301	15.8	64.5	0.77
chrX	99403504	99403780	CpG: 23	276	23	170	16.7	61.6	0.89
chrX	99495063	99495441	CpG: 33	378	33	234	17.5	61.9	0.93
chrX	99497626	99497966	CpG: 24	340	24	198	14.1	58.2	0.85
chrX	99541440	99541707	CpG: 27	267	27	172	20.2	64.4	0.98
chrX	99635330	99635827	CpG: 48	497	48	352	19.3	70.8	0.77
chrX	99735190	99736349	CpG: 109	1159	109	748	18.8	64.5	0.91
chrX	99782504	99782734	CpG: 17	230	17	138	14.8	60.0	0.83
chrX	99792755	99793083	CpG: 37	328	37	226	22.6	68.9	0.97
chrX	99834904	99835231	CpG: 30	327	30	197	18.3	60.2	1.02
chrX	99851954	99852719	CpG: 51	765	51	419	13.3	54.8	0.89
chrX	99862318	99862800	CpG: 39	482	39	327	16.2	67.8	0.72
chrX	99929397	99929778	CpG: 37	381	37	271	19.4	71.1	0.80
chrX	99997437	99997692	CpG: 21	255	21	156	16.5	61.2	0.90
chrX	100226393	100226674	CpG: 24	281	24	175	17.1	62.3	0.90
chrX	100296252	100296488	CpG: 19	236	19	140	16.1	59.3	0.93
chrX	100376143	100376877	CpG: 78	734	78	503	21.3	68.5	0.91
chrX	100570183	100570574	CpG: 41	391	41	291	21.0	74.4	0.79
chrX	100586754	100587126	CpG: 37	372	37	274	19.9	73.7	0.76
chrX	100960897	100961233	CpG: 36	336	36	237	21.4	70.5	0.88
chrX	101044302	101044554	CpG: 22	252	22	139	17.5	55.2	1.15
chrX	101096028	101097044	CpG: 89	1016	89	706	17.5	69.5	0.73
chrX	101156988	101157991	CpG: 95	1003	95	710	18.9	70.8	0.76
chrX	101190710	101191579	CpG: 75	869	75	604	17.3	69.5	0.73
chrX	101214053	101214274	CpG: 16	221	16	125	14.5	56.6	0.92
chrX	101222150	101222435	CpG: 22	285	22	174	15.4	61.1	0.84
chrX	101382216	101382597	CpG: 28	381	28	240	14.7	63.0	0.74
chrX	101508600	101509303	CpG: 60	703	60	490	17.1	69.7	0.71
chrX	101539047	101539351	CpG: 24	304	24	219	15.8	72.0	0.61
chrX	101549798	101550090	CpG: 21	292	21	184	14.4	63.0	0.73
chrX	101589404	101589674	CpG: 23	270	23	169	17.0	62.6	0.87
chrX	101610842	101611118	CpG: 22	276	22	173	15.9	62.7	0.82
chrX	101620703	101620940	CpG: 18	237	18	143	15.2	60.3	0.85
chrX	101661217	101661477	CpG: 22	260	22	163	16.9	62.7	0.87
chrX	101662005	101662796	CpG: 75	791	75	565	19.0	71.4	0.76
chrX	101757361	101758081	CpG: 70	720	70	509	19.4	70.7	0.79
chrX	101822042	101822419	CpG: 27	377	27	199	14.3	52.8	1.03
chrX	101823396	101824148	CpG: 73	752	73	538	19.4	71.5	0.77
chrX	101866843	101867068	CpG: 19	225	19	137	16.9	60.9	0.92
chrX	101937446	101937688	CpG: 18	242	18	144	14.9	59.5	0.86
chrX	102032438	102033237	CpG: 53	799	53	507	13.3	63.5	0.69
chrX	102054775	102055204	CpG: 47	429	47	320	21.9	74.6	0.81
chrX	102069019	102069254	CpG: 18	235	18	143	15.3	60.9	0.84
chrX	102076501	102076742	CpG: 22	241	22	167	18.3	69.3	0.83
chrX	102134153	102134532	CpG: 38	379	38	250	20.1	66.0	1.01
chrX	102158175	102158449	CpG: 23	274	23	169	16.8	61.7	0.89
chrX	102279057	102279351	CpG: 36	294	36	220	24.5	74.8	0.88
chrX	102353675	102353914	CpG: 19	239	19	146	15.9	61.1	0.88
chrX	102359594	102360419	CpG: 73	825	73	542	17.7	65.7	0.84
chrX	102403597	102404170	CpG: 47	573	47	394	16.4	68.8	0.72
chrX	102439517	102439824	CpG: 23	307	23	200	15.0	65.1	0.71
chrX	102447031	102447458	CpG: 32	427	32	257	15.0	60.2	0.83
chrX	102466037	102466731	CpG: 45	694	45	433	13.0	62.4	0.67
chrX	102543541	102544075	CpG: 65	534	65	387	24.3	72.5	0.93
chrX	102587919	102588297	CpG: 37	378	37	231	19.6	61.1	1.18
chrX	102597436	102598307	CpG: 88	871	88	622	20.2	71.4	0.79
chrX	102681487	102681759	CpG: 32	272	32	216	23.5	79.4	0.77
chrX	102684805	102686611	CpG: 145	1806	145	1073	16.1	59.4	0.91
chrX	102687611	102687873	CpG: 24	262	24	165	18.3	63.0	0.93
chrX	102819679	102819909	CpG: 18	230	18	140	15.7	60.9	0.85
chrX	102875827	102876065	CpG: 19	238	19	144	16.0	60.5	0.90
chrX	102996255	102996628	CpG: 26	373	26	205	13.9	55.0	0.93
chrX	102998011	102998504	CpG: 41	493	41	311	16.6	63.1	0.84
chrX	103284826	103285056	CpG: 20	230	20	142	17.4	61.7	0.92
chrX	103530757	103531029	CpG: 20	272	20	163	14.7	59.9	0.83
chrX	103749508	103749779	CpG: 21	271	21	166	15.5	61.3	0.83
chrX	103983651	103983882	CpG: 18	231	18	138	15.6	59.7	0.89
chrX	104014978	104015252	CpG: 19	274	19	160	13.9	58.4	0.82
chrX	104091180	104091384	CpG: 16	204	16	124	15.7	60.8	0.86
chrX	104210986	104211271	CpG: 24	285	24	178	16.8	62.5	0.88
chrX	104228736	104229046	CpG: 25	310	25	182	16.1	58.7	0.94
chrX	104254011	104254927	CpG: 77	916	77	613	16.8	66.9	0.76
chrX	104379025	104379255	CpG: 20	230	20	142	17.4	61.7	0.92
chrX	104621620	104621897	CpG: 22	277	22	171	15.9	61.7	0.84
chrX	104905245	104905672	CpG: 31	427	31	256	14.5	60.0	0.81
chrX	105048241	105048510	CpG: 33	269	33	170	24.5	63.2	1.27
chrX	105074728	105075002	CpG: 24	274	24	171	17.5	62.4	0.91
chrX	105153410	105153641	CpG: 19	231	19	141	16.5	61.0	0.90
chrX	105162898	105163810	CpG: 80	912	80	585	17.5	64.1	0.85
chrX	105199961	105200246	CpG: 21	285	21	171	14.7	60.0	0.83
chrX	105435800	105436887	CpG: 124	1087	124	775	22.8	71.3	0.90
chrX	105554807	105555188	CpG: 31	381	31	243	16.3	63.8	0.81
chrX	105592406	105592648	CpG: 21	242	21	148	17.4	61.2	0.93
chrX	105642208	105642919	CpG: 58	711	58	429	16.3	60.3	0.90
chrX	105708868	105709538	CpG: 59	670	59	423	17.6	63.1	0.88
chrX	105760477	105760703	CpG: 19	226	19	164	16.8	72.6	0.64
chrX	105800710	105801069	CpG: 29	359	29	212	16.2	59.1	0.93
chrX	105854584	105854858	CpG: 23	274	23	169	16.8	61.7	0.90
chrX	105886067	105887147	CpG: 126	1080	126	801	23.3	74.2	0.85
chrX	105937991	105938272	CpG: 24	281	24	175	17.1	62.3	0.90
chrX	105943391	105944374	CpG: 74	983	74	649	15.1	66.0	0.70
chrX	106065155	106065361	CpG: 22	206	22	128	21.4	62.1	1.11
chrX	106152906	106153442	CpG: 52	536	52	385	19.4	71.8	0.76
chrX	106153595	106153802	CpG: 16	207	16	141	15.5	68.1	0.70
chrX	106212115	106213121	CpG: 79	1006	79	679	15.7	67.5	0.69
chrX	106242820	106243097	CpG: 22	277	22	166	15.9	59.9	0.90
chrX	106262814	106263707	CpG: 117	893	117	664	26.2	74.4	0.95
chrX	106373091	106373640	CpG: 48	549	48	341	17.5	62.1	1.13
chrX	106420615	106420853	CpG: 17	238	17	136	14.3	57.1	0.89
chrX	106528786	106529505	CpG: 58	719	58	444	16.1	61.8	0.85
chrX	106550048	106550288	CpG: 17	240	17	139	14.2	57.9	0.88
chrX	107170213	107170576	CpG: 31	363	31	235	17.1	64.7	0.82
chrX	107172564	107174499	CpG: 160	1935	160	1248	16.5	64.5	0.80
chrX	107182406	107182680	CpG: 22	274	22	170	16.1	62.0	0.85
chrX	107302613	107302853	CpG: 21	240	21	152	17.5	63.3	0.90
chrX	107366434	107366708	CpG: 24	274	24	170	17.5	62.0	0.92
chrX	107430095	107430369	CpG: 24	274	24	170	17.5	62.0	0.92
chrX	107463087	107463341	CpG: 20	254	20	155	15.7	61.0	0.86
chrX	107501632	107502121	CpG: 38	489	38	292	15.5	59.7	0.88
chrX	107984287	107984646	CpG: 30	359	30	225	16.7	62.7	0.86
chrX	108019121	108019394	CpG: 20	273	20	163	14.7	59.7	0.84
chrX	108072323	108073175	CpG: 83	852	83	605	19.5	71.0	0.78
chrX	108180697	108181429	CpG: 88	732	88	515	24.0	70.4	0.97
chrX	108266066	108266277	CpG: 17	211	17	125	16.1	59.2	0.94
chrX	108323678	108324084	CpG: 33	406	33	298	16.3	73.4	0.60
chrX	108363218	108363492	CpG: 24	274	24	172	17.5	62.8	0.91
chrX	108450073	108451274	CpG: 114	1201	114	866	19.0	72.1	0.77
chrX	108485850	108486125	CpG: 23	275	23	170	16.7	61.8	0.89
chrX	108765385	108766232	CpG: 95	847	95	607	22.4	71.7	0.87
chrX	108825684	108825914	CpG: 20	230	20	142	17.4	61.7	0.92
chrX	109243797	109244221	CpG: 44	424	44	294	20.8	69.3	0.86
chrX	109270470	109270712	CpG: 18	242	18	143	14.9	59.1	0.85
chrX	109544323	109544638	CpG: 29	315	29	222	18.4	70.5	0.77
chrX	109948827	109949101	CpG: 24	274	24	170	17.5	62.0	0.92
chrX	110042509	110042819	CpG: 23	310	23	187	14.8	60.3	0.82
chrX	110072483	110072759	CpG: 22	276	22	177	15.9	64.1	0.79
chrX	110129319	110130291	CpG: 90	972	90	623	18.5	64.1	0.92
chrX	110530197	110530417	CpG: 19	220	19	139	17.3	63.2	0.89
chrX	110531253	110531482	CpG: 20	229	20	162	17.5	70.7	0.70
chrX	110660474	110660748	CpG: 23	274	23	171	16.8	62.4	0.88
chrX	110830668	110830879	CpG: 18	211	18	131	17.1	62.1	0.92
chrX	111074895	111075120	CpG: 16	225	16	134	14.2	59.6	0.81
chrX	111170491	111170918	CpG: 33	427	33	252	15.5	59.0	0.89
chrX	111199783	111200019	CpG: 19	236	19	141	16.1	59.7	0.93
chrX	111292183	111293434	CpG: 93	1251	93	801	14.9	64.0	0.74
chrX	111306780	111307071	CpG: 24	291	24	211	16.5	72.5	0.63
chrX	111371850	111372086	CpG: 19	236	19	146	16.1	61.9	0.86
chrX	111395999	111396265	CpG: 22	266	22	166	16.5	62.4	0.86
chrX	111512994	111513279	CpG: 25	285	25	176	17.5	61.8	0.93
chrX	111796284	111796610	CpG: 28	326	28	196	17.2	60.1	0.96
chrX	112099259	112099493	CpG: 17	234	17	139	14.5	59.4	0.85
chrX	112192782	112193067	CpG: 23	285	23	177	16.1	62.1	0.85
chrX	112353054	112353324	CpG: 22	270	22	165	16.3	61.1	0.88
chrX	112445523	112445801	CpG: 22	278	22	169	15.8	60.8	0.87
chrX	112500504	112500740	CpG: 16	236	16	140	13.6	59.3	0.79
chrX	112721809	112722137	CpG: 23	328	23	192	14.0	58.5	0.84
chrX	112722743	112723131	CpG: 37	388	37	285	19.1	73.5	0.71
chrX	112735985	112736221	CpG: 20	236	20	142	16.9	60.2	0.96
chrX	112785375	112785649	CpG: 22	274	22	167	16.1	60.9	0.88
chrX	112798367	112798732	CpG: 28	365	28	211	15.3	57.8	0.93
chrX	112866752	112866988	CpG: 17	236	17	139	14.4	58.9	0.85
chrX	112990129	112990449	CpG: 34	320	34	207	21.2	64.7	1.03
chrX	112992553	112993487	CpG: 88	934	88	582	18.8	62.3	0.99
chrX	113109230	113109447	CpG: 17	217	17	129	15.7	59.4	0.89
chrX	113193201	113193423	CpG: 21	222	21	135	18.9	60.8	1.04
chrX	113369876	113370171	CpG: 21	295	21	176	14.2	59.7	0.80
chrX	113437854	113438128	CpG: 23	274	23	170	16.8	62.0	0.88
chrX	113597920	113601236	CpG: 264	3316	264	2162	15.9	65.2	0.75
chrX	113642117	113642731	CpG: 51	614	51	424	16.6	69.1	0.72
chrX	113668665	113668934	CpG: 19	269	19	160	14.1	59.5	0.82
chrX	113720380	113720672	CpG: 25	292	25	211	17.1	72.3	0.66
chrX	113844617	113844848	CpG: 20	231	20	138	17.3	59.7	0.98
chrX	113969452	113970687	CpG: 91	1235	91	785	14.7	63.6	0.73
chrX	113974938	113975196	CpG: 21	258	21	157	16.3	60.9	0.88
chrX	113995805	113996079	CpG: 20	274	20	168	14.6	61.3	0.79
chrX	114022374	114022604	CpG: 19	230	19	136	16.5	59.1	0.96
chrX	114088324	114088554	CpG: 20	230	20	138	17.4	60.0	1.01
chrX	114092032	114092319	CpG: 24	287	24	175	16.7	61.0	0.91
chrX	114133588	114298736	CpG: 10269	165148	10269	102722	12.4	62.2	0.65
chrX	114378009	114378641	CpG: 45	632	45	394	14.2	62.3	0.74
chrX	114596976	114597257	CpG: 23	281	23	175	16.4	62.3	0.86
chrX	114825735	114825943	CpG: 16	208	16	121	15.4	58.2	0.93
chrX	115608312	115608590	CpG: 24	278	24	172	17.3	61.9	0.91
chrX	115734546	115734782	CpG: 21	236	21	145	17.8	61.4	0.96
chrX	115771259	115771649	CpG: 32	390	32	277	16.4	71.0	0.65
chrX	115870888	115871171	CpG: 23	283	23	175	16.3	61.8	0.87
chrX	115984609	115984818	CpG: 16	209	16	126	15.3	60.3	0.85
chrX	116198607	116198881	CpG: 23	274	23	170	16.8	62.0	0.88
chrX	116493866	116494662	CpG: 75	796	75	555	18.8	69.7	0.78
chrX	116629911	116630181	CpG: 22	270	22	163	16.3	60.4	0.91
chrX	116658967	116659172	CpG: 17	205	17	114	16.6	55.6	1.08
chrX	116720719	116720931	CpG: 16	212	16	124	15.1	58.5	0.90
chrX	116723259	116724182	CpG: 82	923	82	561	17.8	60.8	0.99
chrX	116744477	116744706	CpG: 18	229	18	139	15.7	60.7	0.88
chrX	116855812	116856035	CpG: 17	223	17	132	15.2	59.2	0.89
chrX	116872791	116873038	CpG: 17	247	17	166	13.8	67.2	0.62
chrX	116873285	116874436	CpG: 128	1151	128	814	22.2	70.7	0.91
chrX	116877693	116877967	CpG: 26	274	26	171	19.0	62.4	0.98
chrX	117094652	117095023	CpG: 32	371	32	273	17.3	73.6	0.64
chrX	117104981	117105944	CpG: 119	963	119	729	24.7	75.7	0.89
chrX	117201385	117201707	CpG: 34	322	34	221	21.1	68.6	0.90
chrX	117217087	117217477	CpG: 44	390	44	281	22.6	72.1	0.87
chrX	117256787	117257092	CpG: 25	305	25	207	16.4	67.9	0.72
chrX	117299948	117300179	CpG: 19	231	19	168	16.5	72.7	0.63
chrX	117321275	117321494	CpG: 17	219	17	131	15.5	59.8	0.88
chrX	117351246	117351726	CpG: 38	480	38	319	15.8	66.5	0.72
chrX	117352279	117354336	CpG: 184	2057	184	1341	17.9	65.2	0.84
chrX	117406161	117406445	CpG: 23	284	23	203	16.2	71.5	0.64
chrX	117427957	117428194	CpG: 18	237	18	142	15.2	59.9	0.88
chrX	117451027	117451551	CpG: 40	524	40	352	15.3	67.2	0.71
chrX	117458706	117458959	CpG: 22	253	22	155	17.4	61.3	0.96
chrX	117528327	117528873	CpG: 38	546	38	360	13.9	65.9	0.64
chrX	117555846	117556057	CpG: 15	211	15	125	14.2	59.2	0.83
chrX	117588786	117588997	CpG: 19	211	19	151	18.0	71.6	0.71
chrX	117600726	117600999	CpG: 36	273	36	202	26.4	74.0	1.03
chrX	117613653	117614764	CpG: 121	1111	121	785	21.8	70.7	0.89
chrX	117650734	117651439	CpG: 76	705	76	476	21.6	67.5	0.95
chrX	117677639	117677846	CpG: 15	207	15	145	14.5	70.0	0.60
chrX	117771896	117772131	CpG: 18	235	18	144	15.3	61.3	0.83
chrX	117776932	117777556	CpG: 73	624	73	485	23.4	77.7	0.78
chrX	117801659	117801894	CpG: 18	235	18	141	15.3	60.0	0.87
chrX	117818826	117819184	CpG: 29	358	29	212	16.2	59.2	0.92
chrX	117845895	117847055	CpG: 120	1160	120	809	20.7	69.7	0.85
chrX	117860165	117860625	CpG: 39	460	39	292	17.0	63.5	0.84
chrX	117865543	117865934	CpG: 31	391	31	278	15.9	71.1	0.63
chrX	117945954	117946232	CpG: 22	278	22	170	15.8	61.2	0.86
chrX	117952043	117952990	CpG: 98	947	98	662	20.7	69.9	0.85
chrX	117983324	117984270	CpG: 94	946	94	638	19.9	67.4	0.87
chrX	118009951	118010214	CpG: 21	263	21	158	16.0	60.1	0.89
chrX	118035572	118035852	CpG: 21	280	21	167	15.0	59.6	0.85
chrX	118049075	118049308	CpG: 16	233	16	139	13.7	59.7	0.79
chrX	118070155	118071495	CpG: 110	1340	110	917	16.4	68.4	0.72
chrX	118071802	118072021	CpG: 18	219	18	149	16.4	68.0	0.72
chrX	118125934	118126332	CpG: 33	398	33	291	16.6	73.1	0.62
chrX	118126831	118127110	CpG: 19	279	19	159	13.6	57.0	0.85
chrX	118133078	118134682	CpG: 150	1604	150	1144	18.7	71.3	0.74
chrX	118141568	118141966	CpG: 27	398	27	231	13.6	58.0	0.82
chrX	118142331	118142571	CpG: 20	240	20	149	16.7	62.1	0.88
chrX	118166318	118167290	CpG: 79	972	79	604	16.3	62.1	0.85
chrX	118227842	118228410	CpG: 45	568	45	357	15.8	62.9	0.84
chrX	118246410	118247939	CpG: 113	1529	113	891	14.8	58.3	0.87
chrX	118265734	118266122	CpG: 42	388	42	287	21.6	74.0	0.79
chrX	118318252	118318827	CpG: 55	575	55	374	19.1	65.0	0.91
chrX	118365690	118366865	CpG: 85	1175	85	741	14.5	63.1	0.73
chrX	118373866	118374069	CpG: 17	203	17	111	16.7	54.7	1.13
chrX	118375053	118375571	CpG: 47	518	47	343	18.1	66.2	0.85
chrX	118390387	118390936	CpG: 46	549	46	351	16.8	63.9	0.87
chrX	118400912	118401472	CpG: 50	560	50	405	17.9	72.3	0.69
chrX	118451975	118452341	CpG: 32	366	32	235	17.5	64.2	0.86
chrX	118490641	118491011	CpG: 33	370	33	240	17.8	64.9	0.85
chrX	118534231	118534597	CpG: 33	366	33	237	18.0	64.8	0.87
chrX	118619848	118620241	CpG: 28	393	28	243	14.2	61.8	0.75
chrX	118625571	118626260	CpG: 74	689	74	461	21.5	66.9	0.96
chrX	118626666	118627037	CpG: 25	371	25	194	13.5	52.3	0.99
chrX	118669216	118669490	CpG: 23	274	23	170	16.8	62.0	0.88
chrX	118684502	118684827	CpG: 29	325	29	207	17.8	63.7	0.88
chrX	118686037	118686450	CpG: 35	413	35	279	16.9	67.6	0.76
chrX	118769185	118769459	CpG: 23	274	23	170	16.8	62.0	0.88
chrX	118844333	118844890	CpG: 45	557	45	362	16.2	65.0	0.77
chrX	118884937	118885211	CpG: 23	274	23	169	16.8	61.7	0.89
chrX	118936551	118936836	CpG: 33	285	33	205	23.2	71.9	0.90
chrX	118949740	118949962	CpG: 19	222	19	134	17.1	60.4	0.97
chrX	118996673	118996905	CpG: 19	232	19	140	16.4	60.3	0.92
chrX	119005335	119005828	CpG: 56	493	56	330	22.7	66.9	1.01
chrX	119007202	119007501	CpG: 25	299	25	187	16.7	62.5	0.88
chrX	119015303	119015578	CpG: 22	275	22	171	16.0	62.2	0.83
chrX	119030549	119030822	CpG: 23	273	23	166	16.8	60.8	0.92
chrX	119108357	119108721	CpG: 34	364	34	238	18.7	65.4	0.89
chrX	119109662	119109935	CpG: 21	273	21	165	15.4	60.4	0.85
chrX	119148781	119149062	CpG: 24	281	24	176	17.1	62.6	0.89
chrX	119250452	119251451	CpG: 78	999	78	700	15.6	70.1	0.64
chrX	119255365	119256334	CpG: 82	969	82	682	16.9	70.4	0.69
chrX	119260226	119261195	CpG: 83	969	83	683	17.1	70.5	0.69
chrX	119265086	119266055	CpG: 83	969	83	683	17.1	70.5	0.69
chrX	119269946	119270915	CpG: 83	969	83	683	17.1	70.5	0.69
chrX	119274806	119275775	CpG: 83	969	83	683	17.1	70.5	0.69
chrX	119279666	119280635	CpG: 83	969	83	683	17.1	70.5	0.69
chrX	119284526	119285495	CpG: 83	969	83	683	17.1	70.5	0.69
chrX	119301763	119301974	CpG: 16	211	16	126	15.2	59.7	0.86
chrX	119347295	119347975	CpG: 79	680	79	483	23.2	71.0	0.92
chrX	119379401	119379637	CpG: 18	236	18	145	15.3	61.4	0.84
chrX	119455753	119455975	CpG: 15	222	15	131	13.5	59.0	0.79
chrX	119474190	119474420	CpG: 19	230	19	141	16.5	61.3	0.89
chrX	119495261	119495535	CpG: 24	274	24	171	17.5	62.4	0.91
chrX	119511477	119511714	CpG: 17	237	17	138	14.3	58.2	0.88
chrX	119731546	119731790	CpG: 19	244	19	174	15.6	71.3	0.61
chrX	119737666	119737909	CpG: 19	243	19	147	15.6	60.5	0.86
chrX	119924885	119925157	CpG: 18	272	18	164	13.2	60.3	0.75
chrX	119968177	119968408	CpG: 19	231	19	139	16.5	60.2	0.93
chrX	120830989	120831269	CpG: 26	280	26	176	18.6	62.9	0.95
chrX	120946048	120946255	CpG: 20	207	20	126	19.3	60.9	1.06
chrX	120994437	120994703	CpG: 19	266	19	158	14.3	59.4	0.82
chrX	120997092	120997328	CpG: 18	236	18	143	15.3	60.6	0.86
chrX	121059932	121060170	CpG: 18	238	18	145	15.1	60.9	0.84
chrX	121319835	121320108	CpG: 24	273	24	168	17.6	61.5	0.94
chrX	121493356	121494004	CpG: 44	648	44	437	13.6	67.4	0.63
chrX	121560147	121560423	CpG: 19	276	19	166	13.8	60.1	0.77
chrX	121685724	121685973	CpG: 19	249	19	147	15.3	59.0	0.90
chrX	122042800	122044879	CpG: 156	2079	156	1301	15.0	62.6	0.77
chrX	122048112	122048348	CpG: 17	236	17	142	14.4	60.2	0.82
chrX	122075475	122075717	CpG: 30	242	30	170	24.8	70.2	1.04
chrX	122083063	122083293	CpG: 17	230	17	140	14.8	60.9	0.81
chrX	122088580	122088818	CpG: 20	238	20	142	16.8	59.7	0.97
chrX	122122634	122122907	CpG: 21	273	21	165	15.4	60.4	0.85
chrX	122129382	122129687	CpG: 24	305	24	174	15.7	57.0	0.99
chrX	122165235	122165496	CpG: 20	261	20	161	15.3	61.7	0.81
chrX	122170097	122170885	CpG: 72	788	72	551	18.3	69.9	0.75
chrX	122188143	122188363	CpG: 18	220	18	133	16.4	60.5	0.91
chrX	122200439	122200713	CpG: 24	274	24	171	17.5	62.4	0.91
chrX	122226858	122227130	CpG: 19	272	19	164	14.0	60.3	0.78
chrX	122270486	122271146	CpG: 71	660	71	418	21.5	63.3	1.07
chrX	122438934	122439726	CpG: 73	792	73	613	18.4	77.4	0.62
chrX	122492632	122492854	CpG: 16	222	16	134	14.4	60.4	0.80
chrX	122500301	122500579	CpG: 22	278	22	172	15.8	61.9	0.83
chrX	122643406	122643918	CpG: 42	512	42	331	16.4	64.6	0.79
chrX	123275539	123275775	CpG: 16	236	16	136	13.6	57.6	0.85
chrX	123276827	123277057	CpG: 19	230	19	140	16.5	60.9	0.90
chrX	123465035	123465249	CpG: 16	214	16	117	15.0	54.7	1.05
chrX	123513309	123513530	CpG: 17	221	17	125	15.4	56.6	0.98
chrX	123513804	123514743	CpG: 83	939	83	619	17.7	65.9	0.82
chrX	123515442	123516478	CpG: 70	1036	70	624	13.5	60.2	0.75
chrX	123566065	123566419	CpG: 29	354	29	259	16.4	73.2	0.62
chrX	123632055	123632303	CpG: 27	248	27	164	21.8	66.1	1.00
chrX	123927114	123927424	CpG: 26	310	26	190	16.8	61.3	0.89
chrX	124003172	124003565	CpG: 38	393	38	292	19.3	74.3	0.70
chrX	124477969	124479160	CpG: 126	1191	126	844	21.2	70.9	0.86
chrX	124858243	124858644	CpG: 31	401	31	237	15.5	59.1	0.90
chrX	124864468	124865698	CpG: 125	1230	125	843	20.3	68.5	0.87
chrX	124893648	124894079	CpG: 47	431	47	329	21.8	76.3	0.75
chrX	124953605	124954505	CpG: 70	900	70	626	15.6	69.6	0.64
chrX	125011347	125011548	CpG: 15	201	15	119	14.9	59.2	0.87
chrX	125435832	125436056	CpG: 19	224	19	133	17.0	59.4	0.97
chrX	125492489	125492764	CpG: 23	275	23	168	16.7	61.1	0.90
chrX	125569639	125569946	CpG: 24	307	24	184	15.6	59.9	0.88
chrX	125675949	125676241	CpG: 22	292	22	177	15.1	60.6	0.82
chrX	125822402	125822638	CpG: 22	236	22	146	18.6	61.9	1.00
chrX	125976528	125977035	CpG: 43	507	43	371	17.0	73.2	0.63
chrX	126136089	126136363	CpG: 24	274	24	169	17.5	61.7	0.93
chrX	126350649	126350931	CpG: 21	282	21	168	14.9	59.6	0.85
chrX	126393467	126393745	CpG: 23	278	23	174	16.5	62.6	0.86
chrX	126696027	126696308	CpG: 21	281	21	173	14.9	61.6	0.80
chrX	126763448	126763733	CpG: 22	285	22	175	15.4	61.4	0.83
chrX	126776612	126776857	CpG: 20	245	20	149	16.3	60.8	0.91
chrX	126924440	126924800	CpG: 41	360	41	275	22.8	76.4	0.78
chrX	126929115	126929396	CpG: 27	281	27	176	19.2	62.6	0.99
chrX	127027350	127027586	CpG: 17	236	17	140	14.4	59.3	0.84
chrX	127100848	127101091	CpG: 21	243	21	148	17.3	60.9	0.93
chrX	127122191	127122426	CpG: 18	235	18	141	15.3	60.0	0.89
chrX	127154780	127155054	CpG: 22	274	22	168	16.1	61.3	0.87
chrX	127655753	127655970	CpG: 17	217	17	130	15.7	59.9	0.87
chrX	127761231	127761493	CpG: 20	262	20	159	15.3	60.7	0.85
chrX	127841572	127842505	CpG: 81	933	81	657	17.4	70.4	0.71
chrX	127855475	127855756	CpG: 22	281	22	171	15.7	60.9	0.86
chrX	127858937	127859531	CpG: 68	594	68	442	22.9	74.4	0.84
chrX	127886713	127886997	CpG: 24	284	24	175	16.9	61.6	0.91
chrX	127972814	127974006	CpG: 119	1192	119	843	20.0	70.7	0.80
chrX	127997047	127997334	CpG: 35	287	35	217	24.4	75.6	0.86
chrX	128125943	128126224	CpG: 24	281	24	176	17.1	62.6	0.88
chrX	128162129	128163012	CpG: 89	883	89	608	20.2	68.9	0.86
chrX	128224564	128224966	CpG: 36	402	36	247	17.9	61.4	0.95
chrX	128250434	128252180	CpG: 181	1746	181	1252	20.7	71.7	0.85
chrX	128271449	128272299	CpG: 61	850	61	571	14.4	67.2	0.67
chrX	128275870	128276439	CpG: 59	569	59	407	20.7	71.5	0.83
chrX	128289694	128289926	CpG: 17	232	17	135	14.7	58.2	0.90
chrX	128298558	128303506	CpG: 417	4948	417	3365	16.9	68.0	0.74
chrX	128378832	128379528	CpG: 87	696	87	515	25.0	74.0	0.92
chrX	128428502	128430404	CpG: 226	1902	226	1385	23.8	72.8	0.90
chrX	128439314	128440466	CpG: 93	1152	93	749	16.1	65.0	0.77
chrX	128482679	128482969	CpG: 22	290	22	166	15.2	57.2	0.95
chrX	128484264	128484937	CpG: 57	673	57	427	16.9	63.4	0.84
chrX	128489778	128491259	CpG: 122	1481	122	976	16.5	65.9	0.76
chrX	128574001	128574241	CpG: 22	240	22	148	18.3	61.7	0.99
chrX	128587285	128587915	CpG: 58	630	58	412	18.4	65.4	0.86
chrX	128658304	128658876	CpG: 48	572	48	362	16.8	63.3	0.84
chrX	128721693	128722029	CpG: 40	336	40	234	23.8	69.6	0.99
chrX	128725704	128725979	CpG: 23	275	23	169	16.7	61.5	0.89
chrX	128823414	128823695	CpG: 22	281	22	174	15.7	61.9	0.83
chrX	128837217	128837576	CpG: 26	359	26	211	14.5	58.8	0.84
chrX	128892990	128893317	CpG: 24	327	24	203	14.7	62.1	0.76
chrX	128934480	128934747	CpG: 22	267	22	167	16.5	62.5	0.85
chrX	129172969	129173192	CpG: 19	223	19	138	17.0	61.9	0.93
chrX	129222543	129222954	CpG: 37	411	37	266	18.0	64.7	0.88
chrX	129278891	129279115	CpG: 21	224	21	137	18.8	61.2	1.00
chrX	129377973	129378577	CpG: 60	604	60	428	19.9	70.9	0.80
chrX	129387979	129388184	CpG: 20	205	20	135	19.5	65.9	0.90
chrX	129392753	129393295	CpG: 36	542	36	343	13.3	63.3	0.67
chrX	129401986	129402715	CpG: 74	729	74	482	20.3	66.1	0.96
chrX	129437449	129437723	CpG: 23	274	23	170	16.8	62.0	0.88
chrX	129482048	129482282	CpG: 19	234	19	143	16.2	61.1	0.87
chrX	129575231	129575541	CpG: 26	310	26	189	16.8	61.0	0.91
chrX	129708027	129708319	CpG: 25	292	25	177	17.1	60.6	0.93
chrX	129902891	129903318	CpG: 34	427	34	257	15.9	60.2	0.88
chrX	129950499	129950773	CpG: 23	274	23	170	16.8	62.0	0.88
chrX	129988203	129988546	CpG: 24	343	24	202	14.0	58.9	0.81
chrX	130120143	130120393	CpG: 26	250	26	174	20.8	69.6	0.86
chrX	130166516	130166752	CpG: 20	236	20	140	16.9	59.3	0.99
chrX	130207227	130207503	CpG: 24	276	24	172	17.4	62.3	0.90
chrX	130347027	130347984	CpG: 80	957	80	658	16.7	68.8	0.71
chrX	130358567	130358829	CpG: 20	262	20	163	15.3	62.2	0.80
chrX	130541720	130542725	CpG: 104	1005	104	734	20.7	73.0	0.78
chrX	130813584	130814757	CpG: 132	1173	132	806	22.5	68.7	0.96
chrX	131281049	131283303	CpG: 238	2254	238	1562	21.1	69.3	0.88
chrX	131543061	131543345	CpG: 40	284	40	182	28.2	64.1	1.57
chrX	131738300	131741017	CpG: 246	2717	246	1793	18.1	66.0	0.83
chrX	131778436	131778677	CpG: 20	241	20	143	16.6	59.3	0.96
chrX	131808532	131808929	CpG: 36	397	36	288	18.1	72.5	0.69
chrX	132188795	132189076	CpG: 24	281	24	174	17.1	61.9	0.91
chrX	132309184	132309597	CpG: 29	413	29	229	14.0	55.4	0.92
chrX	132310063	132311093	CpG: 104	1030	104	739	20.2	71.7	0.79
chrX	132496795	132498053	CpG: 111	1258	111	821	17.6	65.3	0.86
chrX	132562213	132562862	CpG: 65	649	65	458	20.0	70.6	0.81
chrX	132698255	132698787	CpG: 52	532	52	353	19.5	66.4	0.89
chrX	132785046	132785961	CpG: 96	915	96	651	21.0	71.1	0.86
chrX	132841610	132841832	CpG: 19	222	19	135	17.1	60.8	0.96
chrX	132869750	132870356	CpG: 53	606	53	421	17.5	69.5	0.73
chrX	132871406	132871847	CpG: 39	441	39	294	17.7	66.7	0.81
chrX	132874332	132876621	CpG: 184	2289	184	1380	16.1	60.3	0.90
chrX	133021922	133022163	CpG: 19	241	19	143	15.8	59.3	0.92
chrX	133121821	133122389	CpG: 53	568	53	398	18.7	70.1	0.77
chrX	133234097	133234365	CpG: 20	268	20	159	14.9	59.3	0.86
chrX	133239784	133240498	CpG: 64	714	64	488	17.9	68.3	0.77
chrX	133285245	133285949	CpG: 53	704	53	475	15.1	67.5	0.66
chrX	133316275	133316644	CpG: 37	369	37	265	20.1	71.8	0.78
chrX	133320686	133320966	CpG: 22	280	22	168	15.7	60.0	0.88
chrX	133329418	133329655	CpG: 21	237	21	159	17.7	67.1	0.84
chrX	133347333	133347939	CpG: 61	606	61	410	20.1	67.7	0.89
chrX	133357404	133358322	CpG: 83	918	83	609	18.1	66.3	0.83
chrX	133376900	133377674	CpG: 76	774	76	525	19.6	67.8	0.86
chrX	133423549	133424464	CpG: 115	915	115	683	25.1	74.6	0.92
chrX	133621518	133621742	CpG: 16	224	16	133	14.3	59.4	0.82
chrX	133651294	133651660	CpG: 30	366	30	267	16.4	73.0	0.62
chrX	133669465	133670939	CpG: 106	1474	106	915	14.4	62.1	0.74
chrX	133747455	133748383	CpG: 114	928	114	701	24.6	75.5	0.88
chrX	133760666	133760927	CpG: 21	261	21	183	16.1	70.1	0.68
chrX	133761897	133762972	CpG: 87	1075	87	751	16.2	69.9	0.68
chrX	133846933	133847962	CpG: 99	1029	99	711	19.2	69.1	0.81
chrX	134201780	134201999	CpG: 16	219	16	140	14.6	63.9	0.72
chrX	134282245	134283255	CpG: 91	1010	91	714	18.0	70.7	0.85
chrX	134294056	134294858	CpG: 74	802	74	543	18.5	67.7	0.82
chrX	134305503	134305720	CpG: 16	217	16	128	14.7	59.0	0.85
chrX	134406659	134407025	CpG: 32	366	32	244	17.5	66.7	0.80
chrX	134455177	134456287	CpG: 144	1110	144	835	25.9	75.2	0.93
chrX	134559115	134559948	CpG: 111	833	111	624	26.7	74.9	0.95
chrX	134608637	134608856	CpG: 31	219	31	171	28.3	78.1	0.93
chrX	134805544	134806683	CpG: 141	1139	141	790	24.8	69.4	1.03
chrX	134869357	134869623	CpG: 23	266	23	166	17.3	62.4	0.90
chrX	135066788	135067064	CpG: 20	276	20	167	14.5	60.5	0.80
chrX	135075587	135076735	CpG: 104	1148	104	806	18.1	70.2	0.74
chrX	135188670	135189519	CpG: 63	849	63	469	14.8	55.2	0.99
chrX	135190286	135190510	CpG: 19	224	19	125	17.0	55.8	1.12
chrX	135208545	135208778	CpG: 17	233	17	139	14.6	59.7	0.84
chrX	135217166	135217442	CpG: 19	276	19	157	13.8	56.9	0.87
chrX	135217997	135218513	CpG: 49	516	49	341	19.0	66.1	0.87
chrX	135257843	135258124	CpG: 24	281	24	175	17.1	62.3	0.90
chrX	135258584	135258858	CpG: 22	274	22	169	16.1	61.7	0.85
chrX	135339873	135340549	CpG: 48	676	48	408	14.2	60.4	0.78
chrX	135342049	135342565	CpG: 71	516	71	391	27.5	75.8	0.97
chrX	135360796	135361555	CpG: 60	759	60	465	15.8	61.3	0.85
chrX	135447193	135447467	CpG: 22	274	22	171	16.1	62.4	0.84
chrX	135450264	135450538	CpG: 22	274	22	168	16.1	61.3	0.87
chrX	135465697	135465971	CpG: 20	274	20	165	14.6	60.2	0.83
chrX	135576118	135576395	CpG: 24	277	24	171	17.3	61.7	0.92
chrX	135715542	135715750	CpG: 15	208	15	136	14.4	65.4	0.68
chrX	135735018	135735263	CpG: 20	245	20	142	16.3	58.0	1.01
chrX	135737116	135738754	CpG: 112	1638	112	1011	13.7	61.7	0.72
chrX	135802850	135803131	CpG: 24	281	24	174	17.1	61.9	0.91
chrX	135857345	135858104	CpG: 53	759	53	420	14.0	55.3	0.91
chrX	135859877	135861120	CpG: 95	1243	95	723	15.3	58.2	0.91
chrX	135875315	135879453	CpG: 320	4138	320	2541	15.5	61.4	0.82
chrX	135883704	135884880	CpG: 112	1176	112	787	19.0	66.9	0.85
chrX	135898506	135898784	CpG: 23	278	23	171	16.5	61.5	0.89
chrX	136052491	136052769	CpG: 25	278	25	175	18.0	62.9	0.91
chrX	136146320	136146593	CpG: 20	273	20	163	14.7	59.7	0.83
chrX	136185161	136185391	CpG: 19	230	19	136	16.5	59.1	0.96
chrX	136317301	136317576	CpG: 23	275	23	167	16.7	60.7	0.92
chrX	136465529	136465814	CpG: 24	285	24	177	16.8	62.1	0.89
chrX	136473400	136473640	CpG: 22	240	22	150	18.3	62.5	0.96
chrX	136593503	136593755	CpG: 19	252	19	171	15.1	67.9	0.67
chrX	136807297	136807567	CpG: 19	270	19	159	14.1	58.9	0.82
chrX	137021429	137022341	CpG: 101	912	101	649	22.1	71.2	0.88
chrX	137138730	137139006	CpG: 26	276	26	173	18.8	62.7	0.97
chrX	137288659	137288895	CpG: 20	236	20	144	16.9	61.0	0.94
chrX	137313473	137313721	CpG: 18	248	18	143	14.5	57.7	0.89
chrX	137314523	137314781	CpG: 23	258	23	187	17.8	72.5	0.68
chrX	137505031	137505373	CpG: 40	342	40	246	23.4	71.9	0.93
chrX	137513523	137515827	CpG: 200	2304	200	1495	17.4	64.9	0.82
chrX	137526878	137527156	CpG: 22	278	22	171	15.8	61.5	0.86
chrX	137592893	137593124	CpG: 17	231	17	139	14.7	60.2	0.84
chrX	137642077	137642317	CpG: 22	240	22	140	18.3	58.3	1.10
chrX	137756934	137757252	CpG: 39	318	39	229	24.5	72.0	0.95
chrX	138003622	138004499	CpG: 73	877	73	603	16.6	68.8	0.71
chrX	138171747	138172021	CpG: 23	274	23	166	16.8	60.6	0.92
chrX	138182694	138182981	CpG: 26	287	26	181	18.1	63.1	0.92
chrX	138243643	138245271	CpG: 173	1628	173	1174	21.3	72.1	0.83
chrX	138403153	138404335	CpG: 118	1182	118	826	20.0	69.9	0.83
chrX	138545226	138545500	CpG: 23	274	23	171	16.8	62.4	0.87
chrX	138751308	138751644	CpG: 38	336	38	236	22.6	70.2	0.93
chrX	138815589	138818300	CpG: 258	2711	258	1792	19.0	66.1	0.87
chrX	138819692	138820202	CpG: 41	510	41	337	16.1	66.1	0.74
chrX	138822820	138823297	CpG: 54	477	54	317	22.6	66.5	1.03
chrX	138889301	138889503	CpG: 15	202	15	122	14.9	60.4	0.83
chrX	139081849	139082337	CpG: 35	488	35	305	14.3	62.5	0.74
chrX	139134156	139134422	CpG: 20	266	20	165	15.0	62.0	0.79
chrX	139201842	139202086	CpG: 21	244	21	146	17.2	59.8	1.00
chrX	139401504	139401760	CpG: 39	256	39	180	30.5	70.3	1.42
chrX	139440539	139440820	CpG: 23	281	23	174	16.4	61.9	0.87
chrX	139455949	139456184	CpG: 17	235	17	138	14.5	58.7	0.87
chrX	139493830	139494744	CpG: 90	914	90	616	19.7	67.4	0.89
chrX	139649932	139650169	CpG: 19	237	19	142	16.0	59.9	0.92
chrX	139685919	139686193	CpG: 24	274	24	170	17.5	62.0	0.92
chrX	139811667	139811923	CpG: 39	256	39	180	30.5	70.3	1.42
chrX	140073421	140073677	CpG: 20	256	20	156	15.6	60.9	0.85
chrX	140177760	140177991	CpG: 17	231	17	135	14.7	58.4	0.89
chrX	140502232	140502511	CpG: 24	279	24	172	17.2	61.6	0.91
chrX	140623079	140623316	CpG: 17	237	17	139	14.3	58.6	0.85
chrX	140691411	140691643	CpG: 19	232	19	138	16.4	59.5	0.94
chrX	140699938	140700165	CpG: 21	227	21	138	18.5	60.8	1.00
chrX	140786677	140786969	CpG: 23	292	23	180	15.8	61.6	0.83
chrX	140818251	140818459	CpG: 18	208	18	124	17.3	59.6	0.98
chrX	140975412	140975642	CpG: 18	230	18	138	15.7	60.0	0.90
chrX	141122195	141122435	CpG: 23	240	23	150	19.2	62.5	1.00
chrX	141161562	141161836	CpG: 23	274	23	170	16.8	62.0	0.88
chrX	141280754	141280957	CpG: 17	203	17	142	16.7	70.0	0.72
chrX	141314822	141315092	CpG: 21	270	21	165	15.6	61.1	0.84
chrX	141368768	141369007	CpG: 18	239	18	139	15.1	58.2	0.92
chrX	141537929	141538319	CpG: 34	390	34	280	17.4	71.8	0.68
chrX	141545630	141545846	CpG: 15	216	15	132	13.9	61.1	0.75
chrX	141840077	141840318	CpG: 20	241	20	144	16.6	59.8	0.95
chrX	141942872	141944420	CpG: 140	1548	140	1036	18.1	66.9	0.81
chrX	142062432	142062756	CpG: 35	324	35	238	21.6	73.5	0.80
chrX	142226072	142226312	CpG: 21	240	21	147	17.5	61.2	0.95
chrX	142233690	142233939	CpG: 18	249	18	155	14.5	62.2	0.76
chrX	142344117	142344391	CpG: 23	274	23	170	16.8	62.0	0.88
chrX	142535520	142535734	CpG: 21	214	21	127	19.6	59.3	1.14
chrX	142536321	142536712	CpG: 31	391	31	279	15.9	71.4	0.62
chrX	142586183	142586421	CpG: 19	238	19	144	16.0	60.5	0.89
chrX	142663766	142663997	CpG: 16	231	16	137	13.9	59.3	0.82
chrX	142691402	142691686	CpG: 20	284	20	171	14.1	60.2	0.78
chrX	142719412	142719645	CpG: 17	233	17	140	14.6	60.1	0.83
chrX	142911678	142911952	CpG: 22	274	22	169	16.1	61.7	0.86
chrX	142941654	142941933	CpG: 21	279	21	175	15.1	62.7	0.77
chrX	143042645	143042850	CpG: 19	205	19	147	18.5	71.7	0.74
chrX	143214947	143215221	CpG: 19	274	19	164	13.9	59.9	0.78
chrX	143452550	143452829	CpG: 21	279	21	162	15.1	58.1	0.91
chrX	143610385	143610670	CpG: 24	285	24	178	16.8	62.5	0.87
chrX	143692242	143693061	CpG: 60	819	60	562	14.7	68.6	0.62
chrX	143887953	143888850	CpG: 63	897	63	568	14.0	63.3	0.71
chrX	144017551	144017847	CpG: 23	296	23	183	15.5	61.8	0.83
chrX	144039853	144040135	CpG: 21	282	21	171	14.9	60.6	0.82
chrX	144074876	144075779	CpG: 98	903	98	642	21.7	71.1	0.86
chrX	144078488	144078690	CpG: 22	202	22	138	21.8	68.3	1.02
chrX	144079045	144079272	CpG: 16	227	16	136	14.1	59.9	0.85
chrX	144106676	144106944	CpG: 19	268	19	159	14.2	59.3	0.81
chrX	144172337	144172567	CpG: 18	230	18	137	15.7	59.6	0.90
chrX	144254263	144254537	CpG: 21	274	21	167	15.3	60.9	0.83
chrX	144304165	144304561	CpG: 36	396	36	287	18.2	72.5	0.69
chrX	144506405	144506679	CpG: 25	274	25	172	18.2	62.8	0.94
chrX	144516808	144517081	CpG: 20	273	20	168	14.7	61.5	0.78
chrX	144582794	144583030	CpG: 18	236	18	140	15.3	59.3	0.88
chrX	144594591	144594865	CpG: 24	274	24	170	17.5	62.0	0.92
chrX	144618596	144618863	CpG: 22	267	22	160	16.5	59.9	0.93
chrX	144703341	144703577	CpG: 20	236	20	144	16.9	61.0	0.93
chrX	144877616	144879104	CpG: 126	1488	126	988	16.9	66.4	0.77
chrX	145043117	145043351	CpG: 17	234	17	139	14.5	59.4	0.85
chrX	145126419	145126785	CpG: 30	366	30	270	16.4	73.8	0.60
chrX	145142483	145142757	CpG: 24	274	24	172	17.5	62.8	0.90
chrX	145600203	145600439	CpG: 21	236	21	140	17.8	59.3	1.05
chrX	145778441	145778715	CpG: 23	274	23	170	16.8	62.0	0.88
chrX	145918396	145918823	CpG: 31	427	31	254	14.5	59.5	0.82
chrX	146042858	146043066	CpG: 16	208	16	121	15.4	58.2	0.93
chrX	146148238	146148809	CpG: 40	571	40	329	14.0	57.6	0.86
chrX	146161766	146162113	CpG: 30	347	30	244	17.3	70.3	0.70
chrX	146176201	146177340	CpG: 135	1139	135	811	23.7	71.2	0.95
chrX	146228244	146228534	CpG: 24	290	24	175	16.6	60.3	0.93
chrX	146245819	146246146	CpG: 27	327	27	220	16.5	67.3	0.73
chrX	146247316	146247630	CpG: 21	314	21	175	13.4	55.7	0.88
chrX	146317542	146317839	CpG: 34	297	34	204	22.9	68.7	1.06
chrX	146394511	146394970	CpG: 35	459	35	275	15.3	59.9	0.85
chrX	146578529	146578804	CpG: 20	275	20	168	14.5	61.1	0.79
chrX	146764927	146766352	CpG: 159	1425	159	1017	22.3	71.4	0.88
chrX	146921935	146922214	CpG: 25	279	25	175	17.9	62.7	0.92
chrX	147181812	147182053	CpG: 18	241	18	148	14.9	61.4	0.81
chrX	147241211	147241485	CpG: 22	274	22	169	16.1	61.7	0.85
chrX	147420903	147421170	CpG: 21	267	21	163	15.7	61.0	0.85
chrX	147736760	147736964	CpG: 17	204	17	140	16.7	68.6	0.71
chrX	147770763	147771195	CpG: 52	432	52	308	24.1	71.3	0.95
chrX	147805705	147805952	CpG: 20	247	20	185	16.2	74.9	0.74
chrX	147806492	147807400	CpG: 76	908	76	575	16.7	63.3	0.84
chrX	147896957	147897797	CpG: 97	840	97	612	23.1	72.9	0.87
chrX	147983790	147984070	CpG: 25	280	25	175	17.9	62.5	0.92
chrX	148024325	148024672	CpG: 28	347	28	253	16.1	72.9	0.61
chrX	148205521	148207530	CpG: 152	2009	152	1368	15.1	68.1	0.72
chrX	148628899	148633479	CpG: 387	4580	387	3082	16.9	67.3	0.75
chrX	148650585	148650859	CpG: 25	274	25	174	18.2	63.5	0.92
chrX	148688750	148688976	CpG: 17	226	17	135	15.0	59.7	0.84
chrX	148815810	148816122	CpG: 37	312	37	222	23.7	71.2	0.96
chrX	148836389	148837425	CpG: 106	1036	106	741	20.5	71.5	0.80
chrX	148960811	148961647	CpG: 108	836	108	653	25.8	78.1	0.85
chrX	149029867	149030079	CpG: 16	212	16	138	15.1	65.1	0.71
chrX	149157509	149157782	CpG: 20	273	20	165	14.7	60.4	0.82
chrX	149165954	149167334	CpG: 141	1380	141	962	20.4	69.7	0.85
chrX	149243735	149244552	CpG: 56	817	56	486	13.7	59.5	0.78
chrX	149250129	149252203	CpG: 284	2074	284	1562	27.4	75.3	0.97
chrX	149309682	149310223	CpG: 36	541	36	312	13.3	57.7	0.81
chrX	149350408	149350733	CpG: 31	325	31	212	19.1	65.2	0.92
chrX	149442654	149443776	CpG: 77	1122	77	645	13.7	57.5	0.83
chrX	149445122	149446084	CpG: 103	962	103	697	21.4	72.5	0.85
chrX	149495746	149495969	CpG: 27	223	27	167	24.2	74.9	0.87
chrX	149504243	149504480	CpG: 18	237	18	141	15.2	59.5	0.89
chrX	149662057	149662296	CpG: 19	239	19	141	15.9	59.0	0.93
chrX	149664815	149665469	CpG: 90	654	90	464	27.5	70.9	1.10
chrX	149672207	149672445	CpG: 17	238	17	141	14.3	59.2	0.84
chrX	149710397	149710633	CpG: 21	236	21	145	17.8	61.4	0.96
chrX	149724866	149725102	CpG: 22	236	22	145	18.6	61.4	1.01
chrX	149779171	149779425	CpG: 20	254	20	155	15.7	61.0	0.86
chrX	149819430	149819641	CpG: 19	211	19	155	18.0	73.5	0.68
chrX	149823495	149823746	CpG: 21	251	21	182	16.7	72.5	0.65
chrX	149829612	149829824	CpG: 18	212	18	116	17.0	54.7	1.14
chrX	149830791	149831623	CpG: 72	832	72	678	17.3	81.5	0.61
chrX	149867603	149868454	CpG: 69	851	69	580	16.2	68.2	0.70
chrX	149963030	149963928	CpG: 101	898	101	694	22.5	77.3	0.77
chrX	150026970	150027245	CpG: 24	275	24	172	17.5	62.5	0.90
chrX	150240414	150241289	CpG: 97	875	97	636	22.2	72.7	0.84
chrX	150404183	150404401	CpG: 17	218	17	145	15.6	66.5	0.71
chrX	150417896	150418170	CpG: 23	274	23	170	16.8	62.0	0.88
chrX	150711405	150711679	CpG: 24	274	24	171	17.5	62.4	0.91
chrX	150723971	150724182	CpG: 17	211	17	128	16.1	60.7	0.89
chrX	150747171	150747616	CpG: 31	445	31	282	13.9	63.4	0.70
chrX	150751484	150751741	CpG: 23	257	23	157	17.9	61.1	0.98
chrX	150811248	150811558	CpG: 25	310	25	190	16.1	61.3	0.87
chrX	150904350	150905089	CpG: 68	739	68	518	18.4	70.1	0.75
chrX	150965272	150965564	CpG: 24	292	24	194	16.4	66.4	0.74
chrX	150985790	150986070	CpG: 25	280	25	175	17.9	62.5	0.92
chrX	151015551	151015831	CpG: 25	280	25	175	17.9	62.5	0.92
chrX	151036044	151036336	CpG: 24	292	24	194	16.4	66.4	0.74
chrX	151097089	151097691	CpG: 59	602	59	413	19.6	68.6	0.85
chrX	151164072	151164701	CpG: 73	629	73	463	23.2	73.6	0.86
chrX	151207947	151208388	CpG: 63	441	63	309	28.6	70.1	1.17
chrX	151225275	151225518	CpG: 30	243	30	156	24.7	64.2	1.21
chrX	151260447	151260737	CpG: 29	290	29	200	20.0	69.0	0.86
chrX	151299892	151300488	CpG: 62	596	62	386	20.8	64.8	0.99
chrX	151323598	151324462	CpG: 89	864	89	661	20.6	76.5	0.72
chrX	151393786	151394600	CpG: 57	814	57	526	14.0	64.6	0.68
chrX	151401204	151401490	CpG: 21	286	21	162	14.7	56.6	0.95
chrX	151470709	151471002	CpG: 23	293	23	181	15.7	61.8	0.85
chrX	151533518	151533804	CpG: 21	286	21	162	14.7	56.6	0.95
chrX	151540422	151541236	CpG: 57	814	57	526	14.0	64.6	0.68
chrX	151587020	151587349	CpG: 22	329	22	219	13.4	66.6	0.62
chrX	151588969	151589223	CpG: 27	254	27	183	21.3	72.0	0.82
chrX	151601416	151602147	CpG: 85	731	85	535	23.3	73.2	0.87
chrX	151614846	151615535	CpG: 62	689	62	448	18.0	65.0	0.86
chrX	151674281	151674785	CpG: 38	504	38	378	15.1	75.0	0.62
chrX	151684837	151685526	CpG: 74	689	74	517	21.5	75.0	0.76
chrX	151694258	151695336	CpG: 119	1078	119	762	22.1	70.7	0.89
chrX	151718329	151718939	CpG: 49	610	49	421	16.1	69.0	0.68
chrX	151743907	151744552	CpG: 72	645	72	476	22.3	73.8	0.82
chrX	151748238	151748780	CpG: 74	542	74	404	27.3	74.5	1.01
chrX	151768427	151768672	CpG: 21	245	21	176	17.1	71.8	0.82
chrX	151791035	151791959	CpG: 130	924	130	730	28.1	79.0	0.91
chrX	151853665	151853929	CpG: 23	264	23	161	17.4	61.0	1.02
chrX	151872224	151873498	CpG: 157	1274	157	936	24.6	73.5	0.92
chrX	151883445	151884291	CpG: 68	846	68	580	16.1	68.6	0.69
chrX	151915711	151918243	CpG: 225	2532	225	1785	17.8	70.5	0.72
chrX	151920665	151921893	CpG: 135	1228	135	896	22.0	73.0	0.83
chrX	151935799	151936375	CpG: 46	576	46	359	16.0	62.3	0.83
chrX	151946646	151947754	CpG: 129	1108	129	833	23.3	75.2	0.86
chrX	151961266	151963132	CpG: 244	1866	244	1465	26.2	78.5	0.85
chrX	151997082	151999927	CpG: 257	2845	257	2031	18.1	71.4	0.71
chrX	152003971	152004251	CpG: 22	280	22	176	15.7	62.9	0.80
chrX	152012028	152012232	CpG: 15	204	15	139	14.7	68.1	0.63
chrX	152040679	152041565	CpG: 70	886	70	623	15.8	70.3	0.64
chrX	152046992	152047234	CpG: 18	242	18	170	14.9	70.2	0.60
chrX	152050138	152050395	CpG: 27	257	27	221	21.0	86.0	0.84
chrX	152054550	152054977	CpG: 42	427	42	312	19.7	73.1	0.74
chrX	152067483	152068765	CpG: 131	1282	131	872	20.4	68.0	0.88
chrX	152076871	152078558	CpG: 145	1687	145	1142	17.2	67.7	0.75
chrX	152080759	152081000	CpG: 19	241	19	167	15.8	69.3	0.66
chrX	152092577	152093117	CpG: 57	540	57	387	21.1	71.7	0.82
chrX	152102318	152104810	CpG: 271	2492	271	1814	21.7	72.8	0.82
chrX	152159243	152160449	CpG: 132	1206	132	911	21.9	75.5	0.77
chrX	152199732	152200090	CpG: 46	358	46	277	25.7	77.4	0.86
chrX	152201776	152202337	CpG: 71	561	71	417	25.3	74.3	0.92
chrX	152208216	152209188	CpG: 128	972	128	752	26.3	77.4	0.88
chrX	152227086	152227440	CpG: 28	354	28	228	15.8	64.4	0.78
chrX	152227899	152228908	CpG: 69	1009	69	688	13.7	68.2	0.60
chrX	152244340	152246749	CpG: 274	2409	274	1677	22.7	69.6	0.95
chrX	152255757	152256311	CpG: 45	554	45	374	16.2	67.5	0.71
chrX	152268930	152269205	CpG: 21	275	21	171	15.3	62.2	0.80
chrX	152292915	152293885	CpG: 127	970	127	759	26.2	78.2	0.86
chrX	152327667	152327963	CpG: 21	296	21	174	14.2	58.8	0.83
chrX	152351966	152352247	CpG: 25	281	25	176	17.8	62.6	0.92
chrX	152359597	152359828	CpG: 17	231	17	137	14.7	59.3	0.84
chrX	152370768	152371673	CpG: 136	905	136	696	30.1	76.9	1.02
chrX	152380602	152380841	CpG: 17	239	17	141	14.2	59.0	0.84
chrX	152399095	152399344	CpG: 19	249	19	168	15.3	67.5	0.67
chrX	152410406	152410853	CpG: 46	447	46	306	20.6	68.5	0.88
chrX	152434705	152434927	CpG: 18	222	18	135	16.2	60.8	0.90
chrX	152471828	152472050	CpG: 18	222	18	135	16.2	60.8	0.90
chrX	152508944	152509167	CpG: 17	223	17	134	15.2	60.1	0.87
chrX	152531903	152532337	CpG: 32	434	32	271	14.7	62.4	0.76
chrX	152569200	152569526	CpG: 27	326	27	217	16.6	66.6	0.76
chrX	152577712	152579604	CpG: 210	1892	210	1377	22.2	72.8	0.84
chrX	152581566	152581788	CpG: 20	222	20	160	18.0	72.1	0.69
chrX	152593862	152594109	CpG: 25	247	25	168	20.2	68.0	0.88
chrX	152607038	152608768	CpG: 177	1730	177	1244	20.5	71.9	0.79
chrX	152610884	152611433	CpG: 85	549	85	423	31.0	77.0	1.05
chrX	152614517	152616420	CpG: 226	1903	226	1370	23.8	72.0	0.93
chrX	152623401	152623623	CpG: 20	222	20	161	18.0	72.5	0.69
chrX	152625585	152627471	CpG: 209	1886	209	1371	22.2	72.7	0.84
chrX	152634017	152635503	CpG: 130	1486	130	938	17.5	63.1	0.88
chrX	152647904	152648844	CpG: 102	940	102	680	21.7	72.3	0.83
chrX	152664715	152665525	CpG: 83	810	83	534	20.5	65.9	0.96
chrX	152672923	152674227	CpG: 169	1304	169	968	25.9	74.2	0.94
chrX	152680435	152681181	CpG: 98	746	98	560	26.3	75.1	0.94
chrX	152694264	152695294	CpG: 141	1030	141	809	27.4	78.5	0.90
chrX	152696762	152697030	CpG: 22	268	22	179	16.4	66.8	0.74
chrX	152700338	152700766	CpG: 32	428	32	302	15.0	70.6	0.60
chrX	152702522	152702944	CpG: 34	422	34	289	16.1	68.5	0.69
chrX	152703788	152704014	CpG: 18	226	18	154	15.9	68.1	0.69
chrX	152704671	152705038	CpG: 30	367	30	248	16.3	67.6	0.74
chrX	152715098	152715986	CpG: 94	888	94	627	21.2	70.6	0.88
chrX	152722458	152723545	CpG: 137	1087	137	830	25.2	76.4	0.87
chrX	152726824	152727951	CpG: 110	1127	110	758	19.5	67.3	0.86
chrX	152743159	152743375	CpG: 19	216	19	154	17.6	71.3	0.70
chrX	152752378	152752998	CpG: 67	620	67	461	21.6	74.4	0.78
chrX	152753690	152753902	CpG: 16	212	16	148	15.1	69.8	0.69
chrX	152782976	152784304	CpG: 155	1328	155	935	23.3	70.4	0.94
chrX	152792789	152793154	CpG: 30	365	30	240	16.4	65.8	0.77
chrX	152793544	152794116	CpG: 40	572	40	380	14.0	66.4	0.64
chrX	152796634	152796969	CpG: 33	335	33	244	19.7	72.8	0.74
chrX	152805244	152805816	CpG: 40	572	40	380	14.0	66.4	0.64
chrX	152871444	152872016	CpG: 40	572	40	380	14.0	66.4	0.64
chrX	152880291	152880626	CpG: 33	335	33	244	19.7	72.8	0.74
chrX	152883144	152883716	CpG: 40	572	40	380	14.0	66.4	0.64
chrX	152884106	152884471	CpG: 30	365	30	240	16.4	65.8	0.77
chrX	152986976	152987788	CpG: 104	812	104	608	25.6	74.9	0.91
chrX	152993942	152994230	CpG: 27	288	27	183	18.8	63.5	0.94
chrX	152998975	152999966	CpG: 105	991	105	684	21.2	69.0	0.89
chrX	153041501	153042070	CpG: 61	569	61	405	21.4	71.2	0.85
chrX	153121257	153121699	CpG: 42	442	42	292	19.0	66.1	0.87
chrX	153122524	153123656	CpG: 156	1132	156	880	27.6	77.7	0.92
chrX	153249269	153249503	CpG: 19	234	19	142	16.2	60.7	0.91
chrX	153262307	153262543	CpG: 22	236	22	145	18.6	61.4	1.01
chrX	153263042	153263823	CpG: 93	781	93	548	23.8	70.2	0.97
chrX	153307195	153308011	CpG: 96	816	96	580	23.5	71.1	0.93
chrX	153452542	153453184	CpG: 50	642	50	420	15.6	65.4	0.74
chrX	153459965	153460776	CpG: 60	811	60	555	14.8	68.4	0.63
chrX	153501326	153501930	CpG: 52	604	52	389	17.2	64.4	0.83
chrX	153529851	153530081	CpG: 19	230	19	140	16.5	60.9	0.90
chrX	153618596	153619038	CpG: 41	442	41	291	18.6	65.8	0.86
chrX	153619863	153620995	CpG: 156	1132	156	881	27.6	77.8	0.92
chrX	153638541	153638815	CpG: 21	274	21	166	15.3	60.6	0.84
chrX	153654778	153655010	CpG: 21	232	21	144	18.1	62.1	0.95
chrX	153660140	153660365	CpG: 17	225	17	135	15.1	60.0	0.84
chrX	153695774	153696906	CpG: 156	1132	156	881	27.6	77.8	0.92
chrX	153697734	153698176	CpG: 41	442	41	291	18.6	65.8	0.86
chrX	153759932	153760291	CpG: 28	359	28	213	15.6	59.3	0.89
chrX	153837674	153838281	CpG: 43	607	43	399	14.2	65.7	0.67
chrX	154012992	154013195	CpG: 16	203	16	113	15.8	55.7	1.07
chrX	154066228	154066502	CpG: 22	274	22	168	16.1	61.3	0.86
chrX	154088365	154088642	CpG: 25	277	25	175	18.1	63.2	0.92
chrX	154109117	154109507	CpG: 36	390	36	258	18.5	66.2	0.85
chrX	154135797	154136428	CpG: 47	631	47	422	14.9	66.9	0.67
chrX	154244598	154244906	CpG: 29	308	29	212	18.8	68.8	0.80
chrX	154255554	154256278	CpG: 120	724	120	549	33.1	75.8	1.16
chrY	9562	10218	CpG: 44	656	44	475	13.4	72.4	0.74
chrY	10409	11084	CpG: 68	675	68	442	20.1	65.5	1.00
chrY	15523	16362	CpG: 91	839	91	575	21.7	68.5	0.96
chrY	72064	74567	CpG: 181	2503	181	1672	14.5	66.8	0.79
chrY	77275	77547	CpG: 27	272	27	180	19.9	66.2	0.93
chrY	78520	80104	CpG: 100	1584	100	920	12.6	58.1	0.75
chrY	85068	85275	CpG: 16	207	16	140	15.5	67.6	0.69
chrY	89782	89993	CpG: 17	211	17	129	16.1	61.1	0.87
chrY	91597	91873	CpG: 28	276	28	185	20.3	67.0	0.90
chrY	103438	104836	CpG: 102	1398	102	958	14.6	68.5	0.63
chrY	110649	111508	CpG: 64	859	64	584	14.9	68.0	0.70
chrY	116653	116884	CpG: 19	231	19	146	16.5	63.2	0.82
chrY	119382	119838	CpG: 31	456	31	290	13.6	63.6	0.69
chrY	120915	121157	CpG: 18	242	18	160	14.9	66.1	0.68
chrY	122066	122313	CpG: 21	247	21	151	17.0	61.1	0.93
chrY	122967	123281	CpG: 23	314	23	192	14.6	61.1	0.80
chrY	126423	126741	CpG: 34	318	34	207	21.4	65.1	1.01
chrY	132245	132539	CpG: 23	294	23	195	15.6	66.3	0.71
chrY	134730	135289	CpG: 47	559	47	382	16.8	68.3	0.72
chrY	138242	139267	CpG: 85	1025	85	695	16.6	67.8	0.73
chrY	140086	140720	CpG: 50	634	50	422	15.8	66.6	0.71
chrY	141575	142916	CpG: 105	1341	105	856	15.7	63.8	0.77
chrY	146851	147552	CpG: 48	701	48	445	13.7	63.5	0.68
chrY	148558	150323	CpG: 190	1765	190	1292	21.5	73.2	0.80
chrY	159043	159314	CpG: 20	271	20	179	14.8	66.1	0.69
chrY	162638	163080	CpG: 38	442	38	305	17.2	69.0	0.73
chrY	165207	182819	CpG: 1230	17612	1230	11712	14.0	66.5	0.64
chrY	184954	185920	CpG: 76	966	76	643	15.7	66.6	0.73
chrY	187067	187728	CpG: 56	661	56	419	16.9	63.4	0.85
chrY	192925	194104	CpG: 99	1179	99	780	16.8	66.2	0.77
chrY	196191	196612	CpG: 40	421	40	272	19.0	64.6	0.92
chrY	198150	202543	CpG: 263	4393	263	2790	12.0	63.5	0.80
chrY	207398	207776	CpG: 32	378	32	259	16.9	68.5	0.73
chrY	208160	208403	CpG: 19	243	19	169	15.6	69.5	0.65
chrY	209075	209522	CpG: 39	447	39	297	17.4	66.4	0.79
chrY	210907	212226	CpG: 148	1319	148	936	22.4	71.0	0.89
chrY	212519	212800	CpG: 19	281	19	163	13.5	58.0	0.82
chrY	213373	213684	CpG: 22	311	22	194	14.1	62.4	0.74
chrY	221444	221691	CpG: 21	247	21	150	17.0	60.7	0.94
chrY	224129	225365	CpG: 160	1236	160	899	25.9	72.7	0.99
chrY	233882	234311	CpG: 29	429	29	243	13.5	56.6	0.85
chrY	237783	237986	CpG: 17	203	17	126	16.7	62.1	0.88
chrY	239904	240115	CpG: 15	211	15	131	14.2	62.1	0.75
chrY	243537	244063	CpG: 43	526	43	322	16.3	61.2	0.88
chrY	244463	246775	CpG: 204	2312	204	1371	17.6	59.3	1.01
chrY	251302	251519	CpG: 20	217	20	143	18.4	65.9	0.85
chrY	255538	255804	CpG: 19	266	19	163	14.3	61.3	0.77
chrY	255960	256225	CpG: 20	265	20	165	15.1	62.3	0.80
chrY	256776	257663	CpG: 70	887	70	573	15.8	64.6	0.77
chrY	257938	258196	CpG: 18	258	18	161	14.0	62.4	0.72
chrY	258585	258840	CpG: 18	255	18	156	14.1	61.2	0.75
chrY	259052	259371	CpG: 23	319	23	194	14.4	60.8	0.78
chrY	266269	267652	CpG: 105	1383	105	896	15.2	64.8	0.73
chrY	276173	276506	CpG: 27	333	27	202	16.2	60.7	0.89
chrY	279672	279930	CpG: 23	258	23	166	17.8	64.3	0.86
chrY	291435	291679	CpG: 20	244	20	152	16.4	62.3	0.86
chrY	303988	304426	CpG: 33	438	33	272	15.1	62.1	0.78
chrY	318410	318647	CpG: 19	237	19	141	16.0	59.5	0.93
chrY	320705	321038	CpG: 26	333	26	189	15.6	56.8	0.97
chrY	321458	321702	CpG: 20	244	20	140	16.4	57.4	1.00
chrY	322973	323184	CpG: 16	211	16	126	15.2	59.7	0.86
chrY	339616	339838	CpG: 17	222	17	133	15.3	59.9	0.87
chrY	346333	346559	CpG: 21	226	21	144	18.6	63.7	0.96
chrY	349510	350082	CpG: 41	572	41	325	14.3	56.8	0.89
chrY	352459	352686	CpG: 17	227	17	130	15.0	57.3	0.93
chrY	410191	410466	CpG: 24	275	24	177	17.5	64.4	0.85
chrY	442776	443706	CpG: 58	930	58	499	12.5	53.7	0.87
chrY	472688	474277	CpG: 119	1589	119	1090	15.0	68.6	0.64
chrY	477485	478251	CpG: 66	766	66	506	17.2	66.1	0.80
chrY	482995	485540	CpG: 223	2545	223	1611	17.5	63.3	0.88
chrY	487294	488271	CpG: 86	977	86	603	17.6	61.7	0.92
chrY	495187	495824	CpG: 51	637	51	420	16.0	65.9	0.75
chrY	497165	497979	CpG: 90	814	90	598	22.1	73.5	0.82
chrY	504955	505192	CpG: 22	237	22	153	18.6	64.6	0.90
chrY	515268	515503	CpG: 17	235	17	123	14.5	52.3	1.06
chrY	516949	517171	CpG: 17	222	17	129	15.3	58.1	0.94
chrY	546413	546648	CpG: 18	235	18	140	15.3	59.6	0.90
chrY	646754	647070	CpG: 23	316	23	183	14.6	57.9	0.87
chrY	737576	737820	CpG: 18	244	18	144	14.8	59.0	0.86
chrY	743079	743319	CpG: 17	240	17	142	14.2	59.2	0.84
chrY	758797	759032	CpG: 18	235	18	141	15.3	60.0	0.88
chrY	917525	917779	CpG: 19	254	19	148	15.0	58.3	0.92
chrY	918859	919112	CpG: 18	253	18	153	14.2	60.5	0.80
chrY	971671	971937	CpG: 20	266	20	167	15.0	62.8	0.78
chrY	995026	995252	CpG: 17	226	17	136	15.0	60.2	0.85
chrY	1051540	1051773	CpG: 17	233	17	136	14.6	58.4	0.87
chrY	1051927	1052152	CpG: 17	225	17	136	15.1	60.4	0.83
chrY	1062330	1062561	CpG: 20	231	20	140	17.3	60.6	0.95
chrY	1067214	1067440	CpG: 17	226	17	133	15.0	58.8	0.88
chrY	1097408	1097629	CpG: 18	221	18	125	16.3	56.6	1.02
chrY	1122172	1122379	CpG: 17	207	17	127	16.4	61.4	0.88
chrY	1138049	1138313	CpG: 19	264	19	152	14.4	57.6	0.90
chrY	1157060	1157265	CpG: 17	205	17	125	16.6	61.0	0.89
chrY	1163654	1163901	CpG: 18	247	18	147	14.6	59.5	0.86
chrY	1165714	1165966	CpG: 18	252	18	149	14.3	59.1	0.85
chrY	1208616	1208851	CpG: 18	235	18	139	15.3	59.1	0.90
chrY	1216830	1217384	CpG: 41	554	41	333	14.8	60.1	0.82
chrY	1230026	1233097	CpG: 461	3071	461	2445	30.0	79.6	1.22
chrY	1250134	1250585	CpG: 32	451	32	270	14.2	59.9	0.79
chrY	1251015	1251363	CpG: 35	348	35	240	20.1	69.0	0.85
chrY	1252941	1253302	CpG: 34	361	34	234	18.8	64.8	0.90
chrY	1255496	1256954	CpG: 180	1458	180	1085	24.7	74.4	0.92
chrY	1275608	1275832	CpG: 17	224	17	148	15.2	66.1	0.73
chrY	1290175	1290514	CpG: 32	339	32	230	18.9	67.8	0.83
chrY	1294534	1295640	CpG: 68	1106	68	661	12.3	59.8	0.69
chrY	1296597	1296880	CpG: 24	283	24	167	17.0	59.0	0.99
chrY	1298171	1298435	CpG: 20	264	20	158	15.2	59.8	0.85
chrY	1302271	1302670	CpG: 33	399	33	249	16.5	62.4	0.86
chrY	1303327	1303553	CpG: 20	226	20	145	17.7	64.2	0.87
chrY	1306251	1306487	CpG: 25	236	25	147	21.2	62.3	1.18
chrY	1315658	1317702	CpG: 170	2044	170	1490	16.6	72.9	0.64
chrY	1328909	1330048	CpG: 103	1139	103	740	18.1	65.0	0.87
chrY	1362311	1362585	CpG: 23	274	23	176	16.8	64.2	0.82
chrY	1401317	1401561	CpG: 19	244	19	156	15.6	63.9	0.77
chrY	1449452	1449690	CpG: 18	238	18	141	15.1	59.2	0.88
chrY	1455853	1456534	CpG: 85	681	85	518	25.0	76.1	0.93
chrY	1458166	1458663	CpG: 40	497	40	315	16.1	63.4	0.80
chrY	1462246	1465868	CpG: 253	3622	253	2394	14.0	66.1	0.64
chrY	1466947	1467298	CpG: 26	351	26	204	14.8	58.1	0.88
chrY	1471575	1471843	CpG: 23	268	23	169	17.2	63.1	0.87
chrY	1487608	1487845	CpG: 17	237	17	135	14.3	57.0	0.90
chrY	1489433	1489700	CpG: 20	267	20	161	15.0	60.3	0.84
chrY	1518733	1519078	CpG: 24	345	24	200	13.9	58.0	0.84
chrY	1520263	1520470	CpG: 19	207	19	128	18.4	61.8	0.97
chrY	1531473	1531740	CpG: 23	267	23	166	17.2	62.2	0.91
chrY	1550087	1550319	CpG: 17	232	17	136	14.7	58.6	0.87
chrY	1568981	1569292	CpG: 22	311	22	185	14.1	59.5	0.80
chrY	1595850	1596060	CpG: 14	210	14	132	13.3	62.9	1.78
chrY	1782827	1783059	CpG: 16	232	16	134	13.8	57.8	0.84
chrY	1901179	1901436	CpG: 19	257	19	159	14.8	61.9	0.78
chrY	1928605	1928810	CpG: 17	205	17	141	16.6	68.8	0.71
chrY	2001812	2002056	CpG: 17	244	17	137	13.9	56.1	0.89
chrY	2049332	2049568	CpG: 17	236	17	142	14.4	60.2	0.81
chrY	2110584	2110792	CpG: 17	208	17	123	16.3	59.1	0.95
chrY	2165473	2167406	CpG: 132	1933	132	1224	13.7	63.3	0.68
chrY	2167561	2167773	CpG: 17	212	17	131	16.0	61.8	0.85
chrY	2177075	2177885	CpG: 116	810	116	655	28.6	80.9	0.88
chrY	2260314	2261646	CpG: 157	1332	157	1006	23.6	75.5	0.84
chrY	2270388	2270676	CpG: 19	288	19	173	13.2	60.1	0.74
chrY	2285967	2286546	CpG: 70	579	70	452	24.2	78.1	0.79
chrY	2367886	2369036	CpG: 108	1150	108	776	18.8	67.5	0.83
chrY	2458323	2458598	CpG: 24	275	24	170	17.5	61.8	0.92
chrY	2466601	2466898	CpG: 29	297	29	192	19.5	64.6	0.93
chrY	2517473	2517763	CpG: 23	290	23	167	15.9	57.6	0.97
chrY	2527697	2527971	CpG: 23	274	23	170	16.8	62.0	0.88
chrY	2612105	2613424	CpG: 145	1319	145	909	22.0	68.9	0.93
chrY	2615198	2615489	CpG: 22	291	22	163	15.1	56.0	0.98
chrY	2675522	2675913	CpG: 30	391	30	278	15.3	71.1	0.61
chrY	2885199	2885472	CpG: 19	273	19	166	13.9	60.8	0.76
chrY	3041088	3041323	CpG: 17	235	17	139	14.5	59.1	0.83
chrY	3120765	3121074	CpG: 26	309	26	185	16.8	59.9	0.95
chrY	3203515	3203789	CpG: 25	274	25	172	18.2	62.8	0.93
chrY	3300447	3300676	CpG: 23	229	23	162	20.1	70.7	0.80
chrY	3412671	3412943	CpG: 21	272	21	167	15.4	61.4	0.83
chrY	3564067	3564342	CpG: 24	275	24	171	17.5	62.2	0.92
chrY	3778609	3779000	CpG: 30	391	30	278	15.3	71.1	0.61
chrY	3797299	3797507	CpG: 17	208	17	120	16.3	57.7	1.00
chrY	4088676	4088962	CpG: 26	286	26	182	18.2	63.6	0.92
chrY	4220073	4220339	CpG: 20	266	20	156	15.0	58.6	0.88
chrY	4282528	4282766	CpG: 18	238	18	142	15.1	59.7	0.88
chrY	4447274	4447510	CpG: 21	236	21	148	17.8	62.7	0.93
chrY	4480745	4481022	CpG: 21	277	21	166	15.2	59.9	0.86
chrY	4574654	4574930	CpG: 25	276	25	170	18.1	61.6	0.97
chrY	4575183	4575458	CpG: 23	275	23	169	16.7	61.5	0.89
chrY	4633998	4634290	CpG: 24	292	24	179	16.4	61.3	0.88
chrY	4652805	4653075	CpG: 21	270	21	156	15.6	57.8	0.93
chrY	4660126	4660355	CpG: 18	229	18	140	15.7	61.1	0.86
chrY	4679433	4680063	CpG: 43	630	43	410	13.7	65.1	0.65
chrY	4682095	4682702	CpG: 53	607	53	388	17.5	63.9	0.85
chrY	4692434	4692650	CpG: 17	216	17	133	15.7	61.6	0.86
chrY	4726221	4726532	CpG: 26	311	26	189	16.7	60.8	0.91
chrY	4747267	4747504	CpG: 21	237	21	142	17.7	59.9	1.01
chrY	4787311	4787551	CpG: 18	240	18	145	15.0	60.4	0.85
chrY	5046946	5047229	CpG: 21	283	21	172	14.8	60.8	0.81
chrY	5060214	5060453	CpG: 19	239	19	142	15.9	59.4	0.92
chrY	5114913	5115194	CpG: 20	281	20	168	14.2	59.8	0.82
chrY	5163492	5163746	CpG: 20	254	20	164	15.7	64.6	0.76
chrY	5291836	5292228	CpG: 30	392	30	235	15.3	59.9	0.85
chrY	5618450	5618769	CpG: 24	319	24	217	15.0	68.0	0.65
chrY	5640415	5640696	CpG: 24	281	24	174	17.1	61.9	0.91
chrY	5683933	5684201	CpG: 24	268	24	167	17.9	62.3	0.93
chrY	5755946	5756227	CpG: 24	281	24	176	17.1	62.6	0.89
chrY	5926009	5926443	CpG: 36	434	36	311	16.6	71.7	0.67
chrY	5963555	5963848	CpG: 25	293	25	184	17.1	62.8	0.87
chrY	6158861	6159135	CpG: 23	274	23	170	16.8	62.0	0.88
chrY	6188427	6188697	CpG: 20	270	20	183	14.8	67.8	0.65
chrY	6562861	6564315	CpG: 143	1454	143	974	19.7	67.0	0.88
chrY	6812009	6812319	CpG: 25	310	25	190	16.1	61.3	0.86
chrY	6860621	6860895	CpG: 24	274	24	171	17.5	62.4	0.91
chrY	6916064	6916352	CpG: 33	288	33	215	22.9	74.7	0.83
chrY	6925807	6927510	CpG: 170	1703	170	1192	20.0	70.0	0.82
chrY	7054587	7054873	CpG: 25	286	25	180	17.5	62.9	0.90
chrY	7157561	7157823	CpG: 24	262	24	166	18.3	63.4	0.92
chrY	7198331	7198593	CpG: 26	262	26	165	19.8	63.0	1.01
chrY	7212491	7212736	CpG: 20	245	20	162	16.3	66.1	0.75
chrY	7275082	7275295	CpG: 17	213	17	153	16.0	71.8	0.63
chrY	7320445	7320970	CpG: 40	525	40	301	15.2	57.3	0.93
chrY	7784790	7785031	CpG: 19	241	19	173	15.8	71.8	0.62
chrY	7873504	7873778	CpG: 22	274	22	168	16.1	61.3	0.86
chrY	7888278	7888545	CpG: 21	267	21	164	15.7	61.4	0.85
chrY	7935791	7936124	CpG: 23	333	23	217	13.8	65.2	0.65
chrY	7941596	7941837	CpG: 19	241	19	146	15.8	60.6	0.87
chrY	7969132	7969362	CpG: 19	230	19	141	16.5	61.3	0.89
chrY	8102058	8102336	CpG: 25	278	25	176	18.0	63.3	0.90
chrY	8177444	8177673	CpG: 20	229	20	143	17.5	62.4	0.91
chrY	8478225	8478503	CpG: 23	278	23	171	16.5	61.5	0.89
chrY	8512705	8512982	CpG: 23	277	23	168	16.6	60.6	0.91
chrY	8574063	8574500	CpG: 37	437	37	317	16.9	72.5	0.64
chrY	8781502	8781744	CpG: 22	242	22	150	18.2	62.0	0.97
chrY	8943427	8943947	CpG: 39	520	39	371	15.0	71.3	0.63
chrY	8963723	8964243	CpG: 39	520	39	371	15.0	71.3	0.63
chrY	8982454	8982717	CpG: 21	263	21	164	16.0	62.4	0.83
chrY	8983318	8983632	CpG: 25	314	25	223	15.9	71.0	0.64
chrY	8984062	8984582	CpG: 39	520	39	371	15.0	71.3	0.63
chrY	9004328	9004849	CpG: 40	521	40	373	15.4	71.6	0.64
chrY	9024634	9025172	CpG: 41	538	41	384	15.2	71.4	0.64
chrY	9044966	9045692	CpG: 52	726	52	509	14.3	70.1	0.62
chrY	9063648	9063911	CpG: 21	263	21	164	16.0	62.4	0.83
chrY	9065257	9065777	CpG: 40	520	40	372	15.4	71.5	0.64
chrY	9083910	9084173	CpG: 21	263	21	164	16.0	62.4	0.83
chrY	9084775	9085089	CpG: 25	314	25	223	15.9	71.0	0.64
chrY	9085519	9086039	CpG: 40	520	40	371	15.4	71.3	0.64
chrY	9104190	9104453	CpG: 21	263	21	164	16.0	62.4	0.83
chrY	9105055	9105369	CpG: 24	314	24	222	15.3	70.7	0.62
chrY	9105799	9106319	CpG: 40	520	40	372	15.4	71.5	0.64
chrY	9124471	9124734	CpG: 21	263	21	164	16.0	62.4	0.83
chrY	9125336	9125643	CpG: 24	307	24	217	15.6	70.7	0.63
chrY	9126076	9126596	CpG: 40	520	40	371	15.4	71.3	0.65
chrY	9146359	9146879	CpG: 40	520	40	372	15.4	71.5	0.64
chrY	9166620	9167158	CpG: 41	538	41	385	15.2	71.6	0.64
chrY	9185324	9185587	CpG: 21	263	21	164	16.0	62.4	0.83
chrY	9186933	9187453	CpG: 40	520	40	372	15.4	71.5	0.64
chrY	9205602	9205865	CpG: 21	263	21	164	16.0	62.4	0.83
chrY	9206467	9206781	CpG: 24	314	24	222	15.3	70.7	0.62
chrY	9207211	9207731	CpG: 40	520	40	372	15.4	71.5	0.64
chrY	9225883	9226146	CpG: 20	263	20	163	15.2	62.0	0.80
chrY	9226748	9227055	CpG: 24	307	24	217	15.6	70.7	0.63
chrY	9227488	9228008	CpG: 40	520	40	371	15.4	71.3	0.65
chrY	9247771	9248291	CpG: 40	520	40	372	15.4	71.5	0.64
chrY	9268034	9268572	CpG: 41	538	41	385	15.2	71.6	0.64
chrY	9286740	9287003	CpG: 21	263	21	164	16.0	62.4	0.83
chrY	9288349	9288869	CpG: 40	520	40	372	15.4	71.5	0.64
chrY	9307020	9307283	CpG: 21	263	21	164	16.0	62.4	0.83
chrY	9307885	9308199	CpG: 24	314	24	222	15.3	70.7	0.62
chrY	9308629	9309149	CpG: 40	520	40	372	15.4	71.5	0.64
chrY	9327301	9327564	CpG: 21	263	21	164	16.0	62.4	0.83
chrY	9328166	9328473	CpG: 24	307	24	217	15.6	70.7	0.63
chrY	9328906	9329426	CpG: 40	520	40	371	15.4	71.3	0.65
chrY	9349192	9349712	CpG: 40	520	40	372	15.4	71.5	0.64
chrY	9369455	9369993	CpG: 41	538	41	385	15.2	71.6	0.64
chrY	9389779	9390299	CpG: 40	520	40	372	15.4	71.5	0.64
chrY	9408462	9408725	CpG: 21	263	21	164	16.0	62.4	0.83
chrY	9409327	9409641	CpG: 25	314	25	223	15.9	71.0	0.64
chrY	9410071	9410591	CpG: 40	520	40	372	15.4	71.5	0.64
chrY	9430361	9430881	CpG: 40	520	40	371	15.4	71.3	0.65
chrY	9449067	9449330	CpG: 21	263	21	164	16.0	62.4	0.83
chrY	9449931	9450245	CpG: 25	314	25	223	15.9	71.0	0.64
chrY	9450786	9451214	CpG: 34	428	34	306	15.9	71.5	0.67
chrY	9469353	9469616	CpG: 21	263	21	164	16.0	62.4	0.83
chrY	9470962	9471482	CpG: 40	520	40	372	15.4	71.5	0.64
chrY	9491246	9491784	CpG: 41	538	41	385	15.2	71.6	0.64
chrY	9509919	9510182	CpG: 21	263	21	163	16.0	62.0	0.84
chrY	9510784	9511098	CpG: 23	314	23	220	14.6	70.1	0.60
chrY	9511528	9512236	CpG: 51	708	51	497	14.4	70.2	0.61
chrY	9531793	9532331	CpG: 41	538	41	385	15.2	71.6	0.64
chrY	9550483	9550746	CpG: 21	263	21	164	16.0	62.4	0.83
chrY	9551348	9551655	CpG: 24	307	24	217	15.6	70.7	0.63
chrY	9552092	9552612	CpG: 40	520	40	371	15.4	71.3	0.65
chrY	9572391	9572911	CpG: 40	520	40	371	15.4	71.3	0.65
chrY	9592697	9593235	CpG: 41	538	41	384	15.2	71.4	0.64
chrY	9611396	9611659	CpG: 21	263	21	164	16.0	62.4	0.83
chrY	9612261	9612575	CpG: 25	314	25	223	15.9	71.0	0.64
chrY	9613005	9613525	CpG: 40	520	40	372	15.4	71.5	0.64
chrY	9633433	9634031	CpG: 44	598	44	418	14.7	69.9	0.63
chrY	9653622	9654160	CpG: 41	538	41	385	15.2	71.6	0.64
chrY	9673936	9674474	CpG: 41	538	41	385	15.2	71.6	0.64
chrY	9694234	9694754	CpG: 40	520	40	371	15.4	71.3	0.65
chrY	9714521	9715041	CpG: 40	520	40	371	15.4	71.3	0.65
chrY	9734818	9735339	CpG: 40	521	40	373	15.4	71.6	0.64
chrY	9755129	9755649	CpG: 40	520	40	371	15.4	71.3	0.65
chrY	9775406	9776222	CpG: 57	816	57	558	14.0	68.4	0.62
chrY	9795714	9796234	CpG: 40	520	40	371	15.4	71.3	0.65
chrY	9815301	9815612	CpG: 25	311	25	218	16.1	70.1	0.66
chrY	9816042	9816858	CpG: 57	816	57	558	14.0	68.4	0.62
chrY	9836353	9836891	CpG: 41	538	41	384	15.2	71.4	0.65
chrY	9856559	9856864	CpG: 25	305	25	213	16.4	69.8	0.68
chrY	9949266	9949536	CpG: 20	270	20	181	14.8	67.0	0.67
chrY	9979664	9979938	CpG: 24	274	24	171	17.5	62.4	0.91
chrY	10167675	10167968	CpG: 25	293	25	185	17.1	63.1	0.86
chrY	10206765	10207125	CpG: 31	360	31	260	17.2	72.2	0.67
chrY	10207555	10207868	CpG: 25	313	25	222	16.0	70.9	0.64
chrY	10226928	10227448	CpG: 41	520	41	371	15.8	71.3	0.66
chrY	10260367	10260659	CpG: 22	292	22	176	15.1	60.3	0.83
chrY	10411631	10412487	CpG: 70	856	70	582	16.4	68.0	0.71
chrY	10514452	10516205	CpG: 147	1753	147	1208	16.8	68.9	0.72
chrY	10518256	10518698	CpG: 32	442	32	294	14.5	66.5	0.65
chrY	11076389	11076676	CpG: 22	287	22	172	15.3	59.9	0.86
chrY	11319982	11320309	CpG: 26	327	26	214	15.9	65.4	0.74
chrY	11321632	11321943	CpG: 21	311	21	197	13.5	63.3	0.67
chrY	11324364	11324869	CpG: 36	505	36	319	14.3	63.2	0.71
chrY	11329144	11329440	CpG: 30	296	30	217	20.3	73.3	0.76
chrY	11388938	11389154	CpG: 16	216	16	126	14.8	58.3	0.89
chrY	11390284	11390666	CpG: 30	382	30	273	15.7	71.5	0.62
chrY	11394357	11395144	CpG: 59	787	59	525	15.0	66.7	0.71
chrY	11436019	11436401	CpG: 29	382	29	266	15.2	69.6	0.65
chrY	11527882	11529586	CpG: 120	1704	120	1155	14.1	67.8	0.61
chrY	11536240	11537405	CpG: 83	1165	83	778	14.2	66.8	0.64
chrY	11552622	11552862	CpG: 19	240	19	143	15.8	59.6	0.92
chrY	11553589	11555621	CpG: 151	2032	151	1396	14.9	68.7	0.63
chrY	11650846	11651781	CpG: 87	935	87	649	18.6	69.4	0.79
chrY	11672991	11673257	CpG: 22	266	22	157	16.5	59.0	0.96
chrY	11674029	11674314	CpG: 23	285	23	177	16.1	62.1	0.85
chrY	12696285	12696711	CpG: 40	426	40	303	18.8	71.1	0.74
chrY	12842371	12842649	CpG: 24	278	24	173	17.3	62.2	0.90
chrY	12860428	12861197	CpG: 68	769	68	520	17.7	67.6	0.77
chrY	12861865	12862350	CpG: 43	485	43	341	17.7	70.3	0.72
chrY	12864026	12864234	CpG: 16	208	16	129	15.4	62.0	0.81
chrY	12886196	12886829	CpG: 72	633	72	416	22.7	65.7	1.06
chrY	12893368	12893711	CpG: 26	343	26	221	15.2	64.4	0.73
chrY	12933969	12934243	CpG: 21	274	21	167	15.3	60.9	0.84
chrY	13238525	13238747	CpG: 16	222	16	133	14.4	59.9	0.84
chrY	13280511	13280745	CpG: 16	234	16	139	13.7	59.4	0.80
chrY	13327941	13329426	CpG: 126	1485	126	1071	17.0	72.1	0.74
chrY	13360910	13361180	CpG: 22	270	22	194	16.3	71.9	0.63
chrY	13405324	13405608	CpG: 24	284	24	176	16.9	62.0	0.89
chrY	13444926	13445545	CpG: 56	619	56	400	18.1	64.6	0.87
chrY	13569096	13569369	CpG: 24	273	24	167	17.6	61.2	0.95
chrY	13722528	13722764	CpG: 21	236	21	144	17.8	61.0	0.98
chrY	13786541	13787233	CpG: 49	692	49	469	14.2	67.8	0.62
chrY	13798428	13798646	CpG: 19	218	19	131	17.4	60.1	0.98
chrY	13812904	13813658	CpG: 52	754	52	400	13.8	53.1	1.03
chrY	13937275	13937553	CpG: 23	278	23	170	16.5	61.2	0.89
chrY	13953977	13954214	CpG: 19	237	19	141	16.0	59.5	0.91
chrY	13989806	13990072	CpG: 20	266	20	148	15.0	55.6	0.99
chrY	14158606	14158880	CpG: 24	274	24	172	17.5	62.8	0.90
chrY	14218017	14218257	CpG: 23	240	23	150	19.2	62.5	1.00
chrY	14218818	14219093	CpG: 25	275	25	172	18.2	62.5	0.94
chrY	14292835	14293101	CpG: 23	266	23	166	17.3	62.4	0.90
chrY	14386068	14386529	CpG: 33	461	33	256	14.3	55.5	0.94
chrY	14471560	14471919	CpG: 24	359	24	210	13.4	58.5	0.78
chrY	14609400	14610529	CpG: 74	1129	74	637	13.1	56.4	0.82
chrY	14658095	14659584	CpG: 128	1489	128	975	17.2	65.5	0.80
chrY	14676537	14676818	CpG: 24	281	24	175	17.1	62.3	0.90
chrY	14700519	14700748	CpG: 19	229	19	141	16.6	61.6	0.91
chrY	14851453	14851690	CpG: 18	237	18	144	15.2	60.8	0.84
chrY	14907503	14907733	CpG: 17	230	17	154	14.8	67.0	0.66
chrY	14948289	14948519	CpG: 17	230	17	154	14.8	67.0	0.66
chrY	15087367	15087648	CpG: 25	281	25	175	17.8	62.3	0.93
chrY	15100400	15100679	CpG: 25	279	25	176	17.9	63.1	0.91
chrY	15103726	15104008	CpG: 22	282	22	174	15.6	61.7	0.84
chrY	15377898	15378108	CpG: 17	210	17	129	16.2	61.4	0.88
chrY	15385324	15385605	CpG: 24	281	24	175	17.1	62.3	0.90
chrY	15396059	15396333	CpG: 24	274	24	171	17.5	62.4	0.91
chrY	15430487	15430795	CpG: 22	308	22	187	14.3	60.7	0.79
chrY	15431038	15431739	CpG: 57	701	57	471	16.3	67.2	0.72
chrY	15629239	15629517	CpG: 25	278	25	174	18.0	62.6	0.93
chrY	15691005	15691283	CpG: 24	278	24	171	17.3	61.5	0.92
chrY	15702944	15703190	CpG: 21	246	21	152	17.1	61.8	0.92
chrY	15736505	15736871	CpG: 32	366	32	215	17.5	58.7	1.01
chrY	15799020	15799279	CpG: 21	259	21	158	16.2	61.0	0.88
chrY	15869364	15869594	CpG: 19	230	19	140	16.5	60.9	0.90
chrY	15938610	15938888	CpG: 24	278	24	174	17.3	62.6	0.89
chrY	15998006	15998279	CpG: 22	273	22	169	16.1	61.9	0.85
chrY	16143764	16144045	CpG: 22	281	22	174	15.7	61.9	0.84
chrY	16269601	16269877	CpG: 24	276	24	170	17.4	61.6	0.93
chrY	16362213	16363251	CpG: 99	1038	99	695	19.1	67.0	0.85
chrY	16378798	16379028	CpG: 20	230	20	141	17.4	61.3	0.94
chrY	16459312	16459586	CpG: 21	274	21	166	15.3	60.6	0.84
chrY	16501727	16501961	CpG: 19	234	19	145	16.2	62.0	0.87
chrY	16715283	16715513	CpG: 17	230	17	136	14.8	59.1	0.87
chrY	16789158	16789431	CpG: 21	273	21	171	15.4	62.6	0.79
chrY	16803294	16803567	CpG: 21	273	21	171	15.4	62.6	0.79
chrY	17159018	17159277	CpG: 20	259	20	158	15.4	61.0	0.83
chrY	17164201	17164485	CpG: 25	284	25	179	17.6	63.0	0.89
chrY	17233953	17234237	CpG: 25	284	25	179	17.6	63.0	0.89
chrY	17239159	17239418	CpG: 20	259	20	158	15.4	61.0	0.83
chrY	17343781	17343997	CpG: 16	216	16	130	14.8	60.2	0.83
chrY	17530380	17530654	CpG: 24	274	24	175	17.5	63.9	0.87
chrY	17541668	17541943	CpG: 25	275	25	172	18.2	62.5	0.94
chrY	17651515	17651801	CpG: 24	286	24	178	16.8	62.2	0.88
chrY	17753610	17753839	CpG: 20	229	20	140	17.5	61.1	0.94
chrY	17920026	17920262	CpG: 21	236	21	145	17.8	61.4	0.97
chrY	17973140	17973441	CpG: 23	301	23	176	15.3	58.5	0.90
chrY	17982097	17982371	CpG: 25	274	25	173	18.2	63.1	0.93
chrY	17984082	17984357	CpG: 25	275	25	171	18.2	62.2	0.95
chrY	18065666	18065924	CpG: 19	258	19	157	14.7	60.9	0.81
chrY	18188757	18189002	CpG: 18	245	18	143	14.7	58.4	0.89
chrY	18341812	18342087	CpG: 24	275	24	170	17.5	61.8	0.92
chrY	18424873	18425134	CpG: 21	261	21	167	16.1	64.0	0.79
chrY	18465982	18466245	CpG: 19	263	19	173	14.4	65.8	0.69
chrY	18468298	18468675	CpG: 30	377	30	246	15.9	65.3	0.75
chrY	18468996	18469303	CpG: 21	307	21	203	13.7	66.1	0.63
chrY	18469933	18471979	CpG: 139	2046	139	1291	13.6	63.1	0.69
chrY	18474382	18474594	CpG: 17	212	17	123	16.0	58.0	0.96
chrY	18485882	18486430	CpG: 39	548	39	352	14.2	64.2	0.69
chrY	18762155	18762429	CpG: 24	274	24	171	17.5	62.4	0.91
chrY	18956607	18956881	CpG: 24	274	24	171	17.5	62.4	0.91
chrY	19232612	19233160	CpG: 39	548	39	352	14.2	64.2	0.69
chrY	19244443	19244655	CpG: 17	212	17	123	16.0	58.0	0.96
chrY	19247058	19249104	CpG: 139	2046	139	1291	13.6	63.1	0.69
chrY	19249734	19250041	CpG: 21	307	21	203	13.7	66.1	0.63
chrY	19250362	19250739	CpG: 30	377	30	246	15.9	65.3	0.75
chrY	19252792	19253055	CpG: 19	263	19	173	14.4	65.8	0.69
chrY	19293901	19294162	CpG: 21	261	21	167	16.1	64.0	0.79
chrY	19398585	19398859	CpG: 24	274	24	172	17.5	62.8	0.90
chrY	19734508	19734782	CpG: 24	274	24	172	17.5	62.8	0.90
chrY	19899221	19899658	CpG: 61	437	61	328	27.9	75.1	0.99
chrY	19953111	19953627	CpG: 49	516	49	373	19.0	72.3	0.73
chrY	19969418	19969688	CpG: 21	270	21	162	15.6	60.0	0.88
chrY	19982476	19984621	CpG: 167	2145	167	1381	15.6	64.4	0.75
chrY	20260226	20260511	CpG: 26	285	26	178	18.2	62.5	0.94
chrY	20319949	20320232	CpG: 23	283	23	174	16.3	61.5	0.87
chrY	20409159	20409741	CpG: 41	582	41	349	14.1	60.0	0.80
chrY	20473817	20474230	CpG: 33	413	33	260	16.0	63.0	0.82
chrY	20767926	20768163	CpG: 19	237	19	141	16.0	59.5	0.94
chrY	20830246	20830635	CpG: 30	389	30	276	15.4	71.0	0.62
chrY	20845358	20845654	CpG: 24	296	24	182	16.2	61.5	0.86
chrY	21451144	21451371	CpG: 16	227	16	131	14.1	57.7	0.86
chrY	21529414	21529699	CpG: 22	285	22	175	15.4	61.4	0.84
chrY	21701872	21702098	CpG: 16	226	16	127	14.2	56.2	0.90
chrY	21747659	21747937	CpG: 24	278	24	175	17.3	62.9	0.88
chrY	22168443	22168717	CpG: 23	274	23	169	16.8	61.7	0.89
chrY	22279947	22280240	CpG: 25	293	25	191	17.1	65.2	0.80
chrY	22282469	22282858	CpG: 32	389	32	278	16.5	71.5	0.65
chrY	22322617	22322897	CpG: 24	280	24	170	17.1	60.7	0.94
chrY	22386415	22386713	CpG: 29	298	29	199	19.5	66.8	0.87
chrY	22409945	22410243	CpG: 29	298	29	199	19.5	66.8	0.87
chrY	22520695	22520924	CpG: 19	229	19	142	16.6	62.0	0.87
chrY	22538838	22539063	CpG: 17	225	17	131	15.1	58.2	0.92
chrY	22552134	22552699	CpG: 46	565	46	410	16.3	72.6	0.62
chrY	22729927	22730225	CpG: 29	298	29	199	19.5	66.8	0.87
chrY	22753456	22753754	CpG: 29	298	29	199	19.5	66.8	0.87
chrY	23018397	23018695	CpG: 30	298	30	200	20.1	67.1	0.89
chrY	23026199	23026466	CpG: 22	267	22	163	16.5	61.0	0.90
chrY	23113004	23113283	CpG: 24	279	24	185	17.2	66.3	0.78
chrY	23146884	23147167	CpG: 22	283	22	173	15.5	61.1	0.84
chrY	23231113	23231380	CpG: 22	267	22	163	16.5	61.0	0.90
chrY	23238884	23239182	CpG: 30	298	30	200	20.1	67.1	0.89
chrY	23775771	23776045	CpG: 24	274	24	170	17.5	62.0	0.92
chrY	23866426	23866649	CpG: 17	223	17	135	15.2	60.5	0.85
chrY	23897084	23897320	CpG: 22	236	22	147	18.6	62.3	0.98
chrY	23977993	23978311	CpG: 26	318	26	191	16.4	60.1	0.91
chrY	24022121	24022402	CpG: 24	281	24	175	17.1	62.3	0.90
chrY	24025542	24025924	CpG: 27	382	27	258	14.1	67.5	0.64
chrY	24026151	24026378	CpG: 21	227	21	162	18.5	71.4	0.76
chrY	24046551	24046778	CpG: 21	227	21	161	18.5	70.9	0.77
chrY	24047005	24047387	CpG: 27	382	27	258	14.1	67.5	0.64
chrY	24050527	24050808	CpG: 24	281	24	175	17.1	62.3	0.90
chrY	24071855	24072173	CpG: 26	318	26	191	16.4	60.1	0.91
chrY	24167168	24167404	CpG: 22	236	22	147	18.6	62.3	0.98
chrY	24197835	24198058	CpG: 17	223	17	135	15.2	60.5	0.85
chrY	24288428	24288702	CpG: 24	274	24	170	17.5	62.0	0.92
chrY	24594498	24594772	CpG: 20	274	20	161	14.6	58.8	0.86
chrY	24656403	24657376	CpG: 76	973	76	672	15.6	69.1	0.66
chrY	24697786	24698064	CpG: 23	278	23	174	16.5	62.6	0.85
chrY	24752101	24752379	CpG: 23	278	23	173	16.5	62.2	0.86
chrY	24918878	24919152	CpG: 24	274	24	171	17.5	62.4	0.91
chrY	25108973	25109210	CpG: 21	237	21	144	17.7	60.8	0.98
chrY	25203633	25203907	CpG: 24	274	24	170	17.5	62.0	0.92
chrY	25587078	25587396	CpG: 26	318	26	191	16.4	60.1	0.91
chrY	25637291	25637572	CpG: 24	281	24	175	17.1	62.3	0.90
chrY	25640712	25641094	CpG: 26	382	26	257	13.6	67.3	0.62
chrY	25641321	25641548	CpG: 21	227	21	161	18.5	70.9	0.77
chrY	25661720	25661947	CpG: 21	227	21	161	18.5	70.9	0.77
chrY	25662174	25662556	CpG: 27	382	27	258	14.1	67.5	0.64
chrY	25665696	25665977	CpG: 24	281	24	175	17.1	62.3	0.90
chrY	25694180	25694498	CpG: 26	318	26	191	16.4	60.1	0.91
chrY	25787109	25787345	CpG: 22	236	22	147	18.6	62.3	0.98
chrY	25817790	25818013	CpG: 17	223	17	135	15.2	60.5	0.85
chrY	25908403	25908677	CpG: 24	274	24	170	17.5	62.0	0.92
chrY	26214444	26214718	CpG: 20	274	20	161	14.6	58.8	0.86
chrY	26276353	26277326	CpG: 76	973	76	672	15.6	69.1	0.66
chrY	26317737	26318015	CpG: 23	278	23	174	16.5	62.6	0.85
chrY	26372065	26372343	CpG: 23	278	23	173	16.5	62.2	0.86
chrY	26538828	26539102	CpG: 24	274	24	171	17.5	62.4	0.91
chrY	26728914	26729151	CpG: 21	237	21	144	17.7	60.8	0.98
chrY	26823581	26823855	CpG: 25	274	25	171	18.2	62.4	0.95
chrY	27123270	27123493	CpG: 18	223	18	135	16.1	60.5	0.90
chrY	27127503	27127789	CpG: 25	286	25	177	17.5	61.9	0.92
chrY	27140040	27140314	CpG: 23	274	23	168	16.8	61.3	0.91
chrY	27156762	27157054	CpG: 24	292	24	182	16.4	62.3	0.86
chrY	27219469	27219742	CpG: 24	273	24	174	17.6	63.7	0.87
chrY	27220813	27221687	CpG: 62	874	62	568	14.2	65.0	0.68
chrY	27390004	27390278	CpG: 24	274	24	171	17.5	62.4	0.91
chrY	27439122	27439351	CpG: 25	229	25	172	21.8	75.1	0.78
chrY	51292333	51292567	CpG: 21	234	21	141	17.9	60.3	1.00
chrY	51343376	51343610	CpG: 21	234	21	142	17.9	60.7	0.99
chrY	52852332	52852566	CpG: 21	234	21	141	17.9	60.3	1.00
chrY	52908200	52908434	CpG: 21	234	21	142	17.9	60.7	0.99
chrY	55267980	55268213	CpG: 21	233	21	141	18.0	60.5	0.99
chrY	57873951	57874185	CpG: 21	234	21	141	17.9	60.3	1.00
chrY	58709514	58709748	CpG: 21	234	21	141	17.9	60.3	1.00
chrY	59769581	59769810	CpG: 20	229	20	137	17.5	59.8	0.98
chrY	62209961	62210163	CpG: 16	202	16	113	15.8	55.9	1.06
chrY	62263185	62263459	CpG: 23	274	23	169	16.8	61.7	0.89
chrY	62285320	62285597	CpG: 25	277	25	175	18.1	63.2	0.92
chrY	62306105	62306495	CpG: 36	390	36	257	18.5	65.9	0.86
chrY	62332791	62333422	CpG: 46	631	46	421	14.6	66.7	0.66
chrY	62441587	62441895	CpG: 29	308	29	212	18.8	68.8	0.80
chrY	62452543	62453296	CpG: 126	753	126	574	33.5	76.2	1.16
